price,bedrooms,bathrooms,sqft_living,sqft_lot,floors,condition,grade,sqft_above,sqft_basement,yr_built,sqft_living15,sqft_lot15,age,day_of_year,bed_bath_ratio,level_ratio,relative_living_space,relative_lot_size,level_difference
221900.0,3,1.0,1180,5650,1.0,3,7,1180,0.0,1955,1340,5650,24538 days 16:47:18.657898,286,3.0,0.0,-160,0,1180.0
538000.0,3,2.25,2570,7242,2.0,3,7,2170,400.0,1951,1690,7639,25999 days 16:47:18.657898,343,1.3333333333333333,5.425,880,-397,1770.0
180000.0,2,1.0,770,10000,1.0,3,6,770,0.0,1933,2720,8062,32573 days 16:47:18.657898,056,2.0,0.0,-1950,1938,770.0
604000.0,4,3.0,1960,5000,1.0,5,7,1050,910.0,1965,1360,5000,20885 days 16:47:18.657898,343,1.3333333333333333,1.1538461538461537,600,0,140.0
510000.0,3,2.0,1680,8080,1.0,3,8,1680,0.0,1987,1800,7503,12850 days 16:47:18.657898,049,1.5,0.0,-120,577,1680.0
1230000.0,4,4.5,5420,101930,1.0,3,1,3890,1530.0,2001,4760,101930,7736 days 16:47:18.657898,132,0.8888888888888888,2.542483660130719,660,0,2360.0
291850.0,3,1.5,1060,9711,1.0,3,7,1060,0.0,1963,1650,9711,21616 days 16:47:18.657898,015,2.0,0.0,-590,0,1060.0
229500.0,3,1.0,1780,7470,1.0,3,7,1050,730.0,1960,1780,8113,22712 days 16:47:18.657898,105,3.0,1.4383561643835616,0,-643,320.0
323000.0,3,2.5,1890,6560,2.0,3,7,1890,0.0,2003,2390,7570,7006 days 16:47:18.657898,071,1.2,0.0,-500,-1010,1890.0
662500.0,3,2.5,3560,9796,1.0,3,8,1860,1700.0,1965,2210,8925,20885 days 16:47:18.657898,093,1.2,1.0941176470588236,1350,871,160.0
468000.0,2,1.0,1160,6000,1.0,4,7,860,300.0,1942,1330,6000,29286 days 16:47:18.657898,147,2.0,2.8666666666666667,-170,0,560.0
310000.0,3,1.0,1430,19901,1.5,4,7,1430,0.0,1927,1780,12697,34765 days 16:47:18.657898,148,3.0,0.0,-350,7204,1430.0
400000.0,3,1.75,1370,9680,1.0,4,7,1370,0.0,1977,1370,10208,16502 days 16:47:18.657898,280,1.7142857142857142,0.0,0,-528,1370.0
530000.0,5,2.0,1810,4850,1.5,3,7,1810,0.0,1900,1360,4850,44626 days 16:47:18.657898,071,2.5,0.0,450,0,1810.0
650000.0,4,3.0,2950,5000,2.0,3,9,1980,970.0,1979,2140,4000,15772 days 16:47:18.657898,024,1.3333333333333333,2.0412371134020617,810,1000,1010.0
395000.0,3,2.0,1890,14040,2.0,3,7,1890,0.0,1994,1890,14018,10293 days 16:47:18.657898,212,1.5,0.0,0,22,1890.0
485000.0,4,1.0,1600,4300,1.5,4,7,1600,0.0,1916,1610,4300,38783 days 16:47:18.657898,149,4.0,0.0,-10,0,1600.0
230000.0,3,1.0,1250,9774,1.0,4,7,1250,0.0,1969,1280,8850,19424 days 16:47:18.657898,114,3.0,0.0,-30,924,1250.0
385000.0,4,1.75,1620,4980,1.0,4,7,860,760.0,1947,1400,4980,27460 days 16:47:18.657898,134,2.2857142857142856,1.131578947368421,220,0,100.0
2000000.0,3,2.75,3050,44867,1.0,3,9,2330,720.0,1968,4110,20336,19790 days 16:47:18.657898,238,1.0909090909090908,3.236111111111111,-1060,24531,1610.0
285000.0,5,2.5,2270,6300,2.0,3,8,2270,0.0,1995,2240,7005,9928 days 16:47:18.657898,184,2.0,0.0,30,-705,2270.0
252700.0,2,1.5,1070,9643,1.0,3,7,1070,0.0,1985,1220,8386,13580 days 16:47:18.657898,136,1.3333333333333333,0.0,-150,1257,1070.0
329000.0,3,2.25,2450,6500,2.0,4,8,2450,0.0,1985,2200,6865,13580 days 16:47:18.657898,324,1.3333333333333333,0.0,250,-365,2450.0
233000.0,3,2.0,1710,4697,1.5,5,6,1710,0.0,1941,1030,4705,29651 days 16:47:18.657898,307,1.5,0.0,680,-8,1710.0
937000.0,3,1.75,2450,2691,2.0,3,8,1750,700.0,1915,1760,3573,39148 days 16:47:18.657898,177,1.7142857142857142,2.5,690,-882,1050.0
667000.0,3,1.0,1400,1581,1.5,5,8,1400,0.0,1909,1860,3861,41339 days 16:47:18.657898,335,3.0,0.0,-460,-2280,1400.0
438000.0,3,1.75,1520,6380,1.0,3,7,790,730.0,1948,1520,6235,27095 days 16:47:18.657898,175,1.7142857142857142,1.082191780821918,0,145,60.0
719000.0,4,2.5,2570,7173,2.0,3,8,2570,0.0,2005,2630,6026,6275 days 16:47:18.657898,061,1.6,0.0,-60,1147,2570.0
580500.0,3,2.5,2320,3980,2.0,3,8,2320,0.0,2003,2580,3980,7006 days 16:47:18.657898,314,1.2,0.0,-260,0,2320.0
280000.0,2,1.5,1190,1265,3.0,3,7,1190,0.0,2005,1390,1756,6275 days 16:47:18.657898,335,1.3333333333333333,0.0,-200,-491,1190.0
687500.0,4,1.75,2330,5000,1.5,4,7,1510,820.0,1929,1460,5000,34034 days 16:47:18.657898,175,2.2857142857142856,1.8414634146341464,870,0,690.0
535000.0,3,1.0,1090,3000,1.5,4,8,1090,0.0,1929,1570,5080,34034 days 16:47:18.657898,314,3.0,0.0,-480,-2080,1090.0
322500.0,4,2.75,2060,6659,1.0,3,7,1280,780.0,1981,2020,8720,15041 days 16:47:18.657898,337,1.4545454545454546,1.641025641025641,40,-2061,500.0
696000.0,3,2.5,2300,3060,1.5,3,8,1510,790.0,1930,1590,3264,33669 days 16:47:18.657898,164,1.2,1.9113924050632911,710,-204,720.0
550000.0,4,1.0,1660,34848,1.0,1,5,930,730.0,1933,2160,11467,32573 days 16:47:18.657898,148,4.0,1.273972602739726,-500,23381,200.0
640000.0,4,2.0,2360,6000,2.0,4,8,2360,0.0,1904,1730,4700,43166 days 16:47:18.657898,364,2.0,0.0,630,1300,2360.0
240000.0,4,1.0,1220,8075,1.0,2,7,890,330.0,1969,1290,7800,19424 days 16:47:18.657898,044,4.0,2.696969696969697,-70,275,560.0
605000.0,4,2.5,2620,7553,2.0,3,8,2620,0.0,1996,2620,11884,9563 days 16:47:18.657898,171,1.6,0.0,0,-4331,2620.0
625000.0,4,2.5,2570,5520,2.0,3,9,2570,0.0,2000,2470,5669,8102 days 16:47:18.657898,196,1.6,0.0,100,-149,2570.0
775000.0,4,2.25,4220,24186,1.0,3,8,2600,1620.0,1984,2410,30617,13946 days 16:47:18.657898,223,1.7777777777777777,1.6049382716049383,1810,-6431,980.0
685000.0,3,1.0,1570,2280,2.0,3,7,1570,0.0,1922,1580,2640,36591 days 16:47:18.657898,301,3.0,0.0,-10,-360,1570.0
309000.0,3,1.0,1280,9656,1.0,4,6,920,360.0,1959,1340,8808,23077 days 16:47:18.657898,210,3.0,2.5555555555555554,-60,848,560.0
488000.0,3,2.5,3160,13603,2.0,3,8,3160,0.0,2003,3050,9232,7006 days 16:47:18.657898,199,1.2,0.0,110,4371,3160.0
210490.0,3,1.0,990,8528,1.0,3,6,990,0.0,1966,1228,8840,20520 days 16:47:18.657898,084,3.0,0.0,-238,-312,990.0
785000.0,4,2.5,2290,13416,2.0,4,9,2290,0.0,1981,2680,13685,15041 days 16:47:18.657898,197,1.6,0.0,-390,-269,2290.0
450000.0,3,1.75,1250,5963,1.0,4,7,1250,0.0,1953,970,5100,25268 days 16:47:18.657898,118,1.7142857142857142,0.0,280,863,1250.0
1350000.0,3,2.5,2753,65005,1.0,5,9,2165,588.0,1953,2680,72513,25268 days 16:47:18.657898,070,1.2,3.681972789115646,73,-7508,1577.0
228000.0,3,1.0,1190,9199,1.0,3,7,1190,0.0,1955,1190,9364,24538 days 16:47:18.657898,259,3.0,0.0,0,-165,1190.0
345000.0,5,2.5,3150,9134,1.0,4,8,1640,1510.0,1966,1990,9133,20520 days 16:47:18.657898,048,2.0,1.086092715231788,1160,1,130.0
600000.0,3,1.75,1410,4080,1.0,4,7,1000,410.0,1950,1410,4080,26364 days 16:47:18.657898,365,1.7142857142857142,2.4390243902439024,0,0,590.0
585000.0,2,1.75,1980,8550,1.0,3,7,990,990.0,1981,1480,6738,15041 days 16:47:18.657898,036,1.1428571428571428,1.0,500,1812,0.0
920000.0,5,2.25,2730,6000,1.5,3,8,2130,600.0,1927,2730,6000,34765 days 16:47:18.657898,062,2.2222222222222223,3.55,0,0,1530.0
885000.0,4,2.5,2830,5000,2.0,3,9,2830,0.0,1995,1950,5000,9928 days 16:47:18.657898,132,1.6,0.0,880,0,2830.0
292500.0,4,2.5,2250,4495,2.0,3,7,2250,0.0,2008,2250,4500,5180 days 16:47:18.657898,231,1.6,0.0,0,-5,2250.0
301000.0,3,2.5,2420,4750,2.0,3,8,2420,0.0,2003,2690,4750,7006 days 16:47:18.657898,097,1.2,0.0,-270,0,2420.0
951000.0,5,3.25,3250,14342,2.0,4,8,3250,0.0,1968,2960,11044,19790 days 16:47:18.657898,239,1.5384615384615385,0.0,290,3298,3250.0
430000.0,4,3.0,1850,9976,2.0,3,8,1850,0.0,1991,2270,8542,11389 days 16:47:18.657898,054,1.3333333333333333,0.0,-420,1434,1850.0
650000.0,3,2.25,2150,21235,1.0,4,8,1590,560.0,1959,2570,18900,23077 days 16:47:18.657898,344,1.3333333333333333,2.8392857142857144,-420,2335,1030.0
289000.0,3,1.75,1260,8400,1.0,3,7,1260,0.0,1954,1290,8750,24903 days 16:47:18.657898,240,1.7142857142857142,0.0,-30,-350,1260.0
505000.0,3,1.75,2519,8690,2.0,5,8,2519,0.0,1973,2500,9500,17963 days 16:47:18.657898,294,1.7142857142857142,0.0,19,-810,2519.0
549000.0,3,1.75,1540,1044,3.0,3,8,1540,0.0,2014,1580,3090,2988 days 16:47:18.657898,341,1.7142857142857142,0.0,-40,-2046,1540.0
425000.0,3,2.25,1660,6000,1.0,3,7,1110,550.0,1979,1440,4080,15772 days 16:47:18.657898,154,1.3333333333333333,2.018181818181818,220,1920,560.0
317625.0,3,2.75,2770,3809,1.5,5,7,1770,1000.0,1925,1440,4000,35495 days 16:47:18.657898,324,1.0909090909090908,1.77,1330,-191,770.0
975000.0,4,2.5,2720,11049,2.0,3,1,2720,0.0,1989,2750,11049,12119 days 16:47:18.657898,252,1.6,0.0,-30,0,2720.0
287000.0,4,2.5,2240,4648,2.0,3,7,2240,0.0,2005,2221,4557,6275 days 16:47:18.657898,282,1.6,0.0,19,91,2240.0
204000.0,3,1.0,1000,12070,1.0,4,7,1000,0.0,1968,1010,12635,19790 days 16:47:18.657898,237,3.0,0.0,-10,-565,1000.0
1330000.0,5,2.25,3200,20158,1.0,3,8,1600,1600.0,1965,3390,20158,20885 days 16:47:18.657898,163,2.2222222222222223,1.0,-190,0,0.0
1040000.0,5,3.25,4770,50094,1.0,4,1,3070,1700.0,1973,3530,38917,17963 days 16:47:18.657898,255,1.5384615384615385,1.8058823529411765,1240,11177,1370.0
325000.0,3,2.0,1260,5612,1.0,4,7,1260,0.0,1972,1640,4745,18329 days 16:47:18.657898,005,1.5,0.0,-380,867,1260.0
571000.0,4,2.0,2750,7807,1.5,5,7,2250,500.0,1916,1510,7807,38783 days 16:47:18.657898,161,2.0,4.5,1240,0,1750.0
360000.0,4,2.5,2380,5000,2.0,3,8,2380,0.0,2005,2420,5000,6275 days 16:47:18.657898,191,1.6,0.0,-40,0,2380.0
349000.0,3,1.75,1790,50529,1.0,5,7,1090,700.0,1965,1940,50529,20885 days 16:47:18.657898,075,1.7142857142857142,1.5571428571428572,-150,0,390.0
832500.0,4,4.0,3430,35102,2.0,4,1,2390,1040.0,1986,3240,35020,13215 days 16:47:18.657898,309,1.0,2.298076923076923,190,82,1350.0
380000.0,4,1.75,1760,7300,1.0,3,7,880,880.0,1956,1680,7500,24173 days 16:47:18.657898,286,2.2857142857142856,1.0,80,-200,0.0
480000.0,3,1.0,1040,5060,1.0,3,7,1040,0.0,1941,890,5060,29651 days 16:47:18.657898,110,3.0,0.0,150,0,1040.0
410000.0,3,1.0,1410,5060,1.0,4,7,910,500.0,1956,1130,5693,24173 days 16:47:18.657898,160,3.0,1.82,280,-633,410.0
390000.0,3,2.5,2350,5100,2.0,3,8,2350,0.0,2003,2350,5363,7006 days 16:47:18.657898,336,1.2,0.0,0,-263,2350.0
360000.0,4,2.5,1900,5889,2.0,3,7,1900,0.0,1992,1870,6405,11024 days 16:47:18.657898,356,1.6,0.0,30,-516,1900.0
355000.0,2,1.0,2020,6720,1.0,3,7,1010,1010.0,1948,1720,6720,27095 days 16:47:18.657898,301,2.0,1.0,300,0,0.0
356000.0,3,1.5,1680,8712,1.0,3,8,1680,0.0,1964,1850,8797,21251 days 16:47:18.657898,028,2.0,0.0,-170,-85,1680.0
315000.0,3,1.0,960,6634,1.0,3,6,960,0.0,1952,1570,7203,25634 days 16:47:18.657898,153,3.0,0.0,-610,-569,960.0
940000.0,3,1.5,2140,3600,2.0,3,9,1900,240.0,1925,2020,4800,35495 days 16:47:18.657898,318,2.0,7.916666666666667,120,-1200,1660.0
305000.0,5,2.25,2660,8400,1.5,5,7,2660,0.0,1961,1590,8165,22346 days 16:47:18.657898,307,2.2222222222222223,0.0,1070,235,2660.0
461000.0,3,3.25,2770,6278,2.0,3,9,1980,790.0,2006,1900,7349,5910 days 16:47:18.657898,169,0.9230769230769231,2.5063291139240507,870,-1071,1190.0
215000.0,2,2.25,1610,2040,2.0,4,7,1610,0.0,1979,1950,2025,15772 days 16:47:18.657898,139,0.8888888888888888,0.0,-340,15,1610.0
335000.0,2,1.75,1030,1066,2.0,3,7,765,265.0,2006,1030,1106,5910 days 16:47:18.657898,247,1.1428571428571428,2.8867924528301887,0,-40,500.0
243500.0,4,2.5,1980,7403,2.0,3,7,1980,0.0,1988,1980,7510,12485 days 16:47:18.657898,142,1.6,0.0,0,-107,1980.0
1100000.0,5,2.75,3520,6353,2.0,4,1,3520,0.0,2001,2520,6250,7736 days 16:47:18.657898,070,1.8181818181818181,0.0,1000,103,3520.0
153000.0,3,1.0,1200,10500,1.0,3,7,1200,0.0,1962,1350,10500,21981 days 16:47:18.657898,057,3.0,0.0,-150,0,1200.0
430000.0,3,1.5,1580,5000,1.0,3,8,1290,290.0,1939,1570,4500,30382 days 16:47:18.657898,206,2.0,4.448275862068965,10,500,1000.0
700000.0,3,1.5,1580,5000,1.0,3,8,1290,290.0,1939,1570,4500,30382 days 16:47:18.657898,357,2.0,4.448275862068965,10,500,1000.0
905000.0,4,2.5,3300,10250,1.0,3,7,2390,910.0,1946,1950,6045,27825 days 16:47:18.657898,251,1.6,2.6263736263736264,1350,4205,1480.0
247500.0,3,1.75,1960,15681,1.0,3,7,1960,0.0,1967,1750,15616,20155 days 16:47:18.657898,089,1.7142857142857142,0.0,210,65,1960.0
199000.0,4,1.5,1160,6400,1.0,4,7,1160,0.0,1975,1160,6400,17233 days 16:47:18.657898,255,2.6666666666666665,0.0,0,0,1160.0
314000.0,3,1.75,1810,41800,1.0,5,7,1210,600.0,1980,1650,135036,15407 days 16:47:18.657898,192,1.7142857142857142,2.0166666666666666,160,-93236,610.0
437500.0,3,2.5,2320,36847,2.0,3,9,2320,0.0,1992,2550,35065,11024 days 16:47:18.657898,136,1.2,0.0,-230,1782,2320.0
850830.0,3,2.5,2070,13241,1.5,5,9,1270,800.0,1910,2200,4500,40974 days 16:47:18.657898,162,1.2,1.5875,-130,8741,470.0
555000.0,3,2.0,1980,3478,1.5,4,7,1440,540.0,1929,1610,3478,34034 days 16:47:18.657898,300,1.5,2.6666666666666665,370,0,900.0
699950.0,3,2.25,2190,107593,2.0,4,8,2190,0.0,1983,2570,47777,14311 days 16:47:18.657898,346,1.3333333333333333,0.0,-380,59816,2190.0
1090000.0,3,2.5,2920,8113,2.0,3,8,2920,0.0,1950,2370,8113,26364 days 16:47:18.657898,280,1.2,0.0,550,0,2920.0
290000.0,3,1.0,1210,33919,1.0,3,7,1210,0.0,1954,1640,14910,24903 days 16:47:18.657898,267,3.0,0.0,-430,19009,1210.0
375000.0,3,2.5,2340,10005,1.0,4,8,1460,880.0,1978,2250,8162,16137 days 16:47:18.657898,092,1.2,1.6590909090909092,90,1843,580.0
460000.0,3,1.0,1670,4005,1.5,4,7,1170,500.0,1939,1240,4005,30382 days 16:47:18.657898,143,3.0,2.34,430,0,670.0
188500.0,2,1.75,1240,2493,1.0,4,8,1240,0.0,1985,1270,4966,13580 days 16:47:18.657898,204,1.1428571428571428,0.0,-30,-2473,1240.0
680000.0,4,2.5,3140,28037,2.0,4,1,3140,0.0,1991,2990,35001,11389 days 16:47:18.657898,064,1.6,0.0,150,-6964,3140.0
470000.0,5,1.75,2030,12342,2.0,4,7,2030,0.0,1942,2500,9433,29286 days 16:47:18.657898,239,2.857142857142857,0.0,-470,2909,2030.0
597750.0,4,2.5,2310,9624,2.0,3,8,2310,0.0,1984,1940,9636,13946 days 16:47:18.657898,206,1.6,0.0,370,-12,2310.0
570000.0,3,1.75,1260,3328,1.0,5,6,700,560.0,1905,1380,3536,42800 days 16:47:18.657898,063,1.7142857142857142,1.25,-120,-208,140.0
329950.0,3,1.75,2080,5969,1.0,3,7,1080,1000.0,1971,2090,5500,18694 days 16:47:18.657898,328,1.7142857142857142,1.08,-10,469,80.0
480000.0,4,2.5,3230,16171,2.0,3,9,2520,710.0,2001,2640,8517,7736 days 16:47:18.657898,301,1.6,3.5492957746478875,590,7654,1810.0
518500.0,3,3.5,1590,1102,3.0,3,8,1590,0.0,2010,1620,3166,4449 days 16:47:18.657898,177,0.8571428571428571,0.0,-30,-2064,1590.0
205425.0,2,1.0,880,6780,1.0,4,6,880,0.0,1945,1190,6780,28190 days 16:47:18.657898,174,2.0,0.0,-310,0,880.0
171800.0,4,2.0,1570,9600,1.0,3,6,1570,0.0,1950,1880,9000,26364 days 16:47:18.657898,008,2.0,0.0,-310,600,1570.0
535000.0,4,1.0,1610,2982,1.5,4,7,1610,0.0,1925,1610,4040,35495 days 16:47:18.657898,131,4.0,0.0,0,-1058,1610.0
660000.0,3,2.5,2400,6474,1.0,3,8,1560,840.0,1964,2340,10856,21251 days 16:47:18.657898,002,1.2,1.8571428571428572,60,-4382,720.0
391500.0,3,2.0,1450,9132,1.0,3,7,1450,0.0,1987,1580,9104,12850 days 16:47:18.657898,323,1.5,0.0,-130,28,1450.0
395000.0,2,1.0,770,6000,1.0,3,6,770,0.0,1953,1710,6000,25268 days 16:47:18.657898,096,2.0,0.0,-940,0,770.0
445000.0,4,1.75,2100,4400,1.5,5,7,1720,380.0,1924,1850,4400,35861 days 16:47:18.657898,308,2.2857142857142856,4.526315789473684,250,0,1340.0
770000.0,3,2.25,2910,10204,2.0,3,9,2910,0.0,1990,2700,13992,11754 days 16:47:18.657898,169,1.3333333333333333,0.0,210,-3788,2910.0
1450000.0,4,2.75,2750,17789,1.5,3,8,1980,770.0,1914,3060,11275,39513 days 16:47:18.657898,061,1.4545454545454546,2.5714285714285716,-310,6514,1210.0
445000.0,3,2.25,2100,8201,1.0,3,8,1620,480.0,1967,2660,8712,20155 days 16:47:18.657898,198,1.3333333333333333,3.375,-560,-511,1140.0
260000.0,4,2.25,2160,8811,1.0,3,8,1360,800.0,1978,2090,8400,16137 days 16:47:18.657898,198,1.7777777777777777,1.7,70,411,560.0
822500.0,5,3.5,2320,4960,2.0,5,7,1720,600.0,1926,1700,4960,35130 days 16:47:18.657898,164,1.4285714285714286,2.8666666666666667,620,0,1120.0
430000.0,4,2.5,2070,4310,2.0,3,7,2070,0.0,2004,1970,3748,6641 days 16:47:18.657898,096,1.6,0.0,100,562,2070.0
212000.0,3,1.75,1060,7875,1.0,4,7,1060,0.0,1986,1420,7680,13215 days 16:47:18.657898,005,1.7142857142857142,0.0,-360,195,1060.0
660500.0,4,2.25,2010,9603,1.0,3,8,1440,570.0,1986,2060,9793,13215 days 16:47:18.657898,118,1.7777777777777777,2.526315789473684,-50,-190,870.0
784000.0,3,3.5,3950,111078,1.5,3,9,2460,1490.0,1989,2480,88500,12119 days 16:47:18.657898,163,0.8571428571428571,1.651006711409396,1470,22578,970.0
453246.0,3,2.5,2010,2287,2.0,3,8,1390,620.0,2014,1690,1662,2988 days 16:47:18.657898,132,1.2,2.2419354838709675,320,625,770.0
675000.0,4,3.5,2140,2278,3.0,3,9,2140,0.0,2005,1540,2285,6275 days 16:47:18.657898,026,1.1428571428571428,0.0,600,-7,2140.0
199000.0,3,1.75,1320,17390,1.0,4,7,1320,0.0,1956,1550,19265,24173 days 16:47:18.657898,225,1.7142857142857142,0.0,-230,-1875,1320.0
220000.0,4,1.75,2020,7840,1.0,3,7,1010,1010.0,1968,1750,8140,19790 days 16:47:18.657898,217,2.2857142857142856,1.0,270,-300,0.0
452000.0,4,2.25,2590,10002,1.0,4,8,1340,1250.0,1968,1550,10436,19790 days 16:47:18.657898,149,1.7777777777777777,1.072,1040,-434,90.0
382500.0,2,1.0,1190,4440,1.0,3,6,1190,0.0,1981,1060,5715,15041 days 16:47:18.657898,188,2.0,0.0,130,-1275,1190.0
519950.0,3,2.25,1170,1249,3.0,3,8,1170,0.0,2014,1350,1310,2988 days 16:47:18.657898,127,1.3333333333333333,0.0,-180,-61,1170.0
665000.0,2,1.0,1110,3200,1.0,3,7,1110,0.0,1925,1170,3600,35495 days 16:47:18.657898,178,2.0,0.0,-60,-400,1110.0
527700.0,5,2.5,2820,9375,1.0,4,8,1550,1270.0,1968,2820,9375,19790 days 16:47:18.657898,189,2.0,1.220472440944882,0,0,280.0
205000.0,3,1.0,1610,8579,1.0,4,7,1010,600.0,1962,1610,8579,21981 days 16:47:18.657898,128,3.0,1.6833333333333333,0,0,410.0
420000.0,3,1.0,1060,8097,1.0,4,7,940,120.0,1923,1560,7940,36226 days 16:47:18.657898,105,3.0,7.833333333333333,-500,157,820.0
500000.0,4,2.25,2030,8517,1.0,4,8,1380,650.0,1961,2230,8824,22346 days 16:47:18.657898,058,1.7777777777777777,2.123076923076923,-200,-307,730.0
921500.0,4,2.5,3670,315374,2.0,4,9,3670,0.0,1994,2840,87991,10293 days 16:47:18.657898,337,1.6,0.0,830,227383,3670.0
890000.0,4,1.0,2550,4000,2.0,3,8,2370,180.0,1905,2200,4000,42800 days 16:47:18.657898,176,4.0,13.166666666666666,350,0,2190.0
430000.0,2,2.5,2420,60984,2.0,3,7,2420,0.0,2007,1940,193842,5545 days 16:47:18.657898,218,0.8,0.0,480,-132858,2420.0
258000.0,5,2.0,2260,12500,1.0,4,8,1130,1130.0,1960,1360,18000,22712 days 16:47:18.657898,303,2.5,1.0,900,-5500,0.0
511000.0,3,1.0,1430,3455,1.0,3,7,980,450.0,1947,1450,4599,27460 days 16:47:18.657898,308,3.0,2.1777777777777776,-20,-1144,530.0
532170.0,3,2.0,1360,3090,2.0,3,8,1360,0.0,1990,1500,3090,11754 days 16:47:18.657898,232,1.5,0.0,-140,0,1360.0
560000.0,3,1.0,1110,5000,1.5,3,7,1110,0.0,1947,1420,5000,27460 days 16:47:18.657898,099,3.0,0.0,-310,0,1110.0
282950.0,3,1.0,1250,8200,1.0,4,7,1250,0.0,1954,1680,8633,24903 days 16:47:18.657898,090,3.0,0.0,-430,-433,1250.0
2250000.0,4,3.25,5180,19850,2.0,3,1,3540,1640.0,2006,3160,9750,5910 days 16:47:18.657898,091,1.2307692307692308,2.158536585365854,2020,10100,1900.0
350000.0,1,1.0,700,5100,1.0,3,7,700,0.0,1942,1010,5100,29286 days 16:47:18.657898,136,1.0,0.0,-310,0,700.0
215000.0,3,1.0,1180,7669,1.0,4,7,1180,0.0,1967,1190,7669,20155 days 16:47:18.657898,209,3.0,0.0,-10,0,1180.0
650000.0,5,3.5,3960,25245,2.0,3,9,2500,1460.0,1996,2640,13675,9563 days 16:47:18.657898,324,1.4285714285714286,1.7123287671232876,1320,11570,1040.0
320000.0,4,2.75,2640,7500,1.0,3,8,1620,1020.0,1967,1980,7875,20155 days 16:47:18.657898,219,1.4545454545454546,1.588235294117647,660,-375,600.0
247000.0,3,2.0,1270,7198,1.5,3,7,1270,0.0,1916,1160,7198,38783 days 16:47:18.657898,317,1.5,0.0,110,0,1270.0
320000.0,4,1.75,1760,11180,1.0,4,8,1760,0.0,1968,1730,11180,19790 days 16:47:18.657898,276,2.2857142857142856,0.0,30,0,1760.0
255000.0,5,2.25,2060,8632,1.0,3,7,1030,1030.0,1962,1010,11680,21981 days 16:47:18.657898,127,2.2222222222222223,1.0,1050,-3048,0.0
438000.0,3,1.75,1780,9660,1.0,3,7,1780,0.0,1962,1200,9660,21981 days 16:47:18.657898,068,1.7142857142857142,0.0,580,0,1780.0
900000.0,3,2.5,3400,16603,2.0,3,1,3400,0.0,2000,3400,12601,8102 days 16:47:18.657898,063,1.2,0.0,0,4002,3400.0
441000.0,3,2.75,1910,7280,1.0,3,7,1160,750.0,1979,1710,8152,15772 days 16:47:18.657898,171,1.0909090909090908,1.5466666666666666,200,-872,410.0
420000.0,3,2.0,2020,38332,1.0,4,7,1010,1010.0,1975,2110,36590,17233 days 16:47:18.657898,224,1.5,1.0,-90,1742,0.0
370000.0,3,1.75,1580,7000,1.0,3,7,1180,400.0,1976,1640,7500,16868 days 16:47:18.657898,342,1.7142857142857142,2.95,-60,-500,780.0
269950.0,2,1.75,1340,7250,1.0,5,5,700,640.0,1949,1830,9750,26729 days 16:47:18.657898,050,1.1428571428571428,1.09375,-490,-2500,60.0
807100.0,4,2.5,2680,4499,2.0,3,9,2680,0.0,1999,2920,4500,8467 days 16:47:18.657898,083,1.6,0.0,-240,-1,2680.0
653000.0,3,2.5,2680,9750,1.0,4,8,1610,1070.0,1979,2480,8750,15772 days 16:47:18.657898,156,1.2,1.5046728971962617,200,1000,540.0
371500.0,3,2.0,1370,8336,1.0,5,7,1370,0.0,1964,1770,7288,21251 days 16:47:18.657898,162,1.5,0.0,-400,1048,1370.0
284000.0,3,1.75,1560,21000,1.0,3,7,1560,0.0,1954,1070,7920,24903 days 16:47:18.657898,075,1.7142857142857142,0.0,490,13080,1560.0
272000.0,3,1.75,2160,7140,1.0,4,7,1670,490.0,1978,1930,7350,16137 days 16:47:18.657898,002,1.7142857142857142,3.4081632653061225,230,-210,1180.0
313000.0,3,1.5,1340,7912,1.5,3,7,1340,0.0,1955,1480,7940,24538 days 16:47:18.657898,122,2.0,0.0,-140,-28,1340.0
917500.0,4,2.5,3880,35003,2.0,3,1,2570,1310.0,1984,3740,35230,13946 days 16:47:18.657898,016,1.6,1.9618320610687023,140,-227,1260.0
673000.0,4,2.25,2590,8190,2.0,4,8,2590,0.0,1980,2260,8335,15407 days 16:47:18.657898,272,1.7777777777777777,0.0,330,-145,2590.0
425000.0,3,2.5,1120,1100,2.0,3,8,820,300.0,2008,1590,1795,5180 days 16:47:18.657898,041,1.2,2.7333333333333334,-470,-695,520.0
399950.0,5,2.75,1970,5400,1.0,3,7,1320,650.0,1986,1280,2150,13215 days 16:47:18.657898,190,1.8181818181818181,2.0307692307692307,690,3250,670.0
385000.0,3,1.0,1220,4800,1.0,3,6,1220,0.0,1901,1200,4800,44261 days 16:47:18.657898,150,3.0,0.0,20,0,1220.0
269950.0,3,1.5,1950,7560,1.0,4,7,1320,630.0,1975,1950,8941,17233 days 16:47:18.657898,321,2.0,2.0952380952380953,0,-1381,690.0
330000.0,2,1.0,1350,8220,1.0,3,7,1060,290.0,1949,1540,8280,26729 days 16:47:18.657898,007,2.0,3.6551724137931036,-190,-60,770.0
260000.0,3,2.5,1670,5797,2.0,3,7,1670,0.0,1988,1670,6183,12485 days 16:47:18.657898,206,1.2,0.0,0,-386,1670.0
470000.0,4,3.0,2380,5125,1.5,4,7,1680,700.0,1925,1410,5375,35495 days 16:47:18.657898,104,1.3333333333333333,2.4,970,-250,980.0
589000.0,4,3.0,2440,9600,2.0,5,7,2440,0.0,1961,2290,9600,22346 days 16:47:18.657898,164,1.3333333333333333,0.0,150,0,2440.0
163500.0,2,1.5,1050,3419,2.0,3,7,1050,0.0,1996,1050,3417,9563 days 16:47:18.657898,204,1.3333333333333333,0.0,0,2,1050.0
835000.0,4,2.75,3130,13412,2.0,3,9,2140,990.0,1993,2260,9984,10658 days 16:47:18.657898,248,1.4545454545454546,2.1616161616161618,870,3428,1150.0
1100000.0,5,3.0,4090,12850,1.0,4,1,2090,2000.0,1986,2540,10270,13215 days 16:47:18.657898,325,1.6666666666666667,1.045,1550,2580,90.0
269000.0,4,1.75,1490,10000,1.0,4,8,1100,390.0,1969,2190,8910,19424 days 16:47:18.657898,105,2.2857142857142856,2.8205128205128207,-700,1090,710.0
560000.0,3,2.5,1900,8744,2.0,3,8,1900,0.0,1987,2030,8744,12850 days 16:47:18.657898,125,1.2,0.0,-130,0,1900.0
615000.0,4,1.0,1330,2400,1.5,4,6,1330,0.0,1901,1330,4400,44261 days 16:47:18.657898,108,4.0,0.0,0,-2000,1330.0
585188.0,3,2.25,2230,10026,1.0,3,8,1430,800.0,1975,2230,9340,17233 days 16:47:18.657898,339,1.3333333333333333,1.7875,0,686,630.0
305000.0,3,1.75,1650,9480,1.0,3,7,1220,430.0,1977,1540,8400,16502 days 16:47:18.657898,230,1.7142857142857142,2.8372093023255816,110,1080,790.0
166950.0,3,1.0,1190,8820,1.0,3,6,1190,0.0,1959,1230,7980,23077 days 16:47:18.657898,309,3.0,0.0,-40,840,1190.0
799000.0,3,2.5,2140,9897,1.0,4,8,2140,0.0,1959,2680,10083,23077 days 16:47:18.657898,255,1.2,0.0,-540,-186,2140.0
400000.0,3,2.5,2180,7508,1.0,4,7,1420,760.0,1962,1900,7818,21981 days 16:47:18.657898,176,1.2,1.868421052631579,280,-310,660.0
230000.0,3,1.0,1060,10228,1.0,3,7,1060,0.0,1948,1570,10228,27095 days 16:47:18.657898,335,3.0,0.0,-510,0,1060.0
256883.0,3,2.5,1690,5025,2.0,3,8,1690,0.0,2003,2550,5001,7006 days 16:47:18.657898,135,1.2,0.0,-860,24,1690.0
423000.0,4,2.0,1970,6480,1.5,5,7,1130,840.0,1920,1500,6480,37322 days 16:47:18.657898,315,2.0,1.3452380952380953,470,0,290.0
465000.0,3,2.5,2150,4084,2.0,3,8,2150,0.0,2007,1750,2385,5545 days 16:47:18.657898,204,1.2,0.0,400,1699,2150.0
440000.0,3,2.5,1910,66211,2.0,3,7,1910,0.0,1997,2330,67268,9197 days 16:47:18.657898,013,1.2,0.0,-420,-1057,1910.0
385000.0,3,1.75,1350,155073,1.0,4,7,1350,0.0,1969,1560,50965,19424 days 16:47:18.657898,287,1.7142857142857142,0.0,-210,104108,1350.0
210000.0,3,1.0,860,11725,1.0,4,6,860,0.0,1943,1300,9514,28921 days 16:47:18.657898,070,3.0,0.0,-440,2211,860.0
297000.0,3,2.5,1940,14952,2.0,3,8,1940,0.0,1994,2030,10450,10293 days 16:47:18.657898,316,1.2,0.0,-90,4502,1940.0
470000.0,3,1.0,1010,5000,1.0,3,7,1010,0.0,1952,1680,5000,25634 days 16:47:18.657898,197,3.0,0.0,-670,0,1010.0
226500.0,3,1.5,1300,7370,1.0,4,7,900,400.0,1976,1430,7500,16868 days 16:47:18.657898,216,2.0,2.25,-130,-130,500.0
274250.0,3,1.0,910,8450,1.0,4,6,910,0.0,1962,1400,8040,21981 days 16:47:18.657898,062,3.0,0.0,-490,410,910.0
840000.0,4,1.75,2480,11010,1.0,4,9,1630,850.0,1966,2770,10744,20520 days 16:47:18.657898,216,2.2857142857142856,1.9176470588235295,-290,266,780.0
677900.0,3,2.5,2440,4587,2.0,3,8,2440,0.0,2010,2750,4587,4449 days 16:47:18.657898,262,1.2,0.0,-310,0,2440.0
425000.0,3,1.0,1010,5864,1.0,3,7,1010,0.0,1915,1290,5000,39148 days 16:47:18.657898,036,3.0,0.0,-280,864,1010.0
180250.0,2,0.75,900,9600,1.0,3,6,900,0.0,1941,1250,14280,29651 days 16:47:18.657898,327,2.6666666666666665,0.0,-350,-4680,900.0
464000.0,6,3.0,2300,3404,2.0,3,7,1600,700.0,1920,1560,1312,37322 days 16:47:18.657898,198,2.0,2.2857142857142856,740,2092,900.0
320000.0,4,2.25,1550,7579,2.0,3,8,1550,0.0,1993,1630,6397,10658 days 16:47:18.657898,112,1.7777777777777777,0.0,-80,1182,1550.0
625504.0,3,2.25,1270,1566,2.0,3,8,1060,210.0,2014,1160,1327,2988 days 16:47:18.657898,198,1.3333333333333333,5.0476190476190474,110,239,850.0
592500.0,4,2.5,2240,12032,1.0,3,9,2240,0.0,1983,2520,12368,14311 days 16:47:18.657898,135,1.6,0.0,-280,-336,2240.0
465000.0,3,2.5,2714,17936,2.0,3,9,2714,0.0,2005,2590,18386,6275 days 16:47:18.657898,014,1.2,0.0,124,-450,2714.0
477000.0,4,2.75,1720,6270,2.0,3,8,1720,0.0,1978,2130,8700,16137 days 16:47:18.657898,147,1.4545454545454546,0.0,-410,-2430,1720.0
280000.0,2,1.0,850,16400,1.0,3,6,850,0.0,1923,1100,14459,36226 days 16:47:18.657898,015,2.0,0.0,-250,1941,850.0
1510000.0,5,3.0,3300,33474,1.0,3,9,1870,1430.0,1957,3836,20953,23807 days 16:47:18.657898,052,1.6666666666666667,1.3076923076923077,-536,12521,440.0
1070000.0,2,2.25,3900,14864,1.0,3,8,1950,1950.0,1947,2580,5184,27460 days 16:47:18.657898,240,0.8888888888888888,1.0,1320,9680,0.0
467000.0,2,1.5,1320,10800,1.0,4,8,1320,0.0,1947,2120,12040,27460 days 16:47:18.657898,296,1.3333333333333333,0.0,-800,-1240,1320.0
686000.0,4,2.5,2760,6440,2.0,3,1,2760,0.0,1999,3070,8127,8467 days 16:47:18.657898,234,1.6,0.0,-310,-1687,2760.0
279950.0,3,2.0,1750,9750,1.0,3,7,1350,400.0,1961,1900,10125,22346 days 16:47:18.657898,156,1.5,3.375,-150,-375,950.0
527000.0,4,2.25,2330,19436,2.0,3,8,2330,0.0,1987,1910,10055,12850 days 16:47:18.657898,247,1.7777777777777777,0.0,420,9381,2330.0
325000.0,3,2.25,2220,16020,1.0,4,8,1780,440.0,1966,2080,9583,20520 days 16:47:18.657898,261,1.3333333333333333,4.045454545454546,140,6437,1340.0
328000.0,3,2.25,2020,8379,2.0,3,7,2020,0.0,1994,2020,8031,10293 days 16:47:18.657898,246,1.3333333333333333,0.0,0,348,2020.0
390000.0,3,2.25,1250,7500,1.0,5,7,1250,0.0,1942,1280,7392,29286 days 16:47:18.657898,155,1.3333333333333333,0.0,-30,108,1250.0
479950.0,2,2.0,1510,6516,1.0,3,8,1510,0.0,2005,1640,6009,6275 days 16:47:18.657898,068,1.0,0.0,-130,507,1510.0
264950.0,4,2.25,1720,9753,1.0,4,7,1120,600.0,1978,1510,9753,16137 days 16:47:18.657898,149,1.7777777777777777,1.8666666666666667,210,0,520.0
235000.0,3,1.0,1430,15246,1.0,4,7,980,450.0,1961,1960,13068,22346 days 16:47:18.657898,015,3.0,2.1777777777777776,-530,2178,530.0
516500.0,3,2.5,1480,4729,2.0,3,7,1480,0.0,2004,2250,4729,6641 days 16:47:18.657898,062,1.2,0.0,-770,0,1480.0
655000.0,2,1.75,1450,15798,2.0,3,7,1230,220.0,1915,2030,13193,39148 days 16:47:18.657898,103,1.1428571428571428,5.590909090909091,-580,2605,1010.0
500000.0,4,2.75,2280,15347,1.0,5,7,2280,0.0,1960,2280,15347,22712 days 16:47:18.657898,167,1.4545454545454546,0.0,0,0,2280.0
315000.0,6,2.75,2940,7350,1.0,3,8,1780,1160.0,1978,2120,8236,16137 days 16:47:18.657898,325,2.1818181818181817,1.5344827586206897,820,-886,620.0
213000.0,2,1.0,1000,10200,1.0,3,6,1000,0.0,1961,1150,13702,22346 days 16:47:18.657898,324,2.0,0.0,-150,-3502,1000.0
475000.0,3,1.5,2480,5280,1.5,5,7,1620,860.0,1947,2090,4800,27460 days 16:47:18.657898,245,2.0,1.8837209302325582,390,480,760.0
1030000.0,5,4.0,3760,28040,2.0,3,1,3760,0.0,1983,3430,35096,14311 days 16:47:18.657898,161,1.25,0.0,330,-7056,3760.0
416000.0,3,2.0,2220,94300,1.0,5,7,1640,580.0,1976,2070,80100,16868 days 16:47:18.657898,099,1.5,2.8275862068965516,150,14200,1060.0
410000.0,4,1.0,1970,4740,1.5,3,7,1670,300.0,1904,1510,4740,43166 days 16:47:18.657898,079,4.0,5.566666666666666,460,0,1370.0
800000.0,3,3.5,3830,221284,2.0,3,1,3530,300.0,1993,2920,148539,10658 days 16:47:18.657898,182,0.8571428571428571,11.766666666666667,910,72745,3230.0
472000.0,6,2.5,4410,14034,1.0,4,9,2350,2060.0,1965,2600,13988,20885 days 16:47:18.657898,149,2.4,1.1407766990291262,1810,46,290.0
225000.0,3,1.75,1430,8505,1.0,4,7,1430,0.0,1968,1190,8640,19790 days 16:47:18.657898,342,1.7142857142857142,0.0,240,-135,1430.0
210000.0,2,1.0,830,6000,1.0,3,6,830,0.0,1940,830,4960,30017 days 16:47:18.657898,274,2.0,0.0,0,1040,830.0
455000.0,2,1.0,1430,5000,1.5,2,7,1430,0.0,1925,1450,3750,35495 days 16:47:18.657898,027,2.0,0.0,-20,1250,1430.0
225000.0,3,1.0,1300,8316,1.0,4,6,1300,0.0,1954,1260,8316,24903 days 16:47:18.657898,117,3.0,0.0,40,0,1300.0
480000.0,2,1.0,1030,3060,1.0,4,7,790,240.0,1918,1390,3060,38052 days 16:47:18.657898,238,2.0,3.2916666666666665,-360,0,550.0
363000.0,3,2.5,2740,11872,2.0,3,9,2740,0.0,1990,2570,10377,11754 days 16:47:18.657898,043,1.2,0.0,170,1495,2740.0
2400000.0,4,2.5,3650,8354,1.0,3,9,1830,1820.0,2000,3120,18841,8102 days 16:47:18.657898,272,1.6,1.0054945054945055,530,-10487,10.0
181000.0,2,1.5,720,5120,1.0,3,6,720,0.0,1954,1150,2566,24903 days 16:47:18.657898,057,1.3333333333333333,0.0,-430,2554,720.0
250000.0,4,2.0,2010,7312,1.0,4,7,2010,0.0,1976,2010,7650,16868 days 16:47:18.657898,073,2.0,0.0,0,-338,2010.0
481000.0,3,1.75,1560,3000,1.0,4,6,770,790.0,1918,1390,3000,38052 days 16:47:18.657898,112,1.7142857142857142,0.9746835443037974,170,0,-20.0
260000.0,3,2.0,1810,7209,1.0,4,7,1240,570.0,1978,1750,7209,16137 days 16:47:18.657898,266,1.5,2.175438596491228,60,0,670.0
455000.0,4,2.5,3360,7685,2.0,3,9,3360,0.0,2001,3060,6567,7736 days 16:47:18.657898,133,1.6,0.0,300,1118,3360.0
415000.0,3,2.25,1510,36224,2.0,3,8,1510,0.0,1991,1730,36224,11389 days 16:47:18.657898,091,1.3333333333333333,0.0,-220,0,1510.0
349500.0,3,1.0,1400,3538,1.0,3,7,800,600.0,1953,1620,6331,25268 days 16:47:18.657898,111,3.0,1.3333333333333333,-220,-2793,200.0
245000.0,3,2.5,1730,7442,2.0,3,7,1730,0.0,1987,1630,6458,12850 days 16:47:18.657898,272,1.2,0.0,100,984,1730.0
592500.0,2,2.0,1420,9191,1.5,5,7,1420,0.0,1928,1420,6816,34400 days 16:47:18.657898,139,1.0,0.0,0,2375,1420.0
385000.0,4,1.75,2360,7620,1.0,4,7,1180,1180.0,1955,1910,7620,24538 days 16:47:18.657898,293,2.2857142857142856,1.0,450,0,0.0
315000.0,3,1.75,1580,11455,1.0,4,7,1200,380.0,1974,1550,10650,17598 days 16:47:18.657898,042,1.7142857142857142,3.1578947368421053,30,805,820.0
255000.0,3,1.0,1230,10170,1.0,3,7,1230,0.0,1979,1380,10098,15772 days 16:47:18.657898,328,3.0,0.0,-150,72,1230.0
693000.0,4,2.5,2460,4425,2.0,3,8,2460,0.0,2006,2990,5659,5910 days 16:47:18.657898,241,1.6,0.0,-530,-1234,2460.0
780000.0,3,1.0,1660,4400,1.5,3,8,1460,200.0,1911,1660,4400,40609 days 16:47:18.657898,336,3.0,7.3,0,0,1260.0
237000.0,3,1.75,1270,8470,1.0,4,7,1270,0.0,1960,1600,8470,22712 days 16:47:18.657898,297,1.7142857142857142,0.0,-330,0,1270.0
525000.0,3,2.25,2100,40510,2.0,3,1,1320,780.0,1979,2380,33450,15772 days 16:47:18.657898,350,1.3333333333333333,1.6923076923076923,-280,7060,540.0
425000.0,2,1.0,770,5040,1.0,3,5,770,0.0,1930,1330,2580,33669 days 16:47:18.657898,118,2.0,0.0,-560,2460,770.0
369900.0,1,0.75,760,10079,1.0,5,5,760,0.0,1936,1230,14267,31478 days 16:47:18.657898,300,1.3333333333333333,0.0,-470,-4188,760.0
290000.0,4,2.5,1700,7280,2.0,4,7,1700,0.0,1988,1950,7475,12485 days 16:47:18.657898,139,1.6,0.0,-250,-195,1700.0
285000.0,3,1.0,1120,10701,1.0,3,7,1120,0.0,1954,1130,6350,24903 days 16:47:18.657898,272,3.0,0.0,-10,4351,1120.0
415000.0,2,1.0,1070,4500,1.0,3,7,1070,0.0,1937,1320,4465,31112 days 16:47:18.657898,226,2.0,0.0,-250,35,1070.0
272500.0,3,2.5,2070,9900,1.0,3,8,1420,650.0,1979,2070,8250,15772 days 16:47:18.657898,099,1.2,2.1846153846153844,0,1650,770.0
2900000.0,4,3.25,5050,20100,1.5,3,1,4750,300.0,1982,3890,20060,14676 days 16:47:18.657898,124,1.2307692307692308,15.833333333333334,1160,40,4450.0
1370000.0,4,4.75,5310,57346,2.0,4,1,5310,0.0,1989,4180,47443,12119 days 16:47:18.657898,280,0.8421052631578947,0.0,1130,9903,5310.0
436000.0,2,1.0,1040,7538,1.0,4,7,1040,0.0,1939,1440,7530,30382 days 16:47:18.657898,121,2.0,0.0,-400,8,1040.0
210000.0,3,1.0,1700,11390,1.0,4,7,1700,0.0,1967,1350,8164,20155 days 16:47:18.657898,290,3.0,0.0,350,3226,1700.0
236000.0,3,1.0,1300,5898,1.0,3,7,1300,0.0,1961,1320,7619,22346 days 16:47:18.657898,268,3.0,0.0,-20,-1721,1300.0
331000.0,3,1.75,1080,1306,1.0,3,7,580,500.0,1954,1440,2225,24903 days 16:47:18.657898,328,1.7142857142857142,1.16,-360,-919,80.0
365000.0,3,2.5,2653,4510,2.0,3,8,2653,0.0,2006,2653,4927,5910 days 16:47:18.657898,079,1.2,0.0,0,-417,2653.0
450000.0,3,2.0,2290,16258,1.0,5,8,2290,0.0,1960,1660,10530,22712 days 16:47:18.657898,027,1.5,0.0,630,5728,2290.0
770000.0,4,2.75,3820,26300,2.0,3,9,2850,970.0,2014,1860,12136,2988 days 16:47:18.657898,317,1.4545454545454546,2.9381443298969074,1960,14164,1880.0
455000.0,4,2.5,2210,49375,1.0,3,8,2210,0.0,1997,2670,49385,9197 days 16:47:18.657898,125,1.6,0.0,-460,-10,2210.0
405000.0,3,1.75,2390,6000,1.0,3,6,1240,1150.0,1908,2020,6000,41705 days 16:47:18.657898,125,1.7142857142857142,1.0782608695652174,370,0,90.0
304900.0,4,1.75,2600,11325,1.0,4,7,1610,990.0,1969,1720,11088,19424 days 16:47:18.657898,184,2.2857142857142856,1.6262626262626263,880,237,620.0
170000.0,2,1.0,860,5265,1.0,3,6,860,0.0,1931,1650,8775,33304 days 16:47:18.657898,058,2.0,0.0,-790,-3510,860.0
2050000.0,5,3.0,3830,8480,2.0,5,9,2630,1200.0,1905,3050,7556,42800 days 16:47:18.657898,133,1.6666666666666667,2.191666666666667,780,924,1430.0
780000.0,4,2.5,3500,7048,2.0,3,9,3500,0.0,2005,3920,7864,6275 days 16:47:18.657898,181,1.6,0.0,-420,-816,3500.0
330000.0,3,3.0,2420,13959,1.0,4,8,1740,680.0,1988,2570,13300,12485 days 16:47:18.657898,100,1.0,2.5588235294117645,-150,659,1060.0
370000.0,4,2.5,2720,8666,2.0,3,9,2720,0.0,1992,2410,8100,11024 days 16:47:18.657898,248,1.6,0.0,310,566,2720.0
467000.0,5,2.25,2500,13500,1.0,3,7,1850,650.0,1979,2300,9750,15772 days 16:47:18.657898,290,2.2222222222222223,2.8461538461538463,200,3750,1200.0
405000.0,3,1.75,1670,6720,1.0,3,7,1140,530.0,1980,1670,7320,15407 days 16:47:18.657898,040,1.7142857142857142,2.150943396226415,0,-600,610.0
675000.0,5,2.25,2900,10300,1.0,3,8,1450,1450.0,1985,2310,10300,13580 days 16:47:18.657898,183,2.2222222222222223,1.0,590,0,0.0
500000.0,2,1.0,1640,14100,1.0,4,7,1140,500.0,1954,1520,13527,24903 days 16:47:18.657898,224,2.0,2.28,120,573,640.0
389999.0,4,2.5,1890,15770,2.0,4,7,1890,0.0,1968,2410,15256,19790 days 16:47:18.657898,204,1.6,0.0,-520,514,1890.0
630000.0,4,1.75,2950,9025,1.0,4,8,1780,1170.0,1975,2120,9600,17233 days 16:47:18.657898,055,2.2857142857142856,1.5213675213675213,830,-575,610.0
360000.0,4,2.5,2160,9528,2.0,3,9,2160,0.0,1992,2280,9937,11024 days 16:47:18.657898,295,1.6,0.0,-120,-409,2160.0
580000.0,4,3.0,3280,11060,2.0,3,8,2270,1010.0,1986,2320,11004,13215 days 16:47:18.657898,275,1.3333333333333333,2.2475247524752477,960,56,1260.0
550000.0,3,2.0,1970,4166,2.0,5,8,1270,700.0,1929,2390,4166,34034 days 16:47:18.657898,190,1.5,1.8142857142857143,-420,0,570.0
879000.0,4,2.5,3360,22111,2.0,3,1,3360,0.0,1994,3150,11374,10293 days 16:47:18.657898,191,1.6,0.0,210,10737,3360.0
265000.0,3,2.0,1320,8959,1.0,3,7,1320,0.0,1993,1740,7316,10658 days 16:47:18.657898,234,1.5,0.0,-420,1643,1320.0
446500.0,3,2.5,2650,7286,2.0,3,8,2650,0.0,1990,2400,7220,11754 days 16:47:18.657898,063,1.2,0.0,250,66,2650.0
404000.0,3,1.5,2030,8880,1.0,3,7,1330,700.0,1963,2140,5592,21616 days 16:47:18.657898,153,2.0,1.9,-110,3288,630.0
267500.0,3,1.75,1590,11914,1.0,3,7,1090,500.0,1957,1630,9052,23807 days 16:47:18.657898,149,1.7142857142857142,2.18,-40,2862,590.0
3080000.0,4,5.0,4550,18641,1.0,3,1,2600,1950.0,2002,4550,19508,7371 days 16:47:18.657898,175,0.8,1.3333333333333333,0,-867,650.0
335000.0,3,2.5,2440,7632,2.0,3,8,2440,0.0,1998,2510,7903,8832 days 16:47:18.657898,223,1.2,0.0,-70,-271,2440.0
576000.0,3,2.5,1940,9000,1.0,4,7,970,970.0,1948,2190,7310,27095 days 16:47:18.657898,170,1.2,1.0,-250,1690,0.0
208633.0,3,2.5,2040,3810,2.0,3,8,2040,0.0,2006,2370,4590,5910 days 16:47:18.657898,091,1.2,0.0,-330,-780,2040.0
315000.0,3,2.25,2200,8750,1.0,4,7,1120,1080.0,1964,1460,10139,21251 days 16:47:18.657898,015,1.3333333333333333,1.037037037037037,740,-1389,40.0
725000.0,3,1.75,1920,3300,1.0,4,8,960,960.0,1913,1740,4000,39878 days 16:47:18.657898,048,1.7142857142857142,1.0,180,-700,0.0
550000.0,4,2.75,1800,7750,1.0,4,8,1400,400.0,1965,1800,8275,20885 days 16:47:18.657898,093,1.4545454545454546,3.5,0,-525,1000.0
610750.0,4,2.25,2180,7297,2.0,3,8,2180,0.0,1984,2250,9781,13946 days 16:47:18.657898,163,1.7777777777777777,0.0,-70,-2484,2180.0
550700.0,2,1.0,1010,5000,1.5,4,6,1010,0.0,1908,1460,5000,41705 days 16:47:18.657898,059,2.0,0.0,-450,0,1010.0
834000.0,4,2.5,2370,4000,1.5,5,8,1980,390.0,1928,2440,5750,34400 days 16:47:18.657898,040,1.6,5.076923076923077,-70,-1750,1590.0
201000.0,5,1.75,1660,78408,1.5,3,6,1660,0.0,1915,1660,78408,39148 days 16:47:18.657898,296,2.857142857142857,0.0,0,0,1660.0
2380000.0,5,2.5,3650,9050,2.0,5,1,3370,280.0,1921,2880,5400,36956 days 16:47:18.657898,122,2.0,12.035714285714286,770,3650,3090.0
1380000.0,4,3.25,4290,12103,1.0,3,1,2690,1600.0,1997,3860,11244,9197 days 16:47:18.657898,169,1.2307692307692308,1.68125,430,859,1090.0
1400000.0,4,3.25,4290,12103,1.0,3,1,2690,1600.0,1997,3860,11244,9197 days 16:47:18.657898,343,1.2307692307692308,1.68125,430,859,1090.0
305000.0,4,2.25,1950,7700,1.0,3,8,1350,600.0,1979,2150,7350,15772 days 16:47:18.657898,309,1.7777777777777777,2.25,-200,350,750.0
487000.0,3,2.0,2590,14052,1.0,5,8,1720,870.0,1948,1570,8162,27095 days 16:47:18.657898,098,1.5,1.9770114942528736,1020,5890,850.0
390000.0,3,2.5,1930,64904,1.0,4,8,1930,0.0,1988,2350,57500,12485 days 16:47:18.657898,131,1.2,0.0,-420,7404,1930.0
548000.0,2,1.0,1470,3864,1.0,4,7,1170,300.0,1916,1570,3864,38783 days 16:47:18.657898,204,2.0,3.9,-100,0,870.0
268750.0,4,1.0,800,8775,1.0,3,6,800,0.0,1943,1310,8775,28921 days 16:47:18.657898,326,4.0,0.0,-510,0,800.0
819900.0,5,2.75,3150,7119,2.0,3,9,3150,0.0,2013,1560,8384,3353 days 16:47:18.657898,133,1.8181818181818181,0.0,1590,-1265,3150.0
520000.0,3,2.25,2030,16200,2.0,3,8,2030,0.0,1984,2660,17958,13946 days 16:47:18.657898,296,1.3333333333333333,0.0,-630,-1758,2030.0
230000.0,3,2.0,1450,11204,1.0,3,7,1450,0.0,2003,1520,9518,7006 days 16:47:18.657898,202,1.5,0.0,-70,1686,1450.0
240000.0,3,1.75,1510,10248,1.0,3,7,1510,0.0,1969,1510,9753,19424 days 16:47:18.657898,033,1.7142857142857142,0.0,0,495,1510.0
232000.0,2,1.0,1240,12092,1.0,3,6,960,280.0,1922,1820,7460,36591 days 16:47:18.657898,248,2.0,3.4285714285714284,-580,4632,680.0
240500.0,2,1.0,1240,12092,1.0,3,6,960,280.0,1922,1820,7460,36591 days 16:47:18.657898,070,2.0,3.4285714285714284,-580,4632,680.0
274975.0,3,2.5,3030,45004,2.0,3,9,3030,0.0,1987,3080,35781,12850 days 16:47:18.657898,300,1.2,0.0,-50,9223,3030.0
740000.0,4,2.0,2050,4400,1.5,4,9,2050,0.0,1922,2320,5500,36591 days 16:47:18.657898,248,2.0,0.0,-270,-1100,2050.0
186375.0,3,1.0,1000,7636,1.0,2,7,1000,0.0,1952,1150,7600,25634 days 16:47:18.657898,118,3.0,0.0,-150,36,1000.0
790000.0,3,2.25,2370,10289,1.0,4,9,1590,780.0,1977,2500,10004,16502 days 16:47:18.657898,206,1.3333333333333333,2.0384615384615383,-130,285,810.0
880000.0,4,3.5,2800,6750,2.0,3,9,1890,910.0,1951,2370,6120,25999 days 16:47:18.657898,259,1.1428571428571428,2.076923076923077,430,630,980.0
279000.0,6,1.75,2240,11180,2.0,4,7,2240,0.0,1955,1590,7955,24538 days 16:47:18.657898,106,3.4285714285714284,0.0,650,3225,2240.0
295000.0,3,2.0,1810,10530,1.0,3,8,1810,0.0,1991,1910,10450,11389 days 16:47:18.657898,210,1.5,0.0,-100,80,1810.0
640000.0,2,1.0,1070,5000,1.0,3,7,1070,0.0,1924,1710,5000,35861 days 16:47:18.657898,098,2.0,0.0,-640,0,1070.0
940000.0,4,2.0,2490,9525,2.0,5,9,2490,0.0,1968,2770,9525,19790 days 16:47:18.657898,184,2.0,0.0,-280,0,2490.0
260000.0,4,2.5,1960,5238,2.0,3,7,1960,0.0,2003,1800,5894,7006 days 16:47:18.657898,280,1.6,0.0,160,-656,1960.0
559900.0,3,2.75,2930,5569,1.0,3,9,1860,1070.0,2004,2580,11045,6641 days 16:47:18.657898,153,1.0909090909090908,1.7383177570093458,350,-5476,790.0
791500.0,4,2.0,1510,3500,1.5,5,7,1510,0.0,1911,1820,3750,40609 days 16:47:18.657898,203,2.0,0.0,-310,-250,1510.0
265000.0,3,1.75,1420,8250,1.0,3,7,1420,0.0,1954,1740,8000,24903 days 16:47:18.657898,238,1.7142857142857142,0.0,-320,250,1420.0
245000.0,3,1.75,1740,11547,1.0,3,7,1740,0.0,1954,880,78408,24903 days 16:47:18.657898,121,1.7142857142857142,0.0,860,-66861,1740.0
485000.0,4,1.75,2560,43995,2.0,4,7,2560,0.0,1962,2560,14764,21981 days 16:47:18.657898,114,2.2857142857142856,0.0,0,29231,2560.0
684000.0,4,3.5,3040,8414,2.0,3,9,2420,620.0,2010,3470,8066,4449 days 16:47:18.657898,310,1.1428571428571428,3.903225806451613,-430,348,1800.0
425000.0,3,1.75,2500,6840,1.0,3,8,1300,1200.0,1957,1580,8691,23807 days 16:47:18.657898,252,1.7142857142857142,1.0833333333333333,920,-1851,100.0
309600.0,4,1.75,1275,20000,1.0,4,6,1275,0.0,1991,1660,20000,11389 days 16:47:18.657898,290,2.2857142857142856,0.0,-385,0,1275.0
552250.0,4,2.5,2580,5823,2.0,3,8,2580,0.0,2002,2380,5823,7371 days 16:47:18.657898,199,1.6,0.0,200,0,2580.0
165000.0,4,1.0,1000,7134,1.0,3,6,1000,0.0,1943,1020,7138,28921 days 16:47:18.657898,204,4.0,0.0,-20,-4,1000.0
239900.0,4,1.0,1000,7134,1.0,3,6,1000,0.0,1943,1020,7138,28921 days 16:47:18.657898,363,4.0,0.0,-20,-4,1000.0
320000.0,2,1.0,1070,32633,1.0,4,6,1070,0.0,1930,1360,32156,33669 days 16:47:18.657898,339,2.0,0.0,-290,477,1070.0
206600.0,3,2.0,1390,13464,1.0,4,7,1390,0.0,1987,1720,12080,12850 days 16:47:18.657898,294,1.5,0.0,-330,1384,1390.0
387000.0,4,1.75,2500,7690,1.0,3,7,1250,1250.0,1973,2040,8646,17963 days 16:47:18.657898,106,2.2857142857142856,1.0,460,-956,0.0
299000.0,1,0.75,560,12120,1.0,3,4,560,0.0,1967,1300,19207,20155 days 16:47:18.657898,155,1.3333333333333333,0.0,-740,-7087,560.0
855000.0,4,2.75,2270,10460,2.0,3,9,2270,0.0,1965,2610,10180,20885 days 16:47:18.657898,265,1.4545454545454546,0.0,-340,280,2270.0
315000.0,3,1.0,1900,14400,1.0,4,7,1300,600.0,1954,1940,14400,24903 days 16:47:18.657898,026,3.0,2.1666666666666665,-40,0,700.0
437500.0,2,1.0,990,3120,1.0,5,7,790,200.0,1907,1930,3120,42070 days 16:47:18.657898,337,2.0,3.95,-940,0,590.0
252000.0,4,1.5,1550,19800,1.0,4,7,1050,500.0,1969,1640,22654,19424 days 16:47:18.657898,083,2.6666666666666665,2.1,-90,-2854,550.0
375000.0,4,1.75,2200,7475,1.0,5,7,1100,1100.0,1955,1600,5766,24538 days 16:47:18.657898,155,2.2857142857142856,1.0,600,1709,0.0
300000.0,4,2.5,1910,4862,2.0,3,7,1910,0.0,2005,2010,5091,6275 days 16:47:18.657898,218,1.6,0.0,-100,-229,1910.0
420000.0,4,1.0,1750,9600,1.5,4,7,1750,0.0,1954,1750,10530,24903 days 16:47:18.657898,279,4.0,0.0,0,-930,1750.0
900000.0,3,1.0,1330,77972,1.0,3,7,1330,0.0,1928,1340,17689,34400 days 16:47:18.657898,125,3.0,0.0,-10,60283,1330.0
679900.0,3,2.5,2440,5750,2.0,3,9,1980,460.0,2000,1520,5750,8102 days 16:47:18.657898,217,1.2,4.304347826086956,920,0,1520.0
463000.0,3,2.5,1640,29970,2.0,3,7,1640,0.0,1992,1580,28399,11024 days 16:47:18.657898,156,1.2,0.0,60,1571,1640.0
380000.0,5,2.5,2760,11340,2.0,4,9,2760,0.0,1978,2470,11340,16137 days 16:47:18.657898,240,2.0,0.0,290,0,2760.0
329500.0,4,2.5,1820,7912,2.0,3,7,1820,0.0,1994,1820,8168,10293 days 16:47:18.657898,344,1.6,0.0,0,-256,1820.0
604950.0,3,2.5,2110,5608,1.0,3,8,1340,770.0,2013,2040,9363,3353 days 16:47:18.657898,231,1.2,1.7402597402597402,70,-3755,570.0
795000.0,5,2.5,3040,9570,1.0,4,8,1640,1400.0,1966,2920,8800,20520 days 16:47:18.657898,260,2.0,1.1714285714285715,120,770,240.0
465000.0,3,2.0,1840,40438,2.0,3,7,1840,0.0,1994,1380,44049,10293 days 16:47:18.657898,030,1.5,0.0,460,-3611,1840.0
673000.0,4,2.5,2990,10400,2.0,3,9,2990,0.0,2002,2140,17449,7371 days 16:47:18.657898,085,1.6,0.0,850,-7049,2990.0
810000.0,4,2.5,3520,15420,2.0,3,1,3520,0.0,1991,3400,21455,11389 days 16:47:18.657898,274,1.6,0.0,120,-6035,3520.0
785000.0,4,2.75,2440,69415,1.0,4,8,1910,530.0,1989,2770,24361,12119 days 16:47:18.657898,113,1.4545454545454546,3.6037735849056602,-330,45054,1380.0
338000.0,4,3.0,2090,7500,1.0,3,7,1370,720.0,1986,1810,7650,13215 days 16:47:18.657898,324,1.3333333333333333,1.9027777777777777,280,-150,650.0
280000.0,3,2.25,1430,7222,2.0,3,7,1430,0.0,1993,1430,7220,10658 days 16:47:18.657898,338,1.3333333333333333,0.0,0,2,1430.0
315000.0,4,2.25,2180,10754,1.0,5,7,1100,1080.0,1954,1810,6929,24903 days 16:47:18.657898,274,1.7777777777777777,1.0185185185185186,370,3825,20.0
530000.0,4,2.25,2180,10754,1.0,5,7,1100,1080.0,1954,1810,6929,24903 days 16:47:18.657898,083,1.7777777777777777,1.0185185185185186,370,3825,20.0
380000.0,5,3.0,3450,9914,2.0,3,9,3450,0.0,2004,2860,9721,6641 days 16:47:18.657898,357,1.6666666666666667,0.0,590,193,3450.0
297000.0,3,2.25,1450,7562,2.0,3,7,1450,0.0,1994,1650,7625,10293 days 16:47:18.657898,223,1.3333333333333333,0.0,-200,-63,1450.0
730000.0,4,2.5,3230,7331,2.0,3,1,3230,0.0,2004,3480,7447,6641 days 16:47:18.657898,140,1.6,0.0,-250,-116,3230.0
450000.0,3,1.75,1640,13500,1.0,3,7,1110,530.0,1940,1770,12600,30017 days 16:47:18.657898,160,1.7142857142857142,2.0943396226415096,-130,900,580.0
275000.0,3,3.0,1590,7750,1.0,3,7,1060,530.0,1997,1680,7500,9197 days 16:47:18.657898,300,1.0,2.0,-90,250,530.0
595000.0,4,2.0,2020,2849,2.0,3,7,2020,0.0,1960,1910,3120,22712 days 16:47:18.657898,119,2.0,0.0,110,-271,2020.0
435000.0,3,1.5,1300,3348,1.5,3,7,1300,0.0,1904,1590,2577,43166 days 16:47:18.657898,111,2.0,0.0,-290,771,1300.0
270000.0,2,1.5,1380,209959,1.0,1,6,1380,0.0,1954,3130,19868,24903 days 16:47:18.657898,259,1.3333333333333333,0.0,-1750,190091,1380.0
950000.0,3,3.0,4040,14338,2.0,3,1,3030,1010.0,1986,3360,14142,13215 days 16:47:18.657898,217,1.0,3.0,680,196,2020.0
389000.0,4,2.25,2130,5337,2.0,3,7,2130,0.0,2001,2300,6930,7736 days 16:47:18.657898,072,1.7777777777777777,0.0,-170,-1593,2130.0
560000.0,4,2.25,2550,7800,1.0,3,8,1580,970.0,1968,2420,8050,19790 days 16:47:18.657898,021,1.7777777777777777,1.6288659793814433,130,-250,610.0
799000.0,4,2.25,2510,11585,2.0,4,8,2510,0.0,1969,2450,9691,19424 days 16:47:18.657898,315,1.7777777777777777,0.0,60,1894,2510.0
365500.0,3,2.0,1410,9600,1.0,4,7,1410,0.0,1983,1410,9600,14311 days 16:47:18.657898,176,1.5,0.0,0,0,1410.0
252350.0,3,2.0,1650,7352,1.0,3,7,1160,490.0,1979,1710,7350,15772 days 16:47:18.657898,135,1.5,2.36734693877551,-60,2,670.0
403950.0,4,2.5,2120,13780,2.0,3,8,2120,0.0,1993,1880,12000,10658 days 16:47:18.657898,248,1.6,0.0,240,1780,2120.0
385000.0,4,1.5,2040,10726,1.0,3,7,1380,660.0,1954,1610,10020,24903 days 16:47:18.657898,213,2.6666666666666665,2.090909090909091,430,706,720.0
345000.0,4,1.0,1550,7620,1.5,3,7,1550,0.0,1957,1450,7620,23807 days 16:47:18.657898,344,4.0,0.0,100,0,1550.0
490000.0,3,2.75,1980,3128,2.0,4,9,1980,0.0,1979,1950,2856,15772 days 16:47:18.657898,260,1.0909090909090908,0.0,30,272,1980.0
330000.0,3,2.5,1600,26977,2.0,3,8,1600,0.0,2005,1790,27743,6275 days 16:47:18.657898,169,1.2,0.0,-190,-766,1600.0
927000.0,4,2.75,3300,12090,2.0,3,8,3300,0.0,1953,3180,12239,25268 days 16:47:18.657898,132,1.4545454545454546,0.0,120,-149,3300.0
1120000.0,4,2.5,3840,16619,2.0,4,1,3840,0.0,1983,3600,16553,14311 days 16:47:18.657898,209,1.6,0.0,240,66,3840.0
330000.0,2,1.0,1220,10000,1.0,5,7,1220,0.0,1950,2000,9600,26364 days 16:47:18.657898,120,2.0,0.0,-780,400,1220.0
530000.0,5,2.25,2720,8800,1.0,4,7,1500,1220.0,1958,2110,8800,23442 days 16:47:18.657898,068,2.2222222222222223,1.2295081967213115,610,0,280.0
365000.0,4,2.0,1940,25600,1.0,1,8,1940,0.0,1962,2000,10071,21981 days 16:47:18.657898,174,2.0,0.0,-60,15529,1940.0
378750.0,3,2.5,2160,3000,1.5,3,7,1260,900.0,1909,1060,3500,41339 days 16:47:18.657898,170,1.2,1.4,1100,-500,360.0
269900.0,4,1.75,1530,8750,1.5,4,7,1530,0.0,1968,1390,8750,19790 days 16:47:18.657898,170,2.2857142857142856,0.0,140,0,1530.0
557000.0,3,3.5,1710,2096,2.0,3,8,1290,420.0,2008,1630,1543,5180 days 16:47:18.657898,065,0.8571428571428571,3.0714285714285716,80,553,870.0
360000.0,4,1.75,3730,16980,1.0,4,7,2150,1580.0,1974,1880,16963,17598 days 16:47:18.657898,237,2.2857142857142856,1.360759493670886,1850,17,570.0
352000.0,2,1.0,940,5000,1.0,4,7,940,0.0,1937,1560,4500,31112 days 16:47:18.657898,112,2.0,0.0,-620,500,940.0
437000.0,3,2.5,1750,22357,2.0,3,8,1750,0.0,1994,2430,22357,10293 days 16:47:18.657898,055,1.2,0.0,-680,0,1750.0
322500.0,4,2.5,1820,6753,2.0,3,7,1820,0.0,1994,1820,7107,10293 days 16:47:18.657898,169,1.6,0.0,0,-354,1820.0
650000.0,3,3.25,1510,2000,2.0,3,9,1330,180.0,2001,1510,1352,7736 days 16:47:18.657898,255,0.9230769230769231,7.388888888888889,0,648,1150.0
450000.0,3,2.0,1290,1213,3.0,3,8,1290,0.0,2001,1290,3235,7736 days 16:47:18.657898,218,1.5,0.0,0,-2022,1290.0
278500.0,3,2.0,1570,5250,1.0,3,7,1570,0.0,1998,1570,5250,8832 days 16:47:18.657898,107,1.5,0.0,0,0,1570.0
364950.0,4,2.5,1930,6957,2.0,3,8,1930,0.0,1995,2090,6996,9928 days 16:47:18.657898,117,1.6,0.0,-160,-39,1930.0
840000.0,4,3.5,2840,40139,1.0,4,1,2840,0.0,1986,3180,36852,13215 days 16:47:18.657898,254,1.1428571428571428,0.0,-340,3287,2840.0
268000.0,3,2.5,1550,8134,2.0,3,7,1550,0.0,1991,1550,8134,11389 days 16:47:18.657898,077,1.2,0.0,0,0,1550.0
517534.0,2,1.0,833,143947,1.0,3,5,833,0.0,2006,1380,143947,5910 days 16:47:18.657898,197,2.0,0.0,-547,0,833.0
632925.0,3,2.5,2990,32239,2.0,4,8,2990,0.0,1978,2990,36497,16137 days 16:47:18.657898,308,1.2,0.0,0,-4258,2990.0
577500.0,3,2.5,2000,7251,2.0,3,9,2000,0.0,1995,2450,8118,9928 days 16:47:18.657898,204,1.2,0.0,-450,-867,2000.0
339000.0,4,1.5,2390,7480,1.5,3,7,2390,0.0,1920,2850,6867,37322 days 16:47:18.657898,043,2.6666666666666665,0.0,-460,613,2390.0
570000.0,3,1.75,2910,37461,1.0,4,7,1530,1380.0,1967,2520,18295,20155 days 16:47:18.657898,252,1.7142857142857142,1.108695652173913,390,19166,150.0
563500.0,4,1.75,2085,174240,1.0,3,7,1610,475.0,1964,2690,174240,21251 days 16:47:18.657898,177,2.2857142857142856,3.389473684210526,-605,0,1135.0
423000.0,4,2.25,2200,9351,1.0,5,7,1290,910.0,1962,1910,8660,21981 days 16:47:18.657898,005,1.7777777777777777,1.4175824175824177,290,691,380.0
355000.0,3,2.25,1860,5028,2.0,3,8,1860,0.0,2012,2320,5465,3719 days 16:47:18.657898,357,1.3333333333333333,0.0,-460,-437,1860.0
1550000.0,5,4.25,6070,171626,2.0,3,1,6070,0.0,1999,4680,211267,8467 days 16:47:18.657898,191,1.1764705882352942,0.0,1390,-39641,6070.0
482000.0,2,1.0,950,3960,1.0,3,7,950,0.0,1941,1320,4050,29651 days 16:47:18.657898,337,2.0,0.0,-370,-90,950.0
625000.0,3,1.75,1600,9135,1.0,5,7,1600,0.0,1955,1580,9800,24538 days 16:47:18.657898,211,1.7142857142857142,0.0,20,-665,1600.0
538000.0,3,2.5,2250,11632,2.0,3,8,2250,0.0,1988,2360,11632,12485 days 16:47:18.657898,353,1.2,0.0,-110,0,2250.0
380000.0,3,2.5,2280,10255,2.0,4,8,2280,0.0,1985,2310,10094,13580 days 16:47:18.657898,007,1.2,0.0,-30,161,2280.0
375000.0,2,1.0,940,5120,1.0,3,7,940,0.0,1909,1300,5120,41339 days 16:47:18.657898,198,2.0,0.0,-360,0,940.0
245000.0,3,2.5,1530,8500,1.0,5,7,1030,500.0,1996,1850,8140,9563 days 16:47:18.657898,093,1.2,2.06,-320,360,530.0
310000.0,5,1.75,2190,27260,1.0,4,7,2190,0.0,1947,1620,39480,27460 days 16:47:18.657898,318,2.857142857142857,0.0,570,-12220,2190.0
1300000.0,3,2.0,2350,15021,1.0,4,8,1770,580.0,1976,3530,15715,16868 days 16:47:18.657898,056,1.5,3.0517241379310347,-1180,-694,1190.0
397000.0,4,2.0,1440,7680,1.0,3,7,1200,240.0,1971,1460,9660,18694 days 16:47:18.657898,126,2.0,5.0,-20,-1980,960.0
365000.0,3,2.5,2200,4052,2.0,3,8,2200,0.0,2005,2310,5082,6275 days 16:47:18.657898,132,1.2,0.0,-110,-1030,2200.0
328500.0,4,3.0,2290,8250,2.0,3,9,2290,0.0,1990,2290,8250,11754 days 16:47:18.657898,301,1.3333333333333333,0.0,0,0,2290.0
988000.0,4,3.0,4040,19700,2.0,3,1,4040,0.0,1987,3930,21887,12850 days 16:47:18.657898,251,1.3333333333333333,0.0,110,-2187,4040.0
1000000.0,4,2.5,2610,3277,1.5,5,8,1920,690.0,1922,1810,3277,36591 days 16:47:18.657898,203,1.6,2.782608695652174,800,0,1230.0
237000.0,3,2.5,1490,2138,2.0,3,7,1490,0.0,2005,1490,2094,6275 days 16:47:18.657898,246,1.2,0.0,0,44,1490.0
525000.0,4,2.5,2450,5280,2.0,3,8,2450,0.0,2003,2300,4674,7006 days 16:47:18.657898,262,1.6,0.0,150,606,2450.0
749000.0,4,2.5,1710,9627,1.0,3,9,1440,270.0,1976,2140,9131,16868 days 16:47:18.657898,259,1.6,5.333333333333333,-430,496,1170.0
722500.0,5,2.5,4870,11800,2.0,3,1,3470,1400.0,1983,3180,11398,14311 days 16:47:18.657898,233,2.0,2.4785714285714286,1690,402,2070.0
843000.0,3,2.5,3130,8750,2.0,3,1,3130,0.0,1991,2860,9003,11389 days 16:47:18.657898,071,1.2,0.0,270,-253,3130.0
438000.0,2,2.0,1270,1372,3.0,3,8,1270,0.0,2000,1610,3090,8102 days 16:47:18.657898,189,1.0,0.0,-340,-1718,1270.0
578000.0,3,1.75,2120,10875,1.0,3,8,1540,580.0,1977,2460,11760,16502 days 16:47:18.657898,259,1.7142857142857142,2.6551724137931036,-340,-885,960.0
227950.0,3,1.5,1670,8230,1.0,5,7,1670,0.0,1954,2077,4910,24903 days 16:47:18.657898,266,2.0,0.0,-407,3320,1670.0
196000.0,3,2.25,2070,11576,2.0,3,7,2070,0.0,1974,1890,7519,17598 days 16:47:18.657898,203,1.3333333333333333,0.0,180,4057,2070.0
641000.0,2,1.0,1420,5332,1.0,3,8,1070,350.0,1953,2400,5406,25268 days 16:47:18.657898,196,2.0,3.057142857142857,-980,-74,720.0
350000.0,3,1.5,1250,219978,1.0,4,6,1250,0.0,1980,1930,210394,15407 days 16:47:18.657898,112,2.0,0.0,-680,9584,1250.0
205000.0,3,1.0,940,7980,1.0,4,7,940,0.0,1960,1150,8050,22712 days 16:47:18.657898,231,3.0,0.0,-210,-70,940.0
400000.0,3,1.75,1920,9102,1.0,3,7,1920,0.0,1968,1920,9760,19790 days 16:47:18.657898,336,1.7142857142857142,0.0,0,-658,1920.0
1030000.0,3,2.5,3545,9816,1.0,3,1,2610,935.0,2005,3630,7704,6275 days 16:47:18.657898,314,1.2,2.7914438502673797,-85,2112,1675.0
505000.0,3,2.0,1260,5460,1.0,3,7,1260,0.0,1972,1510,5460,18329 days 16:47:18.657898,078,1.5,0.0,-250,0,1260.0
475000.0,5,2.5,2340,7200,1.0,3,7,1300,1040.0,1975,1930,7221,17233 days 16:47:18.657898,282,2.0,1.25,410,-21,260.0
520000.0,3,2.25,2590,9263,1.0,5,8,1440,1150.0,1977,2580,9450,16502 days 16:47:18.657898,309,1.3333333333333333,1.2521739130434784,10,-187,290.0
1450000.0,3,4.5,3970,24920,2.0,3,1,3260,710.0,1977,2610,13838,16502 days 16:47:18.657898,122,0.6666666666666666,4.591549295774648,1360,11082,2550.0
333500.0,3,1.75,1220,9732,1.0,3,7,1220,0.0,1965,1630,10007,20885 days 16:47:18.657898,365,1.7142857142857142,0.0,-410,-275,1220.0
232000.0,3,1.0,1400,10403,1.0,4,6,1400,0.0,1976,1230,10209,16868 days 16:47:18.657898,053,3.0,0.0,170,194,1400.0
691100.0,3,2.75,2360,16117,1.0,4,8,1710,650.0,1983,2120,16117,14311 days 16:47:18.657898,111,1.0909090909090908,2.6307692307692307,240,0,1060.0
811000.0,3,1.75,1870,9897,1.0,4,8,1870,0.0,1960,1900,10005,22712 days 16:47:18.657898,287,1.7142857142857142,0.0,-30,-108,1870.0
551000.0,3,2.5,2830,5802,2.0,3,9,2830,0.0,2001,2500,5788,7736 days 16:47:18.657898,140,1.2,0.0,330,14,2830.0
496500.0,3,2.5,2260,3640,2.0,3,8,2260,0.0,1994,2350,3710,10293 days 16:47:18.657898,008,1.2,0.0,-90,-70,2260.0
705000.0,3,3.0,1970,20978,2.0,4,9,1770,200.0,1980,2280,75396,15407 days 16:47:18.657898,330,1.0,8.85,-310,-54418,1570.0
578000.0,4,2.5,3140,9225,1.0,5,9,1770,1370.0,1966,2460,9600,20520 days 16:47:18.657898,163,1.6,1.2919708029197081,680,-375,400.0
255000.0,3,1.75,1240,8659,1.0,5,7,1240,0.0,1986,1490,8223,13215 days 16:47:18.657898,028,1.7142857142857142,0.0,-250,436,1240.0
1050000.0,4,3.5,3450,7832,2.0,3,1,3450,0.0,2007,3220,8567,5545 days 16:47:18.657898,177,1.1428571428571428,0.0,230,-735,3450.0
348000.0,3,2.25,2570,8491,2.0,4,8,2570,0.0,1989,2400,8049,12119 days 16:47:18.657898,064,1.3333333333333333,0.0,170,442,2570.0
230000.0,3,2.0,1510,3413,2.0,3,7,1510,0.0,1985,1570,3777,13580 days 16:47:18.657898,308,1.5,0.0,-60,-364,1510.0
359500.0,4,2.25,2390,11250,2.0,3,9,2390,0.0,1988,2480,11250,12485 days 16:47:18.657898,343,1.7777777777777777,0.0,-90,0,2390.0
330000.0,3,1.0,980,7000,1.0,3,6,980,0.0,1953,1220,7000,25268 days 16:47:18.657898,316,3.0,0.0,-240,0,980.0
80000.0,1,0.75,430,5050,1.0,2,4,430,0.0,1912,1200,7500,40244 days 16:47:18.657898,143,1.3333333333333333,0.0,-770,-2450,430.0
465000.0,3,1.75,1480,6360,1.0,3,7,1480,0.0,1954,1480,6360,24903 days 16:47:18.657898,335,1.7142857142857142,0.0,0,0,1480.0
325000.0,4,2.5,1850,7324,2.0,3,8,1850,0.0,1997,2100,7329,9197 days 16:47:18.657898,288,1.6,0.0,-250,-5,1850.0
340500.0,3,2.0,2270,28025,1.0,4,7,1920,350.0,1947,1770,14833,27460 days 16:47:18.657898,007,1.5,5.485714285714286,500,13192,1570.0
342500.0,3,2.5,1810,5192,2.0,3,8,1810,0.0,1993,1810,6200,10658 days 16:47:18.657898,006,1.2,0.0,0,-1008,1810.0
290900.0,2,2.0,1610,17600,2.0,3,6,1610,0.0,1930,1310,12950,33669 days 16:47:18.657898,174,1.0,0.0,300,4650,1610.0
868700.0,3,4.25,3840,6161,2.0,3,1,3840,0.0,2000,3230,7709,8102 days 16:47:18.657898,044,0.7058823529411765,0.0,610,-1548,3840.0
1200000.0,4,2.75,4110,8400,2.0,3,9,3130,980.0,1928,2820,8400,34400 days 16:47:18.657898,317,1.4545454545454546,3.193877551020408,1290,0,2150.0
1150000.0,4,3.25,4190,10259,2.0,3,1,3150,1040.0,2000,4300,11919,8102 days 16:47:18.657898,287,1.2307692307692308,3.0288461538461537,-110,-1660,2110.0
859900.0,4,2.75,3390,6298,2.0,3,9,3390,0.0,2011,3390,7111,4084 days 16:47:18.657898,223,1.4545454545454546,0.0,0,-813,3390.0
520000.0,4,2.25,1890,3006,2.0,3,7,1890,0.0,2003,1580,3000,7006 days 16:47:18.657898,220,1.7777777777777777,0.0,310,6,1890.0
460000.0,3,2.5,1610,2527,2.0,3,9,1080,530.0,2005,1610,4173,6275 days 16:47:18.657898,192,1.2,2.0377358490566038,0,-1646,550.0
438924.0,3,1.5,1050,4590,1.0,3,7,850,200.0,1949,1770,5400,26729 days 16:47:18.657898,244,2.0,4.25,-720,-810,650.0
315000.0,2,1.0,630,6550,1.0,3,5,630,0.0,1918,1420,6550,38052 days 16:47:18.657898,096,2.0,0.0,-790,0,630.0
590000.0,4,2.75,2910,10650,1.0,3,8,1780,1130.0,1975,2920,10988,17233 days 16:47:18.657898,199,1.4545454545454546,1.575221238938053,-10,-338,650.0
378500.0,4,1.75,1700,8640,1.0,3,7,850,850.0,1955,1620,9000,24538 days 16:47:18.657898,308,2.2857142857142856,1.0,80,-360,0.0
328500.0,3,2.5,1950,8130,2.0,4,9,1950,0.0,1990,2350,7691,11754 days 16:47:18.657898,154,1.2,0.0,-400,439,1950.0
849950.0,3,3.0,2990,9773,2.0,4,8,2990,0.0,1973,2230,11553,17963 days 16:47:18.657898,084,1.0,0.0,760,-1780,2990.0
525000.0,3,1.5,1350,6000,1.0,3,7,900,450.0,1950,1730,6012,26364 days 16:47:18.657898,300,2.0,2.0,-380,-12,450.0
1390000.0,4,3.25,4860,181319,2.5,3,9,4860,0.0,1993,3850,181319,10658 days 16:47:18.657898,100,1.2307692307692308,0.0,1010,0,4860.0
295000.0,4,2.5,2160,7725,1.0,4,8,1460,700.0,1978,2060,8250,16137 days 16:47:18.657898,118,1.6,2.085714285714286,100,-525,760.0
1070000.0,6,3.5,4860,11793,2.0,3,1,3860,1000.0,1998,3600,11793,8832 days 16:47:18.657898,192,1.7142857142857142,3.86,1260,0,2860.0
207950.0,2,2.0,890,5000,1.0,3,6,890,0.0,1917,1860,5000,38417 days 16:47:18.657898,202,1.0,0.0,-970,0,890.0
699900.0,4,2.75,2810,7302,2.0,3,9,2810,0.0,2002,2820,7302,7371 days 16:47:18.657898,350,1.4545454545454546,0.0,-10,0,2810.0
1280000.0,5,2.5,3400,9500,2.0,4,8,3400,0.0,1977,3080,11081,16502 days 16:47:18.657898,041,2.0,0.0,320,-1581,3400.0
452000.0,4,1.5,1580,7350,1.0,4,7,960,620.0,1963,1560,7350,21616 days 16:47:18.657898,324,2.6666666666666665,1.5483870967741935,20,0,340.0
370000.0,3,2.0,1680,5036,1.0,4,7,1680,0.0,1987,1680,4921,12850 days 16:47:18.657898,036,1.5,0.0,0,115,1680.0
232000.0,3,1.75,1300,11230,1.0,5,7,1300,0.0,1968,1300,10794,19790 days 16:47:18.657898,027,1.7142857142857142,0.0,0,436,1300.0
669950.0,5,2.5,2820,14062,2.0,4,7,2380,440.0,1960,1910,10392,22712 days 16:47:18.657898,303,2.0,5.409090909090909,910,3670,1940.0
397500.0,3,2.0,1510,6710,1.0,3,7,1070,440.0,1972,1660,6600,18329 days 16:47:18.657898,165,1.5,2.4318181818181817,-150,110,630.0
490000.0,2,2.5,1230,1391,2.0,3,8,870,360.0,2004,1240,1350,6641 days 16:47:18.657898,132,0.8,2.4166666666666665,-10,41,510.0
725000.0,4,2.0,2110,4140,2.0,3,9,1710,400.0,1925,1440,4420,35495 days 16:47:18.657898,028,2.0,4.275,670,-280,1310.0
299000.0,3,2.75,3080,19635,1.0,4,7,1610,1470.0,1958,2424,12410,23442 days 16:47:18.657898,260,1.0909090909090908,1.0952380952380953,656,7225,140.0
625000.0,2,1.5,1490,5750,1.5,4,7,1190,300.0,1900,1590,4025,44626 days 16:47:18.657898,230,1.3333333333333333,3.966666666666667,-100,1725,890.0
437500.0,3,2.5,2120,4500,2.0,3,7,2120,0.0,2000,2530,4816,8102 days 16:47:18.657898,310,1.2,0.0,-410,-316,2120.0
650000.0,4,2.5,3180,5438,2.0,3,9,3180,0.0,2003,3030,5335,7006 days 16:47:18.657898,130,1.6,0.0,150,103,3180.0
475000.0,2,1.0,1490,3825,1.0,3,7,860,630.0,1929,1460,3825,34034 days 16:47:18.657898,139,2.0,1.3650793650793651,30,0,230.0
342000.0,3,2.0,1930,11947,1.0,4,8,1930,0.0,1966,2200,12825,20520 days 16:47:18.657898,122,1.5,0.0,-270,-878,1930.0
1200000.0,4,2.5,2770,7800,2.0,3,1,2770,0.0,1999,2720,10000,8467 days 16:47:18.657898,288,1.6,0.0,50,-2200,2770.0
280000.0,3,1.5,1670,11610,1.0,4,7,1670,0.0,1963,1930,10200,21616 days 16:47:18.657898,041,2.0,0.0,-260,1410,1670.0
240000.0,2,1.75,1330,7200,1.0,3,7,1330,0.0,1993,1450,11682,10658 days 16:47:18.657898,141,1.1428571428571428,0.0,-120,-4482,1330.0
529000.0,3,1.0,1210,3328,1.5,4,7,1210,0.0,1924,1640,3333,35861 days 16:47:18.657898,147,3.0,0.0,-430,-5,1210.0
442000.0,3,1.0,1190,5100,1.0,4,7,1030,160.0,1941,1690,5100,29651 days 16:47:18.657898,033,3.0,6.4375,-500,0,870.0
1490000.0,4,3.75,4030,10800,2.0,3,1,4030,0.0,2006,2160,7200,5910 days 16:47:18.657898,163,1.0666666666666667,0.0,1870,3600,4030.0
585000.0,4,1.75,2430,7559,1.0,4,8,1580,850.0,1981,1980,8750,15041 days 16:47:18.657898,125,2.2857142857142856,1.8588235294117648,450,-1191,730.0
480000.0,4,2.5,2600,7787,2.0,3,8,2600,0.0,2005,2830,7787,6275 days 16:47:18.657898,064,1.6,0.0,-230,0,2600.0
1100000.0,5,3.5,4410,57063,2.0,4,9,4410,0.0,1990,2900,50529,11754 days 16:47:18.657898,202,1.4285714285714286,0.0,1510,6534,4410.0
290000.0,4,1.0,1330,8184,1.5,3,7,1330,0.0,1949,1220,660,26729 days 16:47:18.657898,309,4.0,0.0,110,7524,1330.0
615000.0,3,1.75,1900,5000,1.0,5,7,950,950.0,1951,1770,5000,25999 days 16:47:18.657898,232,1.7142857142857142,1.0,130,0,0.0
300000.0,2,1.0,1100,7680,1.0,4,7,1100,0.0,1950,1460,7680,26364 days 16:47:18.657898,070,2.0,0.0,-360,0,1100.0
308000.0,3,1.0,1980,39150,1.5,3,6,1580,400.0,1932,1860,11811,32939 days 16:47:18.657898,302,3.0,3.95,120,27339,1180.0
750000.0,3,2.5,2400,7745,2.0,3,9,2400,0.0,2001,2080,8615,7736 days 16:47:18.657898,127,1.2,0.0,320,-870,2400.0
2250000.0,4,2.25,4760,8036,2.5,5,9,3390,1370.0,1916,2950,9323,38783 days 16:47:18.657898,318,1.7777777777777777,2.4744525547445257,1810,-1287,2020.0
890000.0,4,3.25,3180,194278,2.0,3,1,3180,0.0,2005,2200,178160,6275 days 16:47:18.657898,217,1.2307692307692308,0.0,980,16118,3180.0
288000.0,3,1.0,1190,7560,1.0,5,6,1190,0.0,1958,1190,7560,23442 days 16:47:18.657898,084,3.0,0.0,0,0,1190.0
190000.0,2,1.0,630,6000,1.0,3,6,630,0.0,1943,1470,6840,28921 days 16:47:18.657898,249,2.0,0.0,-840,-840,630.0
515000.0,5,3.0,2530,5105,1.0,3,8,1520,1010.0,2005,2290,4011,6275 days 16:47:18.657898,085,1.6666666666666667,1.504950495049505,240,1094,510.0
235000.0,4,1.5,1690,11054,1.0,4,5,1690,0.0,1930,1690,9040,33669 days 16:47:18.657898,309,2.6666666666666665,0.0,0,2014,1690.0
275000.0,2,1.0,940,5000,1.0,3,6,940,0.0,1951,940,5000,25999 days 16:47:18.657898,230,2.0,0.0,0,0,940.0
727500.0,2,2.0,1240,9119,1.0,4,7,1240,0.0,1952,1380,9121,25634 days 16:47:18.657898,325,1.0,0.0,-140,-2,1240.0
650000.0,4,2.5,3040,6587,2.0,3,7,3040,0.0,2003,2740,6587,7006 days 16:47:18.657898,171,1.6,0.0,300,0,3040.0
1600000.0,6,5.0,6050,230652,2.0,3,1,6050,0.0,2001,4210,233971,7736 days 16:47:18.657898,169,1.2,0.0,1840,-3319,6050.0
365000.0,4,1.0,1590,7085,1.5,3,6,1590,0.0,1944,1320,7085,28556 days 16:47:18.657898,309,4.0,0.0,270,0,1590.0
662000.0,3,1.75,2500,36947,1.0,3,9,2500,0.0,1984,2590,28837,13946 days 16:47:18.657898,281,1.7142857142857142,0.0,-90,8110,2500.0
270500.0,3,2.5,1780,7848,1.0,3,7,1320,460.0,1978,1680,7848,16137 days 16:47:18.657898,119,1.2,2.869565217391304,100,0,860.0
200000.0,2,1.5,1360,1898,2.0,3,7,1360,0.0,1978,1360,1898,16137 days 16:47:18.657898,125,1.3333333333333333,0.0,0,0,1360.0
970000.0,4,3.25,4740,76230,2.0,3,1,4740,0.0,1987,3340,49206,12850 days 16:47:18.657898,055,1.2307692307692308,0.0,1400,27024,4740.0
160000.0,3,1.5,1010,9600,1.0,4,7,1010,0.0,1962,1400,9660,21981 days 16:47:18.657898,175,2.0,0.0,-390,-60,1010.0
204000.0,3,1.0,1040,7405,1.0,4,6,1040,0.0,1971,1580,7405,18694 days 16:47:18.657898,049,3.0,0.0,-540,0,1040.0
358000.0,3,2.25,1610,6655,2.0,4,7,1610,0.0,1985,1780,7529,13580 days 16:47:18.657898,049,1.3333333333333333,0.0,-170,-874,1610.0
452000.0,4,1.75,1570,8268,1.0,3,7,1570,0.0,1979,1870,8190,15772 days 16:47:18.657898,121,2.2857142857142856,0.0,-300,78,1570.0
595000.0,2,2.0,1510,4000,1.0,4,7,1010,500.0,1900,1920,4000,44626 days 16:47:18.657898,338,1.0,2.02,-410,0,510.0
249000.0,3,2.0,1360,6082,1.0,3,7,1360,0.0,1994,1360,6987,10293 days 16:47:18.657898,100,1.5,0.0,0,-905,1360.0
346900.0,4,2.5,1970,5106,2.0,3,8,1970,0.0,1999,2230,5109,8467 days 16:47:18.657898,069,1.6,0.0,-260,-3,1970.0
2130000.0,3,2.5,5403,24069,2.0,4,1,5403,0.0,1976,3980,104374,16868 days 16:47:18.657898,049,1.2,0.0,1423,-80305,5403.0
280000.0,4,2.5,1560,4350,2.0,3,7,1560,0.0,2003,1560,4350,7006 days 16:47:18.657898,303,1.6,0.0,0,0,1560.0
318888.0,4,1.75,2320,12000,1.0,4,8,2270,50.0,1973,2120,9880,17963 days 16:47:18.657898,286,2.2857142857142856,45.4,200,2120,2220.0
530000.0,3,2.25,2120,40518,1.0,3,8,2120,0.0,1967,2480,13492,20155 days 16:47:18.657898,254,1.3333333333333333,0.0,-360,27026,2120.0
375000.0,3,2.25,2120,18500,2.0,4,8,2120,0.0,1983,2120,14479,14311 days 16:47:18.657898,325,1.3333333333333333,0.0,0,4021,2120.0
910000.0,4,2.5,3350,29242,2.0,3,1,3350,0.0,1988,3920,24728,12485 days 16:47:18.657898,112,1.6,0.0,-570,4514,3350.0
782000.0,4,2.5,2380,9614,2.0,4,1,2380,0.0,1991,2560,9770,11389 days 16:47:18.657898,143,1.6,0.0,-180,-156,2380.0
259950.0,2,2.0,1070,649,2.0,3,9,720,350.0,2008,1070,928,5180 days 16:47:18.657898,078,1.0,2.057142857142857,0,-279,370.0
315000.0,4,2.75,2300,18360,1.0,4,7,1560,740.0,1979,1870,9588,15772 days 16:47:18.657898,266,1.4545454545454546,2.108108108108108,430,8772,820.0
215000.0,2,1.0,1320,8865,1.0,4,6,1320,0.0,1943,1190,6490,28921 days 16:47:18.657898,148,2.0,0.0,130,2375,1320.0
705000.0,3,1.75,2180,10221,1.0,4,7,1140,1040.0,1946,2180,8535,27825 days 16:47:18.657898,204,1.7142857142857142,1.0961538461538463,0,1686,100.0
1450000.0,3,3.0,4380,6320,2.0,5,1,3580,800.0,1952,3080,7680,25634 days 16:47:18.657898,286,1.0,4.475,1300,-1360,2780.0
451000.0,3,1.75,1790,9813,2.0,3,7,1790,0.0,1949,1520,10125,26729 days 16:47:18.657898,128,1.7142857142857142,0.0,270,-312,1790.0
261000.0,2,1.0,750,8125,1.0,4,6,750,0.0,1943,1340,8750,28921 days 16:47:18.657898,245,2.0,0.0,-590,-625,750.0
396000.0,3,1.5,1300,8280,1.0,5,7,1300,0.0,1956,1570,8692,24173 days 16:47:18.657898,321,2.0,0.0,-270,-412,1300.0
725000.0,4,2.5,2990,29170,2.0,3,9,2990,0.0,1999,3715,29170,8467 days 16:47:18.657898,203,1.6,0.0,-725,0,2990.0
1950000.0,7,3.5,4640,15235,2.0,3,1,2860,1780.0,1965,3230,20697,20885 days 16:47:18.657898,171,2.0,1.6067415730337078,1410,-5462,1080.0
238000.0,4,1.0,1400,7242,1.5,3,7,1400,0.0,1959,1310,7314,23077 days 16:47:18.657898,196,4.0,0.0,90,-72,1400.0
750000.0,6,1.75,2750,9563,2.0,4,8,2750,0.0,1973,2040,9563,17963 days 16:47:18.657898,117,3.4285714285714284,0.0,710,0,2750.0
331500.0,4,2.5,2050,10271,2.0,3,7,2050,0.0,1998,2050,8103,8832 days 16:47:18.657898,300,1.6,0.0,0,2168,2050.0
460000.0,4,3.0,2230,108900,1.0,3,7,1410,820.0,1978,1960,65340,16137 days 16:47:18.657898,301,1.3333333333333333,1.7195121951219512,270,43560,590.0
404950.0,4,2.25,2340,217014,1.0,4,8,2340,0.0,1982,2340,107898,14676 days 16:47:18.657898,188,1.7777777777777777,0.0,0,109116,2340.0
880000.0,3,2.5,2870,5163,2.0,3,9,2870,0.0,2014,1630,7995,2988 days 16:47:18.657898,351,1.2,0.0,1240,-2832,2870.0
863000.0,4,2.5,4120,22370,2.0,3,1,4120,0.0,1997,3180,7257,9197 days 16:47:18.657898,164,1.6,0.0,940,15113,4120.0
638700.0,3,1.75,2080,9162,1.0,3,7,1370,710.0,1960,1870,8944,22712 days 16:47:18.657898,350,1.7142857142857142,1.9295774647887325,210,218,660.0
435000.0,3,2.5,1840,5680,2.0,3,7,1840,0.0,2008,1600,4697,5180 days 16:47:18.657898,209,1.2,0.0,240,983,1840.0
260000.0,3,1.0,1180,5350,1.5,4,6,1180,0.0,1959,1490,5350,23077 days 16:47:18.657898,365,3.0,0.0,-310,0,1180.0
671500.0,5,2.75,2160,4000,1.5,5,7,1530,630.0,1927,2040,4000,34765 days 16:47:18.657898,226,1.8181818181818181,2.4285714285714284,120,0,900.0
610000.0,3,1.0,1180,3400,1.5,3,8,1180,0.0,1907,1440,3400,42070 days 16:47:18.657898,295,3.0,0.0,-260,0,1180.0
405000.0,2,0.75,1160,15029,1.0,4,6,870,290.0,1937,1870,25346,31112 days 16:47:18.657898,352,2.6666666666666665,3.0,-710,-10317,580.0
338900.0,4,2.5,1830,5612,2.0,3,7,1830,0.0,2003,1830,5998,7006 days 16:47:18.657898,199,1.6,0.0,0,-386,1830.0
720000.0,4,4.0,3200,7708,2.0,3,1,3200,0.0,2004,3480,7944,6641 days 16:47:18.657898,023,1.0,0.0,-280,-236,3200.0
442000.0,5,3.0,2560,5445,1.5,4,7,1760,800.0,1927,1080,5445,34765 days 16:47:18.657898,114,1.6666666666666667,2.2,1480,0,960.0
650000.0,5,2.75,2550,5040,1.5,5,8,2550,0.0,1902,1590,3840,43896 days 16:47:18.657898,154,1.8181818181818181,0.0,960,1200,2550.0
263500.0,3,1.75,1330,9917,1.0,3,7,1040,290.0,1981,1330,9081,15041 days 16:47:18.657898,002,1.7142857142857142,3.586206896551724,0,836,750.0
300000.0,2,1.0,1220,75794,1.0,4,7,1220,0.0,1963,2010,98010,21616 days 16:47:18.657898,351,2.0,0.0,-790,-22216,1220.0
266000.0,3,2.5,1805,3402,2.0,3,7,1805,0.0,2009,2095,3402,4814 days 16:47:18.657898,343,1.2,0.0,-290,0,1805.0
930000.0,4,4.0,6050,84942,2.5,3,9,4150,1900.0,2009,2700,199504,4814 days 16:47:18.657898,345,1.0,2.1842105263157894,3350,-114562,2250.0
530000.0,4,2.5,2320,5493,2.0,3,8,2320,0.0,2004,2450,5471,6641 days 16:47:18.657898,027,1.6,0.0,-130,22,2320.0
180000.0,3,1.0,1384,8960,1.0,4,6,1384,0.0,1965,1000,8470,20885 days 16:47:18.657898,345,3.0,0.0,384,490,1384.0
619000.0,3,2.5,2720,6439,2.0,3,9,2720,0.0,2005,3180,7320,6275 days 16:47:18.657898,136,1.2,0.0,-460,-881,2720.0
264000.0,3,1.5,1820,10608,1.0,4,7,1820,0.0,1962,1380,8976,21981 days 16:47:18.657898,233,2.0,0.0,440,1632,1820.0
730000.0,2,2.25,2130,4920,1.5,4,7,1530,600.0,1941,2130,4920,29651 days 16:47:18.657898,182,0.8888888888888888,2.55,0,0,930.0
439000.0,4,2.25,2060,10070,2.0,3,7,2060,0.0,1975,2060,8155,17233 days 16:47:18.657898,295,1.7777777777777777,0.0,0,1915,2060.0
268500.0,4,1.75,1420,7500,1.0,4,7,1080,340.0,1981,1500,7260,15041 days 16:47:18.657898,321,2.2857142857142856,3.176470588235294,-80,240,740.0
330000.0,3,1.75,1510,15744,1.0,3,7,1510,0.0,1985,1470,15744,13580 days 16:47:18.657898,196,1.7142857142857142,0.0,40,0,1510.0
640000.0,3,2.5,2160,4000,1.5,3,8,1960,200.0,1903,2160,5120,43531 days 16:47:18.657898,231,1.2,9.8,0,-1120,1760.0
900000.0,3,2.5,3180,12600,2.0,4,1,3180,0.0,1978,3030,12835,16137 days 16:47:18.657898,189,1.2,0.0,150,-235,3180.0
370000.0,3,2.25,2110,13300,2.0,4,8,2110,0.0,1985,2470,14000,13580 days 16:47:18.657898,273,1.3333333333333333,0.0,-360,-700,2110.0
685000.0,3,2.0,2060,2900,1.5,5,8,1330,730.0,1931,1910,3900,33304 days 16:47:18.657898,073,1.5,1.821917808219178,150,-1000,600.0
505000.0,3,1.5,1830,217800,1.0,3,7,1010,820.0,1981,2450,165963,15041 days 16:47:18.657898,247,2.0,1.2317073170731707,-620,51837,190.0
265000.0,3,1.75,1820,32666,1.0,4,7,1820,0.0,1966,2050,43560,20520 days 16:47:18.657898,294,1.7142857142857142,0.0,-230,-10894,1820.0
290000.0,3,2.5,1610,2937,2.0,3,8,1610,0.0,2006,1610,3049,5910 days 16:47:18.657898,083,1.2,0.0,0,-112,1610.0
296000.0,4,2.5,1780,3600,2.0,3,7,1780,0.0,2006,2020,3802,5910 days 16:47:18.657898,245,1.6,0.0,-240,-202,1780.0
360000.0,4,2.5,1840,9611,2.0,3,7,1840,0.0,1996,1830,8505,9563 days 16:47:18.657898,044,1.6,0.0,10,1106,1840.0
240500.0,3,1.75,1460,10584,1.0,3,7,990,470.0,1997,1220,12012,9197 days 16:47:18.657898,155,1.7142857142857142,2.106382978723404,240,-1428,520.0
372500.0,2,2.5,1400,2958,2.0,3,8,1400,0.0,2007,1540,2385,5545 days 16:47:18.657898,203,0.8,0.0,-140,573,1400.0
595000.0,3,2.5,3370,14402,2.0,3,9,3370,0.0,2004,3330,9691,6641 days 16:47:18.657898,275,1.2,0.0,40,4711,3370.0
515000.0,4,3.0,3590,8249,2.0,3,9,3590,0.0,1997,2860,7995,9197 days 16:47:18.657898,290,1.3333333333333333,0.0,730,254,3590.0
1220000.0,4,2.25,3200,15367,2.0,4,9,3200,0.0,1962,3070,15263,21981 days 16:47:18.657898,217,1.7777777777777777,0.0,130,104,3200.0
507000.0,2,1.75,1670,6460,1.0,3,8,1670,0.0,2004,2170,6254,6641 days 16:47:18.657898,282,1.1428571428571428,0.0,-500,206,1670.0
399950.0,4,2.0,2420,31465,1.0,3,9,2420,0.0,1984,2560,32186,13946 days 16:47:18.657898,035,2.0,0.0,-140,-721,2420.0
185000.0,3,1.75,1430,10816,2.0,3,7,1430,0.0,1994,1560,10816,10293 days 16:47:18.657898,232,1.7142857142857142,0.0,-130,0,1430.0
460000.0,3,1.75,1440,7070,1.0,3,7,1440,0.0,1980,1440,7210,15407 days 16:47:18.657898,237,1.7142857142857142,0.0,0,-140,1440.0
435500.0,3,2.25,1450,4789,2.0,3,7,1450,0.0,1985,1560,4490,13580 days 16:47:18.657898,055,1.3333333333333333,0.0,-110,299,1450.0
469000.0,4,2.75,3550,13938,1.0,5,8,2100,1450.0,1966,2050,9000,20520 days 16:47:18.657898,098,1.4545454545454546,1.4482758620689655,1500,4938,650.0
531000.0,2,3.0,1270,1175,2.0,3,8,1110,160.0,2000,1290,1800,8102 days 16:47:18.657898,125,0.6666666666666666,6.9375,-20,-625,950.0
443500.0,2,1.0,940,6804,1.0,3,7,940,0.0,1949,1150,6930,26729 days 16:47:18.657898,037,2.0,0.0,-210,-126,940.0
223000.0,3,2.0,1670,6824,1.0,3,7,1300,370.0,1990,1660,7586,11754 days 16:47:18.657898,330,1.5,3.5135135135135136,10,-762,930.0
590000.0,4,3.5,3100,15842,2.0,3,8,2400,700.0,1996,2200,19400,9563 days 16:47:18.657898,107,1.1428571428571428,3.4285714285714284,900,-3558,1700.0
340000.0,2,2.5,1100,1760,3.0,3,7,1100,0.0,1997,1200,1415,9197 days 16:47:18.657898,343,0.8,0.0,-100,345,1100.0
650000.0,3,2.0,1870,3388,1.0,4,8,1230,640.0,1925,1780,4050,35495 days 16:47:18.657898,309,1.5,1.921875,90,-662,590.0
533600.0,3,2.5,1930,5080,2.0,4,8,1930,0.0,1990,2190,5085,11754 days 16:47:18.657898,268,1.2,0.0,-260,-5,1930.0
695000.0,3,2.75,2540,4694,2.0,3,9,2540,0.0,2005,2600,6344,6275 days 16:47:18.657898,161,1.0909090909090908,0.0,-60,-1650,2540.0
242000.0,3,1.75,1280,7524,1.5,4,7,1280,0.0,1988,1500,7777,12485 days 16:47:18.657898,168,1.7142857142857142,0.0,-220,-253,1280.0
425000.0,3,2.25,1820,8814,1.0,3,7,1280,540.0,1967,1810,7515,20155 days 16:47:18.657898,014,1.3333333333333333,2.3703703703703702,10,1299,740.0
525000.0,3,2.25,1490,9414,2.0,3,7,1490,0.0,1981,1290,10125,15041 days 16:47:18.657898,126,1.3333333333333333,0.0,200,-711,1490.0
485000.0,3,2.5,1880,5502,2.0,3,8,1880,0.0,1988,2040,5411,12485 days 16:47:18.657898,265,1.2,0.0,-160,91,1880.0
175000.0,3,1.0,1250,9775,1.0,3,7,1250,0.0,1971,1390,9650,18694 days 16:47:18.657898,013,3.0,0.0,-140,125,1250.0
210000.0,3,2.0,1440,7210,1.0,3,8,1440,0.0,1983,1700,7245,14311 days 16:47:18.657898,170,1.5,0.0,-260,-35,1440.0
260000.0,3,2.5,1920,7415,2.0,3,7,1920,0.0,1989,1930,7536,12119 days 16:47:18.657898,105,1.2,0.0,-10,-121,1920.0
577000.0,3,2.5,2060,5750,1.0,3,7,1330,730.0,1976,1920,5750,16868 days 16:47:18.657898,174,1.2,1.821917808219178,140,0,600.0
200000.0,3,1.5,1210,10588,1.0,4,7,1210,0.0,1958,1408,10588,23442 days 16:47:18.657898,294,2.0,0.0,-198,0,1210.0
605000.0,2,1.75,1760,5000,1.0,4,7,940,820.0,1927,1530,5000,34765 days 16:47:18.657898,056,1.1428571428571428,1.146341463414634,230,0,120.0
325000.0,3,1.0,990,6750,1.0,4,6,990,0.0,1947,1440,6860,27460 days 16:47:18.657898,141,3.0,0.0,-450,-110,990.0
289500.0,3,1.0,960,6400,1.0,4,6,820,140.0,1944,1200,6600,28556 days 16:47:18.657898,226,3.0,5.857142857142857,-240,-200,680.0
559950.0,3,2.5,1660,1458,3.0,3,9,1660,0.0,2014,1660,1784,2988 days 16:47:18.657898,220,1.2,0.0,0,-326,1660.0
1040000.0,3,1.75,1900,9375,1.0,4,8,1330,570.0,1941,2760,9375,29651 days 16:47:18.657898,096,1.7142857142857142,2.3333333333333335,-860,0,760.0
543500.0,3,2.25,1270,2790,1.0,3,7,990,280.0,1970,1920,4000,19059 days 16:47:18.657898,282,1.3333333333333333,3.5357142857142856,-650,-1210,710.0
480000.0,4,2.25,3250,34293,2.0,4,9,3250,0.0,1983,3110,35982,14311 days 16:47:18.657898,142,1.7777777777777777,0.0,140,-1689,3250.0
218000.0,3,1.0,960,9633,1.0,5,6,960,0.0,1982,1080,8610,14676 days 16:47:18.657898,143,3.0,0.0,-120,1023,960.0
565000.0,2,1.75,1330,6000,1.0,4,7,960,370.0,1914,1620,6000,39513 days 16:47:18.657898,173,1.1428571428571428,2.5945945945945947,-290,0,590.0
426700.0,3,1.75,2080,7700,1.0,5,7,1600,480.0,1968,1680,7700,19790 days 16:47:18.657898,346,1.7142857142857142,3.3333333333333335,400,0,1120.0
542000.0,2,1.0,890,3060,1.0,3,7,770,120.0,1910,1760,4080,40974 days 16:47:18.657898,267,2.0,6.416666666666667,-870,-1020,650.0
415000.0,3,1.75,1070,8000,1.0,3,7,1070,0.0,1977,1200,7990,16502 days 16:47:18.657898,175,1.7142857142857142,0.0,-130,10,1070.0
214000.0,3,1.0,1200,8316,1.0,4,6,1200,0.0,1953,1200,8316,25268 days 16:47:18.657898,227,3.0,0.0,0,0,1200.0
245000.0,3,1.5,1360,8910,2.0,5,7,1360,0.0,1949,1220,8912,26729 days 16:47:18.657898,021,2.0,0.0,140,-2,1360.0
314500.0,3,2.0,2050,13303,1.0,3,8,2050,0.0,1993,2180,11590,10658 days 16:47:18.657898,182,1.5,0.0,-130,1713,2050.0
1120000.0,3,1.5,3000,5750,2.0,5,9,2000,1000.0,1924,1820,5750,35861 days 16:47:18.657898,099,2.0,2.0,1180,0,1000.0
378000.0,2,2.0,1300,3850,1.0,3,7,800,500.0,1963,950,5500,21616 days 16:47:18.657898,062,1.0,1.6,350,-1650,300.0
305000.0,4,2.5,2250,9091,1.0,3,7,1340,910.0,1982,1540,7802,14676 days 16:47:18.658895,209,1.6,1.4725274725274726,710,1289,430.0
595000.0,5,2.75,3740,6750,1.0,4,8,1980,1760.0,1978,2620,7920,16137 days 16:47:18.658895,079,1.8181818181818181,1.125,1120,-1170,220.0
729500.0,3,2.5,1660,1091,3.0,3,9,1530,130.0,2015,1510,1352,2623 days 16:47:18.658895,132,1.2,11.76923076923077,150,-261,1400.0
430000.0,3,2.5,2360,6699,2.0,3,7,2360,0.0,2003,2360,4744,7006 days 16:47:18.658895,273,1.2,0.0,0,1955,2360.0
545000.0,3,1.75,1680,6200,1.5,3,7,1680,0.0,1916,1680,5100,38783 days 16:47:18.658895,079,1.7142857142857142,0.0,0,1100,1680.0
530000.0,3,1.75,1320,2500,1.0,3,7,870,450.0,1918,1580,2750,38052 days 16:47:18.658895,188,1.7142857142857142,1.9333333333333333,-260,-250,420.0
157000.0,1,1.0,870,26326,1.0,3,6,870,0.0,1939,1250,10608,30382 days 16:47:18.658895,322,1.0,0.0,-380,15718,870.0
425000.0,4,1.0,1260,7645,1.5,3,6,1260,0.0,1925,1170,7649,35495 days 16:47:18.658895,097,4.0,0.0,90,-4,1260.0
220000.0,3,1.0,1000,6020,1.0,3,6,1000,0.0,1944,1300,8640,28556 days 16:47:18.658895,321,3.0,0.0,-300,-2620,1000.0
521000.0,4,1.75,2020,36400,1.0,4,8,1550,470.0,1976,2520,38255,16868 days 16:47:18.658895,328,2.2857142857142856,3.297872340425532,-500,-1855,1080.0
325000.0,3,1.0,1920,6862,1.0,3,7,1120,800.0,1952,2000,6900,25634 days 16:47:18.658895,143,3.0,1.4,-80,-38,320.0
597500.0,3,2.0,2150,5400,1.5,4,7,1380,770.0,1911,1940,6500,40609 days 16:47:18.658895,093,1.5,1.7922077922077921,210,-1100,610.0
337000.0,3,2.5,1470,3976,2.0,3,7,1470,0.0,1999,1490,4400,8467 days 16:47:18.658895,204,1.2,0.0,-20,-424,1470.0
1000000.0,3,2.5,3180,10492,2.0,3,1,3180,0.0,1991,3000,9812,11389 days 16:47:18.658895,112,1.2,0.0,180,680,3180.0
3070000.0,3,2.5,3930,55867,1.0,4,8,2330,1600.0,1957,2730,26324,23807 days 16:47:18.658895,324,1.2,1.45625,1200,29543,730.0
495000.0,3,1.0,990,6000,1.0,3,6,990,0.0,1943,1250,6000,28921 days 16:47:18.658895,127,3.0,0.0,-260,0,990.0
748000.0,4,3.5,2770,3330,2.0,3,8,1970,800.0,2001,2180,3380,7736 days 16:47:18.658895,002,1.1428571428571428,2.4625,590,-50,1170.0
888000.0,3,1.5,1250,8710,1.0,4,7,1250,0.0,1953,1750,9185,25268 days 16:47:18.658895,245,2.0,0.0,-500,-475,1250.0
269900.0,3,1.75,1140,22267,1.0,3,7,1140,0.0,1986,1150,15625,13215 days 16:47:18.658895,083,1.7142857142857142,0.0,-10,6642,1140.0
496500.0,4,2.5,2250,14440,1.0,3,7,1550,700.0,1967,2090,11400,20155 days 16:47:18.658895,317,1.6,2.2142857142857144,160,3040,850.0
475000.0,3,2.5,1640,5097,2.0,3,7,1640,0.0,1969,1880,6000,19424 days 16:47:18.658895,021,1.2,0.0,-240,-903,1640.0
312000.0,3,1.5,1255,1374,3.0,3,7,1255,0.0,2004,1307,1232,6641 days 16:47:18.658895,147,2.0,0.0,-52,142,1255.0
331000.0,3,1.75,1300,9079,1.0,3,7,1300,0.0,1986,1890,7369,13215 days 16:47:18.658895,328,1.7142857142857142,0.0,-590,1710,1300.0
306000.0,3,1.5,1220,1086,3.0,3,8,1220,0.0,2007,1220,1422,5545 days 16:47:18.658895,134,2.0,0.0,0,-336,1220.0
655000.0,4,2.5,2630,4000,3.0,3,8,2630,0.0,2002,1640,4000,7371 days 16:47:18.658895,273,1.6,0.0,990,0,2630.0
290000.0,3,1.5,1950,15954,1.0,4,8,1950,0.0,1959,1940,12667,23077 days 16:47:18.658895,190,2.0,0.0,10,3287,1950.0
1250000.0,4,3.25,3160,5000,2.0,5,9,2360,800.0,1965,2220,4000,20885 days 16:47:18.658895,214,1.2307692307692308,2.95,940,1000,1560.0
460000.0,3,1.75,1550,4708,1.0,4,7,860,690.0,1949,1880,5600,26729 days 16:47:18.658895,167,1.7142857142857142,1.2463768115942029,-330,-892,170.0
664000.0,4,2.75,2510,11880,1.0,5,8,1630,880.0,1978,2390,11211,16137 days 16:47:18.658895,075,1.4545454545454546,1.8522727272727273,120,669,750.0
865000.0,4,1.75,1800,4180,2.0,4,8,1800,0.0,1921,2180,4620,36956 days 16:47:18.658895,210,2.2857142857142856,0.0,-380,-440,1800.0
385000.0,3,1.75,1800,18000,1.0,3,8,1200,600.0,1968,1800,18000,19790 days 16:47:18.658895,225,1.7142857142857142,2.0,0,0,600.0
497000.0,3,2.25,1870,9315,1.0,3,7,1350,520.0,1975,2230,9579,17233 days 16:47:18.658895,199,1.3333333333333333,2.5961538461538463,-360,-264,830.0
280000.0,2,1.0,1010,3000,1.0,4,7,1010,0.0,1925,1150,7000,35495 days 16:47:18.658895,174,2.0,0.0,-140,-4000,1010.0
188000.0,2,1.5,1120,17487,1.0,3,6,1120,0.0,1924,1690,8056,35861 days 16:47:18.658895,027,1.3333333333333333,0.0,-570,9431,1120.0
478500.0,3,1.0,2090,4755,1.0,3,8,1200,890.0,1969,1850,5300,19424 days 16:47:18.658895,273,3.0,1.348314606741573,240,-545,310.0
1150000.0,4,3.5,4370,18361,2.0,3,1,4370,0.0,2001,4190,13641,7736 days 16:47:18.658895,212,1.1428571428571428,0.0,180,4720,4370.0
222000.0,3,2.0,1440,7187,1.0,4,7,970,470.0,1981,1440,7187,15041 days 16:47:18.658895,227,1.5,2.0638297872340425,0,0,500.0
799000.0,4,3.0,2580,209523,2.0,3,8,2580,0.0,1984,3440,213444,13946 days 16:47:18.658895,148,1.3333333333333333,0.0,-860,-3921,2580.0
609900.0,4,2.5,3190,7399,2.0,3,1,3190,0.0,2006,3250,7323,5910 days 16:47:18.658895,160,1.6,0.0,-60,76,3190.0
413000.0,4,3.5,2380,5809,2.0,4,7,1750,630.0,1995,1620,5775,9928 days 16:47:18.658895,289,1.1428571428571428,2.7777777777777777,760,34,1120.0
400000.0,4,1.0,1420,4875,1.5,3,7,1420,0.0,1930,1110,5413,33669 days 16:47:18.658895,286,4.0,0.0,310,-538,1420.0
320000.0,3,2.5,2680,7757,2.0,3,8,2680,0.0,1990,2430,8231,11754 days 16:47:18.658895,139,1.2,0.0,250,-474,2680.0
507000.0,4,2.5,2730,7649,2.0,3,7,2730,0.0,2006,2730,6216,5910 days 16:47:18.658895,070,1.6,0.0,0,1433,2730.0
387500.0,3,1.0,1220,8329,1.0,3,6,1220,0.0,1946,1490,8322,27825 days 16:47:18.658895,267,3.0,0.0,-270,7,1220.0
396000.0,3,1.0,1500,12616,1.0,3,7,1500,0.0,1967,1820,13950,20155 days 16:47:18.658895,055,3.0,0.0,-320,-1334,1500.0
373000.0,3,1.75,1830,11788,1.0,3,8,1430,400.0,1958,2140,11964,23442 days 16:47:18.658895,233,1.7142857142857142,3.575,-310,-176,1030.0
1480000.0,5,2.5,4570,19252,2.0,5,1,4570,0.0,1965,3180,13314,20885 days 16:47:18.658895,266,2.0,0.0,1390,5938,4570.0
359900.0,4,2.25,2470,7698,2.0,3,8,2470,0.0,1983,2330,7986,14311 days 16:47:18.658895,202,1.7777777777777777,0.0,140,-288,2470.0
410000.0,2,1.0,800,4342,1.0,3,6,670,130.0,1927,1210,4343,34765 days 16:47:18.658895,063,2.0,5.153846153846154,-410,-1,540.0
690000.0,4,2.5,2900,23488,2.0,3,9,2900,0.0,1992,2900,34589,11024 days 16:47:18.658895,193,1.6,0.0,0,-11101,2900.0
245000.0,3,2.0,1410,5760,1.0,3,7,1410,0.0,1985,1670,6222,13580 days 16:47:18.658895,176,1.5,0.0,-260,-462,1410.0
700000.0,5,2.5,2830,25958,1.0,5,8,1610,1220.0,1979,2670,21567,15772 days 16:47:18.658895,363,2.0,1.319672131147541,160,4391,390.0
268000.0,4,1.75,1680,9966,1.0,3,7,1100,580.0,1977,2400,10369,16502 days 16:47:18.658895,265,2.2857142857142856,1.896551724137931,-720,-403,520.0
225000.0,3,1.75,1760,26055,1.0,3,7,920,840.0,1979,1350,13475,15772 days 16:47:18.658895,161,1.7142857142857142,1.0952380952380953,410,12580,80.0
980000.0,4,2.25,2240,11034,2.0,3,8,2240,0.0,1976,2300,11550,16868 days 16:47:18.658895,282,1.7777777777777777,0.0,-60,-516,2240.0
795000.0,2,1.0,1380,5000,1.5,3,5,1380,0.0,1905,1500,5000,42800 days 16:47:18.658895,097,2.0,0.0,-120,0,1380.0
195000.0,2,1.0,820,5100,1.0,3,6,820,0.0,1953,1170,5304,25268 days 16:47:18.658895,124,2.0,0.0,-350,-204,820.0
480000.0,4,2.0,2180,10575,1.0,2,6,1730,450.0,1950,2180,12010,26364 days 16:47:18.658895,307,2.0,3.8444444444444446,0,-1435,1280.0
485000.0,4,2.0,1400,3600,1.0,3,7,1100,300.0,1900,1630,2048,44626 days 16:47:18.658895,353,2.0,3.6666666666666665,-230,1552,800.0
130000.0,2,1.0,880,9000,1.0,3,5,880,0.0,1928,1410,10000,34400 days 16:47:18.658895,227,2.0,0.0,-530,-1000,880.0
325000.0,2,1.0,1060,5703,1.0,4,6,1060,0.0,1946,2240,4416,27825 days 16:47:18.658895,216,2.0,0.0,-1180,1287,1060.0
440000.0,3,1.75,1530,7245,1.0,4,7,1530,0.0,1984,1530,7490,13946 days 16:47:18.658895,103,1.7142857142857142,0.0,0,-245,1530.0
550000.0,4,1.75,2480,14782,1.0,3,8,1460,1020.0,1958,2910,10800,23442 days 16:47:18.658895,287,2.2857142857142856,1.4313725490196079,-430,3982,440.0
310000.0,3,1.75,1490,7150,1.0,5,6,1490,0.0,1967,1350,9100,20155 days 16:47:18.658895,217,1.7142857142857142,0.0,140,-1950,1490.0
530000.0,3,2.5,3660,39478,2.0,4,9,3260,400.0,1989,2700,38312,12119 days 16:47:18.658895,182,1.2,8.15,960,1166,2860.0
390000.0,4,2.5,2340,8548,2.0,3,8,2340,0.0,1993,1970,6818,10658 days 16:47:18.658895,176,1.6,0.0,370,1730,2340.0
243000.0,3,1.75,1450,12125,1.0,4,7,1450,0.0,1981,1210,12125,15041 days 16:47:18.658895,251,1.7142857142857142,0.0,240,0,1450.0
639000.0,4,2.5,2210,9875,2.0,3,9,2210,0.0,1990,2440,8799,11754 days 16:47:18.658895,203,1.6,0.0,-230,1076,2210.0
215000.0,4,1.0,1130,7400,1.0,4,7,1130,0.0,1969,1540,7379,19424 days 16:47:18.658895,261,4.0,0.0,-410,21,1130.0
405000.0,5,1.75,1550,10500,1.0,3,7,1100,450.0,1961,1420,9823,22346 days 16:47:18.658895,063,2.857142857142857,2.4444444444444446,130,677,650.0
250000.0,4,1.75,1710,7140,1.0,5,7,1010,700.0,1968,1770,8960,19790 days 16:47:18.658895,356,2.2857142857142856,1.4428571428571428,-60,-1820,310.0
405500.0,3,1.5,1010,8108,1.0,5,7,1010,0.0,1954,1300,8108,24903 days 16:47:18.658895,196,2.0,0.0,-290,0,1010.0
452000.0,6,2.25,2660,13579,2.0,3,7,2660,0.0,1937,1120,8242,31112 days 16:47:18.658895,209,2.6666666666666665,0.0,1540,5337,2660.0
730000.0,6,2.25,2660,13579,2.0,3,7,2660,0.0,1937,1120,8242,31112 days 16:47:18.658895,002,2.6666666666666665,0.0,1540,5337,2660.0
267000.0,3,2.0,1300,9644,1.0,3,7,1300,0.0,1994,1430,9656,10293 days 16:47:18.658895,104,1.5,0.0,-130,-12,1300.0
289950.0,3,2.5,1670,6186,2.0,3,7,1670,0.0,2002,2390,6924,7371 days 16:47:18.658895,220,1.2,0.0,-720,-738,1670.0
565000.0,2,1.0,960,4080,1.0,5,7,960,0.0,1911,1300,4080,40609 days 16:47:18.658895,209,2.0,0.0,-340,0,960.0
1580000.0,4,3.25,4670,51836,2.0,4,1,4670,0.0,1988,4230,41075,12485 days 16:47:18.658895,220,1.2307692307692308,0.0,440,10761,4670.0
636000.0,3,2.5,2140,2770,2.0,3,8,1770,370.0,2007,2510,2708,5545 days 16:47:18.658895,110,1.2,4.783783783783784,-370,62,1400.0
350000.0,5,3.0,2520,5500,1.0,3,8,1550,970.0,2004,1700,8000,6641 days 16:47:18.658895,261,1.6666666666666667,1.597938144329897,820,-2500,580.0
320000.0,3,1.5,1650,9380,1.0,5,7,1130,520.0,1978,1720,8856,16137 days 16:47:18.658895,155,2.0,2.173076923076923,-70,524,610.0
210000.0,2,1.75,1440,5680,1.0,4,8,1440,0.0,1978,1320,3547,16137 days 16:47:18.658895,164,1.1428571428571428,0.0,120,2133,1440.0
245000.0,2,1.0,1050,5900,1.0,3,7,1050,0.0,1950,1280,5900,26364 days 16:47:18.658895,253,2.0,0.0,-230,0,1050.0
328000.0,3,1.75,1470,7650,1.0,3,7,1130,340.0,1983,1590,7500,14311 days 16:47:18.658895,310,1.7142857142857142,3.323529411764706,-120,150,790.0
985000.0,4,2.25,4230,37769,2.0,3,1,4230,0.0,1989,3890,37034,12119 days 16:47:18.658895,129,1.7777777777777777,0.0,340,735,4230.0
501000.0,3,1.75,1970,7972,1.0,5,8,1370,600.0,1976,2460,9796,16868 days 16:47:18.658895,163,1.7142857142857142,2.283333333333333,-490,-1824,770.0
315000.0,3,2.25,1540,17424,2.0,3,7,1540,0.0,1992,1560,11439,11024 days 16:47:18.658895,260,1.3333333333333333,0.0,-20,5985,1540.0
403000.0,3,2.75,2090,8354,2.0,3,8,2090,0.0,2012,2280,6348,3719 days 16:47:18.658895,128,1.0909090909090908,0.0,-190,2006,2090.0
550000.0,3,2.0,2380,17950,2.0,4,8,2110,270.0,1934,2030,23900,32208 days 16:47:18.658895,196,1.5,7.814814814814815,350,-5950,1840.0
347500.0,4,2.5,2156,3562,2.0,3,9,2156,0.0,2012,1708,3539,3719 days 16:47:18.658895,013,1.6,0.0,448,23,2156.0
365000.0,4,2.25,2070,8893,2.0,4,8,2070,0.0,1986,2390,7700,13215 days 16:47:18.658895,279,1.7777777777777777,0.0,-320,1193,2070.0
588000.0,3,1.0,1910,8167,1.0,4,8,1270,640.0,1951,1500,6816,25999 days 16:47:18.658895,055,3.0,1.984375,410,1351,630.0
605000.0,3,1.75,1920,7400,1.0,4,8,1260,660.0,1977,2360,8048,16502 days 16:47:18.658895,232,1.7142857142857142,1.9090909090909092,-440,-648,600.0
1300000.0,3,3.25,3400,5979,2.0,4,9,2290,1110.0,1937,3090,6435,31112 days 16:47:18.658895,317,0.9230769230769231,2.063063063063063,310,-456,1180.0
233000.0,3,2.0,1400,9177,1.0,3,7,1400,0.0,1974,2020,8547,17598 days 16:47:18.658895,323,1.5,0.0,-620,630,1400.0
360000.0,4,2.5,2210,17715,2.0,3,8,2210,0.0,1997,2210,16907,9197 days 16:47:18.658895,209,1.6,0.0,0,808,2210.0
459000.0,2,1.75,1170,4887,1.0,3,6,1020,150.0,1929,1170,5441,34034 days 16:47:18.658895,349,1.1428571428571428,6.8,0,-554,870.0
740000.0,3,2.0,2100,72745,1.0,4,9,2100,0.0,1995,2290,54885,9928 days 16:47:18.658895,311,1.5,0.0,-190,17860,2100.0
305000.0,3,1.0,1160,9750,1.0,3,7,1160,0.0,1967,1160,9650,20155 days 16:47:18.658895,260,3.0,0.0,0,100,1160.0
395000.0,3,1.0,1500,4000,1.0,3,6,900,600.0,1925,950,4000,35495 days 16:47:18.658895,171,3.0,1.5,550,0,300.0
560000.0,4,2.5,2940,6000,2.0,3,8,2940,0.0,2000,2510,6600,8102 days 16:47:18.658895,023,1.6,0.0,430,-600,2940.0
650000.0,4,1.75,2010,5070,1.0,4,7,1300,710.0,1963,2180,5400,21616 days 16:47:18.658895,195,2.2857142857142856,1.8309859154929577,-170,-330,590.0
449950.0,3,2.5,2170,4912,2.0,3,7,2170,0.0,2003,2010,4395,7006 days 16:47:18.658895,156,1.2,0.0,160,517,2170.0
517500.0,3,1.5,1430,5200,1.0,4,7,1250,180.0,1940,2210,6240,30017 days 16:47:18.658895,055,2.0,6.944444444444445,-780,-1040,1070.0
435000.0,4,1.5,1510,6460,1.0,3,7,1070,440.0,1970,1450,6630,19059 days 16:47:18.658895,246,2.6666666666666665,2.4318181818181817,60,-170,630.0
329999.0,3,1.0,1150,6908,1.0,3,6,800,350.0,1952,1150,6908,25634 days 16:47:18.658895,099,3.0,2.2857142857142856,0,0,450.0
950000.0,3,1.75,2150,4200,1.0,5,8,1140,1010.0,1960,2510,7500,22712 days 16:47:18.658895,344,1.7142857142857142,1.1287128712871286,-360,-3300,130.0
447000.0,3,1.0,1370,6001,1.0,5,7,1230,140.0,1944,1370,5520,28556 days 16:47:18.658895,211,3.0,8.785714285714286,0,481,1090.0
699800.0,2,2.5,2380,6600,1.0,3,8,2380,0.0,2010,1870,6600,4449 days 16:47:18.658895,240,0.8,0.0,510,0,2380.0
850000.0,3,1.75,1370,3850,1.0,5,7,770,600.0,1911,1390,3600,40609 days 16:47:18.658895,154,1.7142857142857142,1.2833333333333334,-20,250,170.0
942500.0,5,3.5,3750,9612,1.0,4,9,2030,1720.0,1981,3270,9688,15041 days 16:47:18.658895,196,1.4285714285714286,1.180232558139535,480,-76,310.0
1310000.0,2,2.25,3950,3938,2.0,3,1,2910,1040.0,1991,3220,4500,11389 days 16:47:18.658895,021,0.8888888888888888,2.798076923076923,730,-562,1870.0
856600.0,4,2.25,2400,13430,1.0,4,9,2400,0.0,1964,2580,10077,21251 days 16:47:18.658895,033,1.7777777777777777,0.0,-180,3353,2400.0
405600.0,5,1.5,2830,4000,2.5,4,8,2830,0.0,1918,1480,4000,38052 days 16:47:18.658895,297,3.3333333333333335,0.0,1350,0,2830.0
565000.0,4,2.5,2440,22594,2.0,3,8,2440,0.0,1996,2560,33341,9563 days 16:47:18.658895,149,1.6,0.0,-120,-10747,2440.0
400000.0,3,2.25,1190,1149,2.0,3,8,1050,140.0,2008,1210,1316,5180 days 16:47:18.658895,254,1.3333333333333333,7.5,-20,-167,910.0
330000.0,3,2.0,1400,218252,1.0,3,7,1400,0.0,1997,2230,218222,9197 days 16:47:18.658895,083,1.5,0.0,-830,30,1400.0
374950.0,4,2.75,2730,4683,2.0,3,7,2730,0.0,2005,2230,4924,6275 days 16:47:18.658895,058,1.4545454545454546,0.0,500,-241,2730.0
405300.0,3,2.75,2390,7939,1.0,5,7,1610,780.0,1983,1920,7939,14311 days 16:47:18.658895,351,1.0909090909090908,2.0641025641025643,470,0,830.0
560000.0,3,2.25,2060,31400,2.0,3,8,2060,0.0,1984,2160,34500,13946 days 16:47:18.658895,308,1.3333333333333333,0.0,-100,-3100,2060.0
824000.0,4,2.25,2490,9864,1.0,4,8,1290,1200.0,1961,2360,9864,22346 days 16:47:18.658895,083,1.7777777777777777,1.075,130,0,90.0
260000.0,3,1.75,1100,10968,1.0,5,7,1100,0.0,1984,1400,7799,13946 days 16:47:18.658895,197,1.7142857142857142,0.0,-300,3169,1100.0
760000.0,4,2.5,2430,6099,1.0,5,8,1470,960.0,1965,2180,6099,20885 days 16:47:18.658895,007,1.6,1.53125,250,0,510.0
405000.0,3,2.5,3170,12750,2.0,3,1,2360,810.0,1995,2970,13125,9928 days 16:47:18.658895,175,1.2,2.9135802469135803,200,-375,1550.0
429900.0,4,2.5,2640,8625,2.0,3,8,2640,0.0,1987,2240,8700,12850 days 16:47:18.658895,170,1.6,0.0,400,-75,2640.0
341500.0,3,1.5,1130,7223,1.0,4,7,1130,0.0,1961,1320,7356,22346 days 16:47:18.658895,317,2.0,0.0,-190,-133,1130.0
465250.0,5,2.0,1940,7642,1.5,3,7,1940,0.0,1957,1940,8724,23807 days 16:47:18.658895,163,2.5,0.0,0,-1082,1940.0
450000.0,2,2.0,1100,3000,1.5,3,7,1100,0.0,1912,1390,4000,40244 days 16:47:18.658895,126,1.0,0.0,-290,-1000,1100.0
390000.0,3,1.0,1200,10800,1.0,4,7,1200,0.0,1955,1370,9950,24538 days 16:47:18.658895,040,3.0,0.0,-170,850,1200.0
420000.0,3,2.25,2000,8030,1.0,4,8,1000,1000.0,1963,2070,8250,21616 days 16:47:18.658895,122,1.3333333333333333,1.0,-70,-220,0.0
269950.0,3,2.5,1890,4838,2.0,3,8,1730,160.0,2002,1910,7409,7371 days 16:47:18.658895,166,1.2,10.8125,-20,-2571,1570.0
493000.0,4,2.0,1910,2874,1.0,3,7,1060,850.0,1910,1520,2874,40974 days 16:47:18.658895,289,2.0,1.2470588235294118,390,0,210.0
370000.0,4,2.5,2710,5880,2.0,3,9,2710,0.0,1998,2520,6000,8832 days 16:47:18.658895,135,1.6,0.0,190,-120,2710.0
2250000.0,5,4.25,4860,9453,1.5,5,1,3100,1760.0,1905,3150,8557,42800 days 16:47:18.658895,163,1.1764705882352942,1.7613636363636365,1710,896,1340.0
305000.0,3,1.0,1250,23680,1.0,5,7,1250,0.0,1967,1450,23680,20155 days 16:47:18.658895,056,3.0,0.0,-200,0,1250.0
400000.0,3,1.75,1590,8219,1.5,5,6,970,620.0,1938,2030,7504,30747 days 16:47:18.658895,163,1.7142857142857142,1.564516129032258,-440,715,350.0
320000.0,3,1.5,1240,1221,2.0,3,8,1050,190.0,2009,1180,887,4814 days 16:47:18.658895,322,2.0,5.526315789473684,60,334,860.0
715000.0,4,1.0,2000,4800,2.0,4,7,2000,0.0,1911,1260,1452,40609 days 16:47:18.658895,021,4.0,0.0,740,3348,2000.0
650000.0,6,2.75,3610,10003,1.5,4,8,3610,0.0,1966,2560,10004,20520 days 16:47:18.658895,336,2.1818181818181817,0.0,1050,-1,3610.0
218000.0,5,1.75,1930,8040,1.0,4,8,1930,0.0,1966,2370,8000,20520 days 16:47:18.658895,063,2.857142857142857,0.0,-440,40,1930.0
500000.0,2,1.0,1280,5400,1.0,3,7,1280,0.0,1964,1540,5670,21251 days 16:47:18.658895,105,2.0,0.0,-260,-270,1280.0
460000.0,4,2.0,2090,40419,1.0,4,7,2090,0.0,1984,2380,63162,13946 days 16:47:18.658895,324,2.0,0.0,-290,-22743,2090.0
232500.0,3,1.5,1940,9887,1.0,4,7,1140,800.0,1969,1410,9936,19424 days 16:47:18.658895,190,2.0,1.425,530,-49,340.0
408200.0,3,2.5,1800,5761,2.0,4,7,1800,0.0,1990,1800,5952,11754 days 16:47:18.658895,136,1.2,0.0,0,-191,1800.0
522000.0,3,1.75,1730,8400,1.0,4,7,1400,330.0,1980,1830,8636,15407 days 16:47:18.658895,162,1.7142857142857142,4.242424242424242,-100,-236,1070.0
675000.0,4,2.5,2810,11120,2.0,3,9,2810,0.0,1982,3100,12672,14676 days 16:47:18.658895,174,1.6,0.0,-290,-1552,2810.0
1360000.0,4,3.5,3550,11000,1.0,3,1,2260,1290.0,1999,4100,10012,8467 days 16:47:18.658895,190,1.1428571428571428,1.751937984496124,-550,988,970.0
249950.0,4,1.0,1330,7980,1.5,3,6,1330,0.0,1952,1570,8588,25634 days 16:47:18.658895,282,4.0,0.0,-240,-608,1330.0
210000.0,2,1.0,750,34133,1.0,3,6,750,0.0,1950,1460,25792,26364 days 16:47:18.658895,063,2.0,0.0,-710,8341,750.0
429950.0,4,1.0,1760,7216,1.0,3,7,1090,670.0,1947,1180,3844,27460 days 16:47:18.658895,192,4.0,1.626865671641791,580,3372,420.0
737500.0,4,2.5,3200,36276,2.0,3,9,3200,0.0,1993,2930,33171,10658 days 16:47:18.658895,279,1.6,0.0,270,3105,3200.0
710000.0,4,2.0,1740,9000,1.0,5,8,1740,0.0,1958,1850,7700,23442 days 16:47:18.658895,269,2.0,0.0,-110,1300,1740.0
470000.0,3,2.5,2100,4700,2.0,3,8,2100,0.0,1999,2100,4700,8467 days 16:47:18.658895,293,1.2,0.0,0,0,2100.0
1100000.0,4,3.5,4270,40097,1.0,4,1,4270,0.0,1993,3510,36149,10658 days 16:47:18.658895,055,1.1428571428571428,0.0,760,3948,4270.0
650000.0,3,2.0,1340,2720,1.5,3,7,1340,0.0,1913,2030,4590,39878 days 16:47:18.658895,227,1.5,0.0,-690,-1870,1340.0
1220000.0,4,2.5,3190,8684,1.0,5,9,1680,1510.0,1967,3160,8684,20155 days 16:47:18.658895,139,1.6,1.1125827814569536,30,0,170.0
422120.0,3,2.5,1630,4534,2.0,3,8,1630,0.0,1987,1380,4779,12850 days 16:47:18.658895,015,1.2,0.0,250,-245,1630.0
625000.0,5,2.5,2990,15085,2.0,3,9,2990,0.0,2007,3150,13076,5545 days 16:47:18.658895,007,2.0,0.0,-160,2009,2990.0
385200.0,4,1.0,1550,7740,1.5,3,6,1550,0.0,1954,1220,7740,24903 days 16:47:18.658895,157,4.0,0.0,330,0,1550.0
500000.0,3,2.25,1690,4964,2.0,3,8,1690,0.0,1989,1800,5036,12119 days 16:47:18.658895,104,1.3333333333333333,0.0,-110,-72,1690.0
308000.0,4,2.25,1960,12243,2.0,3,8,1960,0.0,1989,1910,12230,12119 days 16:47:18.658895,322,1.7777777777777777,0.0,50,13,1960.0
565000.0,3,2.75,2390,9966,1.0,5,8,1360,1030.0,1977,2140,10713,16502 days 16:47:18.658895,156,1.0909090909090908,1.3203883495145632,250,-747,330.0
581000.0,3,2.5,2600,4438,2.0,3,7,2600,0.0,2004,2600,4904,6641 days 16:47:18.658895,251,1.2,0.0,0,-466,2600.0
361000.0,3,2.0,1950,8698,1.0,3,8,1950,0.0,1999,2330,7212,8467 days 16:47:18.658895,218,1.5,0.0,-380,1486,1950.0
345000.0,3,1.0,1250,7210,1.0,4,7,1250,0.0,1964,1530,8800,21251 days 16:47:18.658895,022,3.0,0.0,-280,-1590,1250.0
419000.0,2,2.25,1180,1253,2.0,3,8,840,340.0,2008,1310,1963,5180 days 16:47:18.658895,289,0.8888888888888888,2.4705882352941178,-130,-710,500.0
347000.0,3,2.5,1680,4308,2.0,3,7,1680,0.0,2004,2160,4182,6641 days 16:47:18.658895,132,1.2,0.0,-480,126,1680.0
625000.0,4,2.25,2220,36085,2.0,3,9,2220,0.0,1989,3000,36906,12119 days 16:47:18.658895,295,1.7777777777777777,0.0,-780,-821,2220.0
2400000.0,4,4.25,4890,15188,2.0,3,1,3090,1800.0,1999,3470,16201,8467 days 16:47:18.658895,084,0.9411764705882353,1.7166666666666666,1420,-1013,1290.0
379000.0,3,3.25,2660,17852,2.5,3,8,2660,0.0,2014,1320,11876,2988 days 16:47:18.658895,357,0.9230769230769231,0.0,1340,5976,2660.0
310000.0,3,1.5,1150,3323,2.0,3,7,1150,0.0,1988,1150,2980,12485 days 16:47:18.658895,356,2.0,0.0,0,343,1150.0
250000.0,2,2.0,1130,5500,1.0,4,6,1130,0.0,1941,1320,6600,29651 days 16:47:18.658895,133,1.0,0.0,-190,-1100,1130.0
682000.0,5,2.75,2760,5000,2.0,3,9,2760,0.0,2005,2870,5030,6275 days 16:47:18.658895,226,1.8181818181818181,0.0,-110,-30,2760.0
246500.0,3,2.0,1430,8919,1.0,3,7,1430,0.0,1992,1580,8919,11024 days 16:47:18.658895,202,1.5,0.0,-150,0,1430.0
325000.0,3,1.0,1490,57381,1.5,4,5,1490,0.0,1932,1580,101529,32939 days 16:47:18.658895,302,3.0,0.0,-90,-44148,1490.0
310950.0,4,2.5,2030,4997,2.0,3,8,2030,0.0,2004,2095,5500,6641 days 16:47:18.658895,218,1.6,0.0,-65,-503,2030.0
1100000.0,3,2.0,3010,5000,2.0,5,9,1890,1120.0,1931,2688,5000,33304 days 16:47:18.658895,244,1.5,1.6875,322,0,770.0
287500.0,3,1.0,1810,7200,1.0,4,7,1130,680.0,1954,1810,8100,24903 days 16:47:18.658895,275,3.0,1.661764705882353,0,-900,450.0
431000.0,3,1.0,1810,7200,1.0,4,7,1130,680.0,1954,1810,8100,24903 days 16:47:18.658895,049,3.0,1.661764705882353,0,-900,450.0
226000.0,3,1.0,970,5000,1.0,3,6,970,0.0,1968,1290,5875,19790 days 16:47:18.658895,234,3.0,0.0,-320,-875,970.0
825000.0,3,1.75,2010,3090,1.5,5,7,1510,500.0,1926,1600,3150,35130 days 16:47:18.658895,132,1.7142857142857142,3.02,410,-60,1010.0
175000.0,4,1.0,1300,6030,1.5,3,6,1300,0.0,1947,1240,6900,27460 days 16:47:18.658895,254,4.0,0.0,60,-870,1300.0
465750.0,3,1.5,1260,10350,1.0,3,7,1260,0.0,1959,1800,10350,23077 days 16:47:18.658895,135,2.0,0.0,-540,0,1260.0
659000.0,4,2.25,2610,24931,2.0,3,8,2610,0.0,1983,2550,18306,14311 days 16:47:18.658895,078,1.7777777777777777,0.0,60,6625,2610.0
595000.0,3,1.75,1910,5753,1.0,3,8,1110,800.0,1941,1630,5580,29651 days 16:47:18.658895,041,1.7142857142857142,1.3875,280,173,310.0
350000.0,3,2.25,1780,16290,2.0,4,8,1780,0.0,1987,1780,8810,12850 days 16:47:18.658895,177,1.3333333333333333,0.0,0,7480,1780.0
270000.0,4,2.25,1900,8600,1.0,4,8,1900,0.0,1975,2120,8000,17233 days 16:47:18.658895,157,1.7777777777777777,0.0,-220,600,1900.0
662500.0,6,2.25,2450,25600,1.0,3,7,1340,1110.0,1957,1850,10230,23807 days 16:47:18.658895,254,2.6666666666666665,1.2072072072072073,600,15370,230.0
249900.0,3,1.75,1380,14000,1.0,4,5,1380,0.0,1939,1490,18503,30382 days 16:47:18.658895,324,1.7142857142857142,0.0,-110,-4503,1380.0
324500.0,3,1.75,1920,11340,1.0,4,7,1230,690.0,1977,1980,9638,16502 days 16:47:18.658895,076,1.7142857142857142,1.7826086956521738,-60,1702,540.0
430000.0,2,1.75,1350,4003,1.0,3,8,1350,0.0,2004,1350,4479,6641 days 16:47:18.658895,199,1.1428571428571428,0.0,0,-476,1350.0
419950.0,2,1.75,1350,4003,1.0,3,8,1350,0.0,2004,1350,4479,6641 days 16:47:18.658895,133,1.1428571428571428,0.0,0,-476,1350.0
285000.0,4,1.75,2510,7440,1.0,4,8,1290,1220.0,1962,1790,8000,21981 days 16:47:18.658895,209,2.2857142857142856,1.0573770491803278,720,-560,70.0
332000.0,4,2.5,2470,7780,2.0,3,8,2470,0.0,2002,2100,5972,7371 days 16:47:18.658895,007,1.6,0.0,370,1808,2470.0
282000.0,4,1.75,1660,10725,1.0,3,7,960,700.0,1956,1340,9023,24173 days 16:47:18.658895,349,2.2857142857142856,1.3714285714285714,320,1702,260.0
320000.0,3,1.0,1340,5175,1.0,3,7,940,400.0,1987,1020,5500,12850 days 16:47:18.658895,322,3.0,2.35,320,-325,540.0
428750.0,3,1.0,1620,30736,1.5,4,7,1620,0.0,1911,2440,28826,40609 days 16:47:18.658895,129,3.0,0.0,-820,1910,1620.0
330000.0,3,2.25,2300,35287,2.0,3,8,2300,0.0,1977,1760,47916,16502 days 16:47:18.658895,014,1.3333333333333333,0.0,540,-12629,2300.0
456500.0,4,3.5,2000,2309,3.0,3,8,2000,0.0,2008,1440,1548,5180 days 16:47:18.658895,343,1.1428571428571428,0.0,560,761,2000.0
352000.0,3,2.25,1640,11050,1.0,4,8,1640,0.0,1972,1870,11050,18329 days 16:47:18.658895,129,1.3333333333333333,0.0,-230,0,1640.0
664000.0,4,2.0,1530,4080,1.5,4,7,1530,0.0,1912,1860,4080,40244 days 16:47:18.658895,329,2.0,0.0,-330,0,1530.0
628000.0,3,1.75,4000,11894,1.0,3,9,2190,1810.0,1987,2530,8650,12850 days 16:47:18.658895,203,1.7142857142857142,1.2099447513812154,1470,3244,380.0
512000.0,3,1.75,1610,12555,1.0,3,7,1080,530.0,1977,1780,10374,16502 days 16:47:18.658895,063,1.7142857142857142,2.0377358490566038,-170,2181,550.0
254000.0,3,2.0,2070,9000,1.0,4,7,1450,620.0,1969,1630,7885,19424 days 16:47:18.658895,345,1.5,2.338709677419355,440,1115,830.0
535800.0,4,2.5,1900,5790,2.0,3,8,1900,0.0,1994,2030,5790,10293 days 16:47:18.658895,141,1.6,0.0,-130,0,1900.0
287653.0,3,1.0,1050,16050,1.0,4,7,1050,0.0,1960,1610,27600,22712 days 16:47:18.658895,283,3.0,0.0,-560,-11550,1050.0
438000.0,3,2.5,1520,1304,2.0,3,8,1180,340.0,2006,1270,1718,5910 days 16:47:18.658895,212,1.2,3.4705882352941178,250,-414,840.0
450000.0,4,1.75,2390,23899,1.0,3,7,1750,640.0,1949,1840,33900,26729 days 16:47:18.658895,197,2.2857142857142856,2.734375,550,-10001,1110.0
327000.0,5,2.75,2400,8050,2.0,3,8,2400,0.0,1998,2400,8050,8832 days 16:47:18.658895,178,1.8181818181818181,0.0,0,0,2400.0
370500.0,4,2.5,1790,6120,2.0,3,7,1790,0.0,2005,1950,5660,6275 days 16:47:18.658895,224,1.6,0.0,-160,460,1790.0
265000.0,3,2.5,1720,6271,2.0,3,7,1720,0.0,1993,1570,6587,10658 days 16:47:18.658895,295,1.2,0.0,150,-316,1720.0
450000.0,4,2.75,2980,13260,1.0,4,8,1800,1180.0,1979,1920,10731,15772 days 16:47:18.658895,069,1.4545454545454546,1.5254237288135593,1060,2529,620.0
425000.0,3,1.0,1520,213444,1.5,5,8,1520,0.0,1988,2640,213444,12485 days 16:47:18.658895,178,3.0,0.0,-1120,0,1520.0
166600.0,3,1.75,1150,8690,1.0,4,7,1150,0.0,1977,1330,7040,16502 days 16:47:18.658895,317,1.7142857142857142,0.0,-180,1650,1150.0
245000.0,1,0.75,380,15000,1.0,3,5,380,0.0,1963,1170,15000,21616 days 16:47:18.658895,171,1.3333333333333333,0.0,-790,0,380.0
565000.0,3,1.0,910,5212,1.0,3,7,910,0.0,1951,1520,6300,25999 days 16:47:18.658895,128,3.0,0.0,-610,-1088,910.0
539900.0,3,1.75,1650,10150,1.0,3,8,1230,420.0,1976,1930,8958,16868 days 16:47:18.658895,223,1.7142857142857142,2.9285714285714284,-280,1192,810.0
910000.0,3,3.5,2480,3200,2.0,3,1,2480,0.0,2010,1980,3200,4449 days 16:47:18.658895,062,0.8571428571428571,0.0,500,0,2480.0
280000.0,4,2.5,2050,7416,2.0,3,8,2050,0.0,1990,2050,7920,11754 days 16:47:18.658895,308,1.6,0.0,0,-504,2050.0
275000.0,3,2.25,1420,8549,2.0,4,7,1420,0.0,1989,1560,7471,12119 days 16:47:18.658895,072,1.3333333333333333,0.0,-140,1078,1420.0
467000.0,3,2.5,3460,6590,2.0,3,7,3460,0.0,2001,2490,6312,7736 days 16:47:18.658895,117,1.2,0.0,970,278,3460.0
457500.0,3,2.5,1500,4445,2.0,3,8,1500,0.0,1996,1730,4408,9563 days 16:47:18.658895,212,1.2,0.0,-230,37,1500.0
381156.0,2,1.0,1320,3090,1.0,4,7,1320,0.0,1908,1270,4120,41705 days 16:47:18.658895,360,2.0,0.0,50,-1030,1320.0
289999.0,5,2.5,2180,8240,1.0,4,8,1220,960.0,1977,2050,7590,16502 days 16:47:18.658895,113,2.0,1.2708333333333333,130,650,260.0
642450.0,3,1.75,1830,4160,1.0,3,7,1230,600.0,1919,1950,4160,37687 days 16:47:18.658895,112,1.7142857142857142,2.05,-120,0,630.0
469950.0,3,2.25,1620,8701,1.0,3,7,1220,400.0,1962,1600,7910,21981 days 16:47:18.658895,262,1.3333333333333333,3.05,20,791,820.0
795000.0,3,2.0,2920,13650,1.0,5,8,1460,1460.0,1975,2920,10988,17233 days 16:47:18.658895,064,1.5,1.0,0,2662,0.0
785000.0,4,2.5,3300,10514,2.0,3,1,3300,0.0,1984,2820,11462,13946 days 16:47:18.658895,042,1.6,0.0,480,-948,3300.0
860000.0,3,2.25,3060,12095,2.0,3,1,3060,0.0,1983,3060,11455,14311 days 16:47:18.658895,150,1.3333333333333333,0.0,0,640,3060.0
147500.0,3,1.0,1530,8498,1.0,3,7,1530,0.0,1959,1380,8498,23077 days 16:47:18.658895,044,3.0,0.0,150,0,1530.0
390000.0,3,2.0,1910,11576,1.0,3,7,1410,500.0,1978,2040,8750,16137 days 16:47:18.658895,329,1.5,2.82,-130,2826,910.0
229000.0,3,1.0,1020,8100,1.0,3,7,1020,0.0,1954,1020,8100,24903 days 16:47:18.658895,353,3.0,0.0,0,0,1020.0
185000.0,3,1.0,1150,8100,1.0,3,6,1150,0.0,1932,1120,8100,32939 days 16:47:18.658895,135,3.0,0.0,30,0,1150.0
414900.0,3,1.5,1260,9570,1.0,3,7,870,390.0,1941,1620,7000,29651 days 16:47:18.658895,238,2.0,2.230769230769231,-360,2570,480.0
200000.0,4,2.0,1920,4822,1.0,2,6,920,1000.0,1914,1120,4822,39513 days 16:47:18.658895,043,2.0,0.92,800,0,-80.0
720000.0,3,1.75,2040,4000,2.0,5,7,1360,680.0,1924,1610,4000,35861 days 16:47:18.658895,255,1.7142857142857142,2.0,430,0,680.0
930000.0,4,2.5,2200,4000,2.0,5,8,1430,770.0,1908,2100,4000,41705 days 16:47:18.658895,154,1.6,1.8571428571428572,100,0,660.0
1270000.0,5,2.5,3200,17204,1.0,3,7,2160,1040.0,1952,4090,15732,25634 days 16:47:18.658895,155,2.0,2.076923076923077,-890,1472,1120.0
700000.0,5,3.25,2400,3118,2.0,4,7,1780,620.0,1928,2100,3941,34400 days 16:47:18.658895,315,1.5384615384615385,2.870967741935484,300,-823,1160.0
466000.0,2,1.5,1140,1058,3.0,3,7,1140,0.0,2005,1170,1116,6275 days 16:47:18.658895,196,1.3333333333333333,0.0,-30,-58,1140.0
374000.0,3,1.5,1330,10640,1.0,3,7,1330,0.0,1976,1460,8520,16868 days 16:47:18.658895,237,2.0,0.0,-130,2120,1330.0
480000.0,3,2.5,1940,10035,2.0,4,8,1940,0.0,1994,2810,8333,10293 days 16:47:18.658895,197,1.2,0.0,-870,1702,1940.0
740000.0,3,2.5,3000,25341,2.0,3,9,3000,0.0,1995,3000,32417,9928 days 16:47:18.658895,161,1.2,0.0,0,-7076,3000.0
395000.0,4,2.5,2910,5000,2.0,3,8,2910,0.0,2002,2740,5045,7371 days 16:47:18.658895,150,1.6,0.0,170,-45,2910.0
340000.0,2,1.0,1090,6771,1.0,3,6,1090,0.0,1954,1200,4992,24903 days 16:47:18.658895,206,2.0,0.0,-110,1779,1090.0
209000.0,3,2.0,1230,1340,2.0,3,7,1020,210.0,2003,1260,1312,7006 days 16:47:18.658895,223,1.5,4.857142857142857,-30,28,810.0
431650.0,5,2.5,1710,7700,1.5,3,7,1710,0.0,1962,1530,7700,21981 days 16:47:18.658895,318,2.0,0.0,180,0,1710.0
980000.0,5,2.5,3160,11470,1.0,4,9,1780,1380.0,1971,3260,11470,18694 days 16:47:18.658895,128,2.0,1.289855072463768,-100,0,400.0
660000.0,3,2.5,2680,28243,2.0,3,9,2680,0.0,1993,2670,32130,10658 days 16:47:18.658895,217,1.2,0.0,10,-3887,2680.0
730000.0,4,2.25,2190,9009,2.0,4,8,1840,350.0,1977,2190,10251,16502 days 16:47:18.658895,070,1.7777777777777777,5.257142857142857,0,-1242,1490.0
291500.0,3,1.75,1260,9600,1.0,4,7,1260,0.0,1988,1640,9946,12485 days 16:47:18.658895,104,1.7142857142857142,0.0,-380,-346,1260.0
905000.0,4,3.5,2970,14486,2.0,3,9,2340,630.0,1997,3680,14486,9197 days 16:47:18.658895,171,1.1428571428571428,3.7142857142857144,-710,0,1710.0
800000.0,4,2.5,2570,50308,1.5,3,1,2570,0.0,1993,3420,37891,10658 days 16:47:18.658895,223,1.6,0.0,-850,12417,2570.0
839900.0,4,3.5,3810,13592,1.0,3,9,2560,1250.0,2013,3230,9311,3353 days 16:47:18.658895,129,1.1428571428571428,2.048,580,4281,1310.0
200000.0,1,1.5,1010,1157,2.0,3,8,950,60.0,2007,1360,1688,5545 days 16:47:18.658895,195,0.6666666666666666,15.833333333333334,-350,-531,890.0
300000.0,3,2.0,1480,6698,1.0,4,7,1080,400.0,1979,1850,7348,15772 days 16:47:18.658895,049,1.5,2.7,-370,-650,680.0
530000.0,3,1.75,1250,6041,1.5,5,7,1250,0.0,1942,1180,6042,29286 days 16:47:18.658895,154,1.7142857142857142,0.0,70,-1,1250.0
314950.0,3,2.25,1654,8479,2.0,3,7,1654,0.0,1995,1654,8479,9928 days 16:47:18.658895,085,1.3333333333333333,0.0,0,0,1654.0
255000.0,3,1.75,1410,9315,1.0,5,7,1410,0.0,1960,1630,8250,22712 days 16:47:18.658895,280,1.7142857142857142,0.0,-220,1065,1410.0
550000.0,5,2.75,2160,5720,1.0,5,7,1500,660.0,1950,2160,4996,26364 days 16:47:18.658895,289,1.8181818181818181,2.272727272727273,0,724,840.0
435000.0,3,1.0,1400,4800,1.0,4,6,700,700.0,1917,1470,6000,38417 days 16:47:18.658895,218,3.0,1.0,-70,-1200,0.0
234000.0,3,1.75,1420,8738,1.0,4,7,1420,0.0,1966,1660,8738,20520 days 16:47:18.658895,328,1.7142857142857142,0.0,-240,0,1420.0
615000.0,4,2.25,2500,10062,1.0,3,8,1600,900.0,1975,2500,9750,17233 days 16:47:18.658895,283,1.7777777777777777,1.7777777777777777,0,312,700.0
205000.0,3,2.0,1410,8384,1.0,3,7,1410,0.0,1985,1410,9205,13580 days 16:47:18.658895,253,1.5,0.0,0,-821,1410.0
384000.0,4,1.75,2100,7135,1.0,4,7,1050,1050.0,1955,1730,4000,24538 days 16:47:18.658895,262,2.2857142857142856,1.0,370,3135,0.0
324000.0,3,2.5,1750,7208,2.0,3,8,1750,0.0,1994,2050,7524,10293 days 16:47:18.658895,142,1.2,0.0,-300,-316,1750.0
645000.0,3,1.75,2070,5500,1.0,4,7,1130,940.0,1946,1800,4400,27825 days 16:47:18.658895,203,1.7142857142857142,1.202127659574468,270,1100,190.0
570000.0,3,3.25,1570,1777,2.0,3,8,1260,310.0,2007,1000,1777,5545 days 16:47:18.658895,296,0.9230769230769231,4.064516129032258,570,0,950.0
324000.0,3,2.5,1920,5322,2.0,3,8,1920,0.0,1999,1920,5000,8467 days 16:47:18.658895,344,1.2,0.0,0,322,1920.0
270000.0,2,1.0,1000,10320,1.0,3,6,1000,0.0,1943,1100,5160,28921 days 16:47:18.658895,240,2.0,0.0,-100,5160,1000.0
290000.0,5,1.5,2120,7700,1.5,5,7,2120,0.0,1962,1730,7700,21981 days 16:47:18.658895,139,3.3333333333333335,0.0,390,0,2120.0
250000.0,3,2.0,1440,9220,1.0,3,7,1440,0.0,1965,1390,7830,20885 days 16:47:18.658895,181,1.5,0.0,50,1390,1440.0
342000.0,3,1.75,1660,16275,2.0,3,7,1660,0.0,1990,1520,16275,11754 days 16:47:18.658895,020,1.7142857142857142,0.0,140,0,1660.0
255000.0,3,1.5,1340,8450,1.0,4,7,1340,0.0,1958,1340,8920,23442 days 16:47:18.658895,077,2.0,0.0,0,-470,1340.0
800000.0,3,2.25,2380,11824,1.0,4,9,1450,930.0,1972,2750,11491,18329 days 16:47:18.658895,174,1.3333333333333333,1.5591397849462365,-370,333,520.0
451000.0,3,1.75,1560,4049,1.5,3,7,1000,560.0,1926,1430,3738,35130 days 16:47:18.658895,136,1.7142857142857142,1.7857142857142858,130,311,440.0
990000.0,4,2.5,2780,10480,1.0,3,7,1390,1390.0,1967,2860,10506,20155 days 16:47:18.658895,337,1.6,1.0,-80,-26,0.0
288400.0,4,2.5,1860,6687,1.0,4,7,1220,640.0,1983,1860,6117,14311 days 16:47:18.658895,140,1.6,1.90625,0,570,580.0
420000.0,3,1.5,2390,4600,2.0,3,8,1750,640.0,1920,1690,5220,37322 days 16:47:18.658895,069,2.0,2.734375,700,-620,1110.0
359000.0,2,2.75,1370,1140,2.0,3,8,1080,290.0,2009,1370,1090,4814 days 16:47:18.658895,134,0.7272727272727273,3.7241379310344827,0,50,790.0
390000.0,4,3.0,2570,262018,1.0,3,7,1420,1150.0,1988,2260,19811,12485 days 16:47:18.658895,220,1.3333333333333333,1.2347826086956522,310,242207,270.0
300000.0,3,2.5,1320,2614,2.0,3,7,1320,0.0,2005,1320,2533,6275 days 16:47:18.658895,245,1.2,0.0,0,81,1320.0
545000.0,5,2.5,2520,7863,1.0,3,7,1500,1020.0,1981,2030,8580,15041 days 16:47:18.658895,064,2.0,1.4705882352941178,490,-717,480.0
288349.0,3,1.0,1250,18616,1.0,4,6,1250,0.0,1972,1920,15654,18329 days 16:47:18.658895,098,3.0,0.0,-670,2962,1250.0
299900.0,3,2.25,1560,35026,1.0,3,7,1290,270.0,1985,1660,35160,13580 days 16:47:18.658895,036,1.3333333333333333,4.777777777777778,-100,-134,1020.0
891000.0,4,2.0,2330,5000,1.5,5,7,1720,610.0,1925,2090,5000,35495 days 16:47:18.658895,198,2.0,2.819672131147541,240,0,1110.0
1200000.0,3,2.0,3660,22410,1.0,4,9,1830,1830.0,1947,2680,8250,27460 days 16:47:18.658895,090,1.5,1.0,980,14160,0.0
378000.0,4,2.5,2790,4650,2.0,3,8,2790,0.0,2004,2820,4650,6641 days 16:47:18.658895,036,1.6,0.0,-30,0,2790.0
299995.0,2,1.0,1060,7200,1.0,4,6,1060,0.0,1951,1850,8291,25999 days 16:47:18.658895,174,2.0,0.0,-790,-1091,1060.0
253000.0,3,2.5,2020,6564,1.0,3,7,1310,710.0,1994,1710,5151,10293 days 16:47:18.658895,280,1.2,1.8450704225352113,310,1413,600.0
350000.0,3,2.25,1580,47916,1.0,3,7,1580,0.0,1979,1980,75358,15772 days 16:47:18.658895,020,1.3333333333333333,0.0,-400,-27442,1580.0
565000.0,4,3.0,2020,4300,1.5,3,6,2020,0.0,1900,1290,3440,44626 days 16:47:18.658895,070,1.3333333333333333,0.0,730,860,2020.0
315000.0,2,1.0,970,5665,1.0,4,6,970,0.0,1908,1490,4429,41705 days 16:47:18.658895,163,2.0,0.0,-520,1236,970.0
570000.0,4,3.0,1490,6766,1.5,5,7,1490,0.0,1915,1990,6526,39148 days 16:47:18.658895,295,1.3333333333333333,0.0,-500,240,1490.0
971000.0,5,3.5,4390,10140,2.0,3,9,3350,1040.0,2005,2010,8400,6275 days 16:47:18.658895,223,1.4285714285714286,3.2211538461538463,2380,1740,2310.0
915000.0,5,2.5,2750,5589,1.5,5,9,1840,910.0,1910,1460,4250,40974 days 16:47:18.658895,240,2.0,2.021978021978022,1290,1339,930.0
419000.0,4,1.5,2150,23568,1.0,4,7,2150,0.0,1950,2150,10125,26364 days 16:47:18.658895,012,2.6666666666666665,0.0,0,13443,2150.0
260000.0,4,1.75,1810,7480,1.0,3,7,1230,580.0,1977,1870,9594,16502 days 16:47:18.658895,040,2.2857142857142856,2.1206896551724137,-60,-2114,650.0
1320000.0,3,3.0,2230,12968,2.0,3,9,2230,0.0,1990,2260,10160,11754 days 16:47:18.658895,098,1.0,0.0,-30,2808,2230.0
369950.0,3,1.0,2430,10720,1.0,3,7,2430,0.0,1977,1660,11560,16502 days 16:47:18.658895,065,3.0,0.0,770,-840,2430.0
1030000.0,3,2.5,3680,13384,2.0,3,1,3680,0.0,1994,3600,11306,10293 days 16:47:18.658895,288,1.2,0.0,80,2078,3680.0
435000.0,5,1.0,1410,6750,1.5,3,6,1410,0.0,1929,1360,6750,34034 days 16:47:18.658895,126,5.0,0.0,50,0,1410.0
601000.0,3,1.75,1330,6743,1.0,3,8,1330,0.0,1958,2600,7350,23442 days 16:47:18.658895,084,1.7142857142857142,0.0,-1270,-607,1330.0
460500.0,3,1.0,1490,10650,1.0,3,7,1150,340.0,1963,1730,9800,21616 days 16:47:18.658895,197,3.0,3.3823529411764706,-240,850,810.0
720000.0,3,2.5,2020,1159,3.0,3,8,2020,0.0,2000,1920,3600,8102 days 16:47:18.658895,141,1.2,0.0,100,-2441,2020.0
851000.0,4,2.5,3130,13202,2.0,3,1,3130,0.0,1996,2840,10470,9563 days 16:47:18.658895,111,1.6,0.0,290,2732,3130.0
550000.0,4,3.0,2670,5000,2.0,3,7,2670,0.0,1916,2300,5000,38783 days 16:47:18.658895,247,1.3333333333333333,0.0,370,0,2670.0
700000.0,4,1.0,1980,4560,1.5,3,7,1980,0.0,1920,1810,3245,37322 days 16:47:18.658895,082,4.0,0.0,170,1315,1980.0
323000.0,3,1.75,2100,14850,1.0,4,7,2100,0.0,1963,1930,17238,21616 days 16:47:18.658895,251,1.7142857142857142,0.0,170,-2388,2100.0
345500.0,3,1.0,1350,8581,1.0,5,6,1350,0.0,1944,2080,8451,28556 days 16:47:18.658895,265,3.0,0.0,-730,130,1350.0
378000.0,4,1.5,2140,7920,1.0,3,7,1190,950.0,1959,2140,7238,23077 days 16:47:18.658895,337,2.6666666666666665,1.2526315789473683,0,682,240.0
650000.0,4,2.0,2208,5000,3.0,5,8,2208,0.0,1917,1760,5000,38417 days 16:47:18.658895,316,2.0,0.0,448,0,2208.0
385000.0,3,2.0,1010,7380,1.0,3,7,1010,0.0,1982,1650,9030,14676 days 16:47:18.658895,103,1.5,0.0,-640,-1650,1010.0
425000.0,2,1.0,970,2970,1.0,3,7,970,0.0,1910,1670,3000,40974 days 16:47:18.658895,259,2.0,0.0,-700,-30,970.0
210000.0,4,2.0,1520,6174,1.5,5,6,1520,0.0,1920,1390,5407,37322 days 16:47:18.658895,336,2.0,0.0,130,767,1520.0
630000.0,4,2.5,2740,43101,2.0,3,9,2740,0.0,1993,2740,33447,10658 days 16:47:18.658895,148,1.6,0.0,0,9654,2740.0
335000.0,3,1.75,1570,7500,1.0,3,7,1300,270.0,1953,1590,7660,25268 days 16:47:18.658895,211,1.7142857142857142,4.814814814814815,-20,-160,1030.0
196500.0,3,1.0,1320,9000,1.0,3,7,1320,0.0,1966,1320,9800,20520 days 16:47:18.658895,176,3.0,0.0,0,-800,1320.0
582800.0,4,2.75,2550,7636,1.0,3,8,1440,1110.0,1986,2290,8223,13215 days 16:47:18.658895,135,1.4545454545454546,1.2972972972972974,260,-587,330.0
440000.0,3,1.75,1560,7207,1.0,3,7,1250,310.0,1983,1540,7485,14311 days 16:47:18.658895,174,1.7142857142857142,4.032258064516129,20,-278,940.0
752500.0,4,2.25,2360,8616,2.0,4,8,2360,0.0,1974,2360,9337,17598 days 16:47:18.658895,237,1.7777777777777777,0.0,0,-721,2360.0
532500.0,3,1.75,1330,5000,2.0,4,7,1210,120.0,1909,1500,4000,41339 days 16:47:18.658895,301,1.7142857142857142,10.083333333333334,-170,1000,1090.0
265000.0,3,1.0,1070,9000,1.0,4,7,1070,0.0,1950,1840,12000,26364 days 16:47:18.658895,126,3.0,0.0,-770,-3000,1070.0
397500.0,3,1.25,1510,13737,1.0,4,6,810,700.0,1961,2560,10202,22346 days 16:47:18.658895,033,2.4,1.1571428571428573,-1050,3535,110.0
524250.0,3,2.5,1710,3469,2.0,3,8,1710,0.0,1999,2120,3560,8467 days 16:47:18.658895,205,1.2,0.0,-410,-91,1710.0
765000.0,4,2.75,2790,10819,2.0,3,1,2790,0.0,1996,3080,12603,9563 days 16:47:18.658895,129,1.4545454545454546,0.0,-290,-1784,2790.0
648000.0,4,2.5,2620,5450,2.0,3,9,2620,0.0,2001,2590,5371,7736 days 16:47:18.658895,218,1.6,0.0,30,79,2620.0
469500.0,5,2.5,2970,24759,1.0,4,8,1670,1300.0,1969,2100,21803,19424 days 16:47:18.658895,224,2.0,1.2846153846153847,870,2956,370.0
237500.0,3,1.75,1050,7854,1.0,4,7,1050,0.0,1975,1360,7668,17233 days 16:47:18.658895,083,1.7142857142857142,0.0,-310,186,1050.0
216000.0,3,1.0,1280,8712,1.0,4,7,1280,0.0,1956,1420,8800,24173 days 16:47:18.658895,021,3.0,0.0,-140,-88,1280.0
427200.0,3,1.0,1030,8400,1.0,4,7,1030,0.0,1963,1270,8400,21616 days 16:47:18.658895,089,3.0,0.0,-240,0,1030.0
280000.0,3,2.25,1900,7800,1.0,4,8,1390,510.0,1977,1730,7800,16502 days 16:47:18.658895,070,1.3333333333333333,2.7254901960784315,170,0,880.0
718000.0,5,3.0,3070,9804,1.0,4,9,1740,1330.0,1968,2550,9689,19790 days 16:47:18.658895,115,1.6666666666666667,1.3082706766917294,520,115,410.0
420000.0,2,2.75,1760,4139,2.0,3,8,1760,0.0,2010,1870,3076,4449 days 16:47:18.658895,069,0.7272727272727273,0.0,-110,1063,1760.0
379000.0,2,1.0,930,5400,1.0,3,7,930,0.0,1952,1050,5400,25634 days 16:47:18.658895,259,2.0,0.0,-120,0,930.0
326100.0,2,1.0,880,7683,1.0,3,6,880,0.0,1942,1370,7695,29286 days 16:47:18.658895,147,2.0,0.0,-490,-12,880.0
535000.0,3,2.5,1360,1016,3.0,3,7,1310,50.0,2003,1365,1156,7006 days 16:47:18.658895,149,1.2,26.2,-5,-140,1260.0
283000.0,4,2.75,2130,8560,1.0,3,7,1560,570.0,1992,2130,8560,11024 days 16:47:18.658895,274,1.4545454545454546,2.736842105263158,0,0,990.0
260000.0,3,1.0,1480,7469,1.5,3,6,1120,360.0,1940,1460,7379,30017 days 16:47:18.658895,233,3.0,3.111111111111111,20,90,760.0
399000.0,4,1.0,1500,6388,1.5,4,7,1500,0.0,1951,980,5366,25999 days 16:47:18.658895,103,4.0,0.0,520,1022,1500.0
484950.0,3,2.25,1670,5004,2.0,3,8,1670,0.0,1987,1850,5276,12850 days 16:47:18.658895,056,1.3333333333333333,0.0,-180,-272,1670.0
640000.0,4,1.75,2060,9828,1.0,4,8,2060,0.0,1960,2260,9996,22712 days 16:47:18.658895,286,2.2857142857142856,0.0,-200,-168,2060.0
585000.0,4,2.5,2160,8158,1.0,4,8,1660,500.0,1952,1520,7208,25634 days 16:47:18.658895,063,1.6,3.32,640,950,1160.0
645000.0,4,2.0,2780,11583,1.0,3,8,1190,1590.0,1955,2580,10241,24538 days 16:47:18.658895,008,2.0,0.7484276729559748,200,1342,-400.0
253000.0,3,2.0,1490,7651,1.0,3,7,1490,0.0,1988,1590,7795,12485 days 16:47:18.658895,125,1.5,0.0,-100,-144,1490.0
178500.0,2,1.0,740,6460,1.0,3,6,740,0.0,1953,1170,6975,25268 days 16:47:18.658895,202,2.0,0.0,-430,-515,740.0
291000.0,4,2.5,1860,6325,2.0,4,7,1860,0.0,1991,1860,6449,11389 days 16:47:18.658895,233,1.6,0.0,0,-124,1860.0
553500.0,2,1.0,850,2340,1.0,3,7,850,0.0,1922,1300,3000,36591 days 16:47:18.658895,216,2.0,0.0,-450,-660,850.0
189950.0,2,1.0,1030,4188,1.0,3,8,1030,0.0,1981,1450,3376,15041 days 16:47:18.658895,105,2.0,0.0,-420,812,1030.0
289000.0,3,2.0,1850,9550,1.0,3,8,1850,0.0,1988,2250,9550,12485 days 16:47:18.658895,267,1.5,0.0,-400,0,1850.0
700000.0,4,2.0,1830,4590,2.0,3,8,1830,0.0,1908,1650,4590,41705 days 16:47:18.658895,117,2.0,0.0,180,0,1830.0
270000.0,3,2.0,1560,8853,1.0,3,7,1560,0.0,1967,1610,8750,20155 days 16:47:18.658895,295,1.5,0.0,-50,103,1560.0
258000.0,4,1.75,1730,8320,1.0,3,7,1230,500.0,1977,1840,9800,16502 days 16:47:18.658895,128,2.2857142857142856,2.46,-110,-1480,730.0
530000.0,3,2.5,1930,7214,2.0,3,8,1930,0.0,2005,1930,7266,6275 days 16:47:18.658895,165,1.2,0.0,0,-52,1930.0
245000.0,3,2.25,1422,3677,2.0,3,7,1422,0.0,2012,1677,3677,3719 days 16:47:18.658895,352,1.3333333333333333,0.0,-255,0,1422.0
563000.0,3,2.0,1380,5000,1.5,4,7,1380,0.0,1917,1350,5000,38417 days 16:47:18.658895,112,1.5,0.0,30,0,1380.0
515000.0,3,2.5,2430,4203,2.0,3,8,2430,0.0,2001,2500,4798,7736 days 16:47:18.658895,323,1.2,0.0,-70,-595,2430.0
325000.0,4,2.5,2610,7091,2.0,3,9,2610,0.0,1987,2610,7773,12850 days 16:47:18.658895,168,1.6,0.0,0,-682,2610.0
540000.0,3,2.25,2000,217800,2.0,3,8,2000,0.0,1996,2220,217800,9563 days 16:47:18.658895,092,1.3333333333333333,0.0,-220,0,2000.0
280300.0,2,1.0,920,5000,1.0,4,6,490,430.0,1949,1500,5000,26729 days 16:47:18.658895,344,2.0,1.1395348837209303,-580,0,60.0
460000.0,4,1.75,1750,5500,1.5,5,7,1050,700.0,1926,1640,5500,35130 days 16:47:18.658895,129,2.2857142857142856,1.5,110,0,350.0
475000.0,3,1.75,2020,8970,1.0,4,7,1180,840.0,1981,2140,8008,15041 days 16:47:18.658895,346,1.7142857142857142,1.4047619047619047,-120,962,340.0
900000.0,4,2.25,2460,44431,1.0,4,9,2460,0.0,1957,2830,44431,23807 days 16:47:18.658895,163,1.7777777777777777,0.0,-370,0,2460.0
538200.0,4,3.0,1780,7260,1.0,4,8,1780,0.0,1964,1810,7920,21251 days 16:47:18.658895,364,1.3333333333333333,0.0,-30,-660,1780.0
429000.0,2,1.0,1080,3600,1.0,3,7,1080,0.0,1922,2230,4500,36591 days 16:47:18.658895,252,2.0,0.0,-1150,-900,1080.0
164808.0,3,1.0,1250,5411,1.0,3,7,1250,0.0,1980,1490,6320,15407 days 16:47:18.658895,206,3.0,0.0,-240,-909,1250.0
520000.0,4,2.25,1870,7700,2.0,3,7,1870,0.0,1977,1970,7700,16502 days 16:47:18.658895,026,1.7777777777777777,0.0,-100,0,1870.0
475000.0,3,1.75,1700,8432,1.0,3,8,1230,470.0,1977,1800,7842,16502 days 16:47:18.658895,169,1.7142857142857142,2.617021276595745,-100,590,760.0
283000.0,4,1.5,1480,47045,1.0,5,6,1480,0.0,1942,1530,11000,29286 days 16:47:18.658895,269,2.6666666666666665,0.0,-50,36045,1480.0
321500.0,4,2.5,1930,6228,2.0,3,8,1930,0.0,2000,1930,6168,8102 days 16:47:18.658895,090,1.6,0.0,0,60,1930.0
840000.0,4,2.75,3130,21810,2.0,4,1,3130,0.0,1993,3330,21810,10658 days 16:47:18.658895,210,1.4545454545454546,0.0,-200,0,3130.0
287000.0,3,2.25,1370,6000,2.0,4,7,1370,0.0,1992,1370,6200,11024 days 16:47:18.658895,104,1.3333333333333333,0.0,0,-200,1370.0
375000.0,3,1.75,960,8106,1.0,3,7,960,0.0,1962,1650,8035,21981 days 16:47:18.658895,156,1.7142857142857142,0.0,-690,71,960.0
349500.0,3,1.75,1260,7128,1.0,4,7,1260,0.0,1969,1330,7326,19424 days 16:47:18.658895,237,1.7142857142857142,0.0,-70,-198,1260.0
446450.0,3,1.5,1480,7749,1.0,5,7,1480,0.0,1960,1140,5320,22712 days 16:47:18.658895,226,2.0,0.0,340,2429,1480.0
315000.0,4,2.5,1930,9643,2.0,4,7,1930,0.0,1992,1930,7525,11024 days 16:47:18.658895,161,1.6,0.0,0,2118,1930.0
271310.0,2,1.0,870,5340,1.5,2,6,870,0.0,1906,1190,4440,42435 days 16:47:18.658895,140,2.0,0.0,-320,900,870.0
315000.0,4,1.0,1300,8400,1.5,4,7,1300,0.0,1953,1330,8400,25268 days 16:47:18.658895,022,4.0,0.0,-30,0,1300.0
245000.0,3,1.75,1490,6930,1.0,4,7,1490,0.0,1990,1880,6861,11754 days 16:47:18.658895,135,1.7142857142857142,0.0,-390,69,1490.0
543115.0,2,1.0,1380,5484,1.0,3,8,1030,350.0,1947,1380,5347,27460 days 16:47:18.658895,064,2.0,2.942857142857143,0,137,680.0
900000.0,4,2.0,1190,8190,1.5,3,7,1190,0.0,1945,1190,1567,28190 days 16:47:18.658895,293,2.0,0.0,0,6623,1190.0
2450000.0,4,4.25,4250,6552,2.0,4,1,2870,1380.0,2008,3640,8841,5180 days 16:47:18.658895,107,0.9411764705882353,2.079710144927536,610,-2289,1490.0
554000.0,2,2.0,1920,6045,1.0,3,8,1920,0.0,2003,1670,5200,7006 days 16:47:18.658895,119,1.0,0.0,250,845,1920.0
249900.0,3,1.75,2080,12522,1.0,5,6,2080,0.0,1950,1690,11200,26364 days 16:47:18.658895,198,1.7142857142857142,0.0,390,1322,2080.0
768000.0,3,2.5,3220,54160,2.0,4,9,2690,530.0,1981,3460,44374,15041 days 16:47:18.658895,232,1.2,5.0754716981132075,-240,9786,2160.0
980000.0,4,3.0,3680,5854,1.0,3,1,2060,1620.0,1967,3140,5000,20155 days 16:47:18.658895,143,1.3333333333333333,1.271604938271605,540,854,440.0
395000.0,5,2.5,2070,9600,1.0,3,7,1270,800.0,1962,1950,7800,21981 days 16:47:18.658895,110,2.0,1.5875,120,1800,470.0
415000.0,3,1.75,1480,2200,2.0,3,7,1480,0.0,1995,1360,2190,9928 days 16:47:18.658895,103,1.7142857142857142,0.0,120,10,1480.0
380000.0,4,2.5,2000,6921,2.0,3,8,2000,0.0,2003,2430,6339,7006 days 16:47:18.658895,051,1.6,0.0,-430,582,2000.0
566000.0,3,2.5,1560,5259,2.0,3,8,1560,0.0,1999,2170,5461,8467 days 16:47:18.658895,057,1.2,0.0,-610,-202,1560.0
218500.0,2,1.0,1600,8961,1.0,4,7,1390,210.0,1949,1502,6798,26729 days 16:47:18.658895,075,2.0,6.619047619047619,98,2163,1180.0
550000.0,4,2.5,1940,10500,1.0,4,7,1140,800.0,1976,2200,10500,16868 days 16:47:18.658895,122,1.6,1.425,-260,0,340.0
512031.0,3,1.75,1540,3000,1.0,3,7,770,770.0,1920,1420,4200,37322 days 16:47:18.658895,183,1.7142857142857142,1.0,120,-1200,0.0
197500.0,2,1.0,820,8860,1.0,3,6,820,0.0,1950,1660,15375,26364 days 16:47:18.658895,076,2.0,0.0,-840,-6515,820.0
470000.0,3,2.25,1780,8784,1.0,3,7,1230,550.0,1977,1780,7704,16502 days 16:47:18.658895,196,1.3333333333333333,2.2363636363636363,0,1080,680.0
590000.0,3,1.75,1560,242629,1.0,3,7,1560,0.0,1981,2320,220654,15041 days 16:47:18.658895,072,1.7142857142857142,0.0,-760,21975,1560.0
465000.0,4,2.25,2210,8862,1.0,4,8,1270,940.0,1977,2030,8862,16502 days 16:47:18.658895,077,1.7777777777777777,1.351063829787234,180,0,330.0
499000.0,2,1.75,2040,114562,1.0,4,7,2040,0.0,1968,1850,94960,19790 days 16:47:18.658895,258,1.1428571428571428,0.0,190,19602,2040.0
515000.0,3,2.25,1920,11500,1.0,3,8,1920,0.0,1972,2260,8866,18329 days 16:47:18.658895,237,1.3333333333333333,0.0,-340,2634,1920.0
716500.0,3,1.75,1930,5000,1.0,3,9,1230,700.0,1936,2300,6000,31478 days 16:47:18.658895,310,1.7142857142857142,1.7571428571428571,-370,-1000,530.0
410000.0,3,2.0,1700,4250,1.0,3,6,890,810.0,1944,1440,4250,28556 days 16:47:18.658895,137,1.5,1.0987654320987654,260,0,80.0
850000.0,4,3.25,3450,6500,2.0,3,8,2450,1000.0,1994,1750,6500,10293 days 16:47:18.658895,295,1.2307692307692308,2.45,1700,0,1450.0
1050000.0,4,3.25,3440,35021,2.0,3,1,3440,0.0,1983,3440,35021,14311 days 16:47:18.658895,142,1.2307692307692308,0.0,0,0,3440.0
648000.0,4,2.5,2380,13435,2.0,3,1,2380,0.0,1992,2730,9677,11024 days 16:47:18.658895,160,1.6,0.0,-350,3758,2380.0
620000.0,4,2.25,2400,5350,1.5,4,7,1460,940.0,1929,1250,4880,34034 days 16:47:18.658895,156,1.7777777777777777,1.553191489361702,1150,470,520.0
935000.0,4,4.5,5670,84267,2.0,3,1,5670,0.0,2008,4100,83729,5180 days 16:47:18.658895,033,0.8888888888888888,0.0,1570,538,5670.0
379000.0,3,1.0,1140,10320,1.0,4,7,1140,0.0,1963,1140,10412,21616 days 16:47:18.658895,078,3.0,0.0,0,-92,1140.0
699000.0,3,1.75,1670,5375,1.0,3,7,1270,400.0,1952,1460,6125,25634 days 16:47:18.658895,197,1.7142857142857142,3.175,210,-750,870.0
528000.0,4,2.25,1910,8005,1.0,3,8,1280,630.0,1960,1860,8010,22712 days 16:47:18.658895,364,1.7777777777777777,2.0317460317460316,50,-5,650.0
425000.0,3,1.75,1560,9452,1.0,4,8,1560,0.0,1974,2200,9985,17598 days 16:47:18.658895,116,1.7142857142857142,0.0,-640,-533,1560.0
249500.0,2,1.75,1500,8645,1.0,4,7,1500,0.0,1963,1220,8645,21616 days 16:47:18.658895,174,1.1428571428571428,0.0,280,0,1500.0
1040000.0,5,3.25,4475,6642,2.0,3,9,4475,0.0,2014,3720,6633,2988 days 16:47:18.658895,197,1.5384615384615385,0.0,755,9,4475.0
790000.0,4,2.75,2840,11900,1.0,4,9,1640,1200.0,1961,2790,10070,22346 days 16:47:18.658895,225,1.4545454545454546,1.3666666666666667,50,1830,440.0
399950.0,3,1.0,1020,18050,1.0,3,7,1020,0.0,1969,1750,11640,19424 days 16:47:18.658895,230,3.0,0.0,-730,6410,1020.0
275000.0,3,1.5,1410,9000,1.0,3,7,1410,0.0,1953,1910,7214,25268 days 16:47:18.658895,294,2.0,0.0,-500,1786,1410.0
550000.0,3,1.0,1520,2500,1.5,3,8,1520,0.0,1912,1880,3600,40244 days 16:47:18.658895,023,3.0,0.0,-360,-1100,1520.0
140000.0,1,1.0,730,6890,1.0,4,4,730,0.0,1926,1790,7969,35130 days 16:47:18.658895,309,1.0,0.0,-1060,-1079,730.0
250000.0,3,1.0,1190,6250,1.0,3,7,990,200.0,1954,1760,6434,24903 days 16:47:18.658895,206,3.0,4.95,-570,-184,790.0
318000.0,3,2.25,1410,8909,2.0,3,7,1410,0.0,1988,2050,8909,12485 days 16:47:18.658895,246,1.3333333333333333,0.0,-640,0,1410.0
505000.0,2,1.0,1240,57000,1.0,3,7,1240,0.0,1962,3050,25545,21981 days 16:47:18.658895,191,2.0,0.0,-1810,31455,1240.0
470500.0,5,2.5,2500,9248,1.0,3,8,1300,1200.0,1966,2090,8568,20520 days 16:47:18.658895,107,2.0,1.0833333333333333,410,680,100.0
360000.0,3,1.0,1050,9206,1.5,3,7,1050,0.0,1954,1380,6384,24903 days 16:47:18.658895,147,3.0,0.0,-330,2822,1050.0
1240000.0,4,2.75,2680,8500,1.0,4,9,1480,1200.0,1962,2940,8650,21981 days 16:47:18.658895,078,1.4545454545454546,1.2333333333333334,-260,-150,280.0
986000.0,3,2.5,2380,16080,1.0,4,9,1340,1040.0,1964,2560,10070,21251 days 16:47:18.658895,100,1.2,1.2884615384615385,-180,6010,300.0
320000.0,3,1.75,2300,41900,1.0,4,8,1310,990.0,1939,1160,8547,30382 days 16:47:18.658895,014,1.7142857142857142,1.3232323232323233,1140,33353,320.0
310000.0,4,3.0,2010,7426,1.0,5,7,1090,920.0,1951,1470,7426,25999 days 16:47:18.658895,033,1.3333333333333333,1.184782608695652,540,0,170.0
356700.0,2,1.0,1090,5000,1.0,4,7,730,360.0,1942,990,5250,29286 days 16:47:18.658895,150,2.0,2.0277777777777777,100,-250,370.0
775000.0,4,1.75,2320,5595,1.0,3,7,1510,810.0,1956,1840,5596,24173 days 16:47:18.658895,112,2.2857142857142856,1.8641975308641976,480,-1,700.0
325000.0,3,1.0,1040,7541,1.0,3,6,1040,0.0,1951,1140,6100,25999 days 16:47:18.658895,111,3.0,0.0,-100,1441,1040.0
208000.0,4,2.75,1810,8677,1.5,3,7,1810,0.0,1962,1740,8677,21981 days 16:47:18.658895,275,1.4545454545454546,0.0,70,0,1810.0
825000.0,2,1.0,1150,12775,1.0,4,6,1150,0.0,1908,2440,11852,41705 days 16:47:18.658895,239,2.0,0.0,-1290,923,1150.0
515000.0,3,2.5,2360,11254,1.0,3,9,2360,0.0,1990,2390,11254,11754 days 16:47:18.658895,197,1.2,0.0,-30,0,2360.0
490000.0,3,1.5,1970,3400,1.5,4,8,1420,550.0,1929,1940,4000,34034 days 16:47:18.658895,027,2.0,2.581818181818182,30,-600,870.0
675000.0,4,3.0,2690,28300,1.0,3,8,2690,0.0,1954,2820,27100,24903 days 16:47:18.658895,140,1.3333333333333333,0.0,-130,1200,2690.0
360000.0,4,2.5,2080,4080,1.0,5,7,1040,1040.0,1962,1340,4080,21981 days 16:47:18.658895,198,1.6,1.0,740,0,0.0
550000.0,4,2.5,2080,4080,1.0,5,7,1040,1040.0,1962,1340,4080,21981 days 16:47:18.658895,110,1.6,1.0,740,0,0.0
225000.0,3,1.5,1370,9000,1.0,3,7,1370,0.0,1962,1400,9075,21981 days 16:47:18.658895,206,2.0,0.0,-30,-75,1370.0
500000.0,3,2.75,3410,9360,1.5,4,8,3410,0.0,1967,2260,10128,20155 days 16:47:18.658895,076,1.0909090909090908,0.0,1150,-768,3410.0
385000.0,4,2.0,1850,11700,1.0,4,8,1850,0.0,1969,2110,11700,19424 days 16:47:18.658895,117,2.0,0.0,-260,0,1850.0
837700.0,5,2.75,3010,12611,2.0,3,1,3010,0.0,1994,2890,9456,10293 days 16:47:18.658895,168,1.8181818181818181,0.0,120,3155,3010.0
448000.0,3,2.25,1530,3056,2.0,3,7,1530,0.0,2003,1560,3064,7006 days 16:47:18.658895,041,1.3333333333333333,0.0,-30,-8,1530.0
730000.0,5,1.75,2690,21357,1.0,4,7,1420,1270.0,1952,2600,17539,25634 days 16:47:18.658895,127,2.857142857142857,1.1181102362204725,90,3818,150.0
575000.0,4,1.5,2810,7140,1.0,3,8,1490,1320.0,1954,2240,6825,24903 days 16:47:18.658895,195,2.6666666666666665,1.128787878787879,570,315,170.0
430000.0,3,1.75,1810,7300,1.0,4,7,1240,570.0,1976,1460,7560,16868 days 16:47:18.658895,322,1.7142857142857142,2.175438596491228,350,-260,670.0
435000.0,3,2.5,1560,3987,2.0,3,7,1560,0.0,2002,1600,3152,7371 days 16:47:18.658895,014,1.2,0.0,-40,835,1560.0
241000.0,3,1.0,1010,9611,1.0,4,6,1010,0.0,1973,1200,9611,17963 days 16:47:18.658895,353,3.0,0.0,-190,0,1010.0
453500.0,2,1.75,1000,1760,1.0,4,6,600,400.0,1924,2120,2802,35861 days 16:47:18.658895,133,1.1428571428571428,1.5,-1120,-1042,200.0
285000.0,2,1.5,990,1380,3.0,3,7,990,0.0,2001,1050,1380,7736 days 16:47:18.658895,096,1.3333333333333333,0.0,-60,0,990.0
151000.0,2,1.0,720,4222,1.0,4,5,720,0.0,1942,860,4785,29286 days 16:47:18.658895,148,2.0,0.0,-140,-563,720.0
1570000.0,5,4.5,6070,14731,2.0,3,1,6070,0.0,2004,4750,13404,6641 days 16:47:18.658895,314,1.1111111111111112,0.0,1320,1327,6070.0
631000.0,5,2.0,2270,2400,2.0,3,7,2270,0.0,1905,1320,2400,42800 days 16:47:18.658895,309,2.5,0.0,950,0,2270.0
285000.0,2,2.5,1380,1073,2.0,3,7,1140,240.0,2011,1580,2036,4084 days 16:47:18.658895,153,0.8,4.75,-200,-963,900.0
195000.0,3,1.0,1260,8378,1.0,4,6,840,420.0,1959,1140,8496,23077 days 16:47:18.658895,051,3.0,2.0,120,-118,420.0
817500.0,4,2.5,2910,35679,2.0,4,9,2910,0.0,1987,2720,36728,12850 days 16:47:18.658895,115,1.6,0.0,190,-1049,2910.0
550000.0,3,2.0,1810,12825,1.0,4,7,1810,0.0,1960,1490,10800,22712 days 16:47:18.658895,009,1.5,0.0,320,2025,1810.0
609850.0,2,2.75,1910,1369,3.0,3,9,1910,0.0,2002,1910,1879,7371 days 16:47:18.658895,364,0.7272727272727273,0.0,0,-510,1910.0
200000.0,3,1.0,1230,4380,1.0,3,6,1230,0.0,1947,1525,6026,27460 days 16:47:18.658895,006,3.0,0.0,-295,-1646,1230.0
367000.0,4,2.5,2960,6219,2.0,3,9,2960,0.0,2006,2960,5361,5910 days 16:47:18.658895,065,1.6,0.0,0,858,2960.0
285167.0,3,2.25,2200,8375,2.0,3,8,2200,0.0,1988,2200,10002,12485 days 16:47:18.658895,237,1.3333333333333333,0.0,0,-1627,2200.0
275000.0,2,1.5,1270,32175,1.0,4,7,1270,0.0,1947,1270,10200,27460 days 16:47:18.658895,092,1.3333333333333333,0.0,0,21975,1270.0
350900.0,4,2.5,2540,12843,2.0,3,9,2540,0.0,1992,2410,9383,11024 days 16:47:18.658895,083,1.6,0.0,130,3460,2540.0
660000.0,4,3.25,3030,9273,2.0,5,8,3030,0.0,1988,2360,7632,12485 days 16:47:18.658895,171,1.2307692307692308,0.0,670,1641,3030.0
525000.0,3,1.75,1520,8835,1.0,4,7,1520,0.0,1957,1760,8580,23807 days 16:47:18.658895,231,1.7142857142857142,0.0,-240,255,1520.0
262000.0,4,2.5,1560,7800,2.0,3,7,1560,0.0,1997,1160,7800,9197 days 16:47:18.658895,037,1.6,0.0,400,0,1560.0
690000.0,2,1.0,970,4560,1.0,4,7,970,0.0,1907,1500,4560,42070 days 16:47:18.658895,174,2.0,0.0,-530,0,970.0
624000.0,5,3.75,3570,14648,2.0,3,9,3570,0.0,2005,3160,7882,6275 days 16:47:18.658895,083,1.3333333333333333,0.0,410,6766,3570.0
353000.0,3,1.0,1350,7740,1.0,4,6,860,490.0,1947,1130,7740,27460 days 16:47:18.658895,126,3.0,1.7551020408163265,220,0,370.0
552500.0,4,3.5,3710,10400,2.0,3,8,2290,1420.0,2002,1720,4276,7371 days 16:47:18.658895,070,1.1428571428571428,1.6126760563380282,1990,6124,870.0
224500.0,4,1.0,1430,8355,1.5,4,7,1430,0.0,1983,1550,7938,14311 days 16:47:18.658895,129,4.0,0.0,-120,417,1430.0
239000.0,3,1.0,940,8571,1.0,3,6,940,0.0,1950,1100,8573,26364 days 16:47:18.658895,117,3.0,0.0,-160,-2,940.0
975000.0,5,4.5,4300,12250,2.0,3,1,4300,0.0,2004,3950,12250,6641 days 16:47:18.658895,192,1.1111111111111112,0.0,350,0,4300.0
1200000.0,4,1.75,3990,13470,2.0,3,1,3990,0.0,2006,5790,13709,5910 days 16:47:18.658895,176,2.2857142857142856,0.0,-1800,-239,3990.0
505000.0,3,1.0,1380,4000,1.5,3,7,1380,0.0,1910,1690,4000,40974 days 16:47:18.658895,084,3.0,0.0,-310,0,1380.0
302000.0,4,1.75,2020,7865,1.0,4,7,1010,1010.0,1963,1650,7865,21616 days 16:47:18.658895,135,2.2857142857142856,1.0,370,0,0.0
170000.0,3,1.0,1480,5670,1.0,3,6,780,700.0,1944,760,5040,28556 days 16:47:18.658895,265,3.0,1.1142857142857143,720,630,80.0
195000.0,2,1.0,1190,27007,1.0,4,5,1190,0.0,1910,1730,12632,40974 days 16:47:18.658895,188,2.0,0.0,-540,14375,1190.0
272000.0,5,1.5,2550,6300,1.0,4,7,1560,990.0,1959,1380,6300,23077 days 16:47:18.658895,252,3.3333333333333335,1.5757575757575757,1170,0,570.0
369000.0,5,1.5,2550,6300,1.0,4,7,1560,990.0,1959,1380,6300,23077 days 16:47:18.658895,044,3.3333333333333335,1.5757575757575757,1170,0,570.0
332500.0,3,1.5,1500,6332,1.0,3,7,1500,0.0,1953,1500,6337,25268 days 16:47:18.658895,014,2.0,0.0,0,-5,1500.0
515000.0,3,2.5,3000,8250,1.0,4,8,1760,1240.0,1963,2040,8250,21616 days 16:47:18.658895,126,1.2,1.4193548387096775,960,0,520.0
269000.0,3,1.0,1690,4250,1.0,3,7,1020,670.0,1967,1820,8865,20155 days 16:47:18.658895,156,3.0,1.5223880597014925,-130,-4615,350.0
1280000.0,4,4.0,4390,17832,1.0,4,1,2430,1960.0,1994,3090,12369,10293 days 16:47:18.658895,211,1.0,1.239795918367347,1300,5463,470.0
303000.0,3,2.5,1560,4100,2.0,3,7,1560,0.0,1985,1660,4400,13580 days 16:47:18.658895,037,1.2,0.0,-100,-300,1560.0
420000.0,7,3.0,2940,8624,1.0,3,8,1690,1250.0,1977,1850,8031,16502 days 16:47:18.658895,005,2.3333333333333335,1.352,1090,593,440.0
400000.0,3,1.0,1130,4100,1.0,3,7,990,140.0,1941,1800,4100,29651 days 16:47:18.658895,314,3.0,7.071428571428571,-670,0,850.0
225000.0,3,1.0,1020,8437,1.0,5,6,1020,0.0,1987,1420,8500,12850 days 16:47:18.658895,035,3.0,0.0,-400,-63,1020.0
219000.0,2,2.0,1310,2550,2.0,3,6,1310,0.0,2004,1310,2550,6641 days 16:47:18.658895,259,1.0,0.0,0,0,1310.0
605000.0,3,2.5,2570,9487,2.0,3,9,2570,0.0,1989,2490,9898,12119 days 16:47:18.658895,365,1.2,0.0,80,-411,2570.0
625000.0,4,2.0,2020,6867,1.0,5,8,1010,1010.0,1942,1250,6842,29286 days 16:47:18.658895,287,2.0,1.0,770,25,0.0
380000.0,5,2.0,1680,3240,1.0,3,5,840,840.0,1906,1380,1260,42435 days 16:47:18.658895,055,2.5,1.0,300,1980,0.0
620000.0,4,2.0,1770,7700,1.5,4,7,1770,0.0,1962,1710,7700,21981 days 16:47:18.658895,114,2.0,0.0,60,0,1770.0
687500.0,4,2.75,3190,10970,2.0,3,1,3190,0.0,1994,2850,8416,10293 days 16:47:18.658895,178,1.4545454545454546,0.0,340,2554,3190.0
225500.0,4,2.0,1440,7950,1.0,5,6,1440,0.0,1962,1530,20037,21981 days 16:47:18.658895,204,2.0,0.0,-90,-12087,1440.0
252500.0,3,2.0,1150,6000,1.0,5,7,1150,0.0,1956,1980,6360,24173 days 16:47:18.658895,349,1.5,0.0,-830,-360,1150.0
510000.0,3,2.5,1860,3658,2.0,3,8,1860,0.0,1994,1840,3739,10293 days 16:47:18.658895,302,1.2,0.0,20,-81,1860.0
510000.0,4,2.5,2430,5203,2.0,3,8,2430,0.0,2003,2260,7474,7006 days 16:47:18.658895,127,1.6,0.0,170,-2271,2430.0
725000.0,3,2.5,1940,4000,1.5,5,7,1940,0.0,1906,1440,4000,42435 days 16:47:18.658895,220,1.2,0.0,500,0,1940.0
492000.0,2,1.0,880,2970,1.0,3,7,880,0.0,1927,1370,3060,34765 days 16:47:18.658895,071,2.0,0.0,-490,-90,880.0
425000.0,4,2.5,1930,14196,1.0,4,7,1330,600.0,1977,1470,12852,16502 days 16:47:18.658895,070,1.6,2.216666666666667,460,1344,730.0
1960000.0,4,2.75,3120,7898,1.0,4,8,1560,1560.0,1963,2630,13868,21616 days 16:47:18.658895,111,1.4545454545454546,1.0,490,-5970,0.0
298900.0,3,2.5,1830,6162,2.0,3,8,1830,0.0,1994,1860,7017,10293 days 16:47:18.658895,068,1.2,0.0,-30,-855,1830.0
699000.0,4,2.5,3230,40319,2.0,4,1,3230,0.0,1987,2990,40234,12850 days 16:47:18.658895,096,1.6,0.0,240,85,3230.0
310000.0,2,1.0,700,3000,1.0,4,6,700,0.0,1918,1560,4500,38052 days 16:47:18.658895,183,2.0,0.0,-860,-1500,700.0
350000.0,3,1.75,1010,8580,1.0,3,7,1010,0.0,1961,1500,8580,22346 days 16:47:18.658895,356,1.7142857142857142,0.0,-490,0,1010.0
790000.0,4,1.75,2460,10061,1.0,3,7,1410,1050.0,1961,2300,10061,22346 days 16:47:18.658895,363,2.2857142857142856,1.3428571428571427,160,0,360.0
305000.0,4,2.5,2230,5000,2.0,3,8,2230,0.0,2003,2230,6137,7006 days 16:47:18.658895,210,1.6,0.0,0,-1137,2230.0
315000.0,3,2.5,1570,2865,2.0,3,7,1570,0.0,2003,1610,2582,7006 days 16:47:18.658895,275,1.2,0.0,-40,283,1570.0
267500.0,5,3.5,2390,6600,2.0,5,7,2390,0.0,1977,1140,6600,16502 days 16:47:18.658895,224,1.4285714285714286,0.0,1250,0,2390.0
1750000.0,4,3.25,3460,7749,2.0,3,1,3020,440.0,1950,3030,8680,26364 days 16:47:18.658895,231,1.2307692307692308,6.863636363636363,430,-931,2580.0
435000.0,6,3.5,2400,8620,2.0,3,8,1640,760.0,1987,1940,7350,12850 days 16:47:18.658895,225,1.7142857142857142,2.1578947368421053,460,1270,880.0
482500.0,6,4.5,2940,7500,1.5,4,8,2940,0.0,1966,2010,7500,20520 days 16:47:18.658895,248,1.3333333333333333,0.0,930,0,2940.0
5110000.0,5,5.25,8010,45517,2.0,3,1,5990,2020.0,1999,3430,26788,8467 days 16:47:18.658895,293,0.9523809523809523,2.9653465346534653,4580,18729,3970.0
439995.0,3,1.75,1570,8400,1.0,4,7,1570,0.0,1959,1860,8639,23077 days 16:47:18.658895,240,1.7142857142857142,0.0,-290,-239,1570.0
460000.0,3,3.0,1520,7500,1.0,3,7,1180,340.0,1967,2080,8000,20155 days 16:47:18.658895,128,1.0,3.4705882352941178,-560,-500,840.0
194000.0,3,1.0,1070,6440,1.0,4,7,1070,0.0,1971,1190,6532,18694 days 16:47:18.658895,210,3.0,0.0,-120,-92,1070.0
290000.0,2,0.75,440,8313,1.0,4,5,440,0.0,1943,880,26289,28921 days 16:47:18.658895,282,2.6666666666666665,0.0,-440,-17976,440.0
274700.0,4,2.0,2440,9600,1.0,5,7,1220,1220.0,1963,1370,9600,21616 days 16:47:18.658895,196,2.0,1.0,1070,0,0.0
900000.0,4,2.5,2660,3672,2.0,5,8,1800,860.0,1910,1510,3825,40974 days 16:47:18.658895,076,1.6,2.0930232558139537,1150,-153,940.0
1150000.0,4,4.0,4460,103382,2.0,3,1,4460,0.0,2001,3470,88519,7736 days 16:47:18.658895,127,1.0,0.0,990,14863,4460.0
605000.0,3,2.5,2010,3667,2.0,3,9,2010,0.0,2008,2350,3600,5180 days 16:47:18.658895,246,1.2,0.0,-340,67,2010.0
359000.0,3,2.5,1450,3850,2.0,3,7,1450,0.0,2004,1970,3748,6641 days 16:47:18.658895,068,1.2,0.0,-520,102,1450.0
850000.0,3,1.75,1400,9900,1.0,3,7,1400,0.0,1951,1810,10796,25999 days 16:47:18.658895,281,1.7142857142857142,0.0,-410,-896,1400.0
505000.0,3,2.0,1500,2500,2.0,3,8,1500,0.0,2002,1550,5000,7371 days 16:47:18.658895,233,1.5,0.0,-50,-2500,1500.0
565000.0,3,2.5,2500,7394,2.0,3,9,2500,0.0,1990,2790,7642,11754 days 16:47:18.658895,190,1.2,0.0,-290,-248,2500.0
585000.0,2,1.75,1280,7110,1.0,4,7,1000,280.0,1955,1550,6835,24538 days 16:47:18.658895,119,1.1428571428571428,3.5714285714285716,-270,275,720.0
328000.0,4,3.25,3380,7500,2.0,3,7,2420,960.0,1990,1920,7500,11754 days 16:47:18.658895,120,1.2307692307692308,2.5208333333333335,1460,0,1460.0
749950.0,4,2.75,2910,18700,1.0,3,9,2210,700.0,1957,2420,26140,23807 days 16:47:18.658895,190,1.4545454545454546,3.157142857142857,490,-7440,1510.0
826000.0,4,2.5,3060,7140,2.0,3,9,3060,0.0,2006,3240,6218,5910 days 16:47:18.658895,177,1.6,0.0,-180,922,3060.0
535000.0,3,1.0,1330,40259,1.0,4,7,1330,0.0,1977,1710,34787,16502 days 16:47:18.658895,247,3.0,0.0,-380,5472,1330.0
925000.0,4,2.5,3300,101930,2.0,4,1,3300,0.0,1991,2880,213879,11389 days 16:47:18.658895,218,1.6,0.0,420,-111949,3300.0
875000.0,3,3.5,3250,6000,2.0,3,1,2500,750.0,2001,1650,6000,7736 days 16:47:18.658895,156,0.8571428571428571,3.3333333333333335,1600,0,1750.0
902000.0,4,2.25,2530,9200,1.0,5,9,1570,960.0,1976,3030,9400,16868 days 16:47:18.658895,143,1.7777777777777777,1.6354166666666667,-500,-200,610.0
423000.0,3,1.0,1830,13900,1.0,3,7,1830,0.0,1951,1840,10667,25999 days 16:47:18.658895,274,3.0,0.0,-10,3233,1830.0
235000.0,3,1.0,1170,11100,1.0,4,6,1170,0.0,1968,2080,8481,19790 days 16:47:18.658895,174,3.0,0.0,-910,2619,1170.0
545000.0,2,2.0,2930,14057,1.0,4,8,1680,1250.0,1980,2234,61011,15407 days 16:47:18.658895,191,1.0,1.344,696,-46954,430.0
343000.0,2,1.0,1230,7560,1.0,3,7,1230,0.0,1961,1270,7560,22346 days 16:47:18.658895,289,2.0,0.0,-40,0,1230.0
334950.0,3,2.5,1620,2930,2.0,3,8,1620,0.0,2002,1900,2943,7371 days 16:47:18.658895,083,1.2,0.0,-280,-13,1620.0
405000.0,3,1.75,1760,5355,1.0,3,7,1160,600.0,1956,1790,6225,24173 days 16:47:18.658895,252,1.7142857142857142,1.9333333333333333,-30,-870,560.0
220000.0,4,1.0,1440,8250,1.0,3,7,1440,0.0,1959,1440,8466,23077 days 16:47:18.658895,349,4.0,0.0,0,-216,1440.0
173000.0,2,1.0,1740,8100,1.0,3,6,1050,690.0,1947,960,8100,27460 days 16:47:18.658895,275,2.0,1.5217391304347827,780,0,360.0
655000.0,3,1.0,1270,3600,1.5,3,7,1270,0.0,1906,1710,3600,42435 days 16:47:18.658895,311,3.0,0.0,-440,0,1270.0
406000.0,2,1.0,880,3000,1.0,3,6,880,0.0,1924,890,3000,35861 days 16:47:18.658895,007,2.0,0.0,-10,0,880.0
632000.0,6,2.5,2560,8320,1.0,3,7,1370,1190.0,1961,2360,7800,22346 days 16:47:18.658895,351,2.4,1.1512605042016806,200,520,180.0
357000.0,5,2.75,1540,4000,1.0,3,7,1140,400.0,1990,1630,4000,11754 days 16:47:18.658895,330,1.8181818181818181,2.85,-90,0,740.0
361000.0,3,1.75,1150,17585,1.0,3,7,1150,0.0,1964,1200,7500,21251 days 16:47:18.658895,343,1.7142857142857142,0.0,-50,10085,1150.0
277000.0,2,1.0,770,8149,1.0,3,6,770,0.0,1948,1160,8149,27095 days 16:47:18.658895,189,2.0,0.0,-390,0,770.0
630000.0,4,3.75,4610,40202,1.0,4,1,2500,2110.0,1980,3050,41056,15407 days 16:47:18.658895,156,1.0666666666666667,1.1848341232227488,1560,-854,390.0
254000.0,3,2.5,1850,4597,2.0,3,8,1850,0.0,2003,2210,5000,7006 days 16:47:18.658895,129,1.2,0.0,-360,-403,1850.0
472800.0,3,2.25,1840,8400,1.0,3,8,1290,550.0,1961,2110,8400,22346 days 16:47:18.658895,317,1.3333333333333333,2.3454545454545452,-270,0,740.0
263000.0,3,1.75,1490,3800,1.0,3,6,700,790.0,1913,2180,4000,39878 days 16:47:18.658895,265,1.7142857142857142,0.8860759493670886,-690,-200,-90.0
510000.0,3,1.75,1490,3800,1.0,3,6,700,790.0,1913,2180,4000,39878 days 16:47:18.658895,124,1.7142857142857142,0.8860759493670886,-690,-200,-90.0
179950.0,3,1.0,960,10125,1.0,4,7,960,0.0,1952,1250,9769,25634 days 16:47:18.658895,311,3.0,0.0,-290,356,960.0
525000.0,4,2.25,1580,7307,1.0,3,8,1160,420.0,1973,2020,7458,17963 days 16:47:18.658895,337,1.7777777777777777,2.761904761904762,-440,-151,740.0
479000.0,3,2.5,1260,889,3.0,3,8,1260,0.0,2008,1340,1324,5180 days 16:47:18.658895,140,1.2,0.0,-80,-435,1260.0
949000.0,4,1.75,2490,7834,1.0,4,8,1240,1250.0,1958,3210,7834,23442 days 16:47:18.658895,254,2.2857142857142856,0.992,-720,0,-10.0
392400.0,5,2.5,2520,27951,1.5,3,7,1890,630.0,1942,1830,14373,29286 days 16:47:18.658895,111,2.0,3.0,690,13578,1260.0
585000.0,4,1.75,1760,5356,1.0,4,7,920,840.0,1950,1680,5184,26364 days 16:47:18.658895,309,2.2857142857142856,1.0952380952380953,80,172,80.0
460000.0,4,2.5,4190,7504,2.0,3,7,4190,0.0,2004,2480,6727,6641 days 16:47:18.658895,346,1.6,0.0,1710,777,4190.0
470000.0,3,1.0,1170,4400,1.0,3,7,870,300.0,1951,1240,4400,25999 days 16:47:18.658895,225,3.0,2.9,-70,0,570.0
245000.0,3,2.5,1600,4271,2.0,3,7,1600,0.0,2003,1520,3225,7006 days 16:47:18.658895,096,1.2,0.0,80,1046,1600.0
500000.0,4,2.0,2760,27631,2.0,4,8,1800,960.0,1978,2490,13158,16137 days 16:47:18.658895,329,2.0,1.875,270,14473,840.0
455000.0,3,2.5,2090,8653,2.0,3,8,2090,0.0,1989,2090,6396,12119 days 16:47:18.658895,317,1.2,0.0,0,2257,2090.0
485500.0,4,2.5,2320,3974,2.0,3,7,2320,0.0,1999,2620,4539,8467 days 16:47:18.658895,098,1.6,0.0,-300,-565,2320.0
1880000.0,5,3.25,4110,7920,2.0,3,9,3150,960.0,1921,3890,7800,36956 days 16:47:18.658895,356,1.5384615384615385,3.28125,220,120,2190.0
100000.0,2,1.0,770,17334,1.0,3,7,770,0.0,1978,1480,17334,16137 days 16:47:18.658895,198,2.0,0.0,-710,0,770.0
307000.0,3,1.75,1410,16105,1.0,3,7,1410,0.0,1982,1550,18615,14676 days 16:47:18.658895,248,1.7142857142857142,0.0,-140,-2510,1410.0
475000.0,4,3.5,3660,14401,2.0,3,1,2660,1000.0,1994,2780,10653,10293 days 16:47:18.658895,283,1.1428571428571428,2.66,880,3748,1660.0
330000.0,4,2.5,2180,7210,1.0,3,7,1190,990.0,1972,2070,7210,18329 days 16:47:18.658895,050,1.6,1.202020202020202,110,0,200.0
130000.0,3,1.0,1110,7520,1.0,4,7,1110,0.0,1960,1440,8400,22712 days 16:47:18.658895,040,3.0,0.0,-330,-880,1110.0
320000.0,3,2.5,2280,7417,2.0,3,8,2280,0.0,1998,2370,6443,8832 days 16:47:18.658895,174,1.2,0.0,-90,974,2280.0
735000.0,4,2.5,2820,6180,2.0,3,9,2050,770.0,2013,1390,4635,3353 days 16:47:18.658895,157,1.6,2.6623376623376624,1430,1545,1280.0
365000.0,4,2.5,1570,9600,1.0,3,7,800,770.0,1972,1340,9110,18329 days 16:47:18.658895,071,1.6,1.0389610389610389,230,490,30.0
234000.0,3,1.5,1200,11935,1.0,4,7,1200,0.0,1968,1350,11935,19790 days 16:47:18.658895,106,2.0,0.0,-150,0,1200.0
211000.0,4,2.0,1710,8288,1.5,3,7,1710,0.0,1970,1710,7200,19059 days 16:47:18.658895,239,2.0,0.0,0,1088,1710.0
680000.0,6,3.5,3000,6320,2.0,3,8,2400,600.0,1969,1720,6360,19424 days 16:47:18.658895,089,1.7142857142857142,4.0,1280,-40,1800.0
457000.0,4,3.0,2800,7845,2.0,3,8,2800,0.0,2002,2800,6977,7371 days 16:47:18.658895,316,1.3333333333333333,0.0,0,868,2800.0
349000.0,3,2.25,1640,7261,2.0,3,7,1640,0.0,1989,1640,6789,12119 days 16:47:18.658895,282,1.3333333333333333,0.0,0,472,1640.0
360000.0,3,2.75,2030,6840,1.0,3,7,1210,820.0,1979,1910,6365,15772 days 16:47:18.658895,297,1.0909090909090908,1.475609756097561,120,475,390.0
350000.0,4,2.5,2530,10155,2.0,3,8,2530,0.0,1998,2330,7205,8832 days 16:47:18.658895,104,1.6,0.0,200,2950,2530.0
208000.0,3,1.0,990,7420,1.0,5,6,990,0.0,1960,1010,7420,22712 days 16:47:18.658895,120,3.0,0.0,-20,0,990.0
250275.0,2,1.0,790,11234,1.0,4,6,790,0.0,1942,1930,11871,29286 days 16:47:18.658895,169,2.0,0.0,-1140,-637,790.0
435000.0,2,1.0,790,11234,1.0,4,6,790,0.0,1942,1930,11871,29286 days 16:47:18.658895,118,2.0,0.0,-1140,-637,790.0
270000.0,3,1.75,1800,7763,1.0,3,6,1470,330.0,1984,1440,7483,13946 days 16:47:18.658895,339,1.7142857142857142,4.454545454545454,360,280,1140.0
438000.0,3,1.75,1650,12940,1.0,4,7,1650,0.0,1961,2830,12600,22346 days 16:47:18.658895,147,1.7142857142857142,0.0,-1180,340,1650.0
659000.0,4,2.0,1980,23625,2.0,3,8,1980,0.0,1938,2300,24640,30747 days 16:47:18.658895,323,2.0,0.0,-320,-1015,1980.0
645000.0,4,2.75,2340,6350,1.0,4,7,1310,1030.0,1974,2020,6350,17598 days 16:47:18.658895,124,1.4545454545454546,1.2718446601941749,320,0,280.0
685100.0,4,2.5,2790,5423,2.0,3,9,2790,0.0,1999,2450,6453,8467 days 16:47:18.659892,303,1.6,0.0,340,-1030,2790.0
350000.0,7,3.0,2800,9569,1.0,3,7,1400,1400.0,1963,2150,7333,21616 days 16:47:18.659892,174,2.3333333333333335,1.0,650,2236,0.0
375000.0,2,1.0,1840,81892,1.0,3,6,1840,0.0,1955,2550,40089,24538 days 16:47:18.659892,058,2.0,0.0,-710,41803,1840.0
170000.0,3,1.5,1350,81549,1.0,2,7,1350,0.0,1966,2220,93825,20520 days 16:47:18.659892,196,2.0,0.0,-870,-12276,1350.0
880000.0,4,2.5,3030,3841,3.0,3,9,3030,0.0,2005,1080,4922,6275 days 16:47:18.659892,175,1.6,0.0,1950,-1081,3030.0
410500.0,4,2.5,1980,5000,2.0,3,8,1980,0.0,2008,1400,8500,5180 days 16:47:18.659892,109,1.6,0.0,580,-3500,1980.0
780000.0,4,2.5,3690,13609,2.0,3,1,3690,0.0,1996,3600,13609,9563 days 16:47:18.659892,296,1.6,0.0,90,0,3690.0
1230000.0,5,4.5,3732,4426,2.5,3,1,2932,800.0,2001,2950,4000,7736 days 16:47:18.659892,253,1.1111111111111112,3.665,782,426,2132.0
449000.0,2,1.75,1510,6852,1.0,3,8,1510,0.0,2005,1510,5912,6275 days 16:47:18.659892,317,1.1428571428571428,0.0,0,940,1510.0
546000.0,3,1.75,2000,5000,1.0,4,7,1110,890.0,1921,1750,5000,36956 days 16:47:18.659892,134,1.7142857142857142,1.247191011235955,250,0,220.0
317000.0,3,2.0,1760,11410,1.0,5,7,1060,700.0,1977,1680,9165,16502 days 16:47:18.659892,136,1.5,1.5142857142857142,80,2245,360.0
276900.0,3,1.0,1270,7566,1.0,4,7,1270,0.0,1958,1780,7520,23442 days 16:47:18.659892,176,3.0,0.0,-510,46,1270.0
399000.0,5,2.0,2620,7030,1.0,3,8,1420,1200.0,1965,1360,7964,20885 days 16:47:18.659892,301,2.5,1.1833333333333333,1260,-934,220.0
495000.0,5,2.75,2630,10165,1.0,4,8,1690,940.0,1976,2440,10165,16868 days 16:47:18.659892,220,1.8181818181818181,1.797872340425532,190,0,750.0
258000.0,3,1.75,2270,9000,1.0,4,8,1330,940.0,1978,2090,8400,16137 days 16:47:18.659892,220,1.7142857142857142,1.4148936170212767,180,600,390.0
600000.0,2,2.5,2410,102366,1.0,4,7,1940,470.0,1912,2460,310582,40244 days 16:47:18.659892,191,0.8,4.127659574468085,-50,-208216,1470.0
265000.0,3,2.75,1120,881,3.0,3,8,1120,0.0,1999,1120,1087,8467 days 16:47:18.659892,321,1.0909090909090908,0.0,0,-206,1120.0
321000.0,5,2.75,3030,7000,1.0,4,7,1540,1490.0,1978,1790,7330,16137 days 16:47:18.659892,114,1.8181818181818181,1.0335570469798658,1240,-330,50.0
682000.0,5,2.25,2120,4000,1.5,4,7,1720,400.0,1910,1960,4000,40974 days 16:47:18.659892,241,2.2222222222222223,4.3,160,0,1320.0
295700.0,4,2.5,1720,5805,2.0,3,8,1720,0.0,2000,2360,7700,8102 days 16:47:18.659892,318,1.6,0.0,-640,-1895,1720.0
609000.0,4,2.5,2150,37981,2.0,3,9,2150,0.0,1985,2450,37981,13580 days 16:47:18.659892,126,1.6,0.0,-300,0,2150.0
995000.0,3,4.5,4380,47044,2.0,3,9,3720,660.0,1968,2460,18512,19790 days 16:47:18.659892,176,0.6666666666666666,5.636363636363637,1920,28532,3060.0
530000.0,3,2.25,2010,11817,2.0,4,8,2010,0.0,1986,2190,10168,13215 days 16:47:18.659892,230,1.3333333333333333,0.0,-180,1649,2010.0
614000.0,5,2.5,3150,5150,2.0,5,8,1870,1280.0,1907,1550,5150,42070 days 16:47:18.659892,363,2.0,1.4609375,1600,0,590.0
390000.0,3,2.5,2500,21780,1.0,3,8,1770,730.0,1986,2670,23400,13215 days 16:47:18.659892,328,1.2,2.4246575342465753,-170,-1620,1040.0
467000.0,3,2.5,1690,6642,2.0,3,7,1690,0.0,2004,2120,5080,6641 days 16:47:18.659892,314,1.2,0.0,-430,1562,1690.0
484000.0,6,2.5,3300,13501,1.0,3,8,2060,1240.0,1980,2060,8745,15407 days 16:47:18.659892,225,2.4,1.6612903225806452,1240,4756,820.0
340000.0,3,2.5,1240,1115,3.0,3,8,1240,0.0,2003,1410,1355,7006 days 16:47:18.659892,317,1.2,0.0,-170,-240,1240.0
302495.0,3,2.5,2200,7201,2.0,3,8,2200,0.0,1994,2250,7240,10293 days 16:47:18.659892,357,1.2,0.0,-50,-39,2200.0
532500.0,3,1.75,1620,3360,1.0,5,7,980,640.0,1927,1400,3840,34765 days 16:47:18.659892,268,1.7142857142857142,1.53125,220,-480,340.0
441500.0,3,2.5,2420,9592,2.0,3,8,1780,640.0,1993,2420,9145,10658 days 16:47:18.659892,253,1.2,2.78125,0,447,1140.0
470000.0,4,2.5,2680,8062,1.0,4,7,1530,1150.0,1967,1920,8600,20155 days 16:47:18.659892,205,1.6,1.3304347826086957,760,-538,380.0
2300000.0,4,3.25,4250,8570,2.0,3,9,4250,0.0,2004,2830,12821,6641 days 16:47:18.659892,176,1.2307692307692308,0.0,1420,-4251,4250.0
590000.0,3,2.5,2400,99752,1.0,3,9,2400,0.0,1996,2800,98010,9563 days 16:47:18.659892,351,1.2,0.0,-400,1742,2400.0
320000.0,3,1.75,2300,12000,1.0,3,8,1770,530.0,1942,2030,6000,29286 days 16:47:18.659892,210,1.7142857142857142,3.339622641509434,270,6000,1240.0
363000.0,2,2.0,920,1201,2.0,3,8,800,120.0,2009,1150,1161,4814 days 16:47:18.659892,307,1.0,6.666666666666667,-230,40,680.0
747500.0,4,2.25,2350,18600,2.0,4,9,2350,0.0,1977,2880,14400,16502 days 16:47:18.659892,188,1.7777777777777777,0.0,-530,4200,2350.0
750000.0,2,2.5,2630,7957,2.0,3,8,2630,0.0,2003,2305,7220,7006 days 16:47:18.659892,204,0.8,0.0,325,737,2630.0
831000.0,4,3.0,2170,4000,2.0,4,9,1610,560.0,1982,1670,4000,14676 days 16:47:18.659892,125,1.3333333333333333,2.875,500,0,1050.0
403000.0,3,2.5,1700,4125,2.0,3,7,1700,0.0,2004,1970,4105,6641 days 16:47:18.659892,114,1.2,0.0,-270,20,1700.0
445000.0,3,2.5,2470,4565,2.0,3,7,2470,0.0,2005,2470,5064,6275 days 16:47:18.659892,220,1.2,0.0,0,-499,2470.0
345000.0,3,1.0,1250,17380,1.0,4,7,1250,0.0,1970,1410,18200,19059 days 16:47:18.659892,085,3.0,0.0,-160,-820,1250.0
2260000.0,3,3.5,3110,14872,1.0,3,1,3110,0.0,2003,3110,12433,7006 days 16:47:18.659892,040,0.8571428571428571,0.0,0,2439,3110.0
371025.0,3,2.0,1530,8925,1.0,3,7,1530,0.0,1977,2040,8856,16502 days 16:47:18.659892,167,1.5,0.0,-510,69,1530.0
355000.0,2,1.0,960,6250,1.0,3,6,960,0.0,1916,1350,6250,38783 days 16:47:18.659892,211,2.0,0.0,-390,0,960.0
270000.0,3,1.0,1240,14110,1.0,4,7,1240,0.0,1972,2060,19350,18329 days 16:47:18.659892,252,3.0,0.0,-820,-5240,1240.0
425000.0,4,2.75,2440,15349,2.0,4,7,2440,0.0,1957,2280,9250,23807 days 16:47:18.659892,156,1.4545454545454546,0.0,160,6099,2440.0
364808.0,3,1.75,2320,7875,1.0,3,8,1620,700.0,1967,1990,9720,20155 days 16:47:18.659892,072,1.7142857142857142,2.3142857142857145,330,-1845,920.0
320000.0,3,2.25,1580,6561,1.0,3,8,1200,380.0,1981,1710,7241,15041 days 16:47:18.659892,013,1.3333333333333333,3.1578947368421053,-130,-680,820.0
325000.0,4,2.5,2963,5797,2.0,3,9,2963,0.0,2006,2665,6119,5910 days 16:47:18.659892,287,1.6,0.0,298,-322,2963.0
350000.0,3,2.25,2470,10290,2.0,3,8,2230,240.0,1984,1970,10150,13946 days 16:47:18.659892,247,1.3333333333333333,9.291666666666666,500,140,1990.0
170000.0,3,1.5,1370,10176,1.0,3,6,1370,0.0,1947,1650,10176,27460 days 16:47:18.659892,050,2.0,0.0,-280,0,1370.0
255000.0,2,1.0,960,28717,1.0,4,6,960,0.0,1984,1860,28717,13946 days 16:47:18.659892,129,2.0,0.0,-900,0,960.0
550000.0,3,1.0,1130,7500,1.0,3,7,880,250.0,1947,2190,5250,27460 days 16:47:18.659892,344,3.0,3.52,-1060,2250,630.0
835000.0,4,4.25,4930,25714,2.0,3,1,4930,0.0,2005,3620,23035,6275 days 16:47:18.659892,184,0.9411764705882353,0.0,1310,2679,4930.0
420000.0,3,1.0,1150,5120,1.0,4,6,800,350.0,1946,1220,5120,27825 days 16:47:18.659892,069,3.0,2.2857142857142856,-70,0,450.0
925000.0,4,2.5,2190,7350,2.5,5,8,2190,0.0,1958,1880,7350,23442 days 16:47:18.659892,134,1.6,0.0,310,0,2190.0
389250.0,2,1.5,1490,4080,1.0,3,7,930,560.0,1956,1320,4080,24173 days 16:47:18.659892,157,1.3333333333333333,1.6607142857142858,170,0,370.0
748000.0,3,2.5,2600,10183,1.0,3,8,1300,1300.0,2004,1860,10401,6641 days 16:47:18.659892,121,1.2,1.0,740,-218,0.0
284000.0,3,1.75,1530,9600,1.0,3,7,1200,330.0,1988,1680,9680,12485 days 16:47:18.659892,083,1.7142857142857142,3.6363636363636362,-150,-80,870.0
588000.0,4,2.0,1680,5000,1.0,3,7,980,700.0,1950,1680,6000,26364 days 16:47:18.659892,162,2.0,1.4,0,-1000,280.0
372500.0,3,1.75,1680,8648,1.0,4,7,1680,0.0,1963,1290,8147,21616 days 16:47:18.659892,079,1.7142857142857142,0.0,390,501,1680.0
285000.0,4,3.0,1900,7194,2.0,4,7,1900,0.0,1988,1690,7194,12485 days 16:47:18.659892,049,1.3333333333333333,0.0,210,0,1900.0
360000.0,3,1.0,1570,9467,1.0,3,7,1570,0.0,1954,1570,9100,24903 days 16:47:18.659892,147,3.0,0.0,0,367,1570.0
275000.0,3,1.0,1370,17859,1.0,4,7,1150,220.0,1930,1460,47044,33669 days 16:47:18.659892,322,3.0,5.2272727272727275,-90,-29185,930.0
428000.0,2,2.0,1350,4225,1.0,3,8,1350,0.0,2003,1660,4225,7006 days 16:47:18.659892,259,1.0,0.0,-310,0,1350.0
847000.0,6,2.5,3010,17864,2.0,3,8,3010,0.0,1969,2560,11532,19424 days 16:47:18.659892,084,2.4,0.0,450,6332,3010.0
316000.0,3,1.0,1010,7838,1.0,4,6,1010,0.0,1977,1380,8128,16502 days 16:47:18.659892,269,3.0,0.0,-370,-290,1010.0
375000.0,3,2.5,2050,7205,2.0,3,8,2050,0.0,2000,2050,7264,8102 days 16:47:18.659892,125,1.2,0.0,0,-59,2050.0
533000.0,3,1.0,1670,4080,1.0,3,7,1170,500.0,1967,1560,4080,20155 days 16:47:18.659892,128,3.0,2.34,110,0,670.0
556000.0,5,2.5,3840,16905,2.0,3,1,3840,0.0,1991,3270,12133,11389 days 16:47:18.659892,143,2.0,0.0,570,4772,3840.0
225000.0,4,2.0,2220,14120,1.0,3,7,1200,1020.0,1966,1300,9709,20520 days 16:47:18.659892,258,2.0,1.1764705882352942,920,4411,180.0
537250.0,4,2.5,2590,9530,1.0,4,8,1640,950.0,1978,2710,10970,16137 days 16:47:18.659892,303,1.6,1.7263157894736842,-120,-1440,690.0
255000.0,3,1.0,1180,13650,1.0,4,7,1180,0.0,1967,1460,11730,20155 days 16:47:18.659892,351,3.0,0.0,-280,1920,1180.0
530000.0,4,2.5,2950,4836,2.0,3,7,2950,0.0,2006,2120,4750,5910 days 16:47:18.659892,099,1.6,0.0,830,86,2950.0
5300000.0,6,6.0,7390,24829,2.0,4,1,5000,2390.0,1991,4320,24619,11389 days 16:47:18.659892,103,1.0,2.092050209205021,3070,210,2610.0
595000.0,3,2.75,2150,31238,2.0,3,9,2150,0.0,1996,2650,38307,9563 days 16:47:18.659892,083,1.0909090909090908,0.0,-500,-7069,2150.0
548000.0,4,2.0,2100,8880,1.0,4,7,2100,0.0,1958,1280,9102,23442 days 16:47:18.659892,226,2.0,0.0,820,-222,2100.0
234975.0,3,1.75,1650,8073,1.0,3,7,1100,550.0,1980,1280,8073,15407 days 16:47:18.659892,079,1.7142857142857142,2.0,370,0,550.0
600000.0,3,1.75,1620,1325,2.5,3,9,1430,190.0,2005,1750,1572,6275 days 16:47:18.659892,231,1.7142857142857142,7.526315789473684,-130,-247,1240.0
432000.0,4,1.0,1750,12528,1.0,4,7,1750,0.0,1967,1550,14120,20155 days 16:47:18.659892,083,4.0,0.0,200,-1592,1750.0
455000.0,3,1.5,1380,6657,2.0,3,7,1380,0.0,1986,1420,8187,13215 days 16:47:18.659892,033,2.0,0.0,-40,-1530,1380.0
279950.0,3,1.75,1510,11234,1.0,3,7,1210,300.0,1965,2080,9076,20885 days 16:47:18.659892,297,1.7142857142857142,4.033333333333333,-570,2158,910.0
267500.0,3,1.5,1600,9072,1.0,4,7,1600,0.0,1963,1710,8000,21616 days 16:47:18.659892,293,2.0,0.0,-110,1072,1600.0
620000.0,4,2.5,1840,220308,2.0,3,8,1840,0.0,2000,1890,65340,8102 days 16:47:18.659892,252,1.6,0.0,-50,154968,1840.0
110000.0,2,1.0,830,7590,1.0,2,6,830,0.0,1943,980,7590,28921 days 16:47:18.659892,027,2.0,0.0,-150,0,830.0
625000.0,3,3.5,1810,1846,2.0,4,8,1440,370.0,2009,1480,3600,4814 days 16:47:18.659892,133,0.8571428571428571,3.891891891891892,330,-1754,1070.0
389000.0,2,1.0,910,7000,1.0,3,7,910,0.0,1952,1260,7528,25634 days 16:47:18.659892,149,2.0,0.0,-350,-528,910.0
1200000.0,4,2.0,2120,3360,2.0,3,9,2120,0.0,1905,2090,3600,42800 days 16:47:18.659892,181,2.0,0.0,30,-240,2120.0
788500.0,4,2.25,2510,133729,2.0,4,8,2510,0.0,1977,2510,69696,16502 days 16:47:18.659892,114,1.7777777777777777,0.0,0,64033,2510.0
567000.0,5,2.25,2100,6936,1.0,3,8,1600,500.0,1974,2100,8661,17598 days 16:47:18.659892,206,2.2222222222222223,3.2,0,-1725,1100.0
515000.0,2,2.25,2690,15000,1.0,3,8,1870,820.0,1987,2690,15000,12850 days 16:47:18.659892,013,0.8888888888888888,2.2804878048780486,0,0,1050.0
605000.0,4,2.5,2430,11870,1.0,5,8,1590,840.0,1968,2430,9600,19790 days 16:47:18.659892,245,1.6,1.8928571428571428,0,2270,750.0
430000.0,4,3.75,2452,4800,2.0,3,7,2452,0.0,1936,1180,4800,31478 days 16:47:18.659892,300,1.0666666666666667,0.0,1272,0,2452.0
805000.0,2,1.75,1550,6000,1.0,3,7,1550,0.0,1920,2360,6000,37322 days 16:47:18.659892,198,1.1428571428571428,0.0,-810,0,1550.0
567500.0,3,2.5,2080,4556,2.0,3,8,2080,0.0,1999,1530,5606,8467 days 16:47:18.659892,103,1.2,0.0,550,-1050,2080.0
647500.0,3,1.75,1290,3870,1.0,5,7,1290,0.0,1916,2020,5850,38783 days 16:47:18.659892,156,1.7142857142857142,0.0,-730,-1980,1290.0
495000.0,2,1.75,1850,2530,2.5,4,7,1850,0.0,1903,1500,1795,43531 days 16:47:18.659892,330,1.1428571428571428,0.0,350,735,1850.0
825000.0,4,2.5,3370,5000,2.0,3,9,3370,0.0,2006,3370,5237,5910 days 16:47:18.659892,308,1.6,0.0,0,-237,3370.0
435000.0,4,2.25,2730,7506,2.0,4,8,2730,0.0,1987,2390,8015,12850 days 16:47:18.659892,068,1.7777777777777777,0.0,340,-509,2730.0
445950.0,3,1.75,1300,7800,1.0,5,7,1300,0.0,1968,1520,7344,19790 days 16:47:18.659892,252,1.7142857142857142,0.0,-220,456,1300.0
960000.0,5,2.75,3040,10257,2.0,3,1,3040,0.0,1993,2860,9327,10658 days 16:47:18.659892,154,1.8181818181818181,0.0,180,930,3040.0
780000.0,4,3.0,2440,3600,1.5,5,8,1480,960.0,1929,1770,4000,34034 days 16:47:18.659892,260,1.3333333333333333,1.5416666666666667,670,-400,520.0
274500.0,3,2.25,1720,9000,1.0,4,8,1320,400.0,1969,1930,8000,19424 days 16:47:18.659892,169,1.3333333333333333,3.3,-210,1000,920.0
729953.0,5,3.0,3230,5167,1.5,4,8,2000,1230.0,1909,1509,1626,41339 days 16:47:18.659892,119,1.6666666666666667,1.6260162601626016,1721,3541,770.0
464950.0,3,1.5,1200,890,2.0,3,8,1030,170.0,2008,1230,2120,5180 days 16:47:18.659892,209,2.0,6.0588235294117645,-30,-1230,860.0
620000.0,4,1.75,2350,18800,1.0,3,8,2350,0.0,1959,3050,14640,23077 days 16:47:18.659892,316,2.2857142857142856,0.0,-700,4160,2350.0
735000.0,4,3.5,3100,5600,2.0,3,9,3100,0.0,2005,3080,5600,6275 days 16:47:18.659892,016,1.1428571428571428,0.0,20,0,3100.0
450000.0,4,2.25,2040,9565,1.0,3,8,1400,640.0,1959,1890,8580,23077 days 16:47:18.659892,111,1.7777777777777777,2.1875,150,985,760.0
450000.0,4,1.0,2000,4676,1.5,3,7,1250,750.0,1916,1140,4676,38783 days 16:47:18.659892,156,4.0,1.6666666666666667,860,0,500.0
842500.0,4,2.5,2160,5298,2.5,4,9,2160,0.0,1902,1720,2283,43896 days 16:47:18.659892,131,1.6,0.0,440,3015,2160.0
360000.0,3,2.0,1970,79714,1.0,3,7,1070,900.0,1979,1890,36626,15772 days 16:47:18.659892,281,1.5,1.1888888888888889,80,43088,170.0
585000.0,3,2.5,2270,100545,2.0,3,8,2270,0.0,1998,1277,100545,8832 days 16:47:18.659892,175,1.2,0.0,993,0,2270.0
461000.0,3,2.25,1850,7923,1.0,4,7,1150,700.0,1977,1780,7420,16502 days 16:47:18.659892,226,1.3333333333333333,1.6428571428571428,70,503,450.0
345000.0,2,1.0,1350,4494,1.0,3,7,920,430.0,1949,1470,5225,26729 days 16:47:18.659892,230,2.0,2.13953488372093,-120,-731,490.0
1080000.0,3,2.5,3280,10302,1.0,3,1,1680,1600.0,1970,1550,6300,19059 days 16:47:18.659892,183,1.2,1.05,1730,4002,80.0
690000.0,4,2.5,2820,8307,2.0,3,9,2820,0.0,1990,2820,8307,11754 days 16:47:18.659892,272,1.6,0.0,0,0,2820.0
549000.0,3,1.75,2000,6130,1.0,4,8,1120,880.0,1951,2140,7150,25999 days 16:47:18.659892,322,1.7142857142857142,1.2727272727272727,-140,-1020,240.0
815000.0,3,2.0,2310,6000,2.0,4,9,1560,750.0,1926,2000,6000,35130 days 16:47:18.659892,008,1.5,2.08,310,0,810.0
2200000.0,5,4.25,4640,22703,2.0,5,8,2860,1780.0,1952,3140,14200,25634 days 16:47:18.659892,131,1.1764705882352942,1.6067415730337078,1500,8503,1080.0
700000.0,3,2.25,2330,11424,2.0,4,8,2330,0.0,1984,2050,11448,13946 days 16:47:18.659892,103,1.3333333333333333,0.0,280,-24,2330.0
933399.0,3,2.5,3940,10360,2.0,3,9,3110,830.0,1992,2720,11941,11024 days 16:47:18.659892,195,1.2,3.746987951807229,1220,-1581,2280.0
290000.0,3,1.0,1440,11250,1.0,3,7,1440,0.0,1967,2200,11250,20155 days 16:47:18.659892,184,3.0,0.0,-760,0,1440.0
372000.0,4,1.75,1960,9300,1.0,5,7,1340,620.0,1979,1500,9752,15772 days 16:47:18.659892,144,2.2857142857142856,2.161290322580645,460,-452,720.0
450000.0,2,1.75,1250,2890,1.0,4,7,790,460.0,1920,1500,3225,37322 days 16:47:18.659892,231,1.1428571428571428,1.7173913043478262,-250,-335,330.0
303700.0,3,2.5,1981,5700,2.0,3,8,1981,0.0,2010,1981,5894,4449 days 16:47:18.659892,248,1.2,0.0,0,-194,1981.0
334000.0,4,1.5,1150,9360,1.5,3,6,1150,0.0,1970,1480,8155,19059 days 16:47:18.659892,174,2.6666666666666665,0.0,-330,1205,1150.0
260000.0,2,1.0,1120,5650,1.0,3,6,1120,0.0,1944,1270,6875,28556 days 16:47:18.659892,176,2.0,0.0,-150,-1225,1120.0
749950.0,3,1.75,1800,5700,1.0,4,8,1000,800.0,1941,1680,5350,29651 days 16:47:18.659892,212,1.7142857142857142,1.25,120,350,200.0
330000.0,4,2.25,2380,122038,2.0,4,8,2380,0.0,1984,2030,48000,13946 days 16:47:18.659892,357,1.7777777777777777,0.0,350,74038,2380.0
830000.0,5,3.0,2920,2808,2.0,3,8,2140,780.0,1960,1620,1544,22712 days 16:47:18.659892,301,1.6666666666666667,2.7435897435897436,1300,1264,1360.0
1130000.0,3,2.25,2790,13791,1.0,3,8,2790,0.0,2006,2720,12600,5910 days 16:47:18.659892,189,1.3333333333333333,0.0,70,1191,2790.0
320000.0,3,1.0,1560,7552,1.0,4,6,910,650.0,1948,1200,8152,27095 days 16:47:18.659892,188,3.0,1.4,360,-600,260.0
260000.0,2,1.0,1550,15250,1.5,5,7,1550,0.0,1920,1520,34929,37322 days 16:47:18.659892,104,2.0,0.0,30,-19679,1550.0
225000.0,3,2.0,1700,11475,1.0,5,6,970,730.0,1945,1560,11475,28190 days 16:47:18.659892,177,1.5,1.3287671232876712,140,0,240.0
279200.0,1,1.0,640,6350,1.0,3,5,640,0.0,1939,1270,6350,30382 days 16:47:18.659892,260,1.0,0.0,-630,0,640.0
520000.0,4,3.5,2680,10000,2.0,3,8,2040,640.0,1942,1530,8000,29286 days 16:47:18.659892,140,1.1428571428571428,3.1875,1150,2000,1400.0
505000.0,3,2.5,1860,8060,2.0,4,8,1860,0.0,1987,1850,4661,12850 days 16:47:18.659892,176,1.2,0.0,10,3399,1860.0
234000.0,3,1.75,1490,8366,1.0,4,7,1010,480.0,1975,1490,7469,17233 days 16:47:18.659892,126,1.7142857142857142,2.1041666666666665,0,897,530.0
503000.0,4,2.5,2470,5044,2.0,3,9,2470,0.0,2005,2790,5583,6275 days 16:47:18.659892,272,1.6,0.0,-320,-539,2470.0
606000.0,4,2.25,2390,8858,1.0,4,8,1740,650.0,1979,2240,8858,15772 days 16:47:18.659892,218,1.7777777777777777,2.6769230769230767,150,0,1090.0
433500.0,3,1.0,1230,6000,1.0,4,7,780,450.0,1937,1570,5000,31112 days 16:47:18.659892,204,3.0,1.7333333333333334,-340,1000,330.0
250000.0,3,1.5,2840,10182,1.0,3,8,1510,1330.0,1951,2210,9669,25999 days 16:47:18.659892,023,2.0,1.1353383458646618,630,513,180.0
719000.0,3,2.5,2120,9307,2.0,4,9,2120,0.0,1984,2290,11524,13946 days 16:47:18.659892,217,1.2,0.0,-170,-2217,2120.0
381000.0,3,2.0,1770,14400,1.0,4,8,1770,0.0,1959,1900,14400,23077 days 16:47:18.659892,344,1.5,0.0,-130,0,1770.0
267000.0,3,2.5,2495,4400,2.0,3,8,2495,0.0,2007,2434,4400,5545 days 16:47:18.659892,148,1.2,0.0,61,0,2495.0
275000.0,1,0.75,1170,14149,1.0,5,7,880,290.0,1962,1130,24513,21981 days 16:47:18.659892,142,1.3333333333333333,3.0344827586206895,40,-10364,590.0
651000.0,4,2.5,2740,7140,2.0,3,8,2740,0.0,1993,2260,7035,10658 days 16:47:18.659892,133,1.6,0.0,480,105,2740.0
439000.0,2,1.0,1050,5671,1.0,3,7,850,200.0,1949,1850,5243,26729 days 16:47:18.659892,035,2.0,4.25,-800,428,650.0
325000.0,2,1.0,1130,5070,1.0,4,7,1130,0.0,1955,860,6300,24538 days 16:47:18.659892,045,2.0,0.0,270,-1230,1130.0
490000.0,2,1.0,880,6380,1.0,3,7,880,0.0,1938,1340,6380,30747 days 16:47:18.659892,122,2.0,0.0,-460,0,880.0
519900.0,4,2.5,2403,6172,2.0,3,9,2403,0.0,1999,2380,6075,8467 days 16:47:18.659892,280,1.6,0.0,23,97,2403.0
545000.0,4,2.75,3410,35040,2.0,3,9,3410,0.0,1984,2580,37263,13946 days 16:47:18.659892,204,1.4545454545454546,0.0,830,-2223,3410.0
1060000.0,4,4.0,5320,20041,2.0,3,1,5320,0.0,2003,4640,17268,7006 days 16:47:18.659892,195,1.0,0.0,680,2773,5320.0
542000.0,4,1.75,1900,8250,1.0,4,7,950,950.0,1955,1480,8360,24538 days 16:47:18.659892,134,2.2857142857142856,1.0,420,-110,0.0
465000.0,4,1.75,1810,21650,2.0,4,7,1810,0.0,1961,2700,29680,22346 days 16:47:18.659892,342,2.2857142857142856,0.0,-890,-8030,1810.0
408000.0,2,2.0,1200,3900,1.0,3,8,1200,0.0,2006,1440,5580,5910 days 16:47:18.659892,090,1.0,0.0,-240,-1680,1200.0
292000.0,4,2.5,2060,5950,2.0,3,8,2060,0.0,2000,2242,6406,8102 days 16:47:18.659892,338,1.6,0.0,-182,-456,2060.0
253000.0,3,1.75,1250,10122,1.0,3,7,1250,0.0,1994,1980,10175,10293 days 16:47:18.659892,127,1.7142857142857142,0.0,-730,-53,1250.0
280000.0,2,1.0,910,4662,1.0,5,6,910,0.0,1942,890,6050,29286 days 16:47:18.659892,248,2.0,0.0,20,-1388,910.0
658588.0,3,2.25,2560,41346,2.0,3,1,2560,0.0,1986,3040,35395,13215 days 16:47:18.659892,155,1.3333333333333333,0.0,-480,5951,2560.0
635000.0,4,2.25,1920,8910,1.0,4,8,1200,720.0,1969,2250,8800,19424 days 16:47:18.659892,350,1.7777777777777777,1.6666666666666667,-330,110,480.0
439000.0,4,2.25,2240,8300,2.0,3,8,2240,0.0,1978,2340,8500,16137 days 16:47:18.659892,282,1.7777777777777777,0.0,-100,-200,2240.0
300000.0,3,2.5,1260,3855,2.0,3,8,1260,0.0,1999,1310,3344,8467 days 16:47:18.659892,218,1.2,0.0,-50,511,1260.0
345000.0,3,1.5,1360,13496,1.0,4,8,1360,0.0,1960,1900,10538,22712 days 16:47:18.659892,036,2.0,0.0,-540,2958,1360.0
283500.0,4,2.25,2100,8050,2.0,3,8,2100,0.0,1978,2190,7700,16137 days 16:47:18.659892,224,1.7777777777777777,0.0,-90,350,2100.0
425000.0,2,1.0,2110,4920,1.5,3,7,1460,650.0,1911,1390,4732,40609 days 16:47:18.659892,267,2.0,2.246153846153846,720,188,810.0
685000.0,3,1.75,2210,8955,1.0,3,8,1560,650.0,1974,2210,8976,17598 days 16:47:18.659892,078,1.7142857142857142,2.4,0,-21,910.0
750000.0,3,2.5,2360,12987,2.0,3,8,2360,0.0,1983,2480,11665,14311 days 16:47:18.659892,111,1.2,0.0,-120,1322,2360.0
245000.0,4,1.5,1280,8000,1.0,3,6,1280,0.0,1960,1420,8211,22712 days 16:47:18.659892,106,2.6666666666666665,0.0,-140,-211,1280.0
585444.0,6,3.75,2740,6924,1.0,3,7,1640,1100.0,1962,1940,6000,21981 days 16:47:18.659892,093,1.6,1.490909090909091,800,924,540.0
706000.0,4,2.5,2740,7571,2.0,3,9,2740,0.0,2009,2880,7203,4814 days 16:47:18.659892,260,1.6,0.0,-140,368,2740.0
445000.0,4,2.0,2630,9099,1.5,3,7,1830,800.0,1944,1430,6825,28556 days 16:47:18.659892,213,2.0,2.2875,1200,2274,1030.0
241000.0,3,2.0,1650,6000,1.0,3,7,1650,0.0,1990,1870,6000,11754 days 16:47:18.659892,050,1.5,0.0,-220,0,1650.0
1180000.0,2,2.5,1770,7155,2.0,3,8,1770,0.0,1957,2410,10476,23807 days 16:47:18.659892,123,0.8,0.0,-640,-3321,1770.0
530000.0,3,1.0,1500,5750,1.5,4,7,1050,450.0,1927,1500,5060,34765 days 16:47:18.659892,037,3.0,2.3333333333333335,0,690,600.0
350000.0,3,1.5,1430,12199,1.0,3,7,1130,300.0,1948,1490,8196,27095 days 16:47:18.659892,061,2.0,3.7666666666666666,-60,4003,830.0
1700000.0,4,3.75,3190,17186,2.0,3,1,3190,0.0,1999,2290,13496,8467 days 16:47:18.659892,105,1.0666666666666667,0.0,900,3690,3190.0
389000.0,3,1.0,1280,9630,1.0,3,7,1280,0.0,1968,1300,9453,19790 days 16:47:18.659892,118,3.0,0.0,-20,177,1280.0
799000.0,4,2.75,2390,6820,2.0,4,7,2140,250.0,1945,1980,6820,28190 days 16:47:18.659892,309,1.4545454545454546,8.56,410,0,1890.0
1400000.0,4,2.5,4040,9630,1.0,4,9,2020,2020.0,1951,3160,8025,25999 days 16:47:18.659892,216,1.6,1.0,880,1605,0.0
340895.0,2,1.0,920,8612,1.0,5,7,920,0.0,1947,1500,7956,27460 days 16:47:18.659892,363,2.0,0.0,-580,656,920.0
780000.0,4,2.5,2730,10281,2.0,3,9,2730,0.0,1996,2750,7220,9563 days 16:47:18.659892,125,1.6,0.0,-20,3061,2730.0
350000.0,2,1.5,1320,73600,1.0,3,7,1320,0.0,1993,1320,33600,10658 days 16:47:18.659892,338,1.3333333333333333,0.0,0,40000,1320.0
470000.0,3,2.5,2620,4874,2.0,3,7,2620,0.0,1999,2360,4231,8467 days 16:47:18.659892,048,1.2,0.0,260,643,2620.0
914600.0,4,3.0,3180,80837,2.0,3,1,3180,0.0,1985,3180,38715,13580 days 16:47:18.659892,028,1.3333333333333333,0.0,0,42122,3180.0
354000.0,4,2.5,2900,4762,2.0,3,8,2900,0.0,2005,2900,5173,6275 days 16:47:18.659892,266,1.6,0.0,0,-411,2900.0
470000.0,5,2.0,1900,6000,1.5,4,6,1900,0.0,1920,2110,8400,37322 days 16:47:18.659892,057,2.5,0.0,-210,-2400,1900.0
715000.0,3,2.0,1760,5400,1.0,5,7,1160,600.0,1927,1640,5400,34765 days 16:47:18.659892,211,1.5,1.9333333333333333,120,0,560.0
265000.0,2,1.0,760,4000,1.0,4,6,760,0.0,1950,1640,4500,26364 days 16:47:18.659892,280,2.0,0.0,-880,-500,760.0
2540000.0,4,3.0,3710,20000,2.0,5,1,2760,950.0,1936,3970,20000,31478 days 16:47:18.659892,089,1.3333333333333333,2.905263157894737,-260,0,1810.0
640000.0,3,1.0,1530,4944,1.0,3,7,1530,0.0,1950,1500,4944,26364 days 16:47:18.659892,227,3.0,0.0,30,0,1530.0
290000.0,4,1.75,1990,18900,2.0,4,7,1870,120.0,1929,1710,12400,34034 days 16:47:18.659892,324,2.2857142857142856,15.583333333333334,280,6500,1750.0
480000.0,5,4.75,3830,35000,1.0,3,8,2130,1700.0,1976,2750,36150,16868 days 16:47:18.659892,133,1.0526315789473684,1.2529411764705882,1080,-1150,430.0
535000.0,3,2.0,2040,5600,1.0,5,7,1120,920.0,1954,2120,4958,24903 days 16:47:18.659892,238,1.5,1.2173913043478262,-80,642,200.0
907000.0,3,1.75,2170,12220,1.0,5,8,2170,0.0,1965,1980,9000,20885 days 16:47:18.659892,241,1.7142857142857142,0.0,190,3220,2170.0
459000.0,3,1.75,1620,7330,1.0,4,7,1090,530.0,1974,1380,7191,17598 days 16:47:18.659892,152,1.7142857142857142,2.056603773584906,240,139,560.0
1360000.0,3,2.5,3600,21399,1.0,3,9,2310,1290.0,1950,2830,17559,26364 days 16:47:18.659892,114,1.2,1.7906976744186047,770,3840,1020.0
264950.0,3,1.5,1470,11599,1.0,3,7,1070,400.0,1967,1580,9760,20155 days 16:47:18.659892,064,2.0,2.675,-110,1839,670.0
352950.0,3,1.0,1760,3000,1.5,1,6,1760,0.0,1900,1320,1266,44626 days 16:47:18.659892,311,3.0,0.0,440,1734,1760.0
491500.0,3,2.25,2230,13100,1.0,4,8,1510,720.0,1974,2010,10650,17598 days 16:47:18.659892,234,1.3333333333333333,2.0972222222222223,220,2450,790.0
1230000.0,4,3.5,3770,37034,2.0,3,1,2830,940.0,1989,3200,36342,12119 days 16:47:18.659892,176,1.1428571428571428,3.0106382978723403,570,692,1890.0
369500.0,3,1.0,1200,9194,1.0,4,7,1200,0.0,1952,1330,8650,25634 days 16:47:18.659892,096,3.0,0.0,-130,544,1200.0
566000.0,3,2.5,2090,6294,2.0,3,9,2090,0.0,2004,2520,5735,6641 days 16:47:18.659892,077,1.2,0.0,-430,559,2090.0
290000.0,3,2.25,1500,7308,1.0,4,7,1210,290.0,1968,1480,7400,19790 days 16:47:18.659892,237,1.3333333333333333,4.172413793103448,20,-92,920.0
5350000.0,5,5.0,8000,23985,2.0,3,1,6720,1280.0,2009,4600,21750,4814 days 16:47:18.659892,103,1.0,5.25,3400,2235,5440.0
180000.0,3,1.0,870,5330,1.0,3,6,870,0.0,1969,840,5200,19424 days 16:47:18.659892,142,3.0,0.0,30,130,870.0
215000.0,2,1.0,1010,6000,1.0,4,6,1010,0.0,1944,1610,7313,28556 days 16:47:18.659892,224,2.0,0.0,-600,-1313,1010.0
302000.0,2,1.0,1010,6000,1.0,4,6,1010,0.0,1944,1610,7313,28556 days 16:47:18.659892,043,2.0,0.0,-600,-1313,1010.0
352500.0,3,1.75,1860,7881,1.0,3,7,1160,700.0,1986,1490,7527,13215 days 16:47:18.659892,100,1.7142857142857142,1.6571428571428573,370,354,460.0
235867.0,4,2.0,1330,5926,1.0,4,5,1330,0.0,1942,1150,5485,29286 days 16:47:18.659892,177,2.0,0.0,180,441,1330.0
500000.0,3,2.25,1760,11946,2.0,3,8,1760,0.0,1978,2080,12068,16137 days 16:47:18.659892,198,1.3333333333333333,0.0,-320,-122,1760.0
382000.0,3,2.25,1800,4500,2.0,3,7,1800,0.0,1995,1760,6589,9928 days 16:47:18.659892,085,1.3333333333333333,0.0,40,-2089,1800.0
515000.0,5,2.5,1690,2402,1.5,3,7,990,700.0,1930,1200,4005,33669 days 16:47:18.659892,112,2.0,1.4142857142857144,490,-1603,290.0
250000.0,1,1.0,660,2600,1.0,3,6,660,0.0,1919,1560,5445,37687 days 16:47:18.659892,121,1.0,0.0,-900,-2845,660.0
672500.0,3,2.25,2400,5300,1.5,4,7,1250,1150.0,1939,1540,4800,30382 days 16:47:18.659892,178,1.3333333333333333,1.0869565217391304,860,500,100.0
755000.0,3,2.25,3020,13031,2.0,3,9,3020,0.0,1989,2480,10204,12119 days 16:47:18.659892,295,1.3333333333333333,0.0,540,2827,3020.0
707500.0,3,1.0,1500,2555,2.0,3,7,1500,0.0,1910,1820,2555,40974 days 16:47:18.659892,079,3.0,0.0,-320,0,1500.0
459000.0,4,2.0,1560,3840,1.0,4,6,960,600.0,1924,1560,4800,35861 days 16:47:18.659892,238,2.0,1.6,0,-960,360.0
140000.0,3,1.0,1090,10620,1.5,3,7,1090,0.0,1959,1380,10620,23077 days 16:47:18.659892,035,3.0,0.0,-290,0,1090.0
495000.0,2,1.0,970,4284,1.0,3,7,970,0.0,1905,2050,4284,42800 days 16:47:18.659892,223,2.0,0.0,-1080,0,970.0
757000.0,3,3.25,3190,5283,2.0,3,9,3190,0.0,2007,2950,5198,5545 days 16:47:18.659892,133,0.9230769230769231,0.0,240,85,3190.0
765000.0,3,3.25,3190,5283,2.0,3,9,3190,0.0,2007,2950,5198,5545 days 16:47:18.659892,007,0.9230769230769231,0.0,240,85,3190.0
359000.0,4,1.5,1890,6052,1.0,4,7,1890,0.0,1955,1510,6072,24538 days 16:47:18.659892,262,2.6666666666666665,0.0,380,-20,1890.0
440000.0,3,1.0,1050,7500,1.0,3,6,1050,0.0,1900,1380,7500,44626 days 16:47:18.659892,156,3.0,0.0,-330,0,1050.0
400000.0,4,1.5,1390,7200,1.0,3,7,1140,250.0,1965,1630,7702,20885 days 16:47:18.659892,149,2.6666666666666665,4.56,-240,-502,890.0
652000.0,3,2.0,1700,4080,1.0,4,7,850,850.0,1941,1480,5100,29651 days 16:47:18.659892,084,1.5,1.0,220,-1020,0.0
260000.0,3,1.75,1050,5850,1.0,3,7,1050,0.0,1980,1220,8880,15407 days 16:47:18.659892,150,1.7142857142857142,0.0,-170,-3030,1050.0
1330000.0,5,3.0,3340,10796,1.0,3,9,2120,1220.0,1964,3290,12955,21251 days 16:47:18.659892,110,1.6666666666666667,1.7377049180327868,50,-2159,900.0
519500.0,4,2.0,1540,17859,1.0,3,6,1540,0.0,1964,1390,9688,21251 days 16:47:18.659892,051,2.0,0.0,150,8171,1540.0
650000.0,3,1.0,1710,5992,1.5,4,7,1560,150.0,1928,1240,3001,34400 days 16:47:18.659892,300,3.0,10.4,470,2991,1410.0
280000.0,4,2.25,2100,8075,2.0,3,8,2100,0.0,1978,2100,7464,16137 days 16:47:18.659892,083,1.7777777777777777,0.0,0,611,2100.0
515000.0,4,1.75,1730,7980,1.0,4,8,1730,0.0,1965,2080,8400,20885 days 16:47:18.659892,253,2.2857142857142856,0.0,-350,-420,1730.0
400000.0,3,2.25,1500,2692,2.0,3,7,1500,0.0,1986,1470,2418,13215 days 16:47:18.659892,077,1.3333333333333333,0.0,30,274,1500.0
652100.0,3,2.5,2380,5017,2.0,3,9,2380,0.0,2003,2670,6066,7006 days 16:47:18.659892,104,1.2,0.0,-290,-1049,2380.0
701000.0,4,1.5,1840,10080,2.0,3,8,1840,0.0,1907,1830,5040,42070 days 16:47:18.659892,098,2.6666666666666665,0.0,10,5040,1840.0
640000.0,4,2.5,2341,9594,2.0,3,9,2341,0.0,1997,2850,9421,9197 days 16:47:18.659892,175,1.6,0.0,-509,173,2341.0
455800.0,3,2.5,1690,4584,2.0,3,7,1690,0.0,2002,1600,3164,7371 days 16:47:18.659892,209,1.2,0.0,90,1420,1690.0
504750.0,3,2.5,2490,21937,2.0,3,8,2490,0.0,1993,2450,21937,10658 days 16:47:18.659892,352,1.2,0.0,40,0,2490.0
483000.0,3,3.0,2440,15540,2.0,3,9,2440,0.0,1992,2440,15283,11024 days 16:47:18.659892,192,1.0,0.0,0,257,2440.0
530000.0,3,0.75,920,20412,1.0,5,6,920,0.0,1950,1162,54705,26364 days 16:47:18.659892,364,4.0,0.0,-242,-34293,920.0
250000.0,2,1.0,1030,8786,1.0,3,6,1030,0.0,1956,1480,8121,24173 days 16:47:18.659892,192,2.0,0.0,-450,665,1030.0
229950.0,5,2.75,2000,5885,1.0,3,7,1260,740.0,1994,1960,6514,10293 days 16:47:18.659892,267,1.8181818181818181,1.7027027027027026,40,-629,520.0
884744.0,4,3.5,4210,9414,2.0,3,9,4210,0.0,2001,3950,8880,7736 days 16:47:18.659892,204,1.1428571428571428,0.0,260,534,4210.0
514000.0,3,1.5,1610,9964,1.0,3,7,1080,530.0,1977,1610,9964,16502 days 16:47:18.659892,091,2.0,2.0377358490566038,0,0,550.0
532000.0,3,2.25,1910,35015,1.0,4,8,1430,480.0,1977,2340,36680,16502 days 16:47:18.659892,126,1.3333333333333333,2.9791666666666665,-430,-1665,950.0
423000.0,4,2.5,2660,5539,2.0,3,8,2660,0.0,2004,2380,5539,6641 days 16:47:18.659892,254,1.6,0.0,280,0,2660.0
420000.0,2,1.0,820,4025,1.0,5,6,820,0.0,1922,1410,5750,36591 days 16:47:18.659892,238,2.0,0.0,-590,-1725,820.0
521000.0,3,1.75,1730,18250,1.0,3,8,1730,0.0,1988,2180,10027,12485 days 16:47:18.659892,314,1.7142857142857142,0.0,-450,8223,1730.0
577000.0,4,2.25,2360,7490,2.0,3,8,2360,0.0,1979,2360,7490,15772 days 16:47:18.659892,036,1.7777777777777777,0.0,0,0,2360.0
425000.0,3,1.0,970,8040,1.0,3,7,970,0.0,1956,1250,7000,24173 days 16:47:18.659892,272,3.0,0.0,-280,1040,970.0
495000.0,4,2.5,2460,4862,2.0,3,8,2460,0.0,2004,2900,4895,6641 days 16:47:18.659892,304,1.6,0.0,-440,-33,2460.0
340000.0,3,2.5,2690,8577,2.0,3,9,2690,0.0,1987,2570,8066,12850 days 16:47:18.659892,274,1.2,0.0,120,511,2690.0
499950.0,3,3.5,1820,1991,2.0,3,8,1430,390.0,2014,1550,1460,2988 days 16:47:18.659892,266,0.8571428571428571,3.6666666666666665,270,531,1040.0
1220000.0,4,3.0,3470,4750,2.0,3,9,2370,1100.0,2014,2420,4761,2988 days 16:47:18.659892,075,1.3333333333333333,2.1545454545454548,1050,-11,1270.0
720000.0,4,2.75,3370,7634,1.0,5,8,2110,1260.0,1977,2460,7634,16502 days 16:47:18.659892,058,1.4545454545454546,1.6746031746031746,910,0,850.0
249000.0,3,1.5,1700,8247,1.0,3,7,1010,690.0,1970,1440,8400,19059 days 16:47:18.659892,071,2.0,1.463768115942029,260,-153,320.0
206135.0,3,1.0,1340,11070,1.0,4,7,1340,0.0,1978,1650,7630,16137 days 16:47:18.659892,164,3.0,0.0,-310,3440,1340.0
300000.0,5,2.75,2000,9276,2.0,4,7,2000,0.0,1968,1240,8270,19790 days 16:47:18.659892,279,1.8181818181818181,0.0,760,1006,2000.0
612000.0,6,3.0,3840,14040,1.5,3,8,2460,1380.0,1949,2170,6765,26729 days 16:47:18.659892,077,2.0,1.7826086956521738,1670,7275,1080.0
1100000.0,5,2.5,3890,27311,2.0,3,1,3890,0.0,1950,3160,22641,26364 days 16:47:18.659892,310,2.0,0.0,730,4670,3890.0
230000.0,4,2.0,1220,9100,1.5,4,7,1220,0.0,1970,1160,7700,19059 days 16:47:18.659892,055,2.0,0.0,60,1400,1220.0
850000.0,3,1.0,2280,4600,1.0,3,8,1250,1030.0,1936,1910,4000,31478 days 16:47:18.659892,124,3.0,1.2135922330097086,370,600,220.0
355000.0,4,2.5,2770,7000,1.0,4,7,1940,830.0,1979,2140,7684,15772 days 16:47:18.659892,268,1.6,2.3373493975903616,630,-684,1110.0
442000.0,4,2.5,2520,7253,2.0,3,9,2520,0.0,1990,2570,8359,11754 days 16:47:18.659892,174,1.6,0.0,-50,-1106,2520.0
399000.0,4,3.0,3060,5000,2.0,3,8,3060,0.0,2001,3060,5668,7736 days 16:47:18.659892,177,1.3333333333333333,0.0,0,-668,3060.0
360000.0,4,2.5,2390,7115,2.0,3,9,2390,0.0,1999,2600,7916,8467 days 16:47:18.659892,310,1.6,0.0,-210,-801,2390.0
390000.0,3,1.75,1320,7725,1.0,3,8,1320,0.0,1978,2020,7210,16137 days 16:47:18.659892,044,1.7142857142857142,0.0,-700,515,1320.0
413000.0,5,2.5,2900,8711,1.0,3,8,1650,1250.0,1977,2340,8869,16502 days 16:47:18.659892,077,2.0,1.32,560,-158,400.0
190000.0,2,1.0,700,9500,1.0,3,6,700,0.0,1951,1020,5617,25999 days 16:47:18.659892,042,2.0,0.0,-320,3883,700.0
432900.0,3,2.5,2210,9226,2.0,3,8,2210,0.0,1998,2430,8902,8832 days 16:47:18.659892,286,1.2,0.0,-220,324,2210.0
621138.0,3,2.25,2180,7741,2.0,3,9,2180,0.0,1986,2300,8581,13215 days 16:47:18.659892,148,1.3333333333333333,0.0,-120,-840,2180.0
270000.0,3,2.25,2080,4252,1.5,3,7,1550,530.0,2003,2080,2275,7006 days 16:47:18.659892,155,1.3333333333333333,2.9245283018867925,0,1977,1020.0
610000.0,4,2.25,2090,35040,1.0,3,8,1490,600.0,1980,2910,21132,15407 days 16:47:18.659892,009,1.7777777777777777,2.4833333333333334,-820,13908,890.0
500000.0,3,2.0,1720,5525,1.0,5,7,960,760.0,1941,1760,5525,29651 days 16:47:18.659892,153,1.5,1.263157894736842,-40,0,200.0
715000.0,4,2.25,2460,40635,1.0,5,8,2460,0.0,1968,2250,40635,19790 days 16:47:18.659892,219,1.7777777777777777,0.0,210,0,2460.0
264000.0,3,1.5,1470,14821,1.0,4,7,1470,0.0,1958,1760,15370,23442 days 16:47:18.659892,149,2.0,0.0,-290,-549,1470.0
550000.0,3,1.75,1650,3200,1.5,3,8,1650,0.0,1901,1500,2400,44261 days 16:47:18.659892,240,1.7142857142857142,0.0,150,800,1650.0
337000.0,3,2.0,1690,9087,1.0,3,8,1690,0.0,1997,2090,8100,9197 days 16:47:18.659892,288,1.5,0.0,-400,987,1690.0
170000.0,3,1.0,970,8710,1.0,4,6,970,0.0,1962,1280,11805,21981 days 16:47:18.659892,133,3.0,0.0,-310,-3095,970.0
405000.0,4,2.5,2030,9095,1.0,4,7,1130,900.0,1972,1940,8000,18329 days 16:47:18.659892,241,1.6,1.2555555555555555,90,1095,230.0
775000.0,4,2.5,2540,28563,1.0,3,1,2540,0.0,1984,2790,20301,13946 days 16:47:18.659892,254,1.6,0.0,-250,8262,2540.0
425000.0,3,2.25,1570,7475,1.0,4,7,1200,370.0,1983,1700,7230,14311 days 16:47:18.659892,237,1.3333333333333333,3.2432432432432434,-130,245,830.0
713000.0,5,2.75,2580,9242,2.0,4,8,1720,860.0,1967,2240,9316,20155 days 16:47:18.659892,265,1.8181818181818181,2.0,340,-74,860.0
555000.0,5,2.5,2090,8712,1.0,3,8,1420,670.0,1966,2490,8712,20520 days 16:47:18.659892,307,2.0,2.1194029850746268,-400,0,750.0
810000.0,4,2.5,3260,5608,2.0,3,9,3260,0.0,2003,3010,5608,7006 days 16:47:18.659892,126,1.6,0.0,250,0,3260.0
1250000.0,4,3.75,3830,41263,2.0,4,1,3830,0.0,1990,5600,56568,11754 days 16:47:18.659892,239,1.0666666666666667,0.0,-1770,-15305,3830.0
819000.0,3,3.5,2130,6150,2.0,5,8,1530,600.0,1908,2040,5381,41705 days 16:47:18.659892,175,0.8571428571428571,2.55,90,769,930.0
409900.0,3,2.5,1690,1200,2.0,3,8,1410,280.0,2013,1690,1760,3353 days 16:47:18.659892,086,1.2,5.035714285714286,0,-560,1130.0
935000.0,2,2.5,1780,2067,2.0,5,9,1780,0.0,1974,2320,2067,17598 days 16:47:18.659892,181,0.8,0.0,-540,0,1780.0
657500.0,4,1.75,1620,7560,1.0,4,7,1380,240.0,1947,2170,8650,27460 days 16:47:18.659892,110,2.2857142857142856,5.75,-550,-1090,1140.0
900000.0,6,3.75,4210,6105,2.0,3,9,3280,930.0,2008,3820,6368,5180 days 16:47:18.659892,118,1.6,3.5268817204301075,390,-263,2350.0
932800.0,5,3.25,2980,7095,2.5,3,9,2980,0.0,1998,1670,7140,8832 days 16:47:18.659892,092,1.5384615384615385,0.0,1310,-45,2980.0
391000.0,3,2.0,1490,9000,1.0,4,8,1490,0.0,1977,2190,9000,16502 days 16:47:18.659892,110,1.5,0.0,-700,0,1490.0
420000.0,4,2.5,2110,9825,2.0,3,8,2110,0.0,2000,1650,9900,8102 days 16:47:18.659892,364,1.6,0.0,460,-75,2110.0
1300000.0,6,3.5,6563,32670,2.0,3,1,5153,1410.0,2002,2610,22651,7371 days 16:47:18.659892,328,1.7142857142857142,3.6546099290780143,3953,10019,3743.0
415000.0,3,1.5,1510,16800,1.0,5,8,1510,0.0,1956,1560,7276,24173 days 16:47:18.659892,099,2.0,0.0,-50,9524,1510.0
350000.0,3,1.75,1830,9425,1.0,3,8,1590,240.0,1946,1670,8430,27825 days 16:47:18.659892,056,1.7142857142857142,6.625,160,995,1350.0
375000.0,2,1.0,1230,1820,2.0,4,7,830,400.0,1948,1660,3056,27095 days 16:47:18.659892,172,2.0,2.075,-430,-1236,430.0
860000.0,3,1.75,2180,14135,1.0,5,8,1300,880.0,1947,3540,10318,27460 days 16:47:18.659892,321,1.7142857142857142,1.4772727272727273,-1360,3817,420.0
495000.0,4,2.25,2220,8872,1.0,4,8,1110,1110.0,1961,2220,9106,22346 days 16:47:18.659892,154,1.7777777777777777,1.0,0,-234,0.0
250000.0,4,2.25,1730,8400,1.0,3,7,1730,0.0,1962,1550,7920,21981 days 16:47:18.659892,104,1.7777777777777777,0.0,180,480,1730.0
365000.0,4,2.25,1990,21312,1.0,4,8,1990,0.0,1968,2400,19210,19790 days 16:47:18.659892,286,1.7777777777777777,0.0,-410,2102,1990.0
503000.0,3,2.75,1540,6760,1.0,5,7,1210,330.0,1980,1540,7416,15407 days 16:47:18.659892,127,1.0909090909090908,3.6666666666666665,0,-656,880.0
150000.0,2,1.0,1100,7200,1.0,4,6,1100,0.0,1944,1390,7200,28556 days 16:47:18.659892,084,2.0,0.0,-290,0,1100.0
450000.0,4,1.75,1640,1480,1.0,4,7,820,820.0,1912,1420,2342,40244 days 16:47:18.659892,281,2.2857142857142856,1.0,220,-862,0.0
355000.0,4,3.0,2590,7213,2.0,3,8,2590,0.0,2001,2550,6800,7736 days 16:47:18.659892,342,1.3333333333333333,0.0,40,413,2590.0
245000.0,3,2.0,1450,9333,2.0,4,7,1450,0.0,1972,1910,7701,18329 days 16:47:18.659892,291,1.5,0.0,-460,1632,1450.0
265900.0,3,2.0,1180,7793,1.0,4,7,1180,0.0,1992,1720,7793,11024 days 16:47:18.659892,184,1.5,0.0,-540,0,1180.0
299000.0,4,2.5,1820,7575,1.0,3,7,1220,600.0,1975,1840,7650,17233 days 16:47:18.659892,329,1.6,2.033333333333333,-20,-75,620.0
957500.0,4,2.25,2360,11523,2.0,4,1,2360,0.0,1968,2850,11362,19790 days 16:47:18.659892,099,1.7777777777777777,0.0,-490,161,2360.0
343000.0,3,1.0,1120,7250,1.0,4,7,1120,0.0,1972,1340,7302,18329 days 16:47:18.659892,251,3.0,0.0,-220,-52,1120.0
307500.0,3,2.25,1646,7364,2.0,3,7,1646,0.0,1994,1975,9161,10293 days 16:47:18.659892,300,1.3333333333333333,0.0,-329,-1797,1646.0
937500.0,5,3.75,4210,14599,2.0,3,1,4210,0.0,2004,3950,13591,6641 days 16:47:18.659892,005,1.3333333333333333,0.0,260,1008,4210.0
610000.0,3,3.0,2480,45302,1.0,4,8,1620,860.0,1976,1260,14100,16868 days 16:47:18.659892,129,1.0,1.8837209302325582,1220,31202,760.0
720000.0,3,1.5,1590,7080,1.0,3,8,1310,280.0,1952,2080,7200,25634 days 16:47:18.659892,260,2.0,4.678571428571429,-490,-120,1030.0
434500.0,3,1.75,1650,7965,1.0,4,7,1650,0.0,1967,1560,7350,20155 days 16:47:18.659892,090,1.7142857142857142,0.0,90,615,1650.0
602500.0,2,2.5,3090,47044,1.0,4,1,2250,840.0,1979,1860,62829,15772 days 16:47:18.659892,132,0.8,2.6785714285714284,1230,-15785,1410.0
607010.0,4,2.5,2180,4000,2.0,3,8,1700,480.0,2002,2180,4000,7371 days 16:47:18.659892,322,1.6,3.5416666666666665,0,0,1220.0
610000.0,3,1.0,1800,5750,1.0,3,7,1040,760.0,1947,1320,5625,27460 days 16:47:18.659892,035,3.0,1.368421052631579,480,125,280.0
828500.0,4,2.5,3720,35000,2.0,3,1,3720,0.0,1983,3720,35000,14311 days 16:47:18.659892,262,1.6,0.0,0,0,3720.0
199990.0,3,1.0,1100,8560,1.0,3,6,1100,0.0,1961,1120,8470,22346 days 16:47:18.659892,188,3.0,0.0,-20,90,1100.0
294000.0,3,1.75,1530,9362,1.0,3,7,1530,0.0,1987,1480,8125,12850 days 16:47:18.659892,091,1.7142857142857142,0.0,50,1237,1530.0
789500.0,4,2.5,3010,6100,2.0,3,9,3010,0.0,2005,2890,5176,6275 days 16:47:18.659892,163,1.6,0.0,120,924,3010.0
797000.0,3,3.5,3500,9473,2.0,3,1,3500,0.0,2008,3510,7833,5180 days 16:47:18.659892,043,0.8571428571428571,0.0,-10,1640,3500.0
539950.0,5,3.0,3100,5250,2.0,3,7,3100,0.0,2006,2460,5250,5910 days 16:47:18.659892,230,1.6666666666666667,0.0,640,0,3100.0
284950.0,4,1.5,2000,6778,1.0,4,7,1170,830.0,1962,1940,7531,21981 days 16:47:18.659892,082,2.6666666666666665,1.4096385542168675,60,-753,340.0
776500.0,4,1.5,2290,10372,1.0,3,7,1510,780.0,1965,1900,8109,20885 days 16:47:18.659892,119,2.6666666666666665,1.935897435897436,390,2263,730.0
525000.0,4,2.5,2400,10070,1.0,3,7,1510,890.0,1967,2030,9964,20155 days 16:47:18.659892,114,1.6,1.696629213483146,370,106,620.0
303000.0,3,2.5,1850,4957,2.0,3,8,1850,0.0,1999,2400,6367,8467 days 16:47:18.659892,115,1.2,0.0,-550,-1410,1850.0
722080.0,3,3.25,3680,7650,2.0,3,9,2340,1340.0,1988,2280,8515,12485 days 16:47:18.659892,069,0.9230769230769231,1.7462686567164178,1400,-865,1000.0
140000.0,3,1.0,1060,7473,1.0,3,7,1060,0.0,1959,1320,7912,23077 days 16:47:18.659892,178,3.0,0.0,-260,-439,1060.0
235000.0,3,1.0,1060,7473,1.0,3,7,1060,0.0,1959,1320,7912,23077 days 16:47:18.659892,091,3.0,0.0,-260,-439,1060.0
440000.0,3,1.0,1610,5500,1.5,3,7,1610,0.0,1903,1200,5701,43531 days 16:47:18.659892,324,3.0,0.0,410,-201,1610.0
605000.0,3,1.75,2330,6000,1.5,4,7,1630,700.0,1940,1600,4000,30017 days 16:47:18.659892,199,1.7142857142857142,2.3285714285714287,730,2000,930.0
380000.0,2,1.0,1210,4800,1.0,3,8,1060,150.0,1950,1380,4800,26364 days 16:47:18.659892,153,2.0,7.066666666666666,-170,0,910.0
352000.0,4,1.0,1530,8890,1.0,3,7,980,550.0,1925,1100,5203,35495 days 16:47:18.659892,176,4.0,1.7818181818181817,430,3687,430.0
420000.0,4,2.25,2270,12000,1.0,4,7,1360,910.0,1979,2500,10120,15772 days 16:47:18.659892,103,1.7777777777777777,1.4945054945054945,-230,1880,450.0
1180000.0,4,2.0,2590,7220,2.0,4,1,2590,0.0,1930,2530,6380,33669 days 16:47:18.659892,120,2.0,0.0,60,840,2590.0
1380000.0,3,1.5,1850,10572,1.0,4,8,1850,0.0,1953,3030,12752,25268 days 16:47:18.659892,295,2.0,0.0,-1180,-2180,1850.0
300000.0,3,1.5,1500,14750,1.5,4,6,1500,0.0,1933,1270,15100,32573 days 16:47:18.659892,269,2.0,0.0,230,-350,1500.0
1150000.0,4,3.25,4740,49091,2.0,3,1,4740,0.0,1990,4800,42387,11754 days 16:47:18.659892,316,1.2307692307692308,0.0,-60,6704,4740.0
453500.0,2,1.5,1710,4189,1.0,5,7,1160,550.0,1951,1530,5608,25999 days 16:47:18.659892,286,1.3333333333333333,2.109090909090909,180,-1419,610.0
443500.0,3,2.0,1920,7598,1.0,4,8,1920,0.0,1972,2220,7598,18329 days 16:47:18.659892,287,1.5,0.0,-300,0,1920.0
332000.0,2,1.0,1150,8138,1.0,3,7,1150,0.0,1954,1300,8139,24903 days 16:47:18.659892,085,2.0,0.0,-150,-1,1150.0
655000.0,3,2.5,2320,4721,2.0,3,8,2320,0.0,2004,2250,4356,6641 days 16:47:18.659892,086,1.2,0.0,70,365,2320.0
475000.0,4,1.0,1420,6000,1.5,3,7,1420,0.0,1950,1420,6180,26364 days 16:47:18.659892,246,4.0,0.0,0,-180,1420.0
372500.0,3,1.75,1550,12956,1.0,3,7,1210,340.0,1988,1630,15360,12485 days 16:47:18.659892,297,1.7142857142857142,3.5588235294117645,-80,-2404,870.0
1050000.0,4,2.5,2920,7200,1.0,3,8,1470,1450.0,1921,3210,6825,36956 days 16:47:18.659892,147,1.6,1.013793103448276,-290,375,20.0
500000.0,3,1.75,1620,4200,1.0,5,7,830,790.0,1945,1580,5000,28190 days 16:47:18.659892,154,1.7142857142857142,1.0506329113924051,40,-800,40.0
900000.0,6,2.75,2300,24773,1.5,4,9,2300,0.0,1950,2720,11740,26364 days 16:47:18.659892,148,2.1818181818181817,0.0,-420,13033,2300.0
327500.0,3,1.0,1070,7140,1.0,3,7,1070,0.0,1989,1390,2374,12119 days 16:47:18.659892,155,3.0,0.0,-320,4766,1070.0
390000.0,3,1.75,1790,7123,1.0,3,7,1790,0.0,1913,1660,8128,39878 days 16:47:18.659892,096,1.7142857142857142,0.0,130,-1005,1790.0
451101.0,2,1.5,1510,1962,2.0,4,8,1510,0.0,1985,1510,2182,13580 days 16:47:18.659892,013,1.3333333333333333,0.0,0,-220,1510.0
455000.0,4,1.0,1340,5800,1.5,3,7,1340,0.0,1914,1900,5800,39513 days 16:47:18.659892,287,4.0,0.0,-560,0,1340.0
650000.0,4,2.5,3350,46748,2.0,3,1,3350,0.0,2004,3350,39683,6641 days 16:47:18.659892,182,1.6,0.0,0,7065,3350.0
895000.0,3,2.5,2500,7746,2.0,4,1,1910,590.0,1993,2480,5099,10658 days 16:47:18.659892,218,1.2,3.23728813559322,20,2647,1320.0
703770.0,4,2.25,2550,12918,2.0,3,9,2550,0.0,1987,2550,11036,12850 days 16:47:18.659892,317,1.7777777777777777,0.0,0,1882,2550.0
249950.0,3,1.75,1320,10454,1.0,4,7,1320,0.0,1968,1680,10183,19790 days 16:47:18.659892,226,1.7142857142857142,0.0,-360,271,1320.0
512000.0,2,2.0,1270,3881,1.0,4,6,610,660.0,1926,1370,5000,35130 days 16:47:18.659892,118,1.0,0.9242424242424242,-100,-1119,-50.0
780000.0,5,2.5,3480,74052,1.0,4,8,1980,1500.0,1972,2610,65775,18329 days 16:47:18.659892,126,2.0,1.32,870,8277,480.0
336000.0,3,2.25,2820,11625,2.0,3,8,2820,0.0,1986,2290,8488,13215 days 16:47:18.659892,197,1.3333333333333333,0.0,530,3137,2820.0
285000.0,3,2.0,2110,6900,1.5,5,6,1220,890.0,1955,1350,7683,24538 days 16:47:18.659892,234,1.5,1.3707865168539326,760,-783,330.0
229900.0,3,1.75,1100,7224,1.0,3,7,1100,0.0,1981,1700,8447,15041 days 16:47:18.659892,294,1.7142857142857142,0.0,-600,-1223,1100.0
667500.0,4,3.0,1920,4000,1.5,4,8,1540,380.0,1931,1660,4000,33304 days 16:47:18.659892,105,1.3333333333333333,4.052631578947368,260,0,1160.0
378000.0,4,2.5,1890,12236,1.0,3,7,1230,660.0,1978,1390,11360,16137 days 16:47:18.659892,171,1.6,1.8636363636363635,500,876,570.0
454000.0,3,2.5,2530,43733,2.0,3,8,1530,1000.0,1991,1730,43548,11389 days 16:47:18.659892,248,1.2,1.53,800,185,530.0
537500.0,4,2.5,2550,4630,2.0,3,7,2550,0.0,2005,2550,5151,6275 days 16:47:18.659892,128,1.6,0.0,0,-521,2550.0
425000.0,3,1.0,1550,4160,1.5,4,6,1550,0.0,1926,1590,5000,35130 days 16:47:18.659892,246,3.0,0.0,-40,-840,1550.0
290000.0,3,2.0,1760,6600,1.0,3,7,1760,0.0,1998,2590,6600,8832 days 16:47:18.659892,328,1.5,0.0,-830,0,1760.0
349500.0,3,2.0,1270,3600,1.0,3,7,1270,0.0,1963,1660,3600,21616 days 16:47:18.659892,182,1.5,0.0,-390,0,1270.0
370000.0,3,2.75,1250,1655,2.0,3,7,830,420.0,2006,1520,3001,5910 days 16:47:18.659892,336,1.0909090909090908,1.9761904761904763,-270,-1346,410.0
549500.0,3,1.75,1620,8438,1.0,4,8,1620,0.0,1961,2040,9450,22346 days 16:47:18.659892,068,1.7142857142857142,0.0,-420,-1012,1620.0
245000.0,2,1.0,710,6322,1.0,3,6,710,0.0,1942,740,6720,29286 days 16:47:18.659892,030,2.0,0.0,-30,-398,710.0
208000.0,3,1.75,1070,7200,1.0,3,7,1070,0.0,1994,1480,7200,10293 days 16:47:18.659892,210,1.7142857142857142,0.0,-410,0,1070.0
248000.0,4,2.25,2320,8760,1.0,4,8,1160,1160.0,1966,1970,8690,20520 days 16:47:18.659892,354,1.7777777777777777,1.0,350,70,0.0
610000.0,4,3.25,5450,37058,1.5,5,9,5450,0.0,1984,2800,35716,13946 days 16:47:18.659892,276,1.2307692307692308,0.0,2650,1342,5450.0
550000.0,4,2.5,1670,5116,2.0,3,8,1670,0.0,1999,1910,7210,8467 days 16:47:18.659892,091,1.6,0.0,-240,-2094,1670.0
750000.0,3,2.75,3010,206910,2.0,3,1,3010,0.0,2001,1580,120675,7736 days 16:47:18.659892,301,1.0909090909090908,0.0,1430,86235,3010.0
192000.0,2,1.75,1340,7380,1.0,3,6,1340,0.0,1940,1980,9600,30017 days 16:47:18.659892,303,1.1428571428571428,0.0,-640,-2220,1340.0
169317.0,2,1.0,790,4000,1.0,3,7,790,0.0,1908,1700,4200,41705 days 16:47:18.659892,049,2.0,0.0,-910,-200,790.0
1200000.0,4,3.5,3400,3850,2.5,3,1,2790,610.0,2008,2030,4000,5180 days 16:47:18.659892,182,1.1428571428571428,4.573770491803279,1370,-150,2180.0
880000.0,2,1.0,1530,6350,1.5,4,7,1530,0.0,1923,2640,6350,36226 days 16:47:18.659892,302,2.0,0.0,-1110,0,1530.0
210000.0,1,1.0,930,7129,1.0,3,6,930,0.0,1948,1300,8075,27095 days 16:47:18.659892,168,1.0,0.0,-370,-946,930.0
180500.0,3,1.5,1540,9800,1.0,3,7,1010,530.0,1973,1600,8250,17963 days 16:47:18.659892,007,2.0,1.9056603773584906,-60,1550,480.0
540000.0,4,2.0,1990,29078,2.0,3,9,1990,0.0,1984,2310,28353,13946 days 16:47:18.659892,209,2.0,0.0,-320,725,1990.0
520000.0,3,1.75,2300,35722,1.0,3,9,2300,0.0,1984,2600,34798,13946 days 16:47:18.659892,175,1.7142857142857142,0.0,-300,924,2300.0
177500.0,3,1.5,1220,6000,1.0,3,7,1220,0.0,1968,1660,6000,19790 days 16:47:18.659892,177,2.0,0.0,-440,0,1220.0
415000.0,3,1.75,2380,5650,1.0,4,8,1190,1190.0,1956,2350,6554,24173 days 16:47:18.659892,309,1.7142857142857142,1.0,30,-904,0.0
495000.0,4,2.5,2020,7200,1.0,5,7,1010,1010.0,1968,1620,7275,19790 days 16:47:18.659892,252,1.6,1.0,400,-75,0.0
325000.0,3,2.25,1890,9646,1.0,3,8,1890,0.0,1966,1580,9488,20520 days 16:47:18.659892,063,1.3333333333333333,0.0,310,158,1890.0
440000.0,2,1.75,1330,4903,1.0,3,7,1330,0.0,1985,1470,2735,13580 days 16:47:18.659892,051,1.1428571428571428,0.0,-140,2168,1330.0
411000.0,3,1.75,1490,9844,1.0,4,7,1190,300.0,1959,1840,10150,23077 days 16:47:18.659892,204,1.7142857142857142,3.966666666666667,-350,-306,890.0
810000.0,5,3.5,3550,9600,2.0,3,9,2550,1000.0,1998,2030,9600,8832 days 16:47:18.659892,302,1.4285714285714286,2.55,1520,0,1550.0
561750.0,5,1.75,2040,8996,1.0,4,7,1020,1020.0,1962,1950,8270,21981 days 16:47:18.659892,289,2.857142857142857,1.0,90,726,0.0
835100.0,4,2.5,2380,12573,1.0,4,9,2380,0.0,1963,2900,10700,21616 days 16:47:18.659892,203,1.6,0.0,-520,1873,2380.0
450000.0,3,2.25,1780,9969,1.0,3,8,1450,330.0,1985,1950,7974,13580 days 16:47:18.659892,244,1.3333333333333333,4.393939393939394,-170,1995,1120.0
238000.0,3,2.5,1650,2807,2.0,3,7,1650,0.0,2004,1460,1875,6641 days 16:47:18.659892,308,1.2,0.0,190,932,1650.0
299000.0,3,1.0,1510,142803,1.0,3,7,1510,0.0,1974,1330,46609,17598 days 16:47:18.659892,339,3.0,0.0,180,96194,1510.0
570000.0,2,1.0,1100,6240,1.0,4,7,1100,0.0,1941,1250,6240,29651 days 16:47:18.659892,290,2.0,0.0,-150,0,1100.0
340000.0,3,1.75,2190,12626,2.0,4,8,2190,0.0,1978,3110,14592,16137 days 16:47:18.659892,155,1.7142857142857142,0.0,-920,-1966,2190.0
450000.0,2,1.75,1760,2275,1.5,3,6,1040,720.0,1912,1380,3750,40244 days 16:47:18.659892,119,1.1428571428571428,1.4444444444444444,380,-1475,320.0
272750.0,4,1.5,1800,8786,1.0,3,7,1330,470.0,1966,1780,8664,20520 days 16:47:18.659892,253,2.6666666666666665,2.8297872340425534,20,122,860.0
520000.0,4,2.0,2000,6380,2.0,4,6,1860,140.0,1949,1600,6380,26729 days 16:47:18.659892,205,2.0,13.285714285714286,400,0,1720.0
284950.0,3,1.0,990,10723,1.0,5,7,990,0.0,1960,1460,10723,22712 days 16:47:18.659892,169,3.0,0.0,-470,0,990.0
255000.0,2,1.5,1480,9660,1.0,3,7,1480,0.0,1949,1990,9660,26729 days 16:47:18.659892,114,1.3333333333333333,0.0,-510,0,1480.0
231500.0,2,1.0,1200,9488,1.0,5,7,1200,0.0,1941,1200,9488,29651 days 16:47:18.659892,316,2.0,0.0,0,0,1200.0
415000.0,1,2.0,3000,204732,2.5,3,8,3000,0.0,1979,2330,213008,15772 days 16:47:18.659892,344,0.5,0.0,670,-8276,3000.0
330000.0,4,2.5,3504,6000,2.0,3,7,3504,0.0,2006,2790,5231,5910 days 16:47:18.659892,005,1.6,0.0,714,769,3504.0
365000.0,3,1.5,1300,12240,1.0,3,7,1300,0.0,1963,2040,9326,21616 days 16:47:18.659892,148,2.0,0.0,-740,2914,1300.0
425000.0,4,2.0,1330,9188,1.5,3,7,1330,0.0,1928,1770,10419,34400 days 16:47:18.659892,280,2.0,0.0,-440,-1231,1330.0
400000.0,4,1.75,1850,6480,1.0,4,7,1120,730.0,1958,1610,5040,23442 days 16:47:18.659892,308,2.2857142857142856,1.5342465753424657,240,1440,390.0
335000.0,4,2.5,2240,9701,2.0,3,9,2240,0.0,1989,2240,9410,12119 days 16:47:18.659892,265,1.6,0.0,0,291,2240.0
342000.0,3,3.0,1260,1251,2.0,3,7,1040,220.0,2003,1780,7715,7006 days 16:47:18.659892,273,1.0,4.7272727272727275,-520,-6464,820.0
490000.0,8,5.0,2800,2580,2.0,3,8,1880,920.0,1997,1800,2580,9197 days 16:47:18.659892,338,1.6,2.0434782608695654,1000,0,960.0
331500.0,4,1.75,1820,14319,1.0,4,7,1820,0.0,1969,1440,10018,19424 days 16:47:18.659892,310,2.2857142857142856,0.0,380,4301,1820.0
960000.0,3,2.5,1730,4102,3.0,3,8,1730,0.0,1996,2340,16994,9563 days 16:47:18.659892,089,1.2,0.0,-610,-12892,1730.0
720500.0,4,2.5,3350,35298,2.0,4,9,3350,0.0,1985,2620,35604,13580 days 16:47:18.659892,190,1.6,0.0,730,-306,3350.0
662990.0,3,1.75,1240,3600,1.5,5,7,1240,0.0,1926,1660,3600,35130 days 16:47:18.659892,143,1.7142857142857142,0.0,-420,0,1240.0
220000.0,4,2.0,2340,10507,1.5,4,6,2340,0.0,1959,990,10507,23077 days 16:47:18.659892,089,2.0,0.0,1350,0,2340.0
349950.0,5,2.0,1880,4179,1.0,3,7,940,940.0,1952,1350,5150,25634 days 16:47:18.659892,008,2.5,1.0,530,-971,0.0
550000.0,3,2.0,1810,2159,1.0,3,7,1010,800.0,1922,1810,2159,36591 days 16:47:18.659892,007,1.5,1.2625,0,0,210.0
396000.0,3,1.75,2340,5668,1.0,4,6,1200,1140.0,1941,860,4800,29651 days 16:47:18.659892,258,1.7142857142857142,1.0526315789473684,1480,868,60.0
635000.0,4,1.5,2820,4000,2.0,3,7,2820,0.0,1911,1470,1627,40609 days 16:47:18.659892,016,2.6666666666666665,0.0,1350,2373,2820.0
339000.0,3,2.25,2090,10120,1.0,4,7,1290,800.0,1979,1820,7983,15772 days 16:47:18.659892,192,1.3333333333333333,1.6125,270,2137,490.0
285000.0,4,2.25,1830,8734,2.0,4,7,1830,0.0,1991,1870,7212,11389 days 16:47:18.659892,181,1.7777777777777777,0.0,-40,1522,1830.0
775000.0,6,2.75,2980,5000,1.5,3,7,2480,500.0,1916,1470,5000,38783 days 16:47:18.659892,191,2.1818181818181817,4.96,1510,0,1980.0
224000.0,4,1.5,1600,9289,1.0,4,7,1600,0.0,1959,1540,9918,23077 days 16:47:18.659892,177,2.6666666666666665,0.0,60,-629,1600.0
2250000.0,4,3.5,4440,8125,2.0,5,1,3140,1300.0,1922,3990,8505,36591 days 16:47:18.659892,302,1.1428571428571428,2.4153846153846152,450,-380,1840.0
165050.0,3,1.0,1200,8514,1.0,3,7,1200,0.0,1959,1210,8985,23077 days 16:47:18.659892,182,3.0,0.0,-10,-471,1200.0
275000.0,3,1.25,1230,4500,1.5,4,7,1230,0.0,1913,1310,5000,39878 days 16:47:18.659892,300,2.4,0.0,-80,-500,1230.0
445000.0,5,3.0,2930,5500,1.0,3,7,1750,1180.0,1951,1400,5500,25999 days 16:47:18.659892,254,1.6666666666666667,1.4830508474576272,1530,0,570.0
510000.0,3,2.25,2370,38639,1.0,3,8,1930,440.0,1978,2900,37452,16137 days 16:47:18.659892,091,1.3333333333333333,4.386363636363637,-530,1187,1490.0
1230000.0,4,2.5,3040,7000,2.0,3,9,3040,0.0,2001,2320,17511,7736 days 16:47:18.659892,161,1.6,0.0,720,-10511,3040.0
390000.0,3,1.5,1610,13500,1.0,3,7,1060,550.0,1970,1540,11479,19059 days 16:47:18.659892,302,2.0,1.9272727272727272,70,2021,510.0
460000.0,3,2.25,2350,10450,1.0,3,8,1390,960.0,1977,2250,10450,16502 days 16:47:18.659892,133,1.3333333333333333,1.4479166666666667,100,0,430.0
700000.0,3,1.75,2000,14733,1.0,4,8,2000,0.0,1958,2620,14733,23442 days 16:47:18.659892,086,1.7142857142857142,0.0,-620,0,2000.0
874150.0,4,3.5,3530,14406,2.0,3,1,2570,960.0,1987,3170,15181,12850 days 16:47:18.659892,173,1.1428571428571428,2.6770833333333335,360,-775,1610.0
470000.0,3,2.25,2220,9800,2.0,3,8,2220,0.0,1987,2420,10232,12850 days 16:47:18.659892,212,1.3333333333333333,0.0,-200,-432,2220.0
374000.0,3,1.75,2000,9416,1.0,4,6,2000,0.0,1961,1440,9555,22346 days 16:47:18.659892,141,1.7142857142857142,0.0,560,-139,2000.0
510000.0,2,1.75,1210,131115,1.5,5,7,1210,0.0,1950,2020,185565,26364 days 16:47:18.659892,198,1.1428571428571428,0.0,-810,-54450,1210.0
467000.0,2,2.5,1140,1181,3.0,3,8,1140,0.0,2007,1220,1189,5545 days 16:47:18.659892,192,0.8,0.0,-80,-8,1140.0
576000.0,4,2.5,2440,28405,2.0,3,8,2440,0.0,2002,2480,11429,7371 days 16:47:18.659892,167,1.6,0.0,-40,16976,2440.0
196440.0,3,2.0,1560,7352,1.0,3,6,1560,0.0,1992,1120,7950,11024 days 16:47:18.659892,150,1.5,0.0,440,-598,1560.0
825000.0,4,2.5,3210,18901,2.0,3,1,3210,0.0,1993,3330,18901,10658 days 16:47:18.659892,365,1.6,0.0,-120,0,3210.0
281000.0,2,1.0,930,2600,1.0,3,7,930,0.0,1981,1370,3488,15041 days 16:47:18.659892,098,2.0,0.0,-440,-888,930.0
326000.0,3,2.5,1782,1577,3.0,3,7,1782,0.0,2000,1550,1744,8102 days 16:47:18.659892,224,1.2,0.0,232,-167,1782.0
340000.0,3,1.75,1740,46580,1.0,4,7,1740,0.0,1980,1576,54685,15407 days 16:47:18.659892,100,1.7142857142857142,0.0,164,-8105,1740.0
440000.0,5,1.75,3690,36036,1.0,3,9,1890,1800.0,1985,2680,44131,13580 days 16:47:18.659892,342,2.857142857142857,1.05,1010,-8095,90.0
749000.0,4,2.5,2930,18199,2.0,3,9,2930,0.0,1998,2930,33976,8832 days 16:47:18.659892,142,1.6,0.0,0,-15777,2930.0
340000.0,4,1.0,1230,8316,1.5,3,7,1230,0.0,1963,1490,8316,21616 days 16:47:18.659892,058,4.0,0.0,-260,0,1230.0
561000.0,3,2.0,2000,7000,2.0,3,7,2000,0.0,1916,1840,7000,38783 days 16:47:18.659892,126,1.5,0.0,160,0,2000.0
270000.0,3,2.25,1520,7930,1.0,3,7,1160,360.0,1988,1530,7930,12485 days 16:47:18.659892,304,1.3333333333333333,3.2222222222222223,-10,0,800.0
600000.0,2,1.0,1040,3600,1.0,4,7,1040,0.0,1919,2250,4800,37687 days 16:47:18.659892,171,2.0,0.0,-1210,-1200,1040.0
219900.0,4,1.5,1120,5427,1.0,3,6,1120,0.0,1969,1150,5304,19424 days 16:47:18.659892,125,2.6666666666666665,0.0,-30,123,1120.0
617000.0,3,1.75,3020,360241,2.0,3,8,3020,0.0,1992,1890,209959,11024 days 16:47:18.659892,342,1.7142857142857142,0.0,1130,150282,3020.0
469000.0,3,2.25,1820,8446,2.0,3,8,1820,0.0,1978,1850,8437,16137 days 16:47:18.659892,247,1.3333333333333333,0.0,-30,9,1820.0
229000.0,3,1.0,1370,56628,1.0,3,7,1370,0.0,1942,1768,8702,29286 days 16:47:18.659892,223,3.0,0.0,-398,47926,1370.0
1270000.0,4,3.0,3130,2646,2.5,5,9,2290,840.0,1906,2920,4500,42435 days 16:47:18.659892,112,1.3333333333333333,2.7261904761904763,210,-1854,1450.0
365000.0,3,1.5,1640,8301,1.0,3,7,1290,350.0,1958,1640,8955,23442 days 16:47:18.659892,217,2.0,3.6857142857142855,0,-654,940.0
429000.0,4,2.5,2650,9301,2.0,3,9,2650,0.0,2001,2730,8688,7736 days 16:47:18.659892,346,1.6,0.0,-80,613,2650.0
550000.0,4,2.5,2850,6809,2.0,3,9,2850,0.0,2003,2820,7500,7006 days 16:47:18.659892,342,1.6,0.0,30,-691,2850.0
453000.0,3,2.5,1820,16300,1.0,4,7,1220,600.0,1955,1870,16300,24538 days 16:47:18.659892,016,1.2,2.033333333333333,-50,0,620.0
187500.0,3,1.5,1180,7000,1.0,4,7,1180,0.0,1977,1180,7370,16502 days 16:47:18.659892,168,2.0,0.0,0,-370,1180.0
520500.0,6,2.5,1880,14350,1.0,5,7,1640,240.0,1955,1510,9840,24538 days 16:47:18.659892,105,2.4,6.833333333333333,370,4510,1400.0
300000.0,3,1.75,1280,12776,1.0,4,7,1280,0.0,1977,1680,11704,16502 days 16:47:18.659892,035,1.7142857142857142,0.0,-400,1072,1280.0
799000.0,4,3.25,3120,5000,2.0,3,9,2370,750.0,2005,2520,6000,6275 days 16:47:18.659892,136,1.2307692307692308,3.16,600,-1000,1620.0
338000.0,3,2.5,2470,4948,2.0,3,8,2470,0.0,2003,2500,4993,7006 days 16:47:18.659892,034,1.2,0.0,-30,-45,2470.0
800000.0,3,1.0,1700,4400,1.5,4,8,1700,0.0,1906,1610,4180,42435 days 16:47:18.659892,134,3.0,0.0,90,220,1700.0
360000.0,2,2.0,1180,3200,1.0,4,6,590,590.0,1945,1350,4000,28190 days 16:47:18.659892,237,1.0,1.0,-170,-800,0.0
442500.0,6,2.5,2800,10490,1.0,3,7,1400,1400.0,1968,2290,8716,19790 days 16:47:18.659892,209,2.4,1.0,510,1774,0.0
700000.0,4,1.0,1300,1651359,1.0,4,6,1300,0.0,1920,2560,425581,37322 days 16:47:18.659892,086,4.0,0.0,-1260,1225778,1300.0
830000.0,5,3.0,3040,9601,1.0,5,9,1970,1070.0,1968,3180,12390,19790 days 16:47:18.659892,128,1.6666666666666667,1.841121495327103,-140,-2789,900.0
360400.0,3,2.5,1630,11592,2.0,3,8,1630,0.0,1987,1700,8850,12850 days 16:47:18.659892,322,1.2,0.0,-70,2742,1630.0
345000.0,3,1.0,1340,9339,1.0,5,7,1340,0.0,1960,1310,9350,22712 days 16:47:18.659892,325,3.0,0.0,30,-11,1340.0
300000.0,3,1.75,1830,51836,1.0,4,7,1430,400.0,1966,1320,51400,20520 days 16:47:18.659892,252,1.7142857142857142,3.575,510,436,1030.0
350000.0,3,1.0,1240,10800,1.0,5,7,1240,0.0,1959,1810,10800,23077 days 16:47:18.659892,247,3.0,0.0,-570,0,1240.0
368000.0,4,2.0,2500,36900,1.0,3,7,1540,960.0,1972,1960,36900,18329 days 16:47:18.659892,281,2.0,1.6041666666666667,540,0,580.0
264000.0,3,1.75,1760,7482,1.0,4,8,1760,0.0,1966,2000,7500,20520 days 16:47:18.659892,174,1.7142857142857142,0.0,-240,-18,1760.0
435000.0,3,2.0,2660,16677,1.0,3,9,2210,450.0,1990,2660,11355,11754 days 16:47:18.659892,071,1.5,4.911111111111111,0,5322,1760.0
200000.0,3,1.5,2060,15837,1.5,3,6,2060,0.0,1903,2190,8549,43531 days 16:47:18.659892,155,2.0,0.0,-130,7288,2060.0
620000.0,5,2.5,2540,3832,2.0,5,8,1760,780.0,1929,2000,5289,34034 days 16:47:18.659892,134,2.0,2.2564102564102564,540,-1457,980.0
1680000.0,5,4.25,4830,11466,2.0,3,1,3720,1110.0,2014,2180,11017,2988 days 16:47:18.659892,324,1.1764705882352942,3.3513513513513513,2650,449,2610.0
337000.0,3,1.75,1400,6000,1.0,4,7,700,700.0,1919,1030,6000,37687 days 16:47:18.659892,343,1.7142857142857142,1.0,370,0,0.0
1930000.0,4,3.25,4280,20296,2.0,4,1,4280,0.0,1984,3420,16351,13946 days 16:47:18.659892,274,1.2307692307692308,0.0,860,3945,4280.0
544500.0,4,2.5,2230,10414,1.0,5,7,1450,780.0,1974,1960,10240,17598 days 16:47:18.659892,148,1.6,1.858974358974359,270,174,670.0
252000.0,1,1.0,680,1638,1.0,1,6,680,0.0,1910,1010,3621,40974 days 16:47:18.659892,002,1.0,0.0,-330,-1983,680.0
445000.0,4,2.5,2340,3784,2.0,3,8,2340,0.0,2008,1730,4000,5180 days 16:47:18.659892,156,1.6,0.0,610,-216,2340.0
379500.0,3,2.25,2070,14196,2.0,3,7,2070,0.0,1989,1550,13860,12119 days 16:47:18.659892,206,1.3333333333333333,0.0,520,336,2070.0
189950.0,4,2.0,1910,4225,1.0,4,6,910,1000.0,1919,1060,4800,37687 days 16:47:18.659892,070,2.0,0.91,850,-575,-90.0
469000.0,3,1.0,950,4250,1.5,5,6,950,0.0,1948,2130,5120,27095 days 16:47:18.659892,153,3.0,0.0,-1180,-870,950.0
600000.0,5,2.75,2910,53898,1.0,5,7,1510,1400.0,1979,3210,216928,15772 days 16:47:18.659892,162,1.8181818181818181,1.0785714285714285,-300,-163030,110.0
785000.0,3,2.5,2930,33981,2.0,3,9,2930,0.0,2000,3720,35230,8102 days 16:47:18.659892,311,1.2,0.0,-790,-1249,2930.0
372000.0,4,2.75,2610,8967,2.0,4,8,2610,0.0,1990,2390,7852,11754 days 16:47:18.659892,041,1.4545454545454546,0.0,220,1115,2610.0
445000.0,5,3.0,3880,7180,2.0,3,7,3880,0.0,2004,2160,4793,6641 days 16:47:18.659892,056,1.6666666666666667,0.0,1720,2387,3880.0
508000.0,4,2.25,3320,53392,2.0,4,8,2000,1320.0,1986,3230,43129,13215 days 16:47:18.659892,287,1.7777777777777777,1.5151515151515151,90,10263,680.0
780000.0,5,1.5,1940,4800,2.0,3,8,1940,0.0,1905,1750,4800,42800 days 16:47:18.659892,077,3.3333333333333335,0.0,190,0,1940.0
541100.0,4,2.25,2510,9800,2.0,3,9,2510,0.0,1978,2440,11000,16137 days 16:47:18.659892,075,1.7777777777777777,0.0,70,-1200,2510.0
729000.0,4,2.5,2660,5608,2.0,3,9,2660,0.0,2003,3010,5608,7006 days 16:47:18.659892,005,1.6,0.0,-350,0,2660.0
397000.0,3,2.0,1710,134489,1.0,5,7,1710,0.0,1952,1700,63823,25634 days 16:47:18.659892,308,1.5,0.0,10,70666,1710.0
451555.0,2,1.0,1320,4520,1.0,3,6,1320,0.0,1912,1420,4560,40244 days 16:47:18.659892,135,2.0,0.0,-100,-40,1320.0
300000.0,2,1.0,960,8153,1.0,3,6,960,0.0,1947,1160,8199,27460 days 16:47:18.659892,181,2.0,0.0,-200,-46,960.0
416000.0,3,2.5,1790,11542,1.0,5,7,1190,600.0,1969,1790,9131,19424 days 16:47:18.659892,097,1.2,1.9833333333333334,0,2411,590.0
490000.0,2,1.0,950,3060,1.0,3,6,810,140.0,1925,1510,3780,35495 days 16:47:18.659892,294,2.0,5.785714285714286,-560,-720,670.0
480000.0,6,3.75,2940,5054,2.0,3,7,2940,0.0,1942,1530,5320,29286 days 16:47:18.659892,029,1.6,0.0,1410,-266,2940.0
368000.0,2,2.0,930,1662,1.0,3,7,670,260.0,2002,1780,2343,7371 days 16:47:18.659892,034,1.0,2.576923076923077,-850,-681,410.0
1040000.0,3,2.5,4570,10615,2.0,3,1,4570,0.0,1991,3860,11576,11389 days 16:47:18.659892,261,1.2,0.0,710,-961,4570.0
545000.0,3,2.5,2370,9000,1.0,4,8,1570,800.0,1952,2120,9500,25634 days 16:47:18.659892,020,1.2,1.9625,250,-500,770.0
850000.0,5,2.75,3430,15119,2.0,3,1,3430,0.0,1998,3430,12045,8832 days 16:47:18.659892,082,1.8181818181818181,0.0,0,3074,3430.0
550000.0,4,3.5,3540,4750,2.0,3,1,3540,0.0,2003,3310,5655,7006 days 16:47:18.659892,338,1.1428571428571428,0.0,230,-905,3540.0
600000.0,3,2.25,2240,9314,2.0,3,9,2240,0.0,1984,2240,9314,13946 days 16:47:18.659892,048,1.3333333333333333,0.0,0,0,2240.0
535000.0,4,2.5,2710,12138,1.0,3,8,1700,1010.0,1968,2390,10052,19790 days 16:47:18.659892,239,1.6,1.683168316831683,320,2086,690.0
599950.0,3,2.5,2660,4975,2.0,3,8,2660,0.0,2014,1840,6653,2988 days 16:47:18.659892,140,1.2,0.0,820,-1678,2660.0
531000.0,5,2.75,2540,5022,1.0,4,8,1540,1000.0,1955,2510,5182,24538 days 16:47:18.659892,199,1.8181818181818181,1.54,30,-160,540.0
530000.0,4,2.25,2210,7665,2.0,4,8,2210,0.0,1968,1960,7903,19790 days 16:47:18.659892,156,1.7777777777777777,0.0,250,-238,2210.0
597326.0,4,4.0,3570,8250,2.0,3,1,2860,710.0,2015,2230,10000,2623 days 16:47:18.659892,176,1.0,4.028169014084507,1340,-1750,2150.0
805000.0,4,2.5,3450,33460,2.0,3,9,3450,0.0,1997,2820,35250,9197 days 16:47:18.659892,119,1.6,0.0,630,-1790,3450.0
390000.0,4,1.75,2330,8364,1.0,4,8,2330,0.0,1968,2180,9630,19790 days 16:47:18.659892,300,2.2857142857142856,0.0,150,-1266,2330.0
487250.0,4,2.0,1690,3250,1.5,3,7,1550,140.0,1901,1620,3250,44261 days 16:47:18.659892,139,2.0,11.071428571428571,70,0,1410.0
301000.0,3,1.5,1030,8414,1.0,4,7,1030,0.0,1967,1750,8414,20155 days 16:47:18.659892,252,2.0,0.0,-720,0,1030.0
1180000.0,5,2.75,2560,5618,1.5,3,8,2220,340.0,1923,2740,4000,36226 days 16:47:18.659892,036,1.8181818181818181,6.529411764705882,-180,1618,1880.0
299000.0,4,2.5,1950,3000,2.0,3,7,1950,0.0,2002,1170,6000,7371 days 16:47:18.659892,269,1.6,0.0,780,-3000,1950.0
400000.0,4,2.5,2350,3904,2.5,3,7,2350,0.0,1999,1120,4000,8467 days 16:47:18.659892,287,1.6,0.0,1230,-96,2350.0
467500.0,4,2.5,3160,7210,1.0,4,7,1880,1280.0,1969,2070,7560,19424 days 16:47:18.659892,335,1.6,1.46875,1090,-350,600.0
305000.0,4,2.5,2430,9103,2.0,3,8,2430,0.0,1990,2260,8090,11754 days 16:47:18.659892,051,1.6,0.0,170,1013,2430.0
210000.0,3,1.0,1340,306848,1.0,3,5,1340,0.0,1953,1800,128066,25268 days 16:47:18.659892,125,3.0,0.0,-460,178782,1340.0
300000.0,3,1.0,1010,10168,1.0,3,6,1010,0.0,1979,1180,10318,15772 days 16:47:18.659892,118,3.0,0.0,-170,-150,1010.0
327500.0,3,2.25,1770,8755,1.0,3,8,1330,440.0,1981,1910,8710,15041 days 16:47:18.659892,251,1.3333333333333333,3.022727272727273,-140,45,890.0
269000.0,3,2.0,1210,7136,1.0,3,7,1210,0.0,2003,1210,5765,7006 days 16:47:18.659892,217,1.5,0.0,0,1371,1210.0
975000.0,4,3.25,3330,17533,1.0,3,9,1750,1580.0,1969,3340,12798,19424 days 16:47:18.659892,090,1.2307692307692308,1.1075949367088607,-10,4735,170.0
355000.0,3,1.0,1240,5400,1.0,4,7,1060,180.0,1940,1429,5400,30017 days 16:47:18.659892,344,3.0,5.888888888888889,-189,0,880.0
712000.0,3,1.0,1250,4620,1.5,4,7,1150,100.0,1900,1900,4400,44626 days 16:47:18.659892,128,3.0,11.5,-650,220,1050.0
883000.0,4,2.5,2960,41656,2.0,3,1,2960,0.0,1985,3900,35104,13580 days 16:47:18.659892,165,1.6,0.0,-940,6552,2960.0
190000.0,2,1.0,840,12252,1.0,3,6,840,0.0,1994,1010,11876,10293 days 16:47:18.659892,227,2.0,0.0,-170,376,840.0
443000.0,3,1.75,1530,8028,1.0,3,7,1200,330.0,1967,1530,8028,20155 days 16:47:18.659892,096,1.7142857142857142,3.6363636363636362,0,0,870.0
920000.0,4,3.0,3750,11025,2.0,3,1,3750,0.0,1976,2930,12835,16868 days 16:47:18.659892,129,1.3333333333333333,0.0,820,-1810,3750.0
285000.0,4,2.25,2150,8250,1.0,4,7,1240,910.0,1978,2050,7875,16137 days 16:47:18.659892,356,1.7777777777777777,1.3626373626373627,100,375,330.0
901000.0,4,3.25,1560,4080,1.0,3,7,1560,0.0,1916,1370,4080,38783 days 16:47:18.659892,113,1.2307692307692308,0.0,190,0,1560.0
552500.0,3,1.75,2040,5775,1.0,3,7,1410,630.0,1958,1360,4400,23442 days 16:47:18.659892,064,1.7142857142857142,2.238095238095238,680,1375,780.0
256000.0,2,1.0,860,5000,1.0,3,6,860,0.0,1915,1220,5000,39148 days 16:47:18.659892,062,2.0,0.0,-360,0,860.0
341000.0,3,1.5,1720,7119,1.5,4,7,1720,0.0,1952,1590,7616,25634 days 16:47:18.659892,132,2.0,0.0,130,-497,1720.0
279000.0,4,2.25,2090,8941,2.0,3,7,2090,0.0,1975,1890,7946,17233 days 16:47:18.659892,085,1.7777777777777777,0.0,200,995,2090.0
686000.0,4,2.25,2130,10650,2.0,4,8,2130,0.0,1977,3380,10050,16502 days 16:47:18.659892,207,1.7777777777777777,0.0,-1250,600,2130.0
225000.0,2,1.0,1300,11867,1.5,4,6,1300,0.0,1975,820,11867,17233 days 16:47:18.659892,143,2.0,0.0,480,0,1300.0
215500.0,2,1.75,1220,15600,1.0,3,6,1220,0.0,1972,1510,17818,18329 days 16:47:18.659892,178,1.1428571428571428,0.0,-290,-2218,1220.0
950000.0,4,3.0,2420,4800,1.5,3,7,1520,900.0,1919,1090,3800,37687 days 16:47:18.659892,104,1.3333333333333333,1.6888888888888889,1330,1000,620.0
503000.0,4,2.5,2940,156988,2.0,3,9,1870,1070.0,1996,2940,71002,9563 days 16:47:18.659892,309,1.6,1.7476635514018692,0,85986,800.0
780000.0,3,2.5,2610,7567,2.0,3,9,2610,0.0,1997,2610,8458,9197 days 16:47:18.659892,022,1.2,0.0,0,-891,2610.0
212000.0,4,2.0,1880,7500,1.0,5,6,980,900.0,1946,1670,14350,27825 days 16:47:18.659892,054,2.0,1.0888888888888888,210,-6850,80.0
580000.0,4,2.75,2330,6703,1.5,3,7,1710,620.0,1983,2060,7500,14311 days 16:47:18.659892,210,1.4545454545454546,2.7580645161290325,270,-797,1090.0
465000.0,4,2.5,2200,3141,2.0,3,7,2060,140.0,1994,1660,3175,10293 days 16:47:18.659892,315,1.6,14.714285714285714,540,-34,1920.0
206000.0,4,2.0,1720,7560,1.0,3,7,1720,0.0,1959,1750,7988,23077 days 16:47:18.659892,323,2.0,0.0,-30,-428,1720.0
615000.0,3,2.5,2250,10171,2.0,3,9,2250,0.0,1987,2440,13390,12850 days 16:47:18.659892,054,1.2,0.0,-190,-3219,2250.0
519000.0,4,1.0,1640,6305,1.5,5,6,1640,0.0,1907,1590,4816,42070 days 16:47:18.659892,200,4.0,0.0,50,1489,1640.0
1140000.0,4,3.25,4130,11444,2.0,3,1,4130,0.0,2001,3720,11431,7736 days 16:47:18.659892,113,1.2307692307692308,0.0,410,13,4130.0
330000.0,5,2.5,2600,3839,2.0,3,7,2600,0.0,2005,2180,4800,6275 days 16:47:18.659892,220,2.0,0.0,420,-961,2600.0
240000.0,4,1.5,1920,7973,1.0,3,8,1920,0.0,1955,2020,8840,24538 days 16:47:18.659892,126,2.6666666666666665,0.0,-100,-867,1920.0
930000.0,4,4.25,5710,24663,2.0,3,1,5710,0.0,2007,4060,23847,5545 days 16:47:18.659892,307,0.9411764705882353,0.0,1650,816,5710.0
850000.0,4,3.0,2720,183823,2.0,3,8,2720,0.0,1975,2140,173804,17233 days 16:47:18.659892,195,1.3333333333333333,0.0,580,10019,2720.0
415000.0,3,1.5,1490,7275,1.0,3,7,1090,400.0,1974,1420,7330,17598 days 16:47:18.659892,346,2.0,2.725,70,-55,690.0
480000.0,3,2.5,2360,9005,1.0,5,7,1340,1020.0,1929,1520,9005,34034 days 16:47:18.659892,322,1.2,1.3137254901960784,840,0,320.0
300000.0,5,1.0,1940,8875,1.0,3,7,1940,0.0,1957,1380,8875,23807 days 16:47:18.659892,202,5.0,0.0,560,0,1940.0
439000.0,4,2.25,2570,9503,2.0,3,8,2570,0.0,1980,1950,9600,15407 days 16:47:18.659892,189,1.7777777777777777,0.0,620,-97,2570.0
450000.0,3,1.0,1160,36831,1.0,3,7,1160,0.0,1938,1800,15640,30747 days 16:47:18.659892,086,3.0,0.0,-640,21191,1160.0
589000.0,3,2.5,2660,206480,1.0,3,8,2660,0.0,1989,2660,206736,12119 days 16:47:18.659892,116,1.2,0.0,0,-256,2660.0
477000.0,3,2.25,1260,3000,2.0,3,7,1260,0.0,2003,1630,3023,7006 days 16:47:18.659892,097,1.3333333333333333,0.0,-370,-23,1260.0
587500.0,4,2.25,1780,6120,1.0,3,8,1310,470.0,1951,1780,6120,25999 days 16:47:18.659892,267,1.7777777777777777,2.7872340425531914,0,0,840.0
1320000.0,4,2.25,3180,6105,2.0,3,1,3180,0.0,1905,3180,6029,42800 days 16:47:18.659892,267,1.7777777777777777,0.0,0,76,3180.0
1430000.0,4,2.5,3380,27589,2.0,3,1,3380,0.0,1966,3390,20075,20520 days 16:47:18.659892,254,1.6,0.0,-10,7514,3380.0
700000.0,4,2.25,2690,15000,2.0,3,9,1890,800.0,1978,2670,15030,16137 days 16:47:18.659892,103,1.7777777777777777,2.3625,20,-30,1090.0
275000.0,2,1.0,1180,6552,1.0,4,6,1180,0.0,1949,1070,7200,26729 days 16:47:18.659892,174,2.0,0.0,110,-648,1180.0
367500.0,3,1.0,1660,11783,1.0,4,7,1160,500.0,1978,1320,10541,16137 days 16:47:18.659892,175,3.0,2.32,340,1242,660.0
453250.0,4,2.5,2260,6300,2.0,3,7,2260,0.0,2001,2300,6300,7736 days 16:47:18.659892,125,1.6,0.0,-40,0,2260.0
607000.0,5,1.75,1910,5428,1.0,3,8,1390,520.0,1954,1820,5900,24903 days 16:47:18.659892,107,2.857142857142857,2.673076923076923,90,-472,870.0
255000.0,4,2.0,2430,8960,1.0,3,7,1430,1000.0,1960,2430,8960,22712 days 16:47:18.659892,183,2.0,1.43,0,0,430.0
501000.0,2,2.0,1300,2500,1.0,4,7,770,530.0,1926,1160,5000,35130 days 16:47:18.659892,121,1.0,1.4528301886792452,140,-2500,240.0
450000.0,3,1.0,1060,4650,1.0,3,7,910,150.0,1950,1480,4750,26364 days 16:47:18.659892,090,3.0,6.066666666666666,-420,-100,760.0
360000.0,3,2.25,2200,8000,2.0,3,8,2200,0.0,1981,2170,8000,15041 days 16:47:18.659892,232,1.3333333333333333,0.0,30,0,2200.0
460000.0,4,1.75,1720,3050,1.5,5,7,1040,680.0,1929,1570,6100,34034 days 16:47:18.659892,318,2.2857142857142856,1.5294117647058822,150,-3050,360.0
753000.0,3,1.75,2360,8290,1.0,4,7,1180,1180.0,1950,1880,7670,26364 days 16:47:18.659892,062,1.7142857142857142,1.0,480,620,0.0
389950.0,2,1.0,820,4234,1.0,3,6,820,0.0,1951,1550,4236,25999 days 16:47:18.659892,126,2.0,0.0,-730,-2,820.0
469000.0,2,1.0,1030,4400,1.0,3,7,1030,0.0,1924,1400,4200,35861 days 16:47:18.659892,126,2.0,0.0,-370,200,1030.0
550000.0,4,1.75,2030,5688,2.0,4,9,1730,300.0,1939,2320,11107,30382 days 16:47:18.659892,255,2.2857142857142856,5.766666666666667,-290,-5419,1430.0
565000.0,5,3.5,2700,11675,1.5,4,6,1950,750.0,1948,2160,8114,27095 days 16:47:18.659892,247,1.4285714285714286,2.6,540,3561,1200.0
189650.0,2,1.75,1100,7600,1.0,3,6,1100,0.0,1980,1230,7350,15407 days 16:47:18.659892,141,1.1428571428571428,0.0,-130,250,1100.0
1530000.0,4,3.25,3620,5131,2.0,4,1,2350,1270.0,1927,2550,5174,34765 days 16:47:18.659892,170,1.2307692307692308,1.8503937007874016,1070,-43,1080.0
260000.0,3,1.75,1340,8000,1.0,3,7,1340,0.0,1980,1690,8000,15407 days 16:47:18.659892,232,1.7142857142857142,0.0,-350,0,1340.0
243000.0,3,1.75,1790,12000,1.0,3,7,1040,750.0,1960,1840,12000,22712 days 16:47:18.659892,152,1.7142857142857142,1.3866666666666667,-50,0,290.0
1100000.0,4,2.5,3830,13800,1.0,4,9,2030,1800.0,1969,3460,9875,19424 days 16:47:18.659892,335,1.6,1.1277777777777778,370,3925,230.0
249000.0,3,1.5,1580,7200,1.0,4,7,1080,500.0,1976,1580,7470,16868 days 16:47:18.659892,232,2.0,2.16,0,-270,580.0
720000.0,2,1.0,2020,7200,1.0,4,7,1700,320.0,1947,2020,7200,27460 days 16:47:18.659892,136,2.0,5.3125,0,0,1380.0
905000.0,4,2.5,3330,9557,2.0,3,1,3330,0.0,1995,3360,9755,9928 days 16:47:18.659892,084,1.6,0.0,-30,-198,3330.0
824500.0,4,2.5,2610,3500,1.5,5,7,1610,1000.0,1927,1820,3900,34765 days 16:47:18.659892,113,1.6,1.61,790,-400,610.0
762500.0,4,2.75,2610,8760,1.0,4,8,1760,850.0,1978,2550,10376,16137 days 16:47:18.659892,175,1.4545454545454546,2.070588235294118,60,-1616,910.0
580000.0,3,2.5,1740,1280,3.0,3,8,1740,0.0,2008,1740,1308,5180 days 16:47:18.659892,103,1.2,0.0,0,-28,1740.0
380000.0,3,2.0,1840,8580,1.0,3,8,1840,0.0,1990,2190,8580,11754 days 16:47:18.659892,230,1.5,0.0,-350,0,1840.0
805000.0,3,1.75,1080,3200,1.0,4,7,880,200.0,1926,1780,5200,35130 days 16:47:18.659892,091,1.7142857142857142,4.4,-700,-2000,680.0
520000.0,4,1.75,1240,4532,1.5,4,7,1240,0.0,1944,1260,4468,28556 days 16:47:18.659892,197,2.2857142857142856,0.0,-20,64,1240.0
1570000.0,5,4.5,5620,5800,3.0,3,1,4700,920.0,1999,2360,5800,8467 days 16:47:18.659892,034,1.1111111111111112,5.108695652173913,3260,0,3780.0
175000.0,2,1.0,1170,8925,1.0,3,6,1170,0.0,1911,1380,7440,40609 days 16:47:18.659892,134,2.0,0.0,-210,1485,1170.0
353500.0,4,2.25,1760,9602,2.0,3,7,1760,0.0,1987,1860,9656,12850 days 16:47:18.659892,167,1.7777777777777777,0.0,-100,-54,1760.0
500000.0,4,2.5,2230,26989,1.0,4,8,1400,830.0,1962,2570,17702,21981 days 16:47:18.659892,002,1.6,1.6867469879518073,-340,9287,570.0
386500.0,3,1.75,1520,7350,1.0,4,7,1140,380.0,1972,1380,7350,18329 days 16:47:18.659892,042,1.7142857142857142,3.0,140,0,760.0
210000.0,2,1.0,1450,4750,1.0,3,7,850,600.0,1950,1190,5000,26364 days 16:47:18.659892,197,2.0,1.4166666666666667,260,-250,250.0
315000.0,5,2.5,3220,5751,2.0,3,8,3220,0.0,2002,2740,5500,7371 days 16:47:18.659892,225,2.0,0.0,480,251,3220.0
339000.0,4,2.5,1830,8601,2.0,3,7,1830,0.0,2003,1830,5184,7006 days 16:47:18.659892,139,1.6,0.0,0,3417,1830.0
655000.0,4,2.25,2200,9163,1.0,4,8,1430,770.0,1971,2420,9163,18694 days 16:47:18.659892,267,1.7777777777777777,1.8571428571428572,-220,0,660.0
740000.0,2,2.5,2170,8678,1.0,3,8,2170,0.0,2008,2170,5890,5180 days 16:47:18.659892,240,0.8,0.0,0,2788,2170.0
685000.0,5,2.5,1900,7843,2.0,5,7,1900,0.0,1966,1900,7350,20520 days 16:47:18.659892,065,2.0,0.0,0,493,1900.0
550000.0,5,2.5,2960,9877,1.0,4,7,1480,1480.0,1960,1900,9877,22712 days 16:47:18.659892,069,2.0,1.0,1060,0,0.0
405000.0,2,1.75,1710,4234,2.0,3,7,1330,380.0,1920,1530,4556,37322 days 16:47:18.659892,153,1.1428571428571428,3.5,180,-322,950.0
765000.0,4,2.25,2620,17366,1.0,3,9,1430,1190.0,1984,2620,15335,13946 days 16:47:18.659892,106,1.7777777777777777,1.2016806722689075,0,2031,240.0
625000.0,3,2.0,2140,3600,2.0,3,8,1680,460.0,1911,2340,5400,40609 days 16:47:18.659892,063,1.5,3.652173913043478,-200,-1800,1220.0
207000.0,4,2.5,2100,19680,1.5,3,6,2100,0.0,1914,1340,12300,39513 days 16:47:18.659892,279,1.6,0.0,760,7380,2100.0
370000.0,4,2.5,2100,19680,1.5,3,6,2100,0.0,1914,1340,12300,39513 days 16:47:18.659892,071,1.6,0.0,760,7380,2100.0
475000.0,3,2.5,1460,4961,1.0,4,8,1150,310.0,1988,1550,5449,12485 days 16:47:18.659892,336,1.2,3.7096774193548385,-90,-488,840.0
365000.0,2,1.0,990,8250,1.0,3,7,990,0.0,1955,1080,8168,24538 days 16:47:18.659892,241,2.0,0.0,-90,82,990.0
411800.0,4,2.25,2190,6800,1.0,5,7,1340,850.0,1969,1560,7611,19424 days 16:47:18.659892,356,1.7777777777777777,1.576470588235294,630,-811,490.0
668000.0,5,3.5,3990,42436,2.0,3,9,2710,1280.0,2002,3030,41684,7371 days 16:47:18.659892,202,1.4285714285714286,2.1171875,960,752,1430.0
618000.0,3,2.5,2340,3630,2.0,3,9,2340,0.0,1998,1820,5120,8832 days 16:47:18.659892,254,1.2,0.0,520,-1490,2340.0
247500.0,4,2.0,2460,5921,1.0,4,7,1230,1230.0,1948,1260,6648,27095 days 16:47:18.659892,360,2.0,1.0,1200,-727,0.0
345000.0,5,3.0,2080,6150,1.0,3,7,1040,1040.0,1950,1420,6150,26364 days 16:47:18.659892,211,1.6666666666666667,1.0,660,0,0.0
616300.0,3,2.0,1700,8400,2.0,3,7,1700,0.0,1927,1820,9000,34765 days 16:47:18.659892,070,1.5,0.0,-120,-600,1700.0
348000.0,3,1.5,1330,6768,1.0,4,7,1330,0.0,1952,1320,6910,25634 days 16:47:18.659892,016,2.0,0.0,10,-142,1330.0
425000.0,3,2.5,1630,10762,1.0,3,7,1630,0.0,1994,1770,10762,10293 days 16:47:18.659892,336,1.2,0.0,-140,0,1630.0
850000.0,5,2.75,2920,11880,1.0,5,8,1660,1260.0,1968,3910,14491,19790 days 16:47:18.659892,165,1.8181818181818181,1.3174603174603174,-990,-2611,400.0
820000.0,5,2.75,2830,6137,2.0,3,9,2830,0.0,2010,3170,6285,4449 days 16:47:18.659892,198,1.8181818181818181,0.0,-340,-148,2830.0
832000.0,4,2.25,3190,52953,2.0,4,1,3190,0.0,1980,3190,51400,15407 days 16:47:18.659892,013,1.7777777777777777,0.0,0,1553,3190.0
835000.0,3,1.75,1490,3840,2.0,3,8,1490,0.0,1984,3450,8500,13946 days 16:47:18.659892,337,1.7142857142857142,0.0,-1960,-4660,1490.0
350000.0,3,2.5,1630,3425,2.0,3,8,1630,0.0,1999,1420,3425,8467 days 16:47:18.659892,100,1.2,0.0,210,0,1630.0
349000.0,4,2.5,2280,4096,2.0,3,7,2280,0.0,2003,2280,3600,7006 days 16:47:18.659892,203,1.6,0.0,0,496,2280.0
1130000.0,6,3.75,3010,4360,2.0,3,9,2000,1010.0,2014,1600,5160,2988 days 16:47:18.659892,164,1.6,1.9801980198019802,1410,-800,990.0
320000.0,3,2.5,1590,3480,2.0,3,7,1590,0.0,2004,1680,3480,6641 days 16:47:18.659892,068,1.2,0.0,-90,0,1590.0
150000.0,3,1.0,1250,7210,1.0,4,7,1250,0.0,1968,1010,7210,19790 days 16:47:18.659892,064,3.0,0.0,240,0,1250.0
340000.0,3,1.0,1710,10190,1.0,3,6,1310,400.0,1949,1200,6251,26729 days 16:47:18.659892,329,3.0,3.275,510,3939,910.0
785500.0,4,4.0,3280,8448,2.0,3,1,3280,0.0,2007,3730,8030,5545 days 16:47:18.659892,286,1.0,0.0,-450,418,3280.0
410500.0,4,2.5,3362,8601,2.0,3,8,3362,0.0,2004,2770,8601,6641 days 16:47:18.659892,048,1.6,0.0,592,0,3362.0
580000.0,3,2.5,2200,11000,2.0,3,9,2200,0.0,1978,2200,12851,16137 days 16:47:18.659892,182,1.2,0.0,0,-1851,2200.0
345000.0,2,1.5,830,920,2.0,3,7,830,0.0,2005,830,1200,6275 days 16:47:18.659892,111,1.3333333333333333,0.0,0,-280,830.0
550000.0,3,2.25,2160,37000,1.5,4,7,1760,400.0,1933,2540,37000,32573 days 16:47:18.659892,272,1.3333333333333333,4.4,-380,0,1360.0
449500.0,4,3.0,2580,7299,2.0,3,8,2580,0.0,1998,2250,6165,8832 days 16:47:18.659892,294,1.3333333333333333,0.0,330,1134,2580.0
300000.0,3,1.0,2150,7007,1.0,3,6,2150,0.0,1954,1720,9000,24903 days 16:47:18.659892,175,3.0,0.0,430,-1993,2150.0
915000.0,4,2.5,3510,28052,2.0,3,1,3510,0.0,1988,2890,28295,12485 days 16:47:18.659892,315,1.6,0.0,620,-243,3510.0
1580000.0,4,3.75,3810,9916,2.0,3,1,3810,0.0,1989,3040,11250,12119 days 16:47:18.659892,027,1.0666666666666667,0.0,770,-1334,3810.0
599000.0,4,2.75,2020,2750,1.0,3,8,1010,1010.0,1917,1840,4000,38417 days 16:47:18.659892,148,1.4545454545454546,1.0,180,-1250,0.0
755000.0,4,2.5,2120,10202,1.0,4,7,1620,500.0,1960,1570,10762,22712 days 16:47:18.659892,125,1.6,3.24,550,-560,1120.0
400000.0,3,1.0,1250,7157,1.0,3,7,1250,0.0,1944,1300,6796,28556 days 16:47:18.659892,092,3.0,0.0,-50,361,1250.0
133000.0,3,1.0,980,9115,1.0,3,7,980,0.0,1968,1470,8716,19790 days 16:47:18.659892,089,3.0,0.0,-490,399,980.0
330000.0,4,1.5,1250,8400,1.0,3,7,960,290.0,1951,1560,8400,25999 days 16:47:18.659892,016,2.6666666666666665,3.310344827586207,-310,0,670.0
330000.0,4,1.0,1100,5000,1.5,5,6,1100,0.0,1904,1560,4838,43166 days 16:47:18.659892,049,4.0,0.0,-460,162,1100.0
375000.0,3,1.75,1330,9417,1.0,5,6,710,620.0,1936,1690,7937,31478 days 16:47:18.659892,248,1.7142857142857142,1.1451612903225807,-360,1480,90.0
485000.0,4,2.75,2560,8956,1.0,4,7,1500,1060.0,1968,2280,9234,19790 days 16:47:18.659892,345,1.4545454545454546,1.4150943396226414,280,-278,440.0
470000.0,4,2.5,1850,11250,1.5,3,7,1210,640.0,1981,1650,7623,15041 days 16:47:18.659892,203,1.6,1.890625,200,3627,570.0
1050000.0,4,3.0,2790,3600,2.0,3,8,1880,910.0,1905,1360,3600,42800 days 16:47:18.659892,355,1.3333333333333333,2.065934065934066,1430,0,970.0
548800.0,4,1.0,1660,4704,1.5,3,7,1260,400.0,1930,1360,5413,33669 days 16:47:18.659892,188,4.0,3.15,300,-709,860.0
315000.0,2,1.0,1080,2674,1.0,4,6,720,360.0,1919,1250,5000,37687 days 16:47:18.659892,189,2.0,2.0,-170,-2326,360.0
590000.0,3,2.0,3030,9374,1.0,4,7,2100,930.0,1959,1990,6012,23077 days 16:47:18.659892,262,1.5,2.2580645161290325,1040,3362,1170.0
439950.0,4,2.5,2380,12067,2.0,3,7,2380,0.0,2002,2330,8621,7371 days 16:47:18.659892,143,1.6,0.0,50,3446,2380.0
325000.0,3,1.75,2250,26337,1.0,3,8,2250,0.0,1980,1830,26337,15407 days 16:47:18.659892,154,1.7142857142857142,0.0,420,0,2250.0
400000.0,2,1.0,880,5111,1.0,3,6,880,0.0,1931,1370,5111,33304 days 16:47:18.659892,342,2.0,0.0,-490,0,880.0
685000.0,4,2.5,2770,10051,2.0,3,1,2770,0.0,1987,2730,10675,12850 days 16:47:18.659892,345,1.6,0.0,40,-624,2770.0
339950.0,3,2.0,1340,10200,1.5,3,7,1340,0.0,1953,1420,10200,25268 days 16:47:18.659892,261,1.5,0.0,-80,0,1340.0
315000.0,3,1.75,1660,8160,1.0,4,7,1660,0.0,1951,1490,8100,25999 days 16:47:18.660890,296,1.7142857142857142,0.0,170,60,1660.0
411753.0,3,2.5,1710,3795,2.0,3,7,1710,0.0,2009,1600,3821,4814 days 16:47:18.660890,042,1.2,0.0,110,-26,1710.0
577000.0,2,1.75,1620,4879,1.0,3,7,1040,580.0,1924,1500,5000,35861 days 16:47:18.660890,240,1.1428571428571428,1.793103448275862,120,-121,460.0
500000.0,3,1.75,1530,8829,1.0,5,8,1530,0.0,1972,2060,9226,18329 days 16:47:18.660890,290,1.7142857142857142,0.0,-530,-397,1530.0
210000.0,3,2.0,1440,10111,1.0,3,7,1440,0.0,1963,1580,10200,21616 days 16:47:18.660890,336,1.5,0.0,-140,-89,1440.0
640000.0,4,1.75,2020,16120,1.0,3,7,2020,0.0,1969,1940,16350,19424 days 16:47:18.660890,239,2.2857142857142856,0.0,80,-230,2020.0
460000.0,4,1.75,1870,8663,1.0,5,7,1870,0.0,1949,1560,7800,26729 days 16:47:18.660890,107,2.2857142857142856,0.0,310,863,1870.0
265000.0,2,1.0,620,4760,1.0,3,6,620,0.0,1941,620,4760,29651 days 16:47:18.660890,049,2.0,0.0,0,0,620.0
740000.0,5,5.0,5774,31675,1.0,3,1,4490,1284.0,1984,3260,13200,13946 days 16:47:18.660890,134,1.0,3.4968847352024923,2514,18475,3206.0
230000.0,3,1.0,1240,6195,1.0,3,6,1240,0.0,1948,1760,11080,27095 days 16:47:18.660890,199,3.0,0.0,-520,-4885,1240.0
315000.0,3,1.75,1890,10661,1.0,5,7,1460,430.0,1978,1680,9604,16137 days 16:47:18.660890,048,1.7142857142857142,3.395348837209302,210,1057,1030.0
432000.0,3,1.75,2410,51763,1.0,4,8,1410,1000.0,1981,2410,49207,15041 days 16:47:18.660890,357,1.7142857142857142,1.41,0,2556,410.0
467000.0,3,2.5,1530,3984,2.0,3,8,1530,0.0,1995,1720,4005,9928 days 16:47:18.660890,034,1.2,0.0,-190,-21,1530.0
255000.0,5,3.75,2800,9900,1.0,3,7,2800,0.0,1964,1700,13200,21251 days 16:47:18.660890,268,1.3333333333333333,0.0,1100,-3300,2800.0
316500.0,3,1.75,1460,6360,1.0,3,7,1010,450.0,1979,1400,4240,15772 days 16:47:18.660890,098,1.7142857142857142,2.2444444444444445,60,2120,560.0
190000.0,4,2.0,1580,6250,1.0,3,7,860,720.0,1977,1580,6250,16502 days 16:47:18.660890,093,2.0,1.1944444444444444,0,0,140.0
490000.0,3,2.0,1450,2400,1.5,3,8,1450,0.0,1900,1450,4275,44626 days 16:47:18.660890,136,1.5,0.0,0,-1875,1450.0
378000.0,4,1.75,1990,23200,1.0,4,7,1990,0.0,1976,1950,17040,16868 days 16:47:18.660890,107,2.2857142857142856,0.0,40,6160,1990.0
598800.0,6,4.0,4470,17877,3.0,3,9,3230,1240.0,2013,1790,18260,3353 days 16:47:18.660890,042,1.5,2.6048387096774195,2680,-383,1990.0
333800.0,5,3.0,1980,3868,1.0,3,7,1220,760.0,1990,1970,3868,11754 days 16:47:18.660890,245,1.6666666666666667,1.605263157894737,10,0,460.0
690000.0,4,2.5,2920,9904,2.0,4,9,2920,0.0,1990,1810,5617,11754 days 16:47:18.660890,149,1.6,0.0,1110,4287,2920.0
320000.0,4,1.75,1660,6200,1.0,4,6,830,830.0,1948,1780,5968,27095 days 16:47:18.660890,294,2.2857142857142856,1.0,-120,232,0.0
1250000.0,4,3.5,3190,6000,1.5,4,9,2410,780.0,1912,2840,4000,40244 days 16:47:18.660890,104,1.1428571428571428,3.08974358974359,350,2000,1630.0
335000.0,3,1.5,1560,9600,1.0,4,7,1560,0.0,1961,1520,10000,22346 days 16:47:18.660890,202,2.0,0.0,40,-400,1560.0
840000.0,3,2.5,3050,33920,1.0,3,8,3050,0.0,2004,1970,60984,6641 days 16:47:18.660890,223,1.2,0.0,1080,-27064,3050.0
608250.0,4,2.75,3030,21780,2.0,3,8,3030,0.0,1986,3020,28027,13215 days 16:47:18.660890,195,1.4545454545454546,0.0,10,-6247,3030.0
550000.0,3,2.5,2260,4165,2.0,3,7,2260,0.0,2005,2770,4566,6275 days 16:47:18.660890,160,1.2,0.0,-510,-401,2260.0
240000.0,3,1.0,1260,7920,1.0,3,7,1260,0.0,1966,1300,7920,20520 days 16:47:18.660890,112,3.0,0.0,-40,0,1260.0
998000.0,3,2.25,3370,11757,2.0,4,9,3370,0.0,1980,2690,10500,15407 days 16:47:18.660890,104,1.3333333333333333,0.0,680,1257,3370.0
275000.0,3,1.75,1490,8000,1.0,3,8,1490,0.0,1978,1740,8165,16137 days 16:47:18.660890,241,1.7142857142857142,0.0,-250,-165,1490.0
284200.0,3,2.5,1570,9292,1.0,3,7,1110,460.0,1977,1470,9222,16502 days 16:47:18.660890,114,1.2,2.4130434782608696,100,70,650.0
1720000.0,4,3.75,4490,7623,2.0,4,1,3090,1400.0,1941,3760,7653,29651 days 16:47:18.660890,205,1.0666666666666667,2.2071428571428573,730,-30,1690.0
2400000.0,4,3.75,4090,24825,2.0,4,1,3400,690.0,1926,3910,11500,35130 days 16:47:18.660890,323,1.0666666666666667,4.927536231884058,180,13325,2710.0
930800.0,5,2.5,4150,96574,2.0,3,1,4150,0.0,1988,3320,40803,12485 days 16:47:18.660890,248,2.0,0.0,830,55771,4150.0
930000.0,4,3.0,2900,10400,1.0,5,8,1530,1370.0,1959,2820,10400,23077 days 16:47:18.660890,210,1.3333333333333333,1.1167883211678833,80,0,160.0
215000.0,4,1.5,1430,8775,1.0,3,7,1030,400.0,1979,1390,7800,15772 days 16:47:18.660890,240,2.6666666666666665,2.575,40,975,630.0
480000.0,2,1.5,1008,26487,1.0,4,6,1008,0.0,1943,1132,24079,28921 days 16:47:18.660890,110,1.3333333333333333,0.0,-124,2408,1008.0
483945.0,2,1.75,1480,5120,1.0,4,6,840,640.0,1951,1090,5120,25999 days 16:47:18.660890,140,1.1428571428571428,1.3125,390,0,200.0
347000.0,3,1.75,1240,8050,1.0,4,7,1240,0.0,1978,1370,9856,16137 days 16:47:18.660890,160,1.7142857142857142,0.0,-130,-1806,1240.0
232500.0,3,2.0,1370,9760,1.0,4,7,1110,260.0,1979,1640,9040,15772 days 16:47:18.660890,089,1.5,4.269230769230769,-270,720,850.0
390000.0,4,2.25,1770,33132,1.0,4,8,1190,580.0,1965,2490,20000,20885 days 16:47:18.660890,140,1.7777777777777777,2.0517241379310347,-720,13132,610.0
550000.0,3,2.25,2160,15360,1.0,3,8,1410,750.0,1965,2180,8480,20885 days 16:47:18.660890,261,1.3333333333333333,1.88,-20,6880,660.0
590000.0,4,2.5,2340,8971,2.0,3,9,2340,0.0,1987,2510,9219,12850 days 16:47:18.660890,224,1.6,0.0,-170,-248,2340.0
420850.0,1,1.0,960,40946,1.0,5,5,960,0.0,1945,1320,20350,28190 days 16:47:18.660890,141,1.0,0.0,-360,20596,960.0
345000.0,4,2.5,2280,8190,1.0,3,7,1390,890.0,1983,1990,9000,14311 days 16:47:18.660890,036,1.6,1.5617977528089888,290,-810,500.0
429800.0,3,2.0,1970,7000,1.0,3,8,1970,0.0,1986,1970,7365,13215 days 16:47:18.660890,058,1.5,0.0,0,-365,1970.0
302000.0,4,1.75,1530,17664,1.5,3,7,1530,0.0,1968,1530,11625,19790 days 16:47:18.660890,177,2.2857142857142856,0.0,0,6039,1530.0
800000.0,4,1.5,1790,3952,1.5,4,8,1790,0.0,1932,1200,3876,32939 days 16:47:18.660890,308,2.6666666666666665,0.0,590,76,1790.0
250000.0,3,2.5,1700,6000,2.0,3,8,1700,0.0,1997,1940,6626,9197 days 16:47:18.660890,349,1.2,0.0,-240,-626,1700.0
605000.0,3,2.0,2660,4500,1.0,4,7,1330,1330.0,1922,1790,5000,36591 days 16:47:18.660890,210,1.5,1.0,870,-500,0.0
412000.0,3,1.75,1950,52256,1.0,4,8,1950,0.0,1985,2450,51836,13580 days 16:47:18.660890,149,1.7142857142857142,0.0,-500,420,1950.0
252000.0,3,2.0,1340,5670,2.0,3,6,1340,0.0,1994,1290,4892,10293 days 16:47:18.660890,316,1.5,0.0,50,778,1340.0
375000.0,3,1.0,1130,12500,1.5,3,7,1130,0.0,1954,2280,8750,24903 days 16:47:18.660890,262,3.0,0.0,-1150,3750,1130.0
725000.0,2,1.75,1950,2719,1.0,5,7,1010,940.0,1919,1360,1256,37687 days 16:47:18.660890,191,1.1428571428571428,1.074468085106383,590,1463,70.0
471750.0,5,3.5,3790,8200,1.0,3,8,2120,1670.0,2001,1740,8676,7736 days 16:47:18.660890,286,1.4285714285714286,1.2694610778443114,2050,-476,450.0
490000.0,4,2.25,2020,85813,2.0,3,7,2020,0.0,1995,2120,85813,9928 days 16:47:18.660890,342,1.7777777777777777,0.0,-100,0,2020.0
439000.0,2,1.0,800,5100,1.0,3,7,800,0.0,1945,1330,5100,28190 days 16:47:18.660890,274,2.0,0.0,-530,0,800.0
355000.0,4,2.0,1770,8890,1.0,5,6,1770,0.0,1949,1010,7620,26729 days 16:47:18.660890,234,2.0,0.0,760,1270,1770.0
250000.0,1,0.75,940,87120,1.0,3,6,940,0.0,1944,1930,165528,28556 days 16:47:18.660890,125,1.3333333333333333,0.0,-990,-78408,940.0
780000.0,4,2.25,2260,16188,1.0,3,1,2260,0.0,1984,2840,10158,13946 days 16:47:18.660890,085,1.7777777777777777,0.0,-580,6030,2260.0
409000.0,2,1.0,890,3271,1.0,4,6,890,0.0,1918,1190,5175,38052 days 16:47:18.660890,309,2.0,0.0,-300,-1904,890.0
420000.0,2,1.0,860,3880,1.0,4,6,860,0.0,1916,1230,4260,38783 days 16:47:18.660890,161,2.0,0.0,-370,-380,860.0
200000.0,1,0.75,680,9600,1.0,3,5,680,0.0,1947,1580,6624,27460 days 16:47:18.660890,317,1.3333333333333333,0.0,-900,2976,680.0
830000.0,2,1.5,2130,35679,1.0,4,7,2130,0.0,1963,2670,35679,21616 days 16:47:18.660890,005,1.3333333333333333,0.0,-540,0,2130.0
695000.0,3,2.5,2390,4555,2.0,3,9,2390,0.0,2006,2540,4500,5910 days 16:47:18.660890,149,1.2,0.0,-150,55,2390.0
815000.0,4,2.75,3488,9614,2.0,3,1,3488,0.0,1998,3600,10891,8832 days 16:47:18.660890,141,1.4545454545454546,0.0,-112,-1277,3488.0
210000.0,3,1.75,1260,6223,1.0,3,7,820,440.0,1983,1260,6553,14311 days 16:47:18.660890,317,1.7142857142857142,1.8636363636363635,0,-330,380.0
635000.0,3,1.75,2940,6000,1.0,4,8,1590,1350.0,1957,2880,8100,23807 days 16:47:18.660890,258,1.7142857142857142,1.1777777777777778,60,-2100,240.0
562500.0,4,2.5,2440,7322,2.0,3,9,2440,0.0,1991,2590,9927,11389 days 16:47:18.660890,202,1.6,0.0,-150,-2605,2440.0
402500.0,4,2.5,2600,11951,2.0,3,1,2600,0.0,1988,2820,12093,12485 days 16:47:18.660890,129,1.6,0.0,-220,-142,2600.0
555000.0,3,2.0,2080,7020,1.0,4,7,1040,1040.0,1951,1920,7000,25999 days 16:47:18.660890,353,1.5,1.0,160,20,0.0
310000.0,3,1.0,1990,7173,1.0,3,7,1990,0.0,1972,1320,7245,18329 days 16:47:18.660890,252,3.0,0.0,670,-72,1990.0
500000.0,4,2.5,2840,18001,2.0,3,9,2840,0.0,1994,2500,18001,10293 days 16:47:18.660890,248,1.6,0.0,340,0,2840.0
430000.0,6,3.0,2630,8800,1.0,3,7,1610,1020.0,1959,1220,1173,23077 days 16:47:18.660890,204,2.0,1.5784313725490196,1410,7627,590.0
1600000.0,3,4.25,2820,7200,2.0,4,1,2460,360.0,1930,3300,7522,33669 days 16:47:18.660890,179,0.7058823529411765,6.833333333333333,-480,-322,2100.0
627500.0,4,1.0,1560,4080,1.5,3,7,1560,0.0,1923,1890,4080,36226 days 16:47:18.660890,274,4.0,0.0,-330,0,1560.0
335000.0,4,2.5,2330,7050,2.0,3,8,2330,0.0,1998,1810,5424,8832 days 16:47:18.660890,328,1.6,0.0,520,1626,2330.0
962000.0,4,2.25,3320,20100,1.0,4,8,1810,1510.0,1981,2450,9821,15041 days 16:47:18.660890,076,1.7777777777777777,1.1986754966887416,870,10279,300.0
299000.0,3,1.75,1730,14270,1.0,3,7,1730,0.0,1959,1600,11232,23077 days 16:47:18.660890,206,1.7142857142857142,0.0,130,3038,1730.0
399950.0,4,2.5,3110,5868,2.0,3,8,3110,0.0,2001,2950,5924,7736 days 16:47:18.660890,104,1.6,0.0,160,-56,3110.0
322000.0,3,1.0,1230,9660,1.0,3,7,1230,0.0,1968,1380,10125,19790 days 16:47:18.660890,084,3.0,0.0,-150,-465,1230.0
430000.0,2,1.5,950,4625,1.0,4,7,950,0.0,1949,1440,4625,26729 days 16:47:18.660890,174,1.3333333333333333,0.0,-490,0,950.0
307000.0,3,1.75,1890,13860,1.0,5,7,1890,0.0,1966,1500,14536,20520 days 16:47:18.660890,128,1.7142857142857142,0.0,390,-676,1890.0
194000.0,3,1.5,1010,5000,1.0,3,6,1010,0.0,1943,980,5000,28921 days 16:47:18.660890,309,2.0,0.0,30,0,1010.0
180000.0,3,1.0,1010,8581,1.0,4,6,1010,0.0,1920,1060,10354,37322 days 16:47:18.660890,318,3.0,0.0,-50,-1773,1010.0
465000.0,4,2.25,2340,13383,1.0,3,8,1170,1170.0,1983,1810,12532,14311 days 16:47:18.660890,199,1.7777777777777777,1.0,530,851,0.0
722500.0,4,2.5,2460,9296,2.0,3,9,2460,0.0,1978,2730,9900,16137 days 16:47:18.660890,082,1.6,0.0,-270,-604,2460.0
470450.0,2,1.0,1010,3400,1.0,3,7,1010,0.0,1921,1800,3600,36956 days 16:47:18.660890,267,2.0,0.0,-790,-200,1010.0
280000.0,3,2.5,1650,6000,2.0,3,7,1650,0.0,1990,1750,6000,11754 days 16:47:18.660890,027,1.2,0.0,-100,0,1650.0
176250.0,4,2.0,1440,6702,1.0,4,7,1440,0.0,1966,1030,6702,20520 days 16:47:18.660890,100,2.0,0.0,410,0,1440.0
560000.0,5,1.0,1710,9100,1.5,4,7,1320,390.0,1926,1880,9100,35130 days 16:47:18.660890,168,5.0,3.3846153846153846,-170,0,930.0
830000.0,3,2.5,2760,11287,2.0,3,1,2000,760.0,1991,2760,13719,11389 days 16:47:18.660890,295,1.2,2.6315789473684212,0,-2432,1240.0
276900.0,2,1.0,1350,10096,1.0,4,7,1350,0.0,1952,1280,10095,25634 days 16:47:18.660890,162,2.0,0.0,70,1,1350.0
625000.0,3,1.75,1660,4800,2.0,3,7,1660,0.0,1906,1660,4800,42435 days 16:47:18.660890,274,1.7142857142857142,0.0,0,0,1660.0
1020000.0,4,2.5,2960,4760,2.0,3,8,2160,800.0,1900,1600,4760,44626 days 16:47:18.660890,063,1.6,2.7,1360,0,1360.0
463500.0,1,1.0,1090,8750,1.0,4,6,1090,0.0,1924,1830,5000,35861 days 16:47:18.660890,273,1.0,0.0,-740,3750,1090.0
485000.0,3,2.5,3110,9015,2.0,3,9,3110,0.0,1990,2650,8960,11754 days 16:47:18.660890,248,1.2,0.0,460,55,3110.0
272000.0,3,2.0,1380,7476,1.0,3,7,1380,0.0,1989,1600,7227,12119 days 16:47:18.660890,168,1.5,0.0,-220,249,1380.0
305000.0,2,1.0,1290,3140,2.0,3,7,1290,0.0,2008,1290,2628,5180 days 16:47:18.660890,351,2.0,0.0,0,512,1290.0
760000.0,3,2.5,1980,13964,1.0,5,7,1980,0.0,1959,2040,13964,23077 days 16:47:18.660890,177,1.2,0.0,-60,0,1980.0
387500.0,2,1.0,870,6126,1.0,4,7,870,0.0,1938,1620,6126,30747 days 16:47:18.660890,044,2.0,0.0,-750,0,870.0
352000.0,4,2.5,2470,5015,2.0,3,8,2470,0.0,2004,2470,5100,6641 days 16:47:18.660890,251,1.6,0.0,0,-85,2470.0
507000.0,3,1.75,2140,40098,1.0,5,8,1490,650.0,1950,2220,35371,26364 days 16:47:18.660890,190,1.7142857142857142,2.292307692307692,-80,4727,840.0
156000.0,3,1.0,770,9750,1.0,3,6,770,0.0,1941,1560,10707,29651 days 16:47:18.660890,199,3.0,0.0,-790,-957,770.0
580000.0,3,3.25,1490,857,3.0,3,8,1220,270.0,2001,1550,1092,7736 days 16:47:18.660890,322,0.9230769230769231,4.518518518518518,-60,-235,950.0
630000.0,4,2.5,2510,35020,1.0,4,8,1610,900.0,1977,2080,34398,16502 days 16:47:18.660890,195,1.6,1.788888888888889,430,622,710.0
275000.0,5,1.5,1950,9000,1.0,3,7,1130,820.0,1964,1680,9526,21251 days 16:47:18.660890,352,3.3333333333333335,1.3780487804878048,270,-526,310.0
835000.0,5,4.0,3600,14720,1.0,5,8,1800,1800.0,1960,3600,15358,22712 days 16:47:18.660890,205,1.25,1.0,0,-638,0.0
340000.0,4,2.5,2380,7850,2.0,3,8,2380,0.0,1995,1940,7334,9928 days 16:47:18.660890,339,1.6,0.0,440,516,2380.0
329350.0,2,1.0,720,6687,1.0,3,6,720,0.0,1942,840,6687,29286 days 16:47:18.660890,126,2.0,0.0,-120,0,720.0
1480000.0,3,3.5,4070,26000,2.0,3,1,4070,0.0,1991,3770,26000,11389 days 16:47:18.660890,209,0.8571428571428571,0.0,300,0,4070.0
475000.0,3,1.0,1250,150117,1.0,3,7,1250,0.0,1975,3060,50055,17233 days 16:47:18.660890,084,3.0,0.0,-1810,100062,1250.0
719950.0,3,2.25,2190,2416,3.0,3,8,2190,0.0,2014,1510,3615,2988 days 16:47:18.660890,322,1.3333333333333333,0.0,680,-1199,2190.0
235000.0,1,1.0,810,2451,1.0,5,7,810,0.0,1941,980,1198,29651 days 16:47:18.660890,132,1.0,0.0,-170,1253,810.0
875000.0,3,1.5,2440,5750,1.0,3,8,1320,1120.0,1939,2160,6820,30382 days 16:47:18.660890,090,2.0,1.1785714285714286,280,-1070,200.0
380000.0,4,1.75,1740,9150,1.0,3,7,1740,0.0,1974,1540,9147,17598 days 16:47:18.660890,111,2.2857142857142856,0.0,200,3,1740.0
325000.0,3,2.25,1480,97138,1.5,3,7,1480,0.0,1984,1730,176418,13946 days 16:47:18.660890,068,1.3333333333333333,0.0,-250,-79280,1480.0
475000.0,4,2.5,2120,57050,2.0,3,9,2120,0.0,1989,3320,39082,12119 days 16:47:18.660890,231,1.6,0.0,-1200,17968,2120.0
152900.0,1,1.0,900,4368,1.0,5,6,900,0.0,1915,1290,5000,39148 days 16:47:18.660890,083,1.0,0.0,-390,-632,900.0
210000.0,2,2.0,1190,7570,1.0,3,6,1190,0.0,1939,1190,7635,30382 days 16:47:18.660890,217,1.0,0.0,0,-65,1190.0
350000.0,4,1.0,1010,6000,1.0,3,6,750,260.0,1925,1450,6000,35495 days 16:47:18.660890,269,4.0,2.8846153846153846,-440,0,490.0
505000.0,3,2.5,2100,17882,2.0,4,8,2100,0.0,1985,2080,16686,13580 days 16:47:18.660890,082,1.2,0.0,20,1196,2100.0
464900.0,4,2.25,2020,8424,1.0,4,7,1380,640.0,1979,2030,7236,15772 days 16:47:18.660890,178,1.7777777777777777,2.15625,-10,1188,740.0
650000.0,3,2.0,2520,5980,1.0,3,8,1790,730.0,1957,1590,5750,23807 days 16:47:18.660890,265,1.5,2.452054794520548,930,230,1060.0
369950.0,2,2.75,1370,1140,2.0,3,8,1080,290.0,2009,1370,1090,4814 days 16:47:18.660890,124,0.7272727272727273,3.7241379310344827,0,50,790.0
250000.0,3,2.5,1530,2890,2.0,3,7,1530,0.0,2001,1540,2890,7736 days 16:47:18.660890,209,1.2,0.0,-10,0,1530.0
320000.0,3,2.5,1530,2890,2.0,3,7,1530,0.0,2001,1540,2890,7736 days 16:47:18.660890,119,1.2,0.0,-10,0,1530.0
2530000.0,4,4.25,5040,16048,1.0,3,1,3420,1620.0,1950,3960,14000,26364 days 16:47:18.660890,084,0.9411764705882353,2.111111111111111,1080,2048,1800.0
340000.0,4,2.25,2530,24700,2.0,3,7,2530,0.0,1974,2650,24700,17598 days 16:47:18.660890,246,1.7777777777777777,0.0,-120,0,2530.0
440000.0,2,1.5,1010,1968,1.5,5,5,1010,0.0,1906,1760,4200,42435 days 16:47:18.660890,139,1.3333333333333333,0.0,-750,-2232,1010.0
940000.0,4,3.0,2720,11740,1.0,5,9,2720,0.0,1957,2640,11740,23807 days 16:47:18.660890,258,1.3333333333333333,0.0,80,0,2720.0
399950.0,4,1.5,1850,6125,1.5,3,6,1110,740.0,1945,990,6125,28190 days 16:47:18.660890,203,2.6666666666666665,1.5,860,0,370.0
1570000.0,3,2.75,2340,8828,1.0,4,9,2340,0.0,1954,3480,8526,24903 days 16:47:18.660890,002,1.0909090909090908,0.0,-1140,302,2340.0
528000.0,4,1.75,1860,9750,1.0,3,7,1460,400.0,1969,1900,8913,19424 days 16:47:18.660890,091,2.2857142857142856,3.65,-40,837,1060.0
545000.0,4,1.75,1940,8990,1.0,4,8,1560,380.0,1956,2310,11745,24173 days 16:47:18.660890,240,2.2857142857142856,4.105263157894737,-370,-2755,1180.0
575000.0,2,2.0,1680,6194,1.0,3,8,1680,0.0,2004,1900,5850,6641 days 16:47:18.660890,117,1.0,0.0,-220,344,1680.0
235000.0,4,2.75,1770,10184,1.0,3,8,1250,520.0,1979,2070,8320,15772 days 16:47:18.660890,308,1.4545454545454546,2.4038461538461537,-300,1864,730.0
272000.0,3,2.5,1790,6371,2.0,3,8,1790,0.0,1998,1850,6371,8832 days 16:47:18.660890,204,1.2,0.0,-60,0,1790.0
380000.0,4,1.75,1720,9600,1.0,4,8,1720,0.0,1969,1660,10720,19424 days 16:47:18.660890,118,2.2857142857142856,0.0,60,-1120,1720.0
195000.0,3,1.0,1280,6967,1.5,3,7,1280,0.0,1949,1280,7245,26729 days 16:47:18.660890,116,3.0,0.0,0,-278,1280.0
297000.0,3,2.5,1690,4988,2.0,3,7,1690,0.0,2002,1830,4733,7371 days 16:47:18.660890,287,1.2,0.0,-140,255,1690.0
349000.0,4,2.5,2190,7294,2.0,3,8,2190,0.0,2003,2240,7379,7006 days 16:47:18.660890,105,1.6,0.0,-50,-85,2190.0
320000.0,2,1.0,710,5200,1.0,4,6,710,0.0,1942,1610,5200,29286 days 16:47:18.660890,272,2.0,0.0,-900,0,710.0
319990.0,4,1.5,1890,10707,1.0,3,7,1890,0.0,1962,1610,8827,21981 days 16:47:18.660890,206,2.6666666666666665,0.0,280,1880,1890.0
439900.0,2,2.0,1410,12282,1.5,5,8,1410,0.0,1909,1410,8931,41339 days 16:47:18.660890,153,1.0,0.0,0,3351,1410.0
429000.0,3,3.25,2210,3600,2.0,3,8,1820,390.0,1995,2010,6690,9928 days 16:47:18.660890,223,0.9230769230769231,4.666666666666667,200,-3090,1430.0
272500.0,3,2.0,1540,6250,1.0,3,7,1540,0.0,1998,2070,6250,8832 days 16:47:18.660890,211,1.5,0.0,-530,0,1540.0
400000.0,4,2.0,1350,7255,1.0,4,7,1350,0.0,1959,1050,7288,23077 days 16:47:18.660890,259,2.0,0.0,300,-33,1350.0
462000.0,5,2.0,1380,4300,1.5,3,7,1380,0.0,1916,1830,3800,38783 days 16:47:18.660890,092,2.5,0.0,-450,500,1380.0
510000.0,2,1.0,890,6095,1.0,3,7,890,0.0,1947,1450,5985,27460 days 16:47:18.660890,069,2.0,0.0,-560,110,890.0
550000.0,3,2.5,1900,3255,2.0,3,8,1900,0.0,1988,1880,3350,12485 days 16:47:18.660890,174,1.2,0.0,20,-95,1900.0
150000.0,3,1.0,1240,5200,1.0,3,6,1240,0.0,1969,870,5200,19424 days 16:47:18.660890,115,3.0,0.0,370,0,1240.0
460000.0,3,2.5,1730,8490,1.0,3,7,1210,520.0,1969,1870,7400,19424 days 16:47:18.660890,177,1.2,2.326923076923077,-140,1090,690.0
632500.0,4,2.5,2090,10306,2.0,3,1,2090,0.0,1986,2660,11481,13215 days 16:47:18.660890,171,1.6,0.0,-570,-1175,2090.0
361000.0,3,1.75,1650,11220,1.0,4,7,1650,0.0,1969,1340,10129,19424 days 16:47:18.660890,268,1.7142857142857142,0.0,310,1091,1650.0
437000.0,3,2.25,1130,1221,2.0,3,8,1030,100.0,2004,1300,5000,6641 days 16:47:18.660890,213,1.3333333333333333,10.3,-170,-3779,930.0
370000.0,6,2.75,3240,5750,1.0,4,6,2160,1080.0,1950,1230,5750,26364 days 16:47:18.660890,125,2.1818181818181817,2.0,2010,0,1080.0
884250.0,4,2.5,3840,12151,2.0,3,1,3840,0.0,1998,3560,11044,8832 days 16:47:18.660890,107,1.6,0.0,280,1107,3840.0
225000.0,3,1.0,1200,9936,1.0,4,6,1200,0.0,1969,1200,10189,19424 days 16:47:18.660890,154,3.0,0.0,0,-253,1200.0
235000.0,2,1.0,870,5000,1.0,3,6,870,0.0,1949,820,5000,26729 days 16:47:18.660890,217,2.0,0.0,50,0,870.0
767500.0,6,3.5,2410,6000,2.0,3,9,2220,190.0,1916,1980,6000,38783 days 16:47:18.660890,201,1.7142857142857142,11.68421052631579,430,0,2030.0
1200000.0,3,1.75,1560,8078,1.5,4,6,1560,0.0,1928,2890,16710,34400 days 16:47:18.660890,132,1.7142857142857142,0.0,-1330,-8632,1560.0
715000.0,3,2.5,2410,46609,2.0,3,9,2410,0.0,1989,3370,40072,12119 days 16:47:18.660890,349,1.2,0.0,-960,6537,2410.0
417000.0,4,2.25,2300,7700,1.0,3,7,1380,920.0,1959,2010,8820,23077 days 16:47:18.660890,178,1.7777777777777777,1.5,290,-1120,460.0
199000.0,3,1.0,1390,12145,1.0,4,7,1390,0.0,1964,1030,10800,21251 days 16:47:18.660890,199,3.0,0.0,360,1345,1390.0
875000.0,5,2.5,2920,5568,2.0,3,8,2320,600.0,1906,2970,5568,42435 days 16:47:18.660890,156,2.0,3.8666666666666667,-50,0,1720.0
545000.0,4,1.5,1370,3708,1.5,3,7,1370,0.0,1926,2030,3708,35130 days 16:47:18.660890,314,2.6666666666666665,0.0,-660,0,1370.0
192500.0,2,1.0,950,7692,1.0,3,6,950,0.0,1926,1820,8221,35130 days 16:47:18.660890,140,2.0,0.0,-870,-529,950.0
822500.0,3,2.5,3090,7708,2.0,3,1,3090,0.0,1999,3140,8592,8467 days 16:47:18.660890,041,1.2,0.0,-50,-884,3090.0
800000.0,4,2.5,2390,10000,1.0,3,9,1590,800.0,1975,1900,9752,17233 days 16:47:18.660890,342,1.6,1.9875,490,248,790.0
1250000.0,3,2.5,2070,4944,2.0,3,9,2070,0.0,1930,3300,6179,33669 days 16:47:18.660890,349,1.2,0.0,-1230,-1235,2070.0
3850000.0,4,4.25,5770,21300,2.0,4,1,5770,0.0,1980,4620,22748,15407 days 16:47:18.660890,318,0.9411764705882353,0.0,1150,-1448,5770.0
295000.0,3,2.5,1460,7936,2.0,3,7,1460,0.0,1995,1830,7936,9928 days 16:47:18.660890,274,1.2,0.0,-370,0,1460.0
419000.0,2,1.75,1510,4980,1.0,3,8,1510,0.0,2006,1350,4157,5910 days 16:47:18.660890,181,1.1428571428571428,0.0,160,823,1510.0
1200000.0,5,3.25,5180,19606,1.0,3,1,2610,2570.0,1993,4050,15296,10658 days 16:47:18.660890,253,1.5384615384615385,1.0155642023346303,1130,4310,40.0
750000.0,4,2.75,3430,13907,2.0,3,1,3430,0.0,1995,3250,13851,9928 days 16:47:18.660890,356,1.4545454545454546,0.0,180,56,3430.0
502000.0,4,1.5,1700,8400,1.0,3,7,1700,0.0,1953,1750,8475,25268 days 16:47:18.660890,118,2.6666666666666665,0.0,-50,-75,1700.0
1030000.0,3,1.75,2640,8000,1.0,4,9,1320,1320.0,1960,2740,6000,22712 days 16:47:18.660890,155,1.7142857142857142,1.0,-100,2000,0.0
398500.0,3,1.0,1200,15960,1.5,3,6,1200,0.0,1945,1120,7800,28190 days 16:47:18.660890,072,3.0,0.0,80,8160,1200.0
700000.0,2,1.5,1850,4945,1.5,4,7,1850,0.0,1907,1850,4950,42070 days 16:47:18.660890,104,1.3333333333333333,0.0,0,-5,1850.0
248000.0,5,1.5,1510,9078,1.0,4,7,1510,0.0,1959,1480,9078,23077 days 16:47:18.660890,162,3.3333333333333335,0.0,30,0,1510.0
800000.0,4,2.0,2130,2800,1.0,5,7,1070,1060.0,1922,1990,3990,36591 days 16:47:18.660890,238,2.0,1.009433962264151,140,-1190,10.0
383000.0,4,2.5,2640,8055,2.0,3,9,2640,0.0,2004,1650,8055,6641 days 16:47:18.660890,021,1.6,0.0,990,0,2640.0
688000.0,4,3.0,3000,4000,1.5,3,8,1970,1030.0,1913,1900,4000,39878 days 16:47:18.660890,147,1.3333333333333333,1.912621359223301,1100,0,940.0
521000.0,3,2.0,1870,5455,1.0,5,7,1060,810.0,1926,1870,7435,35130 days 16:47:18.660890,281,1.5,1.308641975308642,0,-1980,250.0
365000.0,2,1.0,990,9223,1.0,3,7,990,0.0,1949,1230,7244,26729 days 16:47:18.660890,309,2.0,0.0,-240,1979,990.0
491000.0,3,2.0,2005,7000,1.0,3,7,1605,400.0,1980,1750,4500,15407 days 16:47:18.660890,280,1.5,4.0125,255,2500,1205.0
643000.0,3,2.75,2030,7700,1.0,5,8,1400,630.0,1965,1780,8160,20885 days 16:47:18.660890,326,1.0909090909090908,2.2222222222222223,250,-460,770.0
279000.0,3,2.5,1500,7350,1.0,2,7,1060,440.0,1979,1390,7770,15772 days 16:47:18.660890,033,1.2,2.409090909090909,110,-420,620.0
583500.0,4,1.0,1530,3900,1.5,4,7,1530,0.0,1908,1300,3900,41705 days 16:47:18.660890,033,4.0,0.0,230,0,1530.0
310000.0,3,2.5,1990,3600,2.0,3,7,1990,0.0,2004,1790,3600,6641 days 16:47:18.660890,204,1.2,0.0,200,0,1990.0
310000.0,3,1.75,1420,7650,1.0,4,7,1100,320.0,1984,1810,7650,13946 days 16:47:18.660890,161,1.7142857142857142,3.4375,-390,0,780.0
280000.0,3,1.0,1400,13975,1.0,4,6,1400,0.0,1956,1260,7500,24173 days 16:47:18.660890,082,3.0,0.0,140,6475,1400.0
272000.0,4,2.5,1870,5692,2.0,3,7,1870,0.0,2004,2390,5293,6641 days 16:47:18.660890,321,1.6,0.0,-520,399,1870.0
870000.0,4,3.0,3040,36246,1.5,3,9,2680,360.0,1923,3520,13178,36226 days 16:47:18.660890,188,1.3333333333333333,7.444444444444445,-480,23068,2320.0
307000.0,3,2.0,1790,7259,1.0,3,7,1390,400.0,1980,1790,7700,15407 days 16:47:18.660890,322,1.5,3.475,0,-441,990.0
490000.0,2,1.5,1590,4500,1.0,4,7,920,670.0,1946,1900,4450,27825 days 16:47:18.660890,198,1.3333333333333333,1.373134328358209,-310,50,250.0
399950.0,3,2.0,2050,9396,1.0,5,7,1170,880.0,1960,1680,9391,22712 days 16:47:18.660890,281,1.5,1.3295454545454546,370,5,290.0
1640000.0,5,3.5,4220,26784,1.0,3,1,2110,2110.0,1958,3450,33945,23442 days 16:47:18.660890,160,1.4285714285714286,1.0,770,-7161,0.0
989000.0,5,4.5,4030,13474,2.0,3,1,4030,0.0,2000,3860,12438,8102 days 16:47:18.660890,190,1.1111111111111112,0.0,170,1036,4030.0
264950.0,4,1.75,1770,9011,1.0,5,7,1050,720.0,1983,1410,8530,14311 days 16:47:18.660890,169,2.2857142857142856,1.4583333333333333,360,481,330.0
491500.0,4,2.75,2100,7236,1.0,3,8,1400,700.0,1979,1900,7519,15772 days 16:47:18.660890,206,1.4545454545454546,2.0,200,-283,700.0
345000.0,3,2.25,2120,15003,2.0,3,7,2120,0.0,1984,2070,15203,13946 days 16:47:18.660890,134,1.3333333333333333,0.0,50,-200,2120.0
339900.0,4,1.75,2600,18042,1.0,4,8,2020,580.0,1969,2200,9408,19424 days 16:47:18.660890,019,2.2857142857142856,3.4827586206896552,400,8634,1440.0
852000.0,3,3.0,2400,4000,2.0,3,7,1860,540.0,1905,1750,3940,42800 days 16:47:18.660890,117,1.0,3.4444444444444446,650,60,1320.0
585000.0,5,3.5,3180,40946,1.0,3,7,1690,1490.0,1968,2430,29620,19790 days 16:47:18.660890,356,1.4285714285714286,1.1342281879194631,750,11326,200.0
723000.0,4,2.0,2790,8793,1.0,4,8,1640,1150.0,1977,2400,9286,16502 days 16:47:18.660890,042,2.0,1.4260869565217391,390,-493,490.0
594000.0,3,2.25,2080,70567,2.0,3,8,2080,0.0,1990,3730,43560,11754 days 16:47:18.660890,026,1.3333333333333333,0.0,-1650,27007,2080.0
405000.0,2,1.5,1370,4102,2.0,4,7,1370,0.0,1987,1380,3211,12850 days 16:47:18.660890,335,1.3333333333333333,0.0,-10,891,1370.0
725500.0,4,2.5,2790,74495,2.0,3,9,2790,0.0,1997,2790,24643,9197 days 16:47:18.660890,213,1.6,0.0,0,49852,2790.0
800000.0,2,1.0,1740,5719,1.0,3,8,1740,0.0,1955,1980,5000,24538 days 16:47:18.660890,176,2.0,0.0,-240,719,1740.0
180500.0,3,2.5,1800,8518,2.0,3,7,1800,0.0,1996,1770,7570,9563 days 16:47:18.660890,288,1.2,0.0,30,948,1800.0
325000.0,3,2.5,1800,8518,2.0,3,7,1800,0.0,1996,1770,7570,9563 days 16:47:18.660890,118,1.2,0.0,30,948,1800.0
330000.0,2,1.0,860,8308,1.0,4,7,860,0.0,1948,1310,8308,27095 days 16:47:18.660890,140,2.0,0.0,-450,0,860.0
678500.0,3,2.0,2460,6600,1.0,4,8,1370,1090.0,1952,2150,6600,25634 days 16:47:18.660890,163,1.5,1.2568807339449541,310,0,280.0
463000.0,4,2.5,1980,6660,2.0,4,7,1980,0.0,1974,1980,7150,17598 days 16:47:18.660890,190,1.6,0.0,0,-490,1980.0
250000.0,2,1.0,670,4640,1.0,3,6,670,0.0,1943,870,4501,28921 days 16:47:18.660890,255,2.0,0.0,-200,139,670.0
655000.0,3,2.0,1410,4800,1.5,4,8,1410,0.0,1927,1820,7200,34765 days 16:47:18.660890,197,1.5,0.0,-410,-2400,1410.0
239900.0,4,2.25,1860,7000,1.0,3,8,1120,740.0,1979,1990,8937,15772 days 16:47:18.660890,136,1.7777777777777777,1.5135135135135136,-130,-1937,380.0
1740000.0,4,2.25,3040,5000,2.0,4,9,2080,960.0,1926,2870,5000,35130 days 16:47:18.660890,167,1.7777777777777777,2.1666666666666665,170,0,1120.0
251700.0,3,2.25,1810,11800,1.0,3,7,1240,570.0,1977,1810,5641,16502 days 16:47:18.660890,248,1.3333333333333333,2.175438596491228,0,6159,670.0
400000.0,4,2.0,1560,8250,1.0,3,8,1320,240.0,1964,1870,8258,21251 days 16:47:18.660890,040,2.0,5.5,-310,-8,1080.0
735000.0,4,1.75,2100,7960,1.0,3,8,1340,760.0,1955,2060,7960,24538 days 16:47:18.660890,247,2.2857142857142856,1.763157894736842,40,0,580.0
1700000.0,5,2.0,2500,15250,2.0,5,8,2500,0.0,1942,1880,18782,29286 days 16:47:18.660890,300,2.5,0.0,620,-3532,2500.0
82500.0,2,1.0,520,22334,1.0,2,5,520,0.0,1951,1572,10570,25999 days 16:47:18.660890,128,2.0,0.0,-1052,11764,520.0
765000.0,4,4.0,3010,7221,2.0,3,1,3010,0.0,2004,3490,7518,6641 days 16:47:18.660890,189,1.0,0.0,-480,-297,3010.0
292500.0,4,1.75,2140,8162,1.0,3,7,1420,720.0,1968,2040,7632,19790 days 16:47:18.660890,266,2.2857142857142856,1.9722222222222223,100,530,700.0
270000.0,3,2.25,2390,7000,1.0,4,7,1990,400.0,1970,1610,7000,19059 days 16:47:18.660890,084,1.3333333333333333,4.975,780,0,1590.0
415000.0,2,1.0,1510,6807,1.0,3,7,1090,420.0,1939,1460,6807,30382 days 16:47:18.660890,358,2.0,2.5952380952380953,50,0,670.0
950000.0,4,1.75,2210,19025,1.0,4,7,1460,750.0,1952,2640,14999,25634 days 16:47:18.660890,328,2.2857142857142856,1.9466666666666668,-430,4026,710.0
353000.0,3,2.75,2170,8396,2.0,3,7,2170,0.0,1995,2170,8378,9928 days 16:47:18.660890,259,1.0909090909090908,0.0,0,18,2170.0
670950.0,3,2.5,1790,2375,3.0,3,8,1790,0.0,2007,1450,2400,5545 days 16:47:18.660890,344,1.2,0.0,340,-25,1790.0
280950.0,3,1.75,1390,8700,1.0,4,7,840,550.0,1912,1390,10875,40244 days 16:47:18.660890,129,1.7142857142857142,1.5272727272727273,0,-2175,290.0
585000.0,3,1.75,1850,7735,1.0,4,8,1850,0.0,1983,2220,7639,14311 days 16:47:18.660890,147,1.7142857142857142,0.0,-370,96,1850.0
525000.0,2,1.5,1480,43645,1.0,3,8,1480,0.0,1974,1600,34326,17598 days 16:47:18.660890,345,1.3333333333333333,0.0,-120,9319,1480.0
605000.0,3,1.75,1850,8823,1.0,4,8,1370,480.0,1973,1880,7580,17963 days 16:47:18.660890,213,1.7142857142857142,2.8541666666666665,-30,1243,890.0
1010000.0,4,3.5,3350,3752,2.0,3,9,2550,800.0,2007,1050,4960,5545 days 16:47:18.660890,323,1.1428571428571428,3.1875,2300,-1208,1750.0
535000.0,4,2.25,2810,12607,2.0,3,1,2810,0.0,1985,2810,17400,13580 days 16:47:18.660890,034,1.7777777777777777,0.0,0,-4793,2810.0
410000.0,1,1.5,1010,5750,1.0,3,7,1010,0.0,1911,1230,5750,40609 days 16:47:18.660890,181,0.6666666666666666,0.0,-220,0,1010.0
550000.0,3,2.5,2250,7752,2.0,4,8,2250,0.0,1988,2080,7033,12485 days 16:47:18.660890,114,1.2,0.0,170,719,2250.0
665000.0,3,1.75,1800,8000,1.0,3,8,1800,0.0,1972,1950,8500,18329 days 16:47:18.660890,254,1.7142857142857142,0.0,-150,-500,1800.0
455000.0,3,1.0,2400,17239,1.0,4,7,1890,510.0,1940,2390,7350,30017 days 16:47:18.660890,117,3.0,3.7058823529411766,10,9889,1380.0
440000.0,4,1.0,1780,4000,1.5,3,7,1780,0.0,1922,1750,4000,36591 days 16:47:18.660890,238,4.0,0.0,30,0,1780.0
332000.0,3,2.25,2120,14915,1.0,3,9,1720,400.0,1979,2320,13100,15772 days 16:47:18.660890,189,1.3333333333333333,4.3,-200,1815,1320.0
280000.0,3,2.5,1860,6607,2.0,3,7,1860,0.0,1989,1760,6766,12119 days 16:47:18.660890,162,1.2,0.0,100,-159,1860.0
570000.0,3,3.5,1460,1021,2.0,3,8,1150,310.0,2006,1460,1245,5910 days 16:47:18.660890,258,0.8571428571428571,3.7096774193548385,0,-224,840.0
250000.0,3,1.0,1230,10350,1.0,4,7,1230,0.0,1957,1510,10427,23807 days 16:47:18.660890,135,3.0,0.0,-280,-77,1230.0
238000.0,2,1.0,1088,8453,1.0,3,6,1088,0.0,1952,1088,8016,25634 days 16:47:18.660890,121,2.0,0.0,0,437,1088.0
306000.0,3,1.0,1190,10350,1.0,4,7,1190,0.0,1959,1850,10500,23077 days 16:47:18.660890,064,3.0,0.0,-660,-150,1190.0
345000.0,5,2.75,1940,4182,1.0,3,7,1240,700.0,2002,1950,4182,7371 days 16:47:18.660890,127,1.8181818181818181,1.7714285714285714,-10,0,540.0
765000.0,4,2.5,3300,10764,1.0,4,9,1720,1580.0,1971,2290,10975,18694 days 16:47:18.660890,247,1.6,1.0886075949367089,1010,-211,140.0
346300.0,4,2.5,2590,11018,2.0,3,8,2590,0.0,1998,2400,8042,8832 days 16:47:18.660890,120,1.6,0.0,190,2976,2590.0
342500.0,3,2.0,2080,11375,1.0,3,8,2080,0.0,2002,1080,12899,7371 days 16:47:18.660890,163,1.5,0.0,1000,-1524,2080.0
501000.0,4,2.25,2680,5439,2.0,3,7,2680,0.0,2000,2460,4473,8102 days 16:47:18.660890,114,1.7777777777777777,0.0,220,966,2680.0
270000.0,3,2.5,1670,8364,1.0,4,7,1300,370.0,1990,1490,8143,11754 days 16:47:18.660890,176,1.2,3.5135135135135136,180,221,930.0
638000.0,3,1.0,1830,4400,1.5,4,8,1720,110.0,1930,1650,4400,33669 days 16:47:18.660890,112,3.0,15.636363636363637,180,0,1610.0
460000.0,3,1.75,1400,2003,1.0,4,8,700,700.0,1908,1370,1281,41705 days 16:47:18.660890,255,1.7142857142857142,1.0,30,722,0.0
760000.0,4,1.75,2770,8521,1.0,4,7,1470,1300.0,1953,1910,9380,25268 days 16:47:18.660890,288,2.2857142857142856,1.1307692307692307,860,-859,170.0
1090000.0,3,2.5,3630,11019,1.0,4,9,2150,1480.0,1972,3150,13555,18329 days 16:47:18.660890,075,1.2,1.4527027027027026,480,-2536,670.0
234000.0,3,1.0,1040,8128,1.0,3,6,1040,0.0,1983,1520,7500,14311 days 16:47:18.660890,179,3.0,0.0,-480,628,1040.0
1650000.0,3,2.75,2690,8890,2.0,4,1,2690,0.0,1975,2940,8890,17233 days 16:47:18.660890,061,1.0909090909090908,0.0,-250,0,2690.0
488000.0,5,2.0,2020,5000,1.5,4,7,2020,0.0,1938,1510,6600,30747 days 16:47:18.660890,126,2.5,0.0,510,-1600,2020.0
1550000.0,5,2.5,2450,20805,2.0,4,9,2450,0.0,1963,3020,20324,21616 days 16:47:18.660890,057,2.0,0.0,-570,481,2450.0
499000.0,4,3.0,2030,12675,2.0,3,7,2030,0.0,1982,1990,7705,14676 days 16:47:18.660890,086,1.3333333333333333,0.0,40,4970,2030.0
150000.0,3,1.0,1450,6776,1.0,3,7,1450,0.0,1952,1680,7200,25634 days 16:47:18.660890,247,3.0,0.0,-230,-424,1450.0
333000.0,4,2.5,2400,7270,2.0,3,8,2400,0.0,1993,2150,6584,10658 days 16:47:18.660890,085,1.6,0.0,250,686,2400.0
700000.0,4,2.75,2870,8625,1.0,4,8,1860,1010.0,1959,2430,8479,23077 days 16:47:18.660890,049,1.4545454545454546,1.8415841584158417,440,146,850.0
275000.0,4,1.0,1340,22500,1.5,3,7,1340,0.0,1926,1620,10800,35130 days 16:47:18.660890,261,4.0,0.0,-280,11700,1340.0
330000.0,3,2.5,1680,11312,1.0,3,7,1080,600.0,1959,1390,10700,23077 days 16:47:18.660890,182,1.2,1.8,290,612,480.0
360000.0,4,2.0,1850,8827,1.0,3,7,1850,0.0,1969,1310,6901,19424 days 16:47:18.660890,328,2.0,0.0,540,1926,1850.0
467000.0,3,1.0,1220,8040,1.5,3,7,1220,0.0,1965,1360,8040,20885 days 16:47:18.660890,131,3.0,0.0,-140,0,1220.0
568000.0,3,2.5,2320,57063,1.0,4,9,1790,530.0,1979,3290,7314,15772 days 16:47:18.660890,302,1.2,3.3773584905660377,-970,49749,1260.0
605000.0,5,2.25,3220,9603,2.0,3,8,3220,0.0,1972,2260,10093,18329 days 16:47:18.660890,307,2.2222222222222223,0.0,960,-490,3220.0
750000.0,4,2.75,3190,9023,2.0,3,9,3190,0.0,2005,3159,5615,6275 days 16:47:18.660890,275,1.4545454545454546,0.0,31,3408,3190.0
760000.0,3,2.75,3530,69834,2.0,3,1,3530,0.0,1994,3560,74256,10293 days 16:47:18.660890,287,1.0909090909090908,0.0,-30,-4422,3530.0
265000.0,3,1.75,2050,10519,1.0,3,7,1240,810.0,1979,1770,9605,15772 days 16:47:18.660890,216,1.7142857142857142,1.5308641975308641,280,914,430.0
490000.0,3,1.75,1720,12540,1.0,4,7,1720,0.0,1956,1440,11850,24173 days 16:47:18.660890,199,1.7142857142857142,0.0,280,690,1720.0
360000.0,4,2.5,2850,4650,2.0,3,8,2850,0.0,2004,2850,4650,6641 days 16:47:18.660890,170,1.6,0.0,0,0,2850.0
311750.0,4,2.25,2270,12000,1.0,4,7,1290,980.0,1976,2030,23980,16868 days 16:47:18.660890,037,1.7777777777777777,1.316326530612245,240,-11980,310.0
399000.0,3,2.25,1880,12473,1.0,3,8,1420,460.0,1958,2300,10469,23442 days 16:47:18.660890,276,1.3333333333333333,3.0869565217391304,-420,2004,960.0
347000.0,4,2.5,2770,9751,2.0,3,8,2770,0.0,1989,2370,6950,12119 days 16:47:18.660890,206,1.6,0.0,400,2801,2770.0
1680000.0,4,3.75,4490,34982,2.0,3,1,4490,0.0,1998,4470,37525,8832 days 16:47:18.660890,247,1.0666666666666667,0.0,20,-2543,4490.0
340000.0,4,2.5,2360,7475,2.0,3,8,2360,0.0,1992,2280,7570,11024 days 16:47:18.660890,255,1.6,0.0,80,-95,2360.0
612000.0,3,2.5,2180,5496,2.0,3,8,2180,0.0,1994,2120,5496,10293 days 16:47:18.660890,105,1.2,0.0,60,0,2180.0
230000.0,2,1.75,1910,3376,2.0,3,8,1910,0.0,1980,1470,3623,15407 days 16:47:18.660890,179,1.1428571428571428,0.0,440,-247,1910.0
604000.0,4,2.5,2260,7753,2.0,3,9,2260,0.0,1989,2690,8924,12119 days 16:47:18.660890,129,1.6,0.0,-430,-1171,2260.0
250000.0,3,1.75,1770,8868,1.0,4,7,1770,0.0,1959,1630,9706,23077 days 16:47:18.660890,184,1.7142857142857142,0.0,140,-838,1770.0
258500.0,3,2.0,1460,7930,1.0,3,7,1460,0.0,1989,1630,7930,12119 days 16:47:18.660890,068,1.5,0.0,-170,0,1460.0
783000.0,4,2.75,2080,5000,1.0,5,8,1470,610.0,1940,1970,5000,30017 days 16:47:18.660890,083,1.4545454545454546,2.4098360655737703,110,0,860.0
1050000.0,5,2.25,2960,7680,1.0,5,8,1550,1410.0,1958,2860,7680,23442 days 16:47:18.660890,303,2.2222222222222223,1.099290780141844,100,0,140.0
760000.0,4,2.5,3220,4031,2.0,3,9,3220,0.0,2002,3150,5083,7371 days 16:47:18.660890,077,1.6,0.0,70,-1052,3220.0
276000.0,3,1.0,1140,5000,1.0,3,7,1140,0.0,1960,1140,5000,22712 days 16:47:18.660890,146,3.0,0.0,0,0,1140.0
550000.0,4,2.0,1660,12377,1.0,3,8,1660,0.0,1966,1820,8968,20520 days 16:47:18.660890,082,2.0,0.0,-160,3409,1660.0
398000.0,4,1.0,1430,6240,1.5,5,7,1430,0.0,1953,1410,6240,25268 days 16:47:18.660890,118,4.0,0.0,20,0,1430.0
775000.0,3,3.0,1820,4300,1.5,4,8,1620,200.0,1914,1440,4300,39513 days 16:47:18.660890,072,1.0,8.1,380,0,1420.0
1030000.0,4,3.0,3540,10202,2.0,3,8,2720,820.0,1988,2780,10714,12485 days 16:47:18.660890,099,1.3333333333333333,3.317073170731707,760,-512,1900.0
327000.0,4,1.0,1620,6000,1.5,5,7,1620,0.0,1905,1310,6000,42800 days 16:47:18.660890,296,4.0,0.0,310,0,1620.0
564500.0,4,2.75,3100,14568,2.0,3,8,3100,0.0,1995,2860,14396,9928 days 16:47:18.660890,111,1.4545454545454546,0.0,240,172,3100.0
398000.0,4,2.5,2820,5510,2.0,3,9,2820,0.0,2005,2820,5510,6275 days 16:47:18.660890,028,1.6,0.0,0,0,2820.0
257000.0,3,1.75,1850,10920,1.5,3,6,1850,0.0,1915,1510,7871,39148 days 16:47:18.660890,030,1.7142857142857142,0.0,340,3049,1850.0
235000.0,4,2.0,1570,9415,2.0,4,7,1570,0.0,1984,1550,8978,13946 days 16:47:18.660890,176,2.0,0.0,20,437,1570.0
453000.0,4,2.75,2300,37533,1.0,5,8,1550,750.0,1979,2130,10092,15772 days 16:47:18.660890,178,1.4545454545454546,2.066666666666667,170,27441,800.0
535000.0,2,1.0,920,9000,1.0,1,6,920,0.0,1954,1760,8400,24903 days 16:47:18.660890,075,2.0,0.0,-840,600,920.0
275000.0,3,2.5,1600,7000,2.0,4,8,1600,0.0,1993,1700,7000,10658 days 16:47:18.660890,127,1.2,0.0,-100,0,1600.0
665000.0,3,2.5,2630,10047,2.0,3,9,2630,0.0,1996,2640,10620,9563 days 16:47:18.660890,258,1.2,0.0,-10,-573,2630.0
670000.0,4,2.75,3020,13530,1.0,4,8,1540,1480.0,1977,2230,11896,16502 days 16:47:18.660890,218,1.4545454545454546,1.0405405405405406,790,1634,60.0
465000.0,3,1.75,1490,10757,1.0,3,7,1060,430.0,1966,1490,10609,20520 days 16:47:18.660890,117,1.7142857142857142,2.4651162790697674,0,148,630.0
210000.0,3,1.5,1160,5200,1.0,5,7,1160,0.0,1970,1170,5200,19059 days 16:47:18.660890,296,2.0,0.0,-10,0,1160.0
265000.0,4,2.5,2040,4443,2.0,3,8,2040,0.0,2001,2040,4637,7736 days 16:47:18.660890,338,1.6,0.0,0,-194,2040.0
426000.0,2,2.5,1550,2657,2.0,4,8,1550,0.0,1987,1570,2442,12850 days 16:47:18.660890,103,0.8,0.0,-20,215,1550.0
529219.0,4,2.25,1990,7610,1.0,4,8,1290,700.0,1966,1820,8198,20520 days 16:47:18.660890,302,1.7777777777777777,1.8428571428571427,170,-588,590.0
600000.0,3,2.25,1900,46609,1.5,4,7,1440,460.0,1969,2460,43560,19424 days 16:47:18.660890,189,1.3333333333333333,3.130434782608696,-560,3049,980.0
875000.0,5,3.5,3840,8279,2.0,3,9,3840,0.0,2001,3570,8279,7736 days 16:47:18.660890,182,1.4285714285714286,0.0,270,0,3840.0
608000.0,4,3.0,2400,7680,1.0,3,7,1200,1200.0,1956,2670,6342,24173 days 16:47:18.660890,006,1.3333333333333333,1.0,-270,1338,0.0
220000.0,3,1.0,1660,21514,1.0,4,7,1660,0.0,1973,1660,21600,17963 days 16:47:18.660890,316,3.0,0.0,0,-86,1660.0
1760000.0,4,5.0,6055,21630,1.0,4,1,3555,2500.0,1996,4890,19223,9563 days 16:47:18.660890,223,0.8,1.422,1165,2407,1055.0
295450.0,3,2.0,2030,17120,1.0,4,8,1890,140.0,1966,1870,13662,20520 days 16:47:18.660890,230,1.5,13.5,160,3458,1750.0
315000.0,2,1.0,840,5087,1.0,3,7,840,0.0,1925,1590,5087,35495 days 16:47:18.660890,315,2.0,0.0,-750,0,840.0
205000.0,4,2.0,1450,8175,1.0,4,7,1450,0.0,1967,1570,9024,20155 days 16:47:18.660890,044,2.0,0.0,-120,-849,1450.0
310000.0,3,1.5,1460,9908,1.0,3,7,1460,0.0,1952,1420,9582,25634 days 16:47:18.660890,190,2.0,0.0,40,326,1460.0
1000000.0,5,1.0,2010,5210,1.5,3,9,1890,120.0,1927,2330,5000,34765 days 16:47:18.660890,123,5.0,15.75,-320,210,1770.0
525000.0,4,2.5,2910,7631,2.0,3,9,2910,0.0,2006,3190,5552,5910 days 16:47:18.660890,153,1.6,0.0,-280,2079,2910.0
284000.0,4,1.75,1880,8800,1.0,3,7,1130,750.0,1960,1340,8733,22712 days 16:47:18.660890,190,2.2857142857142856,1.5066666666666666,540,67,380.0
510000.0,3,1.75,2170,26460,1.0,3,8,1450,720.0,1986,2090,29075,13215 days 16:47:18.660890,134,1.7142857142857142,2.013888888888889,80,-2615,730.0
405000.0,2,1.0,1260,4377,1.0,4,7,1260,0.0,1947,1420,6376,27460 days 16:47:18.660890,170,2.0,0.0,-160,-1999,1260.0
509950.0,3,2.5,1970,9153,2.0,3,8,1970,0.0,2007,1800,9800,5545 days 16:47:18.660890,259,1.2,0.0,170,-647,1970.0
600000.0,4,2.25,2090,45738,2.0,3,8,2090,0.0,1987,3420,45738,12850 days 16:47:18.660890,300,1.7777777777777777,0.0,-1330,0,2090.0
990000.0,4,3.75,3450,4940,2.0,3,1,2570,880.0,2006,1880,5387,5910 days 16:47:18.660890,113,1.0666666666666667,2.9204545454545454,1570,-447,1690.0
280005.0,3,1.5,1130,7200,1.0,3,7,1130,0.0,1954,1130,7200,24903 days 16:47:18.660890,104,2.0,0.0,0,0,1130.0
700000.0,3,1.75,2600,7668,1.0,4,8,1300,1300.0,1968,1980,13664,19790 days 16:47:18.660890,246,1.7142857142857142,1.0,620,-5996,0.0
330000.0,3,1.0,1030,7620,1.0,3,7,1030,0.0,1953,1030,7560,25268 days 16:47:18.660890,216,3.0,0.0,0,60,1030.0
340000.0,2,1.0,1700,6718,1.0,3,7,1230,470.0,1956,2040,7500,24173 days 16:47:18.660890,054,2.0,2.617021276595745,-340,-782,760.0
468000.0,2,2.5,1480,2167,2.0,3,8,1390,90.0,2007,2130,2556,5545 days 16:47:18.660890,230,0.8,15.444444444444445,-650,-389,1300.0
1340000.0,4,2.5,4250,19387,2.0,4,9,3260,990.0,1972,3690,17024,18329 days 16:47:18.660890,160,1.6,3.292929292929293,560,2363,2270.0
515000.0,3,1.75,1600,20873,1.0,3,8,1600,0.0,1955,2640,18364,24538 days 16:47:18.660890,262,1.7142857142857142,0.0,-1040,2509,1600.0
245000.0,4,2.0,1870,8750,1.0,3,7,1870,0.0,1977,1770,8207,16502 days 16:47:18.660890,316,2.0,0.0,100,543,1870.0
265000.0,3,2.5,1440,7741,1.0,4,7,1000,440.0,1983,1680,7316,14311 days 16:47:18.660890,147,1.2,2.272727272727273,-240,425,560.0
372400.0,3,2.5,2720,11937,2.0,3,9,2720,0.0,1990,2590,9683,11754 days 16:47:18.660890,076,1.2,0.0,130,2254,2720.0
390000.0,3,1.5,1240,8410,1.0,5,6,1240,0.0,1948,1630,8410,27095 days 16:47:18.660890,124,2.0,0.0,-390,0,1240.0
208000.0,3,1.0,1020,6120,1.0,4,7,1020,0.0,1967,1370,8000,20155 days 16:47:18.660890,034,3.0,0.0,-350,-1880,1020.0
273000.0,2,0.5,1180,7750,1.0,4,6,590,590.0,1945,1380,8976,28190 days 16:47:18.660890,276,4.0,1.0,-200,-1226,0.0
455000.0,5,3.5,3080,7759,2.0,3,8,2310,770.0,2003,2980,8223,7006 days 16:47:18.660890,282,1.4285714285714286,3.0,100,-464,1540.0
270000.0,4,2.5,1750,6397,2.0,3,7,1750,0.0,1988,1940,6502,12485 days 16:47:18.660890,089,1.6,0.0,-190,-105,1750.0
618000.0,4,2.25,2530,8736,1.0,4,7,1210,1320.0,1958,1720,8500,23442 days 16:47:18.660890,211,1.7777777777777777,0.9166666666666666,810,236,-110.0
213550.0,3,2.5,1580,8541,2.0,3,7,1580,0.0,1990,1640,7542,11754 days 16:47:18.660890,294,1.2,0.0,-60,999,1580.0
210000.0,5,1.75,2340,9148,2.0,3,7,2340,0.0,1957,1390,10019,23807 days 16:47:18.660890,210,2.857142857142857,0.0,950,-871,2340.0
2750000.0,5,4.0,6300,16065,2.0,3,1,4360,1940.0,2004,3260,17287,6641 days 16:47:18.660890,012,1.25,2.247422680412371,3040,-1222,2420.0
403500.0,4,2.75,2400,3844,1.0,5,7,1200,1200.0,1974,1100,3844,17598 days 16:47:18.660890,349,1.4545454545454546,1.0,1300,0,0.0
235000.0,3,1.5,1300,7600,1.0,4,7,1300,0.0,1963,1570,7600,21616 days 16:47:18.660890,056,2.0,0.0,-270,0,1300.0
287500.0,3,2.0,1760,7147,1.0,4,6,880,880.0,1936,1720,7147,31478 days 16:47:18.660890,111,1.5,1.0,40,0,0.0
546800.0,4,1.5,1520,5910,1.0,3,7,1020,500.0,1946,1710,5910,27825 days 16:47:18.660890,272,2.6666666666666665,2.04,-190,0,520.0
183000.0,3,1.75,1070,8100,1.0,4,6,1070,0.0,1957,1260,8100,23807 days 16:47:18.660890,167,1.7142857142857142,0.0,-190,0,1070.0
560000.0,3,2.0,2560,216777,1.0,3,8,2560,0.0,1986,2360,108463,13215 days 16:47:18.660890,132,1.5,0.0,200,108314,2560.0
299500.0,3,1.0,1280,6726,1.0,3,6,1280,0.0,1958,1630,5000,23442 days 16:47:18.660890,339,3.0,0.0,-350,1726,1280.0
610000.0,4,2.25,1660,7350,1.0,3,8,1660,0.0,1965,1790,7455,20885 days 16:47:18.660890,300,1.7777777777777777,0.0,-130,-105,1660.0
288350.0,3,1.5,1860,7963,1.0,3,7,1200,660.0,1963,1800,10400,21616 days 16:47:18.660890,160,2.0,1.8181818181818181,60,-2437,540.0
500000.0,2,1.0,950,4500,1.0,3,7,850,100.0,1926,1670,4000,35130 days 16:47:18.660890,182,2.0,8.5,-720,500,750.0
625000.0,4,2.75,2140,4000,1.0,3,7,1190,950.0,1951,2140,4770,25999 days 16:47:18.660890,339,1.4545454545454546,1.2526315789473683,0,-770,240.0
418000.0,2,1.5,1480,1349,2.0,3,7,1240,240.0,2007,1550,1349,5545 days 16:47:18.660890,119,1.3333333333333333,5.166666666666667,-70,0,1000.0
660000.0,3,3.0,2260,1825,2.0,3,8,1660,600.0,2002,2260,1834,7371 days 16:47:18.660890,237,1.0,2.7666666666666666,0,-9,1060.0
775000.0,4,2.5,2300,6158,2.0,3,9,2300,0.0,1999,2170,6434,8467 days 16:47:18.660890,174,1.6,0.0,130,-276,2300.0
429500.0,3,2.75,1650,7272,1.0,4,7,1230,420.0,1972,1770,7272,18329 days 16:47:18.660890,023,1.0909090909090908,2.9285714285714284,-120,0,810.0
569000.0,3,2.0,1990,3000,1.5,3,7,1230,760.0,1908,1600,4080,41705 days 16:47:18.660890,328,1.5,1.618421052631579,390,-1080,470.0
250000.0,4,2.0,1960,7560,1.0,5,7,1160,800.0,1978,1950,7560,16137 days 16:47:18.660890,140,2.0,1.45,10,0,360.0
225000.0,3,1.5,1310,10491,1.0,4,7,1310,0.0,1969,1430,9664,19424 days 16:47:18.660890,343,2.0,0.0,-120,827,1310.0
530000.0,4,2.75,2450,15002,1.0,5,9,2450,0.0,1974,2650,15055,17598 days 16:47:18.660890,134,1.4545454545454546,0.0,-200,-53,2450.0
306000.0,3,1.0,910,8658,1.0,3,7,910,0.0,1955,1170,10200,24538 days 16:47:18.660890,248,3.0,0.0,-260,-1542,910.0
517100.0,3,1.75,1580,9719,1.0,5,7,1580,0.0,1962,1760,8539,21981 days 16:47:18.660890,103,1.7142857142857142,0.0,-180,1180,1580.0
354950.0,3,1.75,1780,9689,1.0,3,7,1130,650.0,1976,1660,9786,16868 days 16:47:18.660890,234,1.7142857142857142,1.7384615384615385,120,-97,480.0
348000.0,3,1.5,1040,1824,1.0,3,6,1040,0.0,1925,1010,5100,35495 days 16:47:18.660890,104,2.0,0.0,30,-3276,1040.0
522250.0,4,2.5,2340,41600,1.0,3,8,1640,700.0,1977,2340,34960,16502 days 16:47:18.660890,199,1.6,2.342857142857143,0,6640,940.0
275000.0,3,2.5,1720,8755,1.0,3,8,1000,720.0,1983,1720,8690,14311 days 16:47:18.660890,155,1.2,1.3888888888888888,0,65,280.0
390000.0,3,1.5,1600,10440,1.0,3,7,1600,0.0,1954,1600,8816,24903 days 16:47:18.660890,352,2.0,0.0,0,1624,1600.0
260000.0,3,1.5,1320,9750,1.0,3,7,1320,0.0,1954,1530,9750,24903 days 16:47:18.660890,253,2.0,0.0,-210,0,1320.0
585000.0,5,2.75,2350,4178,1.5,3,8,1520,830.0,1922,1920,4178,36591 days 16:47:18.660890,209,1.8181818181818181,1.8313253012048192,430,0,690.0
605000.0,5,2.75,2740,5616,1.5,5,7,1670,1070.0,1925,1600,4592,35495 days 16:47:18.660890,154,1.8181818181818181,1.560747663551402,1140,1024,600.0
342000.0,4,2.5,2300,6448,2.0,3,8,2300,0.0,2001,1860,5872,7736 days 16:47:18.660890,184,1.6,0.0,440,576,2300.0
900000.0,5,3.0,4350,37169,2.0,3,1,2950,1400.0,1972,3280,41631,18329 days 16:47:18.660890,239,1.6666666666666667,2.107142857142857,1070,-4462,1550.0
252000.0,3,1.75,1430,7700,1.0,4,7,980,450.0,1981,1430,8625,15041 days 16:47:18.660890,089,1.7142857142857142,2.1777777777777776,0,-925,530.0
357000.0,3,1.75,2400,14012,1.0,3,9,2400,0.0,1971,2800,13988,18694 days 16:47:18.660890,050,1.7142857142857142,0.0,-400,24,2400.0
370000.0,3,1.0,940,7910,1.0,4,6,940,0.0,1959,1000,7700,23077 days 16:47:18.660890,358,3.0,0.0,-60,210,940.0
322500.0,3,1.0,1020,13504,1.0,5,7,1020,0.0,1959,1110,11158,23077 days 16:47:18.660890,096,3.0,0.0,-90,2346,1020.0
210000.0,2,2.0,1680,5756,2.0,4,7,1680,0.0,1910,1340,5447,40974 days 16:47:18.660890,171,1.0,0.0,340,309,1680.0
290000.0,2,1.0,1340,9840,1.0,3,7,1340,0.0,1949,1610,8949,26729 days 16:47:18.660890,342,2.0,0.0,-270,891,1340.0
860000.0,4,3.25,3960,7012,2.0,3,1,3960,0.0,2005,3680,8522,6275 days 16:47:18.660890,163,1.2307692307692308,0.0,280,-1510,3960.0
302000.0,6,2.0,2650,4621,1.5,3,8,2650,0.0,1911,1640,4879,40609 days 16:47:18.660890,056,3.0,0.0,1010,-258,2650.0
369160.0,4,2.25,2120,9680,2.0,4,8,2120,0.0,1965,2360,9647,20885 days 16:47:18.660890,233,1.7777777777777777,0.0,-240,33,2120.0
1190000.0,4,2.75,2850,3000,2.5,3,9,2530,320.0,2003,2083,4500,7006 days 16:47:18.660890,127,1.4545454545454546,7.90625,767,-1500,2210.0
993000.0,4,2.0,2850,14810,2.0,5,8,2490,360.0,1954,2430,10454,24903 days 16:47:18.660890,245,2.0,6.916666666666667,420,4356,2130.0
380000.0,6,2.0,1870,6969,1.0,4,7,1870,0.0,1968,1500,6969,19790 days 16:47:18.660890,318,3.0,0.0,370,0,1870.0
635000.0,4,2.0,2660,8160,1.0,4,7,1380,1280.0,1949,1660,8160,26729 days 16:47:18.660890,253,2.0,1.078125,1000,0,100.0
260000.0,3,1.0,1190,11120,1.0,3,6,1190,0.0,1947,1230,12720,27460 days 16:47:18.660890,303,3.0,0.0,-40,-1600,1190.0
243000.0,2,1.0,1770,5522,1.5,4,7,960,810.0,1943,1830,7378,28921 days 16:47:18.660890,140,2.0,1.1851851851851851,-60,-1856,150.0
1400000.0,4,2.5,2770,8879,2.0,3,9,2770,0.0,2001,2770,8882,7736 days 16:47:18.660890,092,1.6,0.0,0,-3,2770.0
665000.0,4,2.5,2080,8100,1.0,5,8,1220,860.0,1952,2090,8100,25634 days 16:47:18.660890,258,1.6,1.4186046511627908,-10,0,360.0
898000.0,5,2.25,2700,9000,2.0,5,9,2700,0.0,1987,2630,9000,12850 days 16:47:18.660890,252,2.2222222222222223,0.0,70,0,2700.0
583000.0,4,2.75,2200,9453,1.0,5,8,1100,1100.0,1955,1390,5355,24538 days 16:47:18.660890,206,1.4545454545454546,1.0,810,4098,0.0
429000.0,4,1.75,2160,7700,2.0,2,8,2160,0.0,1977,2080,7700,16502 days 16:47:18.660890,338,2.2857142857142856,0.0,80,0,2160.0
471000.0,3,2.5,2010,4059,2.0,3,8,2010,0.0,1998,2010,5779,8832 days 16:47:18.660890,350,1.2,0.0,0,-1720,2010.0
1810000.0,3,3.5,3780,8295,2.0,3,9,2430,1350.0,1951,3780,9127,25999 days 16:47:18.660890,071,0.8571428571428571,1.8,0,-832,1080.0
739500.0,3,3.25,4460,51177,2.0,3,9,4460,0.0,2005,2670,38925,6275 days 16:47:18.660890,288,0.9230769230769231,0.0,1790,12252,4460.0
450000.0,3,1.5,1770,17208,1.0,3,8,1160,610.0,1959,2450,17118,23077 days 16:47:18.660890,132,2.0,1.901639344262295,-680,90,550.0
552500.0,3,1.0,1430,5000,1.0,3,7,1430,0.0,1949,1210,5000,26729 days 16:47:18.660890,098,3.0,0.0,220,0,1430.0
437000.0,4,1.75,1700,10642,1.0,4,7,850,850.0,1954,1610,11200,24903 days 16:47:18.660890,048,2.2857142857142856,1.0,90,-558,0.0
270000.0,4,2.0,1830,5220,1.5,3,7,1830,0.0,1951,1760,5757,25999 days 16:47:18.660890,009,2.0,0.0,70,-537,1830.0
226740.0,3,1.5,1410,8800,1.0,4,7,1410,0.0,1965,2180,10108,20885 days 16:47:18.660890,197,2.0,0.0,-770,-1308,1410.0
283000.0,3,2.0,1820,15068,2.0,3,7,1520,300.0,1920,1490,9589,37322 days 16:47:18.660890,329,1.5,5.066666666666666,330,5479,1220.0
445000.0,4,1.75,2430,13211,1.5,4,7,2430,0.0,1909,1330,10500,41339 days 16:47:18.660890,196,2.2857142857142856,0.0,1100,2711,2430.0
250000.0,2,1.0,740,6840,1.0,5,6,740,0.0,1942,740,6840,29286 days 16:47:18.660890,228,2.0,0.0,0,0,740.0
307000.0,3,1.0,770,6552,1.0,3,6,670,100.0,1942,920,7200,29286 days 16:47:18.660890,068,3.0,6.7,-150,-648,570.0
315000.0,4,2.75,2200,8580,1.0,3,8,1860,340.0,1991,2290,7816,11389 days 16:47:18.660890,202,1.4545454545454546,5.470588235294118,-90,764,1520.0
555000.0,3,3.0,2920,23085,1.5,3,7,1540,1380.0,1908,2270,18180,41705 days 16:47:18.660890,006,1.0,1.1159420289855073,650,4905,160.0
264900.0,4,2.5,2040,7000,1.0,3,7,1250,790.0,1979,1900,7378,15772 days 16:47:18.660890,114,1.6,1.5822784810126582,140,-378,460.0
510000.0,3,2.0,1600,4510,1.0,3,7,990,610.0,1978,1580,4561,16137 days 16:47:18.660890,265,1.5,1.6229508196721312,20,-51,380.0
328000.0,4,2.5,1990,3980,2.0,3,7,1990,0.0,2002,1990,4373,7371 days 16:47:18.660890,226,1.6,0.0,0,-393,1990.0
358000.0,4,2.5,1830,7308,2.0,3,7,1830,0.0,2002,1830,5692,7371 days 16:47:18.660890,124,1.6,0.0,0,1616,1830.0
325000.0,3,2.5,2540,4260,2.0,3,7,2540,0.0,2005,2190,4260,6275 days 16:47:18.660890,111,1.2,0.0,350,0,2540.0
1370000.0,2,3.25,2700,3444,3.0,3,9,2700,0.0,1990,2710,3444,11754 days 16:47:18.660890,195,0.6153846153846154,0.0,-10,0,2700.0
230000.0,4,2.0,1440,10800,1.0,4,7,1440,0.0,1967,1190,7380,20155 days 16:47:18.660890,064,2.0,0.0,250,3420,1440.0
545000.0,3,2.0,1550,4000,1.0,3,7,940,610.0,1955,1880,4000,24538 days 16:47:18.660890,113,1.5,1.540983606557377,-330,0,330.0
705380.0,3,2.5,2490,4343,2.0,3,9,2490,0.0,2003,2130,4106,7006 days 16:47:18.660890,125,1.2,0.0,360,237,2490.0
459000.0,5,2.5,2650,12987,1.0,4,7,1350,1300.0,1979,2160,12726,15772 days 16:47:18.660890,232,2.0,1.0384615384615385,490,261,50.0
815000.0,4,2.25,2000,3800,2.0,3,8,2000,0.0,2001,1610,3800,7736 days 16:47:18.660890,148,1.7777777777777777,0.0,390,0,2000.0
495000.0,6,5.0,3440,4500,2.0,3,8,3280,160.0,2007,1400,5500,5545 days 16:47:18.660890,162,1.2,20.5,2040,-1000,3120.0
520000.0,3,2.5,2280,58712,2.5,3,9,2280,0.0,1987,2240,24332,12850 days 16:47:18.660890,314,1.2,0.0,40,34380,2280.0
430000.0,2,1.5,1320,1194,3.0,3,7,1320,0.0,2001,1320,1250,7736 days 16:47:18.660890,351,1.3333333333333333,0.0,0,-56,1320.0
255000.0,4,2.5,2070,7800,2.0,3,8,2070,0.0,1989,1950,7815,12119 days 16:47:18.660890,135,1.6,0.0,120,-15,2070.0
588000.0,3,2.0,1860,4777,2.0,5,7,1860,0.0,1908,1580,3822,41705 days 16:47:18.660890,188,1.5,0.0,280,955,1860.0
350000.0,3,1.0,940,7811,1.0,3,6,940,0.0,1959,1180,7490,23077 days 16:47:18.660890,314,3.0,0.0,-240,321,940.0
625000.0,4,2.75,2290,21486,1.0,5,7,2290,0.0,1963,2540,15936,21616 days 16:47:18.660890,072,1.4545454545454546,0.0,-250,5550,2290.0
172500.0,2,2.0,1510,20685,1.0,2,6,1250,260.0,1958,1490,29527,23442 days 16:47:18.660890,114,1.0,4.8076923076923075,20,-8842,990.0
554000.0,3,2.0,1830,3500,1.5,5,7,1290,540.0,1909,1530,4000,41339 days 16:47:18.660890,237,1.5,2.388888888888889,300,-500,750.0
775000.0,4,2.5,3090,7112,2.0,3,9,3090,0.0,2001,3050,6000,7736 days 16:47:18.660890,209,1.6,0.0,40,1112,3090.0
1190000.0,4,3.5,4340,217800,2.0,3,1,4340,0.0,2003,3430,219106,7006 days 16:47:18.660890,311,1.1428571428571428,0.0,910,-1306,4340.0
618000.0,3,2.75,3200,12682,2.0,3,9,3200,0.0,1977,2880,10432,16502 days 16:47:18.660890,301,1.0909090909090908,0.0,320,2250,3200.0
305000.0,4,1.0,1560,8450,1.5,4,6,1560,0.0,1954,1380,8100,24903 days 16:47:18.660890,272,4.0,0.0,180,350,1560.0
232000.0,3,2.0,1280,13356,1.0,3,7,1280,0.0,1994,1590,8071,10293 days 16:47:18.660890,339,1.5,0.0,-310,5285,1280.0
262000.0,4,2.5,2020,6236,2.0,3,7,2020,0.0,2002,1940,5076,7371 days 16:47:18.660890,128,1.6,0.0,80,1160,2020.0
234000.0,3,1.0,1040,8122,1.0,5,7,1040,0.0,1971,1470,8676,18694 days 16:47:18.660890,084,3.0,0.0,-430,-554,1040.0
500000.0,4,2.75,2260,7209,1.0,3,7,1330,930.0,2002,1790,10860,7371 days 16:47:18.660890,092,1.4545454545454546,1.4301075268817205,470,-3651,400.0
278000.0,3,1.0,860,7632,1.0,3,6,860,0.0,1920,890,7632,37322 days 16:47:18.660890,239,3.0,0.0,-30,0,860.0
230000.0,5,1.0,1920,19040,1.0,3,7,1160,760.0,1961,1920,11520,22346 days 16:47:18.660890,247,5.0,1.5263157894736843,0,7520,400.0
500000.0,4,1.75,2290,9215,1.0,5,8,1270,1020.0,1969,2290,10200,19424 days 16:47:18.660890,265,2.2857142857142856,1.2450980392156863,0,-985,250.0
366500.0,4,2.75,2070,9300,1.0,5,7,1120,950.0,1945,1010,8308,28190 days 16:47:18.660890,139,1.4545454545454546,1.1789473684210525,1060,992,170.0
665000.0,6,3.0,4250,4400,2.5,4,7,3020,1230.0,1902,1520,4950,43896 days 16:47:18.660890,162,2.0,2.4552845528455283,2730,-550,1790.0
1100000.0,3,1.5,2220,4830,2.0,3,9,1790,430.0,1928,1670,4830,34400 days 16:47:18.660890,075,2.0,4.162790697674419,550,0,1360.0
575000.0,2,1.75,1840,4076,1.0,3,8,1140,700.0,1957,1540,4076,23807 days 16:47:18.660890,335,1.1428571428571428,1.6285714285714286,300,0,440.0
674750.0,4,2.5,2590,9753,2.0,3,1,2590,0.0,1993,2800,9917,10658 days 16:47:18.660890,307,1.6,0.0,-210,-164,2590.0
719000.0,5,2.0,3110,6131,1.0,5,7,1560,1550.0,1940,1720,6600,30017 days 16:47:18.660890,259,2.5,1.0064516129032257,1390,-469,10.0
482000.0,3,1.75,2600,105587,1.0,4,7,1300,1300.0,1980,1941,208438,15407 days 16:47:18.660890,268,1.7142857142857142,1.0,659,-102851,0.0
254000.0,2,1.0,1060,8187,1.0,4,6,1060,0.0,1952,1260,8188,25634 days 16:47:18.660890,148,2.0,0.0,-200,-1,1060.0
443725.0,3,1.75,1250,3880,1.0,4,7,750,500.0,1944,1240,3880,28556 days 16:47:18.660890,231,1.7142857142857142,1.5,10,0,250.0
575000.0,4,2.5,2520,35636,2.0,3,8,2520,0.0,1980,2230,35673,15407 days 16:47:18.660890,310,1.6,0.0,290,-37,2520.0
469000.0,3,2.25,2070,9957,1.0,3,8,1440,630.0,1977,2070,10158,16502 days 16:47:18.660890,027,1.3333333333333333,2.2857142857142856,0,-201,810.0
175000.0,2,1.0,1300,44431,1.0,5,6,1300,0.0,1958,1470,14850,23442 days 16:47:18.660890,143,2.0,0.0,-170,29581,1300.0
437000.0,5,2.0,2190,8316,1.0,3,7,1390,800.0,1961,2010,8316,22346 days 16:47:18.660890,252,2.5,1.7375,180,0,590.0
550000.0,4,3.0,2760,13113,1.0,4,8,1760,1000.0,1974,1900,13113,17598 days 16:47:18.660890,232,1.3333333333333333,1.76,860,0,760.0
172040.0,3,2.25,1710,7134,1.0,4,7,1130,580.0,1979,1790,7455,15772 days 16:47:18.660890,110,1.3333333333333333,1.9482758620689655,-80,-321,550.0
363000.0,3,2.0,1750,7000,1.0,3,8,1750,0.0,1993,1840,6969,10658 days 16:47:18.660890,358,1.5,0.0,-90,31,1750.0
282000.0,3,2.25,1552,3600,2.0,3,7,1552,0.0,2012,1677,3600,3719 days 16:47:18.660890,120,1.3333333333333333,0.0,-125,0,1552.0
400000.0,6,2.0,2350,6554,2.0,3,8,2000,350.0,1905,1560,6554,42800 days 16:47:18.660890,226,3.0,5.714285714285714,790,0,1650.0
650000.0,5,3.5,5110,10018,2.0,3,1,3850,1260.0,2003,1790,10018,7006 days 16:47:18.660890,267,1.4285714285714286,3.0555555555555554,3320,0,2590.0
365000.0,3,2.5,1720,99916,2.0,4,7,1720,0.0,1990,1340,73180,11754 days 16:47:18.660890,154,1.2,0.0,380,26736,1720.0
269950.0,4,2.5,1960,7230,2.0,3,8,1960,0.0,2002,1850,7208,7371 days 16:47:18.660890,297,1.6,0.0,110,22,1960.0
260000.0,2,1.0,1270,19602,1.0,3,6,1270,0.0,1977,1270,17699,16502 days 16:47:18.660890,199,2.0,0.0,0,1903,1270.0
193000.0,3,1.5,1180,7000,1.0,4,7,1180,0.0,1977,1630,7500,16502 days 16:47:18.660890,297,2.0,0.0,-450,-500,1180.0
340000.0,4,2.25,2230,6791,2.0,3,8,2230,0.0,2005,2420,6297,6275 days 16:47:18.660890,206,1.7777777777777777,0.0,-190,494,2230.0
900000.0,4,3.25,4700,38412,2.0,3,1,3420,1280.0,1978,3640,35571,16137 days 16:47:18.660890,132,1.2307692307692308,2.671875,1060,2841,2140.0
371000.0,3,2.5,2150,8361,2.0,3,8,2150,0.0,1991,2150,9368,11389 days 16:47:18.660890,294,1.2,0.0,0,-1007,2150.0
592000.0,3,2.5,2400,81892,2.0,3,8,2400,0.0,1985,1370,37270,13580 days 16:47:18.660890,239,1.2,0.0,1030,44622,2400.0
300000.0,3,2.5,1830,12750,2.0,3,7,1830,0.0,1991,1610,10000,11389 days 16:47:18.660890,227,1.2,0.0,220,2750,1830.0
449950.0,4,3.0,2800,6977,2.0,3,8,2800,0.0,2003,2800,6600,7006 days 16:47:18.660890,239,1.3333333333333333,0.0,0,377,2800.0
299500.0,3,2.5,2090,7163,2.0,3,8,2090,0.0,1989,2320,8634,12119 days 16:47:18.660890,295,1.2,0.0,-230,-1471,2090.0
995000.0,4,2.25,2340,13406,1.0,4,9,2340,0.0,1963,2340,10743,21616 days 16:47:18.660890,085,1.7777777777777777,0.0,0,2663,2340.0
335000.0,4,1.75,1670,9472,1.0,3,7,1100,570.0,1960,1080,5195,22712 days 16:47:18.660890,266,2.2857142857142856,1.9298245614035088,590,4277,530.0
280000.0,4,2.25,1990,7350,1.0,4,8,1180,810.0,1978,2030,7210,16137 days 16:47:18.660890,314,1.7777777777777777,1.4567901234567902,-40,140,370.0
446000.0,4,2.25,2270,7800,1.0,3,7,1290,980.0,1977,1480,7280,16502 days 16:47:18.660890,136,1.7777777777777777,1.316326530612245,790,520,310.0
1540000.0,4,2.75,4910,15139,1.0,4,1,2560,2350.0,1964,3980,15139,21251 days 16:47:18.660890,270,1.4545454545454546,1.0893617021276596,930,0,210.0
325000.0,3,1.0,950,4500,1.0,4,6,950,0.0,1943,1140,4500,28921 days 16:47:18.660890,097,3.0,0.0,-190,0,950.0
450000.0,3,1.75,1610,11200,1.0,3,7,1610,0.0,1955,1610,11200,24538 days 16:47:18.660890,170,1.7142857142857142,0.0,0,0,1610.0
322500.0,4,2.5,1940,7107,2.0,3,7,1940,0.0,2000,1850,5705,8102 days 16:47:18.660890,300,1.6,0.0,90,1402,1940.0
453000.0,3,1.0,1210,9473,1.0,5,7,1210,0.0,1955,1700,11465,24538 days 16:47:18.660890,258,3.0,0.0,-490,-1992,1210.0
655000.0,4,2.5,2570,4412,2.0,3,9,2570,0.0,2001,2460,5470,7736 days 16:47:18.660890,281,1.6,0.0,110,-1058,2570.0
603000.0,3,2.25,1700,2800,2.0,5,7,1150,550.0,1926,1500,3400,35130 days 16:47:18.660890,124,1.3333333333333333,2.090909090909091,200,-600,600.0
235000.0,4,1.0,1610,24000,1.5,3,6,1610,0.0,1947,1270,9600,27460 days 16:47:18.660890,245,4.0,0.0,340,14400,1610.0
968933.0,4,3.5,4120,7304,2.0,3,1,3070,1050.0,2006,2470,9600,5910 days 16:47:18.660890,209,1.1428571428571428,2.9238095238095236,1650,-2296,2020.0
1020000.0,3,3.5,2880,11340,1.0,3,8,1690,1190.0,1980,2530,11340,15407 days 16:47:18.660890,318,0.8571428571428571,1.4201680672268908,350,0,500.0
435000.0,4,2.25,1990,8548,2.0,3,8,1990,0.0,1973,2320,8926,17963 days 16:47:18.660890,337,1.7777777777777777,0.0,-330,-378,1990.0
242000.0,3,2.0,1260,8092,1.0,3,7,1260,0.0,1986,1950,8092,13215 days 16:47:18.660890,169,1.5,0.0,-690,0,1260.0
487000.0,6,3.25,4750,248600,2.0,4,8,4750,0.0,1947,2230,311610,27460 days 16:47:18.660890,300,1.8461538461538463,0.0,2520,-63010,4750.0
810000.0,4,2.75,3010,10450,2.0,3,9,3010,0.0,1996,3010,10530,9563 days 16:47:18.660890,213,1.4545454545454546,0.0,0,-80,3010.0
625000.0,3,2.5,2410,64073,1.0,4,8,1820,590.0,1976,2980,48760,16868 days 16:47:18.660890,175,1.2,3.0847457627118646,-570,15313,1230.0
165000.0,3,1.5,1280,7742,1.0,3,7,1280,0.0,1973,1566,7696,17963 days 16:47:18.660890,296,2.0,0.0,-286,46,1280.0
335000.0,3,1.0,2320,6750,1.0,3,7,1160,1160.0,1960,1230,6075,22712 days 16:47:18.660890,117,3.0,1.0,1090,675,0.0
286700.0,3,1.0,1220,6600,1.0,3,6,1220,0.0,1958,1100,6600,23442 days 16:47:18.660890,205,3.0,0.0,120,0,1220.0
699000.0,2,1.5,1400,4050,1.0,4,8,1400,0.0,1954,1900,5940,24903 days 16:47:18.660890,114,1.3333333333333333,0.0,-500,-1890,1400.0
280000.0,3,1.75,1590,7280,1.0,3,7,1140,450.0,1974,1590,9634,17598 days 16:47:18.660890,086,1.7142857142857142,2.533333333333333,0,-2354,690.0
580000.0,4,2.5,2220,7064,2.0,3,8,2220,0.0,1988,2220,7451,12485 days 16:47:18.660890,153,1.6,0.0,0,-387,2220.0
754800.0,2,2.5,2770,7781,2.0,3,8,2770,0.0,2006,1870,5984,5910 days 16:47:18.660890,171,0.8,0.0,900,1797,2770.0
525000.0,4,2.5,2303,16801,2.0,3,8,2303,0.0,1995,2080,14013,9928 days 16:47:18.660890,041,1.6,0.0,223,2788,2303.0
562000.0,3,1.75,1600,10530,1.0,3,8,1600,0.0,1962,2590,8274,21981 days 16:47:18.660890,048,1.7142857142857142,0.0,-990,2256,1600.0
575000.0,4,1.75,1280,6060,1.0,3,7,860,420.0,1926,1490,4680,35130 days 16:47:18.660890,140,2.2857142857142856,2.0476190476190474,-210,1380,440.0
808900.0,5,2.5,2900,5901,2.0,3,9,2900,0.0,2006,3200,5775,5910 days 16:47:18.660890,192,2.0,0.0,-300,126,2900.0
992000.0,3,2.25,2950,15207,1.0,4,1,2070,880.0,1966,2950,22000,20520 days 16:47:18.660890,062,1.3333333333333333,2.352272727272727,0,-6793,1190.0
335000.0,3,2.5,1700,6698,2.0,3,7,1700,0.0,1997,2190,7346,9197 days 16:47:18.660890,262,1.2,0.0,-490,-648,1700.0
473000.0,3,2.75,1050,7200,1.0,3,7,1050,0.0,1985,1860,9000,13580 days 16:47:18.660890,360,1.0909090909090908,0.0,-810,-1800,1050.0
350000.0,4,2.75,2990,11210,1.0,4,8,1880,1110.0,1977,2790,9858,16502 days 16:47:18.660890,084,1.4545454545454546,1.6936936936936937,200,1352,770.0
1600000.0,5,2.5,3100,5374,2.5,4,9,3100,0.0,1906,2180,5800,42435 days 16:47:18.660890,114,2.0,0.0,920,-426,3100.0
305500.0,3,1.0,1240,6090,1.0,4,7,1240,0.0,1950,1550,9096,26364 days 16:47:18.660890,351,3.0,0.0,-310,-3006,1240.0
306000.0,2,1.0,780,13500,1.0,4,7,780,0.0,1946,2200,67518,27825 days 16:47:18.660890,143,2.0,0.0,-1420,-54018,780.0
233000.0,2,2.25,850,1656,2.0,3,8,850,0.0,2001,850,1312,7736 days 16:47:18.660890,336,0.8888888888888888,0.0,0,344,850.0
490000.0,3,1.75,1540,9000,1.0,3,8,1540,0.0,1971,1710,7488,18694 days 16:47:18.660890,090,1.7142857142857142,0.0,-170,1512,1540.0
445000.0,4,2.5,2280,42077,2.0,3,8,2280,0.0,1994,2280,36236,10293 days 16:47:18.660890,182,1.6,0.0,0,5841,2280.0
355000.0,3,2.25,2550,9674,1.0,3,7,1850,700.0,1959,2240,9674,23077 days 16:47:18.660890,324,1.3333333333333333,2.642857142857143,310,0,1150.0
360000.0,2,2.0,1770,7607,1.0,4,8,1770,0.0,1987,2090,7109,12850 days 16:47:18.660890,092,1.0,0.0,-320,498,1770.0
737500.0,3,1.75,2320,10900,2.0,3,7,2320,0.0,1935,1610,5800,31843 days 16:47:18.660890,190,1.7142857142857142,0.0,710,5100,2320.0
985000.0,3,3.5,2600,11920,2.0,5,8,2600,0.0,1969,2430,10050,19424 days 16:47:18.660890,349,0.8571428571428571,0.0,170,1870,2600.0
349950.0,2,3.25,1570,2031,2.0,3,8,1310,260.0,2006,1570,2039,5910 days 16:47:18.660890,218,0.6153846153846154,5.038461538461538,0,-8,1050.0
520000.0,4,2.5,3060,7161,2.0,3,8,2860,200.0,2005,2950,6822,6275 days 16:47:18.660890,051,1.6,14.3,110,339,2660.0
355950.0,4,2.5,1960,8540,1.0,3,7,1220,740.0,1955,1910,9120,24538 days 16:47:18.660890,351,1.6,1.6486486486486487,50,-580,480.0
485000.0,5,2.5,3270,6129,2.0,3,9,3270,0.0,2004,2980,5928,6641 days 16:47:18.660890,363,2.0,0.0,290,201,3270.0
143000.0,3,1.0,1090,3315,1.0,4,6,1090,0.0,1969,960,3120,19424 days 16:47:18.660890,346,3.0,0.0,130,195,1090.0
3280000.0,2,1.75,6840,10000,2.5,3,1,4350,2490.0,2001,3120,12300,7736 days 16:47:18.660890,344,1.1428571428571428,1.7469879518072289,3720,-2300,1860.0
355000.0,3,1.0,940,8512,1.0,4,7,940,0.0,1967,1060,8512,20155 days 16:47:18.660890,204,3.0,0.0,-120,0,940.0
1130000.0,5,3.5,3880,13885,2.0,4,9,2540,1340.0,1979,3690,13885,15772 days 16:47:18.660890,155,1.4285714285714286,1.8955223880597014,190,0,1200.0
200000.0,5,1.75,1770,15525,1.0,4,7,1770,0.0,1959,1370,10395,23077 days 16:47:18.660890,230,2.857142857142857,0.0,400,5130,1770.0
913000.0,4,2.5,3640,10576,2.0,3,1,3640,0.0,1999,3370,10351,8467 days 16:47:18.660890,169,1.6,0.0,270,225,3640.0
1600000.0,3,2.5,3160,12824,1.0,4,9,1820,1340.0,1966,3390,11985,20520 days 16:47:18.660890,142,1.2,1.3582089552238805,-230,839,480.0
409900.0,2,2.5,1590,1845,2.0,3,9,1590,0.0,1997,2320,3174,9197 days 16:47:18.660890,176,0.8,0.0,-730,-1329,1590.0
265000.0,4,1.0,1290,6034,1.0,3,6,1050,240.0,1950,1060,6034,26364 days 16:47:18.660890,121,4.0,4.375,230,0,810.0
740000.0,5,3.0,3655,51836,1.0,5,8,2174,1481.0,1955,2530,8606,24538 days 16:47:18.660890,100,1.6666666666666667,1.4679270762997974,1125,43230,693.0
306000.0,4,2.5,2490,8124,2.0,3,7,2490,0.0,2001,2760,6300,7736 days 16:47:18.660890,163,1.6,0.0,-270,1824,2490.0
381000.0,3,2.5,1470,3999,2.0,3,7,1470,0.0,2003,1960,4444,7006 days 16:47:18.660890,280,1.2,0.0,-490,-445,1470.0
1220000.0,3,3.25,3960,6132,2.0,3,1,2600,1360.0,1933,2730,5221,32573 days 16:47:18.660890,125,0.9230769230769231,1.911764705882353,1230,911,1240.0
1050000.0,3,3.5,3190,29982,1.0,4,8,2630,560.0,1941,2600,19878,29651 days 16:47:18.660890,079,0.8571428571428571,4.696428571428571,590,10104,2070.0
408000.0,2,1.0,810,7440,1.0,5,6,810,0.0,1948,830,7500,27095 days 16:47:18.660890,246,2.0,0.0,-20,-60,810.0
739900.0,5,2.5,2980,5377,2.0,3,9,2980,0.0,2006,3150,6593,5910 days 16:47:18.660890,176,2.0,0.0,-170,-1216,2980.0
674250.0,4,2.5,2780,35000,1.0,4,9,2780,0.0,1985,2740,35072,13580 days 16:47:18.660890,325,1.6,0.0,40,-72,2780.0
438400.0,2,1.0,1340,8100,1.0,4,7,1340,0.0,1953,1700,8100,25268 days 16:47:18.660890,254,2.0,0.0,-360,0,1340.0
1700000.0,5,5.0,4930,14649,2.0,3,1,4160,770.0,2000,3030,8479,8102 days 16:47:18.660890,364,1.0,5.402597402597403,1900,6170,3390.0
703000.0,3,2.0,1360,5980,1.5,3,8,1360,0.0,1945,1520,4440,28190 days 16:47:18.660890,170,1.5,0.0,-160,1540,1360.0
262000.0,3,1.75,1320,6530,1.0,4,7,1320,0.0,1989,1620,6817,12119 days 16:47:18.660890,363,1.7142857142857142,0.0,-300,-287,1320.0
353000.0,3,2.0,1210,14499,1.0,3,7,1210,0.0,1984,1570,15360,13946 days 16:47:18.660890,113,1.5,0.0,-360,-861,1210.0
500000.0,4,2.5,1940,7607,2.0,3,8,1940,0.0,1995,2250,7600,9928 days 16:47:18.660890,014,1.6,0.0,-310,7,1940.0
1280000.0,4,2.5,3160,4620,1.5,3,9,2020,1140.0,1917,2790,5308,38417 days 16:47:18.660890,187,1.6,1.7719298245614035,370,-688,880.0
332000.0,4,2.5,1980,6566,2.0,3,8,1980,0.0,2004,2590,6999,6641 days 16:47:18.660890,098,1.6,0.0,-610,-433,1980.0
824000.0,4,2.5,2320,14240,1.0,4,9,1620,700.0,1974,2810,13200,17598 days 16:47:18.660890,233,1.6,2.3142857142857145,-490,1040,920.0
290000.0,4,2.0,1660,4788,1.0,3,7,1660,0.0,1968,1150,5000,19790 days 16:47:18.660890,051,2.0,0.0,510,-212,1660.0
700000.0,3,2.5,1660,1545,2.0,3,9,1400,260.0,2002,1820,2570,7371 days 16:47:18.660890,178,1.2,5.384615384615385,-160,-1025,1140.0
550000.0,2,1.0,1080,3420,1.0,4,7,780,300.0,1922,1380,3656,36591 days 16:47:18.660890,279,2.0,2.6,-300,-236,480.0
549000.0,2,1.0,1510,11165,1.5,4,7,1510,0.0,1921,2210,8851,36956 days 16:47:18.660890,246,2.0,0.0,-700,2314,1510.0
1870000.0,4,2.5,2950,43560,1.0,4,9,2550,400.0,1951,3260,41016,25999 days 16:47:18.660890,065,1.6,6.375,-310,2544,2150.0
858000.0,4,2.25,3070,13720,2.0,3,9,3070,0.0,1978,3010,9657,16137 days 16:47:18.660890,061,1.7777777777777777,0.0,60,4063,3070.0
345000.0,2,1.0,970,10423,1.0,3,7,970,0.0,1947,1200,7857,27460 days 16:47:18.660890,303,2.0,0.0,-230,2566,970.0
1220000.0,4,2.25,2570,9600,2.5,4,9,2570,0.0,1962,2570,13200,21981 days 16:47:18.660890,115,1.7777777777777777,0.0,0,-3600,2570.0
275000.0,3,2.25,1260,1488,3.0,3,7,1260,0.0,2009,1190,1095,4814 days 16:47:18.660890,345,1.3333333333333333,0.0,70,393,1260.0
405000.0,3,1.0,1220,7771,1.0,3,7,1220,0.0,1963,1420,7674,21616 days 16:47:18.660890,239,3.0,0.0,-200,97,1220.0
432500.0,3,2.0,1720,8145,2.0,5,7,1720,0.0,1949,1400,8138,26729 days 16:47:18.660890,016,1.5,0.0,320,7,1720.0
236500.0,4,1.0,2140,4217,1.5,3,6,1320,820.0,1925,1720,5413,35495 days 16:47:18.660890,012,4.0,1.6097560975609757,420,-1196,500.0
679000.0,4,1.5,1420,4923,1.5,4,8,1420,0.0,1928,1470,4923,34400 days 16:47:18.660890,199,2.6666666666666665,0.0,-50,0,1420.0
543000.0,4,2.5,2060,8451,2.0,3,8,2060,0.0,1995,2060,9460,9928 days 16:47:18.660890,304,1.6,0.0,0,-1009,2060.0
294000.0,3,1.0,1320,9520,1.0,3,7,990,330.0,1953,1460,10610,25268 days 16:47:18.660890,269,3.0,3.0,-140,-1090,660.0
340500.0,3,1.75,1810,10463,1.0,4,7,1810,0.0,1969,1620,8551,19424 days 16:47:18.660890,093,1.7142857142857142,0.0,190,1912,1810.0
1010000.0,4,2.5,2980,16263,2.0,3,9,2980,0.0,1989,2730,10018,12119 days 16:47:18.660890,184,1.6,0.0,250,6245,2980.0
335000.0,2,2.0,1350,2560,1.0,3,8,1350,0.0,1976,1790,2560,16868 days 16:47:18.660890,122,1.0,0.0,-440,0,1350.0
425000.0,3,2.0,1540,8011,1.0,3,7,1540,0.0,1988,1630,7141,12485 days 16:47:18.660890,204,1.5,0.0,-90,870,1540.0
353000.0,3,2.5,2510,9240,2.0,4,8,2510,0.0,2001,2690,9240,7736 days 16:47:18.660890,041,1.2,0.0,-180,0,2510.0
540000.0,3,2.5,1670,5146,2.0,3,8,1670,0.0,1991,1940,5146,11389 days 16:47:18.660890,124,1.2,0.0,-270,0,1670.0
640000.0,5,3.5,3690,11928,2.0,3,9,2540,1150.0,2006,2640,11928,5910 days 16:47:18.660890,163,1.4285714285714286,2.208695652173913,1050,0,1390.0
339950.0,3,1.0,1320,11457,1.0,3,8,1320,0.0,1959,1900,9800,23077 days 16:47:18.660890,203,3.0,0.0,-580,1657,1320.0
195000.0,3,1.75,1510,8400,1.0,2,7,980,530.0,1979,1500,10125,15772 days 16:47:18.660890,311,1.7142857142857142,1.849056603773585,10,-1725,450.0
322000.0,3,1.75,1510,8400,1.0,2,7,980,530.0,1979,1500,10125,15772 days 16:47:18.660890,057,1.7142857142857142,1.849056603773585,10,-1725,450.0
660000.0,4,1.75,1870,10450,1.0,3,8,1620,250.0,1978,2060,10450,16137 days 16:47:18.660890,091,2.2857142857142856,6.48,-190,0,1370.0
280000.0,6,3.0,2400,9373,2.0,3,7,2400,0.0,1991,2060,7316,11389 days 16:47:18.660890,259,2.0,0.0,340,2057,2400.0
300000.0,6,3.0,2400,9373,2.0,3,7,2400,0.0,1991,2060,7316,11389 days 16:47:18.660890,112,2.0,0.0,340,2057,2400.0
207500.0,3,1.0,1170,8816,1.0,4,6,1170,0.0,1966,1200,9108,20520 days 16:47:18.660890,227,3.0,0.0,-30,-292,1170.0
195000.0,3,1.5,1190,8726,1.0,3,7,1190,0.0,1956,1390,8741,24173 days 16:47:18.660890,237,2.0,0.0,-200,-15,1190.0
700000.0,3,2.0,2080,3880,1.0,5,7,1160,920.0,1954,1330,3880,24903 days 16:47:18.660890,161,1.5,1.2608695652173914,750,0,240.0
560000.0,4,1.75,2150,8555,1.0,4,7,1460,690.0,1982,1480,7405,14676 days 16:47:18.660890,107,2.2857142857142856,2.1159420289855073,670,1150,770.0
260000.0,3,1.75,1580,7344,1.0,5,7,1580,0.0,1911,1580,6207,40609 days 16:47:18.660890,232,1.7142857142857142,0.0,0,1137,1580.0
575000.0,3,1.75,1580,7344,1.0,5,7,1580,0.0,1911,1580,6207,40609 days 16:47:18.660890,056,1.7142857142857142,0.0,0,1137,1580.0
475000.0,3,2.5,2370,3239,2.0,3,8,1950,420.0,2006,2520,3431,5910 days 16:47:18.660890,107,1.2,4.642857142857143,-150,-192,1530.0
285000.0,3,1.75,1840,8601,1.0,3,7,920,920.0,1905,1390,7452,42800 days 16:47:18.660890,164,1.7142857142857142,1.0,450,1149,0.0
753888.0,4,2.5,2660,5500,2.0,3,9,2660,0.0,2003,3620,5500,7006 days 16:47:18.660890,128,1.6,0.0,-960,0,2660.0
650000.0,3,2.5,2190,3600,2.0,3,9,2190,0.0,2003,2300,3600,7006 days 16:47:18.660890,100,1.2,0.0,-110,0,2190.0
620000.0,3,2.25,1660,3478,1.5,4,7,1100,560.0,1929,1610,3478,34034 days 16:47:18.660890,219,1.3333333333333333,1.9642857142857142,50,0,540.0
526000.0,3,1.75,1780,37801,1.0,3,7,1300,480.0,1977,2380,47480,16502 days 16:47:18.660890,072,1.7142857142857142,2.7083333333333335,-600,-9679,820.0
155000.0,2,1.0,700,5200,1.0,5,6,700,0.0,1952,1030,5200,25634 days 16:47:18.660890,134,2.0,0.0,-330,0,700.0
342000.0,4,2.0,1570,11200,1.0,3,7,1120,450.0,1959,1570,11200,23077 days 16:47:18.660890,239,2.0,2.488888888888889,0,0,670.0
390000.0,3,1.75,1220,216332,1.0,3,7,1220,0.0,1981,1540,61419,15041 days 16:47:18.660890,097,1.7142857142857142,0.0,-320,154913,1220.0
685000.0,3,2.75,3150,219978,2.0,4,9,3000,150.0,1990,3180,218235,11754 days 16:47:18.660890,156,1.0909090909090908,20.0,-30,1743,2850.0
608000.0,4,2.5,2690,4736,2.0,3,7,2690,0.0,2001,2690,4791,7736 days 16:47:18.660890,176,1.6,0.0,0,-55,2690.0
179900.0,2,1.0,680,6400,1.0,3,6,680,0.0,1943,1240,7800,28921 days 16:47:18.660890,259,2.0,0.0,-560,-1400,680.0
1250000.0,6,3.25,3750,14150,2.0,5,9,2750,1000.0,1936,2140,7968,31478 days 16:47:18.660890,247,1.8461538461538463,2.75,1610,6182,1750.0
166000.0,3,1.0,1010,11675,1.0,3,7,1010,0.0,1957,1370,10042,23807 days 16:47:18.660890,120,3.0,0.0,-360,1633,1010.0
462000.0,3,1.5,1710,4500,1.5,3,8,1410,300.0,1928,1860,6000,34400 days 16:47:18.660890,139,2.0,4.7,-150,-1500,1110.0
545000.0,4,2.5,2090,6023,2.0,3,8,2090,0.0,1990,2090,6023,11754 days 16:47:18.660890,173,1.6,0.0,0,0,2090.0
415000.0,3,1.0,1560,4500,1.5,3,7,1560,0.0,1903,1660,4500,43531 days 16:47:18.660890,016,3.0,0.0,-100,0,1560.0
269000.0,3,2.5,1560,4200,2.0,3,7,1560,0.0,2003,1560,4200,7006 days 16:47:18.660890,161,1.2,0.0,0,0,1560.0
356500.0,4,2.5,2570,11473,2.0,3,8,2570,0.0,2008,2430,5997,5180 days 16:47:18.660890,346,1.6,0.0,140,5476,2570.0
225000.0,3,1.0,1010,7633,1.0,4,6,1010,0.0,1961,1190,8386,22346 days 16:47:18.660890,357,3.0,0.0,-180,-753,1010.0
175000.0,2,1.0,1020,5130,1.0,4,6,1020,0.0,1948,1200,6497,27095 days 16:47:18.660890,171,2.0,0.0,-180,-1367,1020.0
549000.0,5,2.5,1710,9720,2.0,4,8,1710,0.0,1974,2270,9672,17598 days 16:47:18.660890,213,2.0,0.0,-560,48,1710.0
535000.0,3,2.75,2300,12197,2.0,3,8,2300,0.0,1989,1710,11220,12119 days 16:47:18.660890,105,1.0909090909090908,0.0,590,977,2300.0
565000.0,3,2.0,2730,15677,2.5,3,9,2730,0.0,1976,2040,12209,16868 days 16:47:18.660890,234,1.5,0.0,690,3468,2730.0
392450.0,4,2.0,2195,2681,1.0,3,7,1060,1135.0,1912,1710,1280,40244 days 16:47:18.660890,316,2.0,0.933920704845815,485,1401,-75.0
509000.0,2,2.0,1560,4675,1.0,3,8,1560,0.0,2006,1870,6361,5910 days 16:47:18.660890,266,1.0,0.0,-310,-1686,1560.0
340000.0,3,2.5,1400,4800,1.0,3,7,1200,200.0,1921,1440,3840,36956 days 16:47:18.660890,255,1.2,6.0,-40,960,1000.0
537000.0,3,2.5,1400,4800,1.0,3,7,1200,200.0,1921,1440,3840,36956 days 16:47:18.660890,085,1.2,6.0,-40,960,1000.0
865000.0,4,3.0,3690,9892,2.0,3,1,3690,0.0,1998,3430,11294,8832 days 16:47:18.660890,125,1.3333333333333333,0.0,260,-1402,3690.0
358000.0,2,1.0,1140,8340,1.0,3,7,1140,0.0,1948,1030,8149,27095 days 16:47:18.660890,348,2.0,0.0,110,191,1140.0
595000.0,4,2.25,1920,3225,1.5,5,7,1300,620.0,1923,1960,3750,36226 days 16:47:18.660890,262,1.7777777777777777,2.096774193548387,-40,-525,680.0
661000.0,4,2.5,2496,8058,2.0,3,9,2496,0.0,1998,2496,7757,8832 days 16:47:18.660890,170,1.6,0.0,0,301,2496.0
419950.0,3,2.25,2280,8500,1.0,4,7,1680,600.0,1977,1890,7700,16502 days 16:47:18.660890,259,1.3333333333333333,2.8,390,800,1080.0
490000.0,4,3.5,3200,6420,2.0,3,9,3200,0.0,2006,3200,6291,5910 days 16:47:18.660890,106,1.1428571428571428,0.0,0,129,3200.0
525000.0,2,1.0,880,4000,1.0,3,7,880,0.0,1940,1310,4000,30017 days 16:47:18.660890,261,2.0,0.0,-430,0,880.0
350000.0,3,2.0,1320,1298,3.0,3,7,1320,0.0,1995,1380,1503,9928 days 16:47:18.660890,225,1.5,0.0,-60,-205,1320.0
552500.0,3,2.5,2450,3582,2.0,3,9,2450,0.0,2008,2490,5449,5180 days 16:47:18.660890,131,1.2,0.0,-40,-1867,2450.0
210000.0,3,1.0,1040,8970,1.0,4,6,1040,0.0,1961,1040,8450,22346 days 16:47:18.660890,086,3.0,0.0,0,520,1040.0
390000.0,3,2.5,2480,53250,2.0,3,9,2480,0.0,1990,2510,36549,11754 days 16:47:18.660890,070,1.2,0.0,-30,16701,2480.0
336800.0,5,1.75,1830,16650,1.5,3,7,1610,220.0,1958,1790,12743,23442 days 16:47:18.660890,029,2.857142857142857,7.318181818181818,40,3907,1390.0
465000.0,3,2.5,1440,4473,2.0,3,7,1440,0.0,2003,1650,3322,7006 days 16:47:18.660890,062,1.2,0.0,-210,1151,1440.0
299900.0,4,2.5,1580,3632,2.0,3,7,1580,0.0,2011,1950,3800,4084 days 16:47:18.660890,352,1.6,0.0,-370,-168,1580.0
715000.0,3,3.25,3230,5000,2.0,3,9,3230,0.0,2006,2670,3977,5910 days 16:47:18.660890,199,0.9230769230769231,0.0,560,1023,3230.0
235000.0,4,2.5,1810,39639,1.0,3,7,1230,580.0,1970,1810,44866,19059 days 16:47:18.660890,143,1.6,2.1206896551724137,0,-5227,650.0
276000.0,3,2.5,2495,4400,2.0,3,8,2495,0.0,2007,2434,4400,5545 days 16:47:18.660890,344,1.2,0.0,61,0,2495.0
265000.0,4,1.5,1740,12728,1.0,4,7,1180,560.0,1964,1830,11125,21251 days 16:47:18.660890,012,2.6666666666666665,2.107142857142857,-90,1603,620.0
425000.0,3,1.75,1680,3000,1.0,4,6,840,840.0,1900,1540,3700,44626 days 16:47:18.660890,150,1.7142857142857142,1.0,140,-700,0.0
313000.0,4,2.5,2460,10320,2.0,3,8,2460,0.0,1993,2210,9024,10658 days 16:47:18.660890,005,1.6,0.0,250,1296,2460.0
715000.0,3,2.5,3050,6000,1.0,3,8,1720,1330.0,1984,2340,7200,13946 days 16:47:18.660890,099,1.2,1.2932330827067668,710,-1200,390.0
265000.0,3,2.25,1630,10969,2.0,3,7,1630,0.0,1991,1410,7920,11389 days 16:47:18.660890,346,1.3333333333333333,0.0,220,3049,1630.0
646000.0,3,2.75,2460,6413,2.0,3,9,2460,0.0,2004,2440,6092,6641 days 16:47:18.660890,083,1.0909090909090908,0.0,20,321,2460.0
175000.0,3,1.0,1030,6600,1.0,3,7,1030,0.0,1954,1220,9040,24903 days 16:47:18.660890,202,3.0,0.0,-190,-2440,1030.0
649000.0,3,2.5,3410,13809,1.0,4,1,2450,960.0,1973,3410,14245,17963 days 16:47:18.660890,212,1.2,2.5520833333333335,0,-436,1490.0
785000.0,3,2.75,2310,5200,1.0,4,7,1520,790.0,1940,2310,5200,30017 days 16:47:18.660890,113,1.0909090909090908,1.9240506329113924,0,0,730.0
890000.0,4,2.75,2610,4400,1.0,5,8,1260,1350.0,1920,1770,4400,37322 days 16:47:18.660890,265,1.4545454545454546,0.9333333333333333,840,0,-90.0
612000.0,3,3.0,2330,10327,1.0,3,9,2330,0.0,1998,2200,4629,8832 days 16:47:18.660890,330,1.0,0.0,130,5698,2330.0
330000.0,4,2.5,2980,5674,2.0,3,8,2980,0.0,2003,2610,5495,7006 days 16:47:18.660890,339,1.6,0.0,370,179,2980.0
493000.0,3,2.25,1790,11393,1.0,3,8,1790,0.0,1978,2290,11894,16137 days 16:47:18.660890,316,1.3333333333333333,0.0,-500,-501,1790.0
1600000.0,4,2.25,2940,5735,1.0,3,9,1470,1470.0,1957,2230,5659,23807 days 16:47:18.660890,093,1.7777777777777777,1.0,710,76,0.0
1620000.0,4,3.0,3900,9750,1.0,5,1,2520,1380.0,1972,3410,9450,18329 days 16:47:18.660890,178,1.3333333333333333,1.826086956521739,490,300,1140.0
1650000.0,4,3.0,3900,9750,1.0,5,1,2520,1380.0,1972,3410,9450,18329 days 16:47:18.660890,042,1.3333333333333333,1.826086956521739,490,300,1140.0
499000.0,3,2.5,1750,2150,2.5,3,7,1230,520.0,1900,1410,3300,44626 days 16:47:18.660890,269,1.2,2.3653846153846154,340,-1150,710.0
603500.0,6,2.75,2660,8400,1.0,5,8,1550,1110.0,1962,2280,8400,21981 days 16:47:18.660890,174,2.1818181818181817,1.3963963963963963,380,0,440.0
530000.0,2,1.5,1580,3680,1.0,3,8,1280,300.0,1941,1730,3680,29651 days 16:47:18.660890,175,1.3333333333333333,4.266666666666667,-150,0,980.0
895000.0,5,2.5,2350,14197,1.0,4,8,1220,1130.0,1962,2470,11629,21981 days 16:47:18.660890,096,2.0,1.079646017699115,-120,2568,90.0
267345.0,4,2.25,2510,8165,1.0,4,7,1610,900.0,1972,1940,8250,18329 days 16:47:18.660890,133,1.7777777777777777,1.788888888888889,570,-85,710.0
275000.0,3,2.5,1480,15639,2.0,3,8,1480,0.0,1987,1480,16454,12850 days 16:47:18.660890,136,1.2,0.0,0,-815,1480.0
439950.0,3,1.75,1720,223377,1.0,3,7,1240,480.0,1950,2530,221442,26364 days 16:47:18.660890,056,1.7142857142857142,2.5833333333333335,-810,1935,760.0
455000.0,3,2.25,1470,4653,2.0,4,7,1470,0.0,1985,1560,4119,13580 days 16:47:18.660890,171,1.3333333333333333,0.0,-90,534,1470.0
630000.0,3,1.75,1540,6930,1.0,3,7,1250,290.0,1944,1760,6930,28556 days 16:47:18.660890,013,1.7142857142857142,4.310344827586207,-220,0,960.0
690000.0,3,2.5,2820,5001,2.0,3,9,2820,0.0,2004,2660,5001,6641 days 16:47:18.660890,307,1.2,0.0,160,0,2820.0
212000.0,4,1.75,1250,12705,1.0,4,7,1250,0.0,1971,1390,8550,18694 days 16:47:18.660890,238,2.2857142857142856,0.0,-140,4155,1250.0
231500.0,4,2.25,2080,7526,1.0,4,7,1280,800.0,1985,1200,7500,13580 days 16:47:18.660890,225,1.7777777777777777,1.6,880,26,480.0
1240000.0,4,3.25,5180,49936,2.0,4,1,5180,0.0,1991,4240,35363,11389 days 16:47:18.660890,120,1.2307692307692308,0.0,940,14573,5180.0
378500.0,3,2.5,2860,43821,2.0,4,9,2860,0.0,1990,2370,65340,11754 days 16:47:18.660890,189,1.2,0.0,490,-21519,2860.0
482000.0,4,2.5,2710,35868,2.0,3,9,2710,0.0,1989,2780,36224,12119 days 16:47:18.660890,122,1.6,0.0,-70,-356,2710.0
695000.0,2,1.0,1140,3990,1.0,3,7,1140,0.0,1924,1800,5700,35861 days 16:47:18.660890,125,2.0,0.0,-660,-1710,1140.0
965000.0,4,2.5,4070,57587,2.0,3,1,4070,0.0,1989,3890,35960,12119 days 16:47:18.660890,336,1.6,0.0,180,21627,4070.0
675000.0,3,1.75,1710,5913,1.0,4,8,1120,590.0,1941,2920,5922,29651 days 16:47:18.660890,035,1.7142857142857142,1.8983050847457628,-1210,-9,530.0
387000.0,3,1.5,1340,6500,1.0,3,7,1340,0.0,1972,1620,7107,18329 days 16:47:18.660890,300,2.0,0.0,-280,-607,1340.0
347500.0,4,2.75,2290,7000,2.0,3,8,2290,0.0,1977,2000,7200,16502 days 16:47:18.660890,089,1.4545454545454546,0.0,290,-200,2290.0
265000.0,3,1.0,1080,4930,1.0,3,6,1080,0.0,1950,1100,5950,26364 days 16:47:18.660890,338,3.0,0.0,-20,-1020,1080.0
406000.0,3,1.0,960,5264,1.0,3,7,960,0.0,1953,1140,5150,25268 days 16:47:18.660890,112,3.0,0.0,-180,114,960.0
134000.0,2,1.5,980,5000,2.0,3,7,980,0.0,1922,1040,5000,36591 days 16:47:18.660890,128,1.3333333333333333,0.0,-60,0,980.0
415000.0,3,1.0,1500,3399,2.0,5,7,1300,200.0,1926,1360,3588,35130 days 16:47:18.660890,293,3.0,6.5,140,-189,1100.0
375000.0,3,1.75,1440,8775,1.0,3,7,1440,0.0,1973,1790,7865,17963 days 16:47:18.661888,147,1.7142857142857142,0.0,-350,910,1440.0
620000.0,4,2.5,2580,7465,2.0,3,8,2580,0.0,1993,2350,7596,10658 days 16:47:18.661888,344,1.6,0.0,230,-131,2580.0
337500.0,5,2.5,2070,4698,2.0,3,7,2070,0.0,1999,2010,4698,8467 days 16:47:18.661888,301,2.0,0.0,60,0,2070.0
565000.0,3,2.5,1880,12368,1.0,4,7,1260,620.0,1967,1950,11551,20155 days 16:47:18.661888,265,1.2,2.032258064516129,-70,817,640.0
399500.0,3,1.75,2420,12676,2.0,3,7,2420,0.0,1911,1210,6769,40609 days 16:47:18.661888,143,1.7142857142857142,0.0,1210,5907,2420.0
1070000.0,2,1.75,1890,9466,2.0,3,8,1890,0.0,1987,2180,12825,12850 days 16:47:18.661888,141,1.1428571428571428,0.0,-290,-3359,1890.0
352500.0,3,2.0,1920,33630,1.0,3,8,1920,0.0,1992,2080,7505,11024 days 16:47:18.661888,233,1.5,0.0,-160,26125,1920.0
259000.0,3,2.0,1870,5909,1.0,3,7,1270,600.0,1986,1870,7887,13215 days 16:47:18.661888,168,1.5,2.1166666666666667,0,-1978,670.0
320000.0,2,1.0,900,7620,1.0,3,7,900,0.0,1971,1520,7620,18694 days 16:47:18.661888,105,2.0,0.0,-620,0,900.0
733000.0,3,2.5,2160,9888,2.0,4,9,2160,0.0,1989,3060,7829,12119 days 16:47:18.661888,223,1.2,0.0,-900,2059,2160.0
381500.0,2,1.0,900,2910,1.0,5,7,900,0.0,1924,1320,2910,35861 days 16:47:18.661888,176,2.0,0.0,-420,0,900.0
343000.0,2,1.0,1180,9261,1.0,4,7,940,240.0,1957,1700,6325,23807 days 16:47:18.661888,336,2.0,3.9166666666666665,-520,2936,700.0
205500.0,2,1.0,900,6400,1.0,5,6,900,0.0,1938,1320,6400,30747 days 16:47:18.661888,230,2.0,0.0,-420,0,900.0
525000.0,3,2.0,1600,16530,1.0,5,7,1600,0.0,1967,1850,41006,20155 days 16:47:18.661888,258,1.5,0.0,-250,-24476,1600.0
300000.0,3,1.75,1500,8352,1.0,5,6,750,750.0,1943,1500,8447,28921 days 16:47:18.661888,078,1.7142857142857142,1.0,0,-95,0.0
299000.0,2,1.0,1070,189486,1.0,3,6,1070,0.0,1942,1970,60548,29286 days 16:47:18.661888,203,2.0,0.0,-900,128938,1070.0
561000.0,4,2.5,2570,5250,2.0,3,8,2570,0.0,1990,2260,5392,11754 days 16:47:18.661888,190,1.6,0.0,310,-142,2570.0
450000.0,3,1.0,1210,4000,1.5,3,7,1090,120.0,1928,1210,4000,34400 days 16:47:18.661888,055,3.0,9.083333333333334,0,0,970.0
540000.0,4,2.5,1850,7850,2.0,3,8,1850,0.0,1985,1830,8140,13580 days 16:47:18.661888,226,1.6,0.0,20,-290,1850.0
379000.0,3,2.5,1740,30886,2.0,3,8,1740,0.0,1992,1740,39133,11024 days 16:47:18.661888,175,1.2,0.0,0,-8247,1740.0
230000.0,3,1.0,1300,14000,1.0,4,7,1300,0.0,1958,1390,8750,23442 days 16:47:18.661888,205,3.0,0.0,-90,5250,1300.0
399950.0,3,2.5,2000,30605,2.0,4,8,2000,0.0,1989,1930,35350,12119 days 16:47:18.661888,069,1.2,0.0,70,-4745,2000.0
355000.0,5,2.5,3220,5806,2.0,3,8,3220,0.0,2002,2760,5813,7371 days 16:47:18.661888,127,2.0,0.0,460,-7,3220.0
700000.0,3,2.0,2130,4299,1.5,4,7,1680,450.0,1922,2040,4548,36591 days 16:47:18.661888,117,1.5,3.7333333333333334,90,-249,1230.0
279900.0,3,1.75,1580,8151,1.0,4,7,1100,480.0,1962,1650,8151,21981 days 16:47:18.661888,126,1.7142857142857142,2.2916666666666665,-70,0,620.0
210000.0,3,1.0,1200,7500,1.0,3,6,1200,0.0,1905,1010,7000,42800 days 16:47:18.661888,317,3.0,0.0,190,500,1200.0
1170000.0,3,3.0,3790,5001,2.0,3,1,2810,980.0,1989,2500,6286,12119 days 16:47:18.661888,181,1.0,2.86734693877551,1290,-1285,1830.0
290300.0,2,1.0,860,3874,1.0,4,6,860,0.0,1931,1400,5106,33304 days 16:47:18.661888,162,2.0,0.0,-540,-1232,860.0
1600000.0,5,4.5,5130,43123,2.0,3,1,5130,0.0,1996,4670,43560,9563 days 16:47:18.661888,276,1.1111111111111112,0.0,460,-437,5130.0
490000.0,3,1.0,1600,6380,1.5,3,7,1400,200.0,1939,1760,6380,30382 days 16:47:18.661888,106,3.0,7.0,-160,0,1200.0
606000.0,4,2.5,2110,13850,2.0,3,9,2110,0.0,1987,2520,10194,12850 days 16:47:18.661888,126,1.6,0.0,-410,3656,2110.0
359950.0,3,1.0,1400,4980,1.0,3,6,950,450.0,1943,990,4980,28921 days 16:47:18.661888,195,3.0,2.111111111111111,410,0,500.0
677100.0,3,2.0,2110,9199,1.0,3,1,2110,0.0,1993,3130,8841,10658 days 16:47:18.661888,043,1.5,0.0,-1020,358,2110.0
465000.0,3,2.0,1430,7125,1.0,4,7,1430,0.0,1984,1570,8075,13946 days 16:47:18.661888,052,1.5,0.0,-140,-950,1430.0
4500000.0,5,5.5,6640,40014,2.0,3,1,6350,290.0,2004,3030,23408,6641 days 16:47:18.661888,227,0.9090909090909091,21.896551724137932,3610,16606,6060.0
500000.0,3,2.0,3040,41072,1.0,4,8,1520,1520.0,1978,2230,54014,16137 days 16:47:18.661888,124,1.5,1.0,810,-12942,0.0
455000.0,2,1.0,980,5000,1.0,4,7,980,0.0,1950,1600,5965,26364 days 16:47:18.661888,123,2.0,0.0,-620,-965,980.0
705000.0,6,2.0,2570,4240,1.5,4,7,1970,600.0,1911,2030,4240,40609 days 16:47:18.661888,230,3.0,3.283333333333333,540,0,1370.0
420000.0,3,2.5,2060,7020,1.0,4,8,1460,600.0,1967,2150,8400,20155 days 16:47:18.661888,224,1.2,2.433333333333333,-90,-1380,860.0
169575.0,3,1.0,1300,8284,1.0,3,7,1300,0.0,1968,1360,7848,19790 days 16:47:18.661888,278,3.0,0.0,-60,436,1300.0
250000.0,3,1.0,1300,8284,1.0,3,7,1300,0.0,1968,1360,7848,19790 days 16:47:18.661888,056,3.0,0.0,-60,436,1300.0
530000.0,3,2.25,1680,7262,1.0,5,7,1180,500.0,1973,1910,7405,17963 days 16:47:18.661888,071,1.3333333333333333,2.36,-230,-143,680.0
590000.0,5,3.25,4020,40341,1.0,5,8,2170,1850.0,1970,2650,53437,19059 days 16:47:18.661888,037,1.5384615384615385,1.172972972972973,1370,-13096,320.0
257500.0,3,1.75,1530,14087,1.0,3,7,1070,460.0,1979,1770,13660,15772 days 16:47:18.661888,266,1.7142857142857142,2.3260869565217392,-240,427,610.0
415000.0,3,1.0,1170,6700,1.0,3,8,1170,0.0,1957,2410,7620,23807 days 16:47:18.661888,177,3.0,0.0,-1240,-920,1170.0
536000.0,3,1.75,1580,3764,1.5,3,7,1280,300.0,1945,1560,3764,28190 days 16:47:18.661888,283,1.7142857142857142,4.266666666666667,20,0,980.0
246500.0,3,1.5,1270,11600,1.0,4,7,1270,0.0,1964,1380,9945,21251 days 16:47:18.661888,149,2.0,0.0,-110,1655,1270.0
395000.0,3,1.75,1480,7700,1.0,3,8,1480,0.0,1975,1930,8560,17233 days 16:47:18.661888,187,1.7142857142857142,0.0,-450,-860,1480.0
739000.0,3,2.25,2220,10530,1.0,4,8,1700,520.0,1974,2500,10014,17598 days 16:47:18.661888,131,1.3333333333333333,3.269230769230769,-280,516,1180.0
1270000.0,4,2.75,3200,13729,2.0,3,1,3200,0.0,1984,4050,16921,13946 days 16:47:18.661888,272,1.4545454545454546,0.0,-850,-3192,3200.0
190000.0,3,1.0,910,10575,1.0,4,7,910,0.0,1968,1470,10425,19790 days 16:47:18.661888,189,3.0,0.0,-560,150,910.0
305000.0,3,1.5,1480,9086,1.0,3,7,1480,0.0,1962,1540,9750,21981 days 16:47:18.661888,100,2.0,0.0,-60,-664,1480.0
925000.0,4,4.25,3770,13058,2.0,4,8,3770,0.0,1983,2200,12255,14311 days 16:47:18.661888,110,0.9411764705882353,0.0,1570,803,3770.0
895000.0,4,3.0,3500,13444,2.0,3,1,2360,1140.0,1977,3140,12935,16502 days 16:47:18.661888,233,1.3333333333333333,2.0701754385964914,360,509,1220.0
656000.0,3,1.75,1480,7475,1.5,3,8,1480,0.0,1943,2120,7216,28921 days 16:47:18.661888,198,1.7142857142857142,0.0,-640,259,1480.0
560000.0,4,1.0,1660,4690,1.5,3,7,1260,400.0,1945,1400,3876,28190 days 16:47:18.661888,139,4.0,3.15,260,814,860.0
610000.0,5,2.25,2520,11700,2.0,3,9,2520,0.0,1977,2530,12000,16502 days 16:47:18.661888,293,2.2222222222222223,0.0,-10,-300,2520.0
645000.0,4,2.5,2850,37522,2.0,3,9,2850,0.0,1987,2980,35280,12850 days 16:47:18.661888,189,1.6,0.0,-130,2242,2850.0
259000.0,3,2.5,2153,4400,2.0,3,8,2153,0.0,2007,2434,4400,5545 days 16:47:18.661888,100,1.2,0.0,-281,0,2153.0
980000.0,4,2.5,3780,10962,2.0,3,1,3780,0.0,1990,3310,11651,11754 days 16:47:18.661888,230,1.6,0.0,470,-689,3780.0
872000.0,4,4.0,3770,9750,1.0,4,9,1940,1830.0,1967,2260,9878,20155 days 16:47:18.661888,204,1.0,1.0601092896174864,1510,-128,110.0
1000000.0,6,2.75,3600,9675,1.0,4,9,1940,1660.0,1977,2990,9675,16502 days 16:47:18.661888,217,2.1818181818181817,1.1686746987951808,610,0,280.0
900000.0,3,2.75,2980,12600,1.5,3,8,1590,1390.0,1941,1520,9660,29651 days 16:47:18.661888,253,1.0909090909090908,1.143884892086331,1460,2940,200.0
475000.0,4,1.5,2320,5534,1.5,4,7,1540,780.0,1915,1670,5913,39148 days 16:47:18.661888,118,2.6666666666666665,1.9743589743589745,650,-379,760.0
350000.0,5,2.75,2980,13482,1.0,4,8,1730,1250.0,1975,2900,14800,17233 days 16:47:18.661888,007,1.8181818181818181,1.384,80,-1318,480.0
840000.0,4,1.75,2930,11562,1.0,3,9,1670,1260.0,1947,2530,6517,27460 days 16:47:18.661888,135,2.2857142857142856,1.3253968253968254,400,5045,410.0
500000.0,4,2.5,2040,8400,1.0,3,8,1420,620.0,1963,2540,8925,21616 days 16:47:18.661888,173,1.6,2.2903225806451615,-500,-525,800.0
202500.0,3,1.5,1510,9898,1.0,3,7,1110,400.0,1954,1420,9250,24903 days 16:47:18.661888,096,2.0,2.775,90,648,710.0
225000.0,3,2.5,1740,10050,2.0,3,7,1740,0.0,1989,1300,10125,12119 days 16:47:18.661888,337,1.2,0.0,440,-75,1740.0
418200.0,3,2.25,2240,9542,1.0,3,7,1190,1050.0,1980,2080,9542,15407 days 16:47:18.661888,068,1.3333333333333333,1.1333333333333333,160,0,140.0
356500.0,4,1.75,1570,9670,1.0,3,7,1170,400.0,1959,2080,9100,23077 days 16:47:18.661888,339,2.2857142857142856,2.925,-510,570,770.0
456150.0,3,2.25,1750,12408,1.0,5,7,1150,600.0,1962,1820,12977,21981 days 16:47:18.661888,338,1.3333333333333333,1.9166666666666667,-70,-569,550.0
471000.0,4,2.5,3030,9687,2.0,3,8,2020,1010.0,1998,2050,10193,8832 days 16:47:18.661888,154,1.6,2.0,980,-506,1010.0
558000.0,3,2.5,1680,934,3.0,3,8,1680,0.0,2008,1740,1280,5180 days 16:47:18.661888,099,1.2,0.0,-60,-346,1680.0
1380000.0,6,4.5,5740,10312,2.0,3,1,3610,2130.0,2000,4350,11917,8102 days 16:47:18.661888,064,1.3333333333333333,1.6948356807511737,1390,-1605,1480.0
161500.0,3,1.0,1220,6000,1.0,5,7,1220,0.0,1961,1420,13137,22346 days 16:47:18.661888,346,3.0,0.0,-200,-7137,1220.0
311000.0,3,1.0,1310,8370,1.5,3,7,1310,0.0,1962,1310,8370,21981 days 16:47:18.661888,283,3.0,0.0,0,0,1310.0
470000.0,6,1.75,2490,8732,1.5,4,8,2490,0.0,1966,1840,8024,20520 days 16:47:18.661888,055,3.4285714285714284,0.0,650,708,2490.0
569000.0,3,3.25,2220,8227,1.5,5,8,1770,450.0,1929,1750,4800,34034 days 16:47:18.661888,190,0.9230769230769231,3.933333333333333,470,3427,1320.0
689000.0,4,2.5,2240,7350,2.0,3,9,2240,0.0,1989,2200,8017,12119 days 16:47:18.661888,077,1.6,0.0,40,-667,2240.0
271900.0,3,1.75,1890,11875,1.0,3,7,1230,660.0,1979,1580,10920,15772 days 16:47:18.661888,196,1.7142857142857142,1.8636363636363635,310,955,570.0
278000.0,4,2.5,1850,6037,2.0,3,7,1850,0.0,1991,1860,6037,11389 days 16:47:18.661888,344,1.6,0.0,-10,0,1850.0
820000.0,2,2.5,2210,4440,2.0,4,8,1440,770.0,1931,1560,4920,33304 days 16:47:18.661888,204,0.8,1.87012987012987,650,-480,670.0
399500.0,3,1.75,1410,7700,1.0,4,7,1410,0.0,1967,1560,7700,20155 days 16:47:18.661888,056,1.7142857142857142,0.0,-150,0,1410.0
462000.0,3,2.75,1890,2614,2.0,4,9,1890,0.0,1979,1800,2769,15772 days 16:47:18.661888,309,1.0909090909090908,0.0,90,-155,1890.0
347500.0,3,1.0,1830,12036,1.0,3,7,1550,280.0,1977,1810,12036,16502 days 16:47:18.661888,103,3.0,5.535714285714286,20,0,1270.0
562100.0,2,0.75,1440,3700,1.0,3,7,1200,240.0,1914,1440,4300,39513 days 16:47:18.661888,176,2.6666666666666665,5.0,0,-600,960.0
230000.0,2,1.0,950,7560,1.0,3,6,950,0.0,1958,1160,7560,23442 days 16:47:18.661888,149,2.0,0.0,-210,0,950.0
687000.0,4,2.5,2370,10083,2.0,5,8,2370,0.0,1966,2370,10133,20520 days 16:47:18.661888,173,1.6,0.0,0,-50,2370.0
725786.0,4,2.5,3070,5762,2.0,3,1,3070,0.0,2000,3630,6500,8102 days 16:47:18.661888,343,1.6,0.0,-560,-738,3070.0
315500.0,3,1.0,1300,12600,1.0,4,7,1300,0.0,1969,1480,13530,19424 days 16:47:18.661888,026,3.0,0.0,-180,-930,1300.0
312000.0,4,2.0,1300,7054,1.0,3,7,1300,0.0,1950,1560,7100,26364 days 16:47:18.661888,126,2.0,0.0,-260,-46,1300.0
343000.0,3,3.25,1210,1173,2.0,3,8,1000,210.0,2002,1650,1493,7371 days 16:47:18.661888,310,0.9230769230769231,4.761904761904762,-440,-320,790.0
385195.0,1,1.0,710,6000,1.5,3,6,710,0.0,2015,1440,4800,2623 days 16:47:18.661888,302,1.0,0.0,-730,1200,710.0
415000.0,4,2.25,2240,12650,1.0,4,8,1730,510.0,1981,2150,12650,15041 days 16:47:18.661888,241,1.7777777777777777,3.392156862745098,90,0,1220.0
461000.0,3,1.75,3600,8666,2.0,4,6,2400,1200.0,1948,2290,8200,27095 days 16:47:18.661888,181,1.7142857142857142,2.0,1310,466,1200.0
369990.0,4,2.5,1960,7133,2.0,3,7,1960,0.0,2002,1960,6705,7371 days 16:47:18.661888,161,1.6,0.0,0,428,1960.0
349950.0,4,2.5,1820,3134,2.0,3,7,1820,0.0,1999,1820,3751,8467 days 16:47:18.661888,272,1.6,0.0,0,-617,1820.0
285750.0,3,2.25,1960,17126,1.0,3,8,1400,560.0,1966,2060,11466,20520 days 16:47:18.661888,102,1.3333333333333333,2.5,-100,5660,840.0
542500.0,4,2.25,1750,10160,1.0,3,8,1320,430.0,1972,2170,11165,18329 days 16:47:18.661888,110,1.7777777777777777,3.0697674418604652,-420,-1005,890.0
830000.0,5,3.5,3700,5400,2.0,3,9,2890,810.0,2011,3620,5460,4084 days 16:47:18.661888,315,1.4285714285714286,3.567901234567901,80,-60,2080.0
705000.0,4,2.5,2910,20946,2.0,4,8,2350,560.0,1976,2020,11342,16868 days 16:47:18.661888,357,1.6,4.196428571428571,890,9604,1790.0
615000.0,2,1.0,1270,5000,1.0,3,8,1090,180.0,1949,1640,5000,26729 days 16:47:18.661888,175,2.0,6.055555555555555,-370,0,910.0
184500.0,2,1.0,720,5880,1.0,3,6,720,0.0,1940,1440,7200,30017 days 16:47:18.661888,029,2.0,0.0,-720,-1320,720.0
412000.0,2,1.0,1040,5120,1.0,3,7,1040,0.0,1901,1250,4000,44261 days 16:47:18.661888,274,2.0,0.0,-210,1120,1040.0
250000.0,3,1.5,2210,11111,1.5,3,7,2210,0.0,1934,1250,8422,32208 days 16:47:18.661888,349,2.0,0.0,960,2689,2210.0
580000.0,5,2.0,2060,6000,2.0,3,7,2060,0.0,1903,1770,5000,43531 days 16:47:18.661888,163,2.5,0.0,290,1000,2060.0
220000.0,2,1.0,780,6000,1.0,5,6,780,0.0,1923,1080,6000,36226 days 16:47:18.661888,071,2.0,0.0,-300,0,780.0
675000.0,4,2.75,2240,8937,1.0,4,8,1460,780.0,1976,2360,9038,16868 days 16:47:18.661888,259,1.4545454545454546,1.8717948717948718,-120,-101,680.0
373500.0,2,1.0,800,3330,1.0,3,7,800,0.0,1918,1300,4320,38052 days 16:47:18.661888,142,2.0,0.0,-500,-990,800.0
662700.0,2,1.5,2440,6900,2.0,3,7,1590,850.0,1910,1770,6900,40974 days 16:47:18.661888,092,1.3333333333333333,1.8705882352941177,670,0,740.0
239950.0,5,1.0,1460,6032,2.0,4,6,1460,0.0,1941,1060,10300,29651 days 16:47:18.661888,136,5.0,0.0,400,-4268,1460.0
383000.0,3,1.0,1150,10196,1.0,4,7,1150,0.0,1957,1410,8925,23807 days 16:47:18.661888,268,3.0,0.0,-260,1271,1150.0
485000.0,3,2.75,2650,12350,1.0,4,7,1470,1180.0,1975,1950,14075,17233 days 16:47:18.661888,029,1.0909090909090908,1.2457627118644068,700,-1725,290.0
610000.0,4,2.75,2600,36583,1.0,5,8,1580,1020.0,1976,2300,27820,16868 days 16:47:18.661888,191,1.4545454545454546,1.5490196078431373,300,8763,560.0
545000.0,6,1.75,1820,6250,1.0,3,7,1130,690.0,1954,1820,5750,24903 days 16:47:18.661888,220,3.4285714285714284,1.6376811594202898,0,500,440.0
780000.0,2,2.5,2560,2500,2.0,5,8,1690,870.0,1901,1890,5000,44261 days 16:47:18.661888,189,0.8,1.9425287356321839,670,-2500,820.0
305000.0,3,2.5,1714,3240,2.0,3,8,1714,0.0,2005,1714,3240,6275 days 16:47:18.661888,114,1.2,0.0,0,0,1714.0
405000.0,3,1.0,1330,15678,1.0,3,7,900,430.0,1984,1330,12696,13946 days 16:47:18.661888,163,3.0,2.0930232558139537,0,2982,470.0
1110000.0,5,3.5,7350,12231,2.0,3,1,4750,2600.0,2001,5380,12587,7736 days 16:47:18.661888,211,1.4285714285714286,1.8269230769230769,1970,-356,2150.0
273000.0,3,1.75,2050,9045,2.0,4,6,2050,0.0,1959,1200,9045,23077 days 16:47:18.661888,092,1.7142857142857142,0.0,850,0,2050.0
326500.0,3,1.0,1810,12375,2.0,3,7,1810,0.0,1970,1420,9357,19059 days 16:47:18.661888,147,3.0,0.0,390,3018,1810.0
365000.0,3,1.75,1380,9134,1.0,5,7,880,500.0,1981,1400,8190,15041 days 16:47:18.661888,114,1.7142857142857142,1.76,-20,944,380.0
1000000.0,3,2.75,3070,10739,2.0,3,1,2440,630.0,1987,3490,11913,12850 days 16:47:18.661888,098,1.0909090909090908,3.873015873015873,-420,-1174,1810.0
422500.0,2,1.0,800,4046,1.0,3,7,800,0.0,1940,1400,4046,30017 days 16:47:18.661888,084,2.0,0.0,-600,0,800.0
354450.0,4,2.75,2140,9920,2.0,3,8,2140,0.0,1993,2130,9920,10658 days 16:47:18.661888,083,1.4545454545454546,0.0,10,0,2140.0
320000.0,3,1.0,1330,9540,1.0,4,7,1330,0.0,1971,1250,10350,18694 days 16:47:18.661888,338,3.0,0.0,80,-810,1330.0
223000.0,3,1.0,1030,9120,1.0,3,7,1030,0.0,1961,1470,10220,22346 days 16:47:18.661888,154,3.0,0.0,-440,-1100,1030.0
410000.0,3,2.5,1740,4948,2.0,3,7,1740,0.0,2008,1290,3383,5180 days 16:47:18.661888,205,1.2,0.0,450,1565,1740.0
438000.0,3,1.0,1200,4000,1.5,4,6,1200,0.0,1923,1390,4000,36226 days 16:47:18.661888,241,3.0,0.0,-190,0,1200.0
390000.0,3,3.0,1490,2944,2.0,3,7,960,530.0,1993,1590,1600,10658 days 16:47:18.661888,310,1.0,1.8113207547169812,-100,1344,430.0
298500.0,4,2.5,1890,5954,2.0,3,7,1890,0.0,2004,2030,5880,6641 days 16:47:18.661888,050,1.6,0.0,-140,74,1890.0
749999.0,5,2.25,3060,13630,2.0,3,1,3060,0.0,1989,3430,10700,12119 days 16:47:18.661888,248,2.2222222222222223,0.0,-370,2930,3060.0
779000.0,6,2.5,3250,12000,1.0,3,8,1800,1450.0,1966,3490,10320,20520 days 16:47:18.661888,241,2.4,1.2413793103448276,-240,1680,350.0
570000.0,3,2.75,2730,11936,2.0,3,8,1530,1200.0,1978,2810,12333,16137 days 16:47:18.661888,014,1.0909090909090908,1.275,-80,-397,330.0
385000.0,3,1.0,810,4600,1.0,3,6,810,0.0,1918,1520,4800,38052 days 16:47:18.661888,132,3.0,0.0,-710,-200,810.0
649000.0,4,2.0,2240,11040,1.0,5,8,1120,1120.0,1961,1790,11040,22346 days 16:47:18.661888,230,2.0,1.0,450,0,0.0
283000.0,3,1.0,1740,5247,1.0,3,7,1270,470.0,1947,1070,5636,27460 days 16:47:18.661888,274,3.0,2.702127659574468,670,-389,800.0
699900.0,4,2.25,2380,16236,1.0,3,7,1540,840.0,1961,2230,8925,22346 days 16:47:18.661888,265,1.7777777777777777,1.8333333333333333,150,7311,700.0
278500.0,4,1.0,1540,8400,1.0,3,7,770,770.0,1971,1520,9891,18694 days 16:47:18.661888,051,4.0,1.0,20,-1491,0.0
700000.0,4,1.75,2340,9100,1.0,3,8,1610,730.0,1975,2470,11000,17233 days 16:47:18.661888,319,2.2857142857142856,2.2054794520547945,-130,-1900,880.0
535000.0,4,2.75,2710,45963,2.0,3,9,2710,0.0,1995,2710,33955,9928 days 16:47:18.661888,209,1.4545454545454546,0.0,0,12008,2710.0
234500.0,3,1.75,1310,18400,1.0,3,7,870,440.0,1954,1840,10790,24903 days 16:47:18.661888,266,1.7142857142857142,1.9772727272727273,-530,7610,430.0
374150.0,3,1.75,1390,9585,1.0,4,7,1390,0.0,1973,1240,8188,17963 days 16:47:18.661888,218,1.7142857142857142,0.0,150,1397,1390.0
397000.0,4,2.5,2201,9542,2.0,3,8,2201,0.0,2006,1990,9542,5910 days 16:47:18.661888,076,1.6,0.0,211,0,2201.0
613000.0,3,2.25,1960,10385,1.0,3,8,1960,0.0,1988,2800,12632,12485 days 16:47:18.661888,261,1.3333333333333333,0.0,-840,-2247,1960.0
1150000.0,3,2.5,2850,10474,1.0,4,8,1730,1120.0,1954,2820,10474,24903 days 16:47:18.661888,160,1.2,1.5446428571428572,30,0,610.0
595000.0,4,1.75,1880,4080,1.0,3,7,940,940.0,1924,1410,4080,35861 days 16:47:18.661888,086,2.2857142857142856,1.0,470,0,0.0
340000.0,5,2.75,2440,6858,2.0,3,8,2440,0.0,2003,2300,6858,7006 days 16:47:18.661888,253,1.8181818181818181,0.0,140,0,2440.0
388000.0,4,2.5,2560,5800,2.0,3,9,2560,0.0,2005,3040,5800,6275 days 16:47:18.661888,008,1.6,0.0,-480,0,2560.0
404000.0,3,1.75,1410,15210,1.0,3,7,1410,0.0,1950,1970,16290,26364 days 16:47:18.661888,265,1.7142857142857142,0.0,-560,-1080,1410.0
810000.0,3,2.0,2870,6360,1.5,4,8,1790,1080.0,1946,2310,6466,27825 days 16:47:18.661888,241,1.5,1.6574074074074074,560,-106,710.0
405000.0,4,2.5,2620,9359,2.0,3,9,2620,0.0,1987,2580,7433,12850 days 16:47:18.661888,093,1.6,0.0,40,1926,2620.0
726000.0,5,3.0,2970,10335,2.0,3,9,2970,0.0,2000,2970,10335,8102 days 16:47:18.661888,195,1.6666666666666667,0.0,0,0,2970.0
266000.0,3,2.5,1780,7214,1.0,4,7,1400,380.0,1986,1520,7228,13215 days 16:47:18.661888,134,1.2,3.6842105263157894,260,-14,1020.0
722500.0,5,2.25,3700,7207,1.0,5,8,1850,1850.0,1970,2340,7900,19059 days 16:47:18.661888,356,2.2222222222222223,1.0,1360,-693,0.0
352000.0,4,2.5,1252,25002,1.0,3,8,992,260.0,1996,1860,25002,9563 days 16:47:18.661888,059,1.6,3.8153846153846156,-608,0,732.0
265000.0,4,1.5,1240,8158,1.0,4,7,1110,130.0,1961,1520,8147,22346 days 16:47:18.661888,078,2.6666666666666665,8.538461538461538,-280,11,980.0
856000.0,3,2.5,2160,3920,2.0,3,9,2160,0.0,2014,1500,4920,2988 days 16:47:18.661888,037,1.2,0.0,660,-1000,2160.0
346950.0,3,2.5,2040,4348,2.0,4,8,2040,0.0,2006,2380,4348,5910 days 16:47:18.661888,205,1.2,0.0,-340,0,2040.0
866059.0,5,3.5,3130,4797,2.0,3,9,2570,560.0,2014,3440,5439,2988 days 16:47:18.661888,168,1.4285714285714286,4.589285714285714,-310,-642,2010.0
410000.0,3,2.5,2350,4456,2.0,3,7,2350,0.0,2004,2350,4456,6641 days 16:47:18.661888,029,1.2,0.0,0,0,2350.0
370000.0,3,1.75,1570,16817,2.0,3,7,1570,0.0,1982,1600,16817,14676 days 16:47:18.661888,189,1.7142857142857142,0.0,-30,0,1570.0
230000.0,3,1.0,1530,389126,1.5,4,7,1530,0.0,1919,1768,42148,37687 days 16:47:18.661888,174,3.0,0.0,-238,346978,1530.0
400000.0,2,2.0,1520,5010,1.0,3,7,1520,0.0,1999,1110,5040,8467 days 16:47:18.661888,283,1.0,0.0,410,-30,1520.0
172000.0,3,1.0,1350,9680,1.0,4,7,820,530.0,1959,1320,9225,23077 days 16:47:18.661888,070,3.0,1.5471698113207548,30,455,290.0
615000.0,3,1.75,1950,8480,1.0,4,8,1250,700.0,1962,1740,8480,21981 days 16:47:18.661888,195,1.7142857142857142,1.7857142857142858,210,0,550.0
860000.0,4,3.5,3950,9600,2.0,3,1,3950,0.0,1998,3110,10213,8832 days 16:47:18.661888,097,1.1428571428571428,0.0,840,-613,3950.0
555000.0,3,1.75,2040,6000,1.0,5,7,1120,920.0,1958,1530,6250,23442 days 16:47:18.661888,169,1.7142857142857142,1.2173913043478262,510,-250,200.0
579000.0,3,2.5,1990,4040,1.5,5,8,1390,600.0,1926,1180,3030,35130 days 16:47:18.661888,202,1.2,2.316666666666667,810,1010,790.0
385000.0,3,1.75,1300,7030,1.0,3,7,1300,0.0,1968,1450,7650,19790 days 16:47:18.661888,181,1.7142857142857142,0.0,-150,-620,1300.0
420000.0,4,2.25,2030,12000,2.0,3,7,2030,0.0,1977,2190,9900,16502 days 16:47:18.661888,104,1.7777777777777777,0.0,-160,2100,2030.0
645000.0,3,1.75,2340,6750,1.5,5,7,1620,720.0,1914,1410,3388,39513 days 16:47:18.661888,197,1.7142857142857142,2.25,930,3362,900.0
549950.0,3,2.5,2160,6288,2.0,3,8,2160,0.0,1996,1830,7600,9563 days 16:47:18.661888,118,1.2,0.0,330,-1312,2160.0
678000.0,3,2.75,2770,10000,1.0,5,8,1640,1130.0,1962,2450,10000,21981 days 16:47:18.661888,266,1.0909090909090908,1.4513274336283186,320,0,510.0
199000.0,4,2.0,2030,8120,2.0,3,7,2030,0.0,1950,1520,9440,26364 days 16:47:18.661888,141,2.0,0.0,510,-1320,2030.0
604000.0,3,1.0,1440,13824,1.0,4,7,1440,0.0,1957,2540,12092,23807 days 16:47:18.661888,049,3.0,0.0,-1100,1732,1440.0
268000.0,5,1.75,1730,10368,1.0,5,7,1010,720.0,1963,1730,7728,21616 days 16:47:18.661888,093,2.857142857142857,1.4027777777777777,0,2640,290.0
960000.0,5,3.5,4510,16305,2.0,3,1,2820,1690.0,2003,4330,18741,7006 days 16:47:18.661888,217,1.4285714285714286,1.668639053254438,180,-2436,1130.0
509250.0,3,2.5,2100,7600,1.0,4,7,1450,650.0,1980,2010,7600,15407 days 16:47:18.661888,049,1.2,2.230769230769231,90,0,800.0
416000.0,3,2.5,1800,5372,2.0,3,8,1800,0.0,1987,1650,6014,12850 days 16:47:18.661888,322,1.2,0.0,150,-642,1800.0
190000.0,3,1.0,1090,8520,1.0,3,7,1090,0.0,1967,1190,8520,20155 days 16:47:18.661888,135,3.0,0.0,-100,0,1090.0
212000.0,3,1.5,1010,10000,1.0,4,7,1010,0.0,1973,2420,34637,17963 days 16:47:18.661888,119,2.0,0.0,-1410,-24637,1010.0
325900.0,3,2.5,2040,9765,2.0,3,8,2040,0.0,1985,2350,10150,13580 days 16:47:18.661888,302,1.2,0.0,-310,-385,2040.0
560000.0,3,3.5,2270,4088,2.0,3,8,1880,390.0,1996,1760,5425,9563 days 16:47:18.661888,213,0.8571428571428571,4.82051282051282,510,-1337,1490.0
275000.0,3,2.5,1730,5799,2.0,4,7,1730,0.0,1987,1710,6490,12850 days 16:47:18.661888,267,1.2,0.0,20,-691,1730.0
665000.0,4,2.5,2480,15411,2.0,3,8,2480,0.0,1994,2940,14679,10293 days 16:47:18.661888,068,1.6,0.0,-460,732,2480.0
375000.0,4,2.0,1720,2410,1.0,3,7,970,750.0,1930,1160,1404,33669 days 16:47:18.662886,337,2.0,1.2933333333333332,560,1006,220.0
359950.0,3,1.75,1570,6975,1.0,3,7,1040,530.0,1979,1280,7813,15772 days 16:47:18.662886,252,1.7142857142857142,1.9622641509433962,290,-838,510.0
340000.0,4,2.75,3527,7200,2.0,3,7,3527,0.0,2005,2490,7200,6275 days 16:47:18.662886,023,1.4545454545454546,0.0,1037,0,3527.0
401000.0,2,1.0,840,8100,1.0,4,7,840,0.0,1948,1100,8220,27095 days 16:47:18.662886,304,2.0,0.0,-260,-120,840.0
669000.0,2,1.75,1950,10766,1.0,4,6,1160,790.0,1952,1780,11721,25634 days 16:47:18.662886,177,1.1428571428571428,1.4683544303797469,170,-955,370.0
638500.0,4,2.5,1980,6568,2.0,3,8,1980,0.0,2004,2310,6496,6641 days 16:47:18.662886,119,1.6,0.0,-330,72,1980.0
545000.0,2,1.5,1620,3760,2.0,5,7,1170,450.0,1924,2130,4000,35861 days 16:47:18.662886,082,1.3333333333333333,2.6,-510,-240,720.0
524000.0,4,1.0,1980,7015,1.0,3,7,1260,720.0,1973,1570,7626,17963 days 16:47:18.662886,360,4.0,1.75,410,-611,540.0
1610000.0,5,3.75,3530,13260,2.0,3,1,3530,0.0,2013,3340,13260,3353 days 16:47:18.662886,312,1.3333333333333333,0.0,190,0,3530.0
280000.0,2,1.0,1260,4800,1.0,3,6,1100,160.0,1947,1260,2435,27460 days 16:47:18.662886,252,2.0,6.875,0,2365,940.0
828000.0,4,2.5,2120,10841,1.0,4,8,1500,620.0,1979,3130,10950,15772 days 16:47:18.662886,237,1.6,2.4193548387096775,-1010,-109,880.0
223000.0,3,1.75,1360,10573,1.0,4,7,1360,0.0,1984,1580,8280,13946 days 16:47:18.662886,290,1.7142857142857142,0.0,-220,2293,1360.0
1290000.0,4,3.5,3100,2261,2.0,3,9,2250,850.0,1981,2660,2000,15041 days 16:47:18.662886,002,1.1428571428571428,2.6470588235294117,440,261,1400.0
750000.0,2,2.0,2370,155130,1.0,3,7,2370,0.0,1970,1860,14475,19059 days 16:47:18.662886,124,1.0,0.0,510,140655,2370.0
430000.0,2,1.0,1460,9207,1.0,3,7,1210,250.0,1947,1500,6898,27460 days 16:47:18.662886,107,2.0,4.84,-40,2309,960.0
711000.0,4,1.75,1980,10800,1.0,5,6,990,990.0,1948,2180,10800,27095 days 16:47:18.662886,169,2.2857142857142856,1.0,-200,0,0.0
310000.0,4,2.5,1930,7014,2.0,3,8,1930,0.0,1994,1990,7920,10293 days 16:47:18.662886,338,1.6,0.0,-60,-906,1930.0
415000.0,5,1.75,3700,9140,1.0,3,8,1850,1850.0,1957,2190,6720,23807 days 16:47:18.662886,360,2.857142857142857,1.0,1510,2420,0.0
274900.0,4,2.5,1970,6600,2.0,3,7,1970,0.0,1987,1970,7682,12850 days 16:47:18.662886,182,1.6,0.0,0,-1082,1970.0
525000.0,3,3.0,2470,36445,2.0,4,8,2470,0.0,1980,2310,35350,15407 days 16:47:18.662886,160,1.0,0.0,160,1095,2470.0
179500.0,3,1.0,1180,32214,1.0,3,7,1180,0.0,1952,2300,13714,25634 days 16:47:18.662886,353,3.0,0.0,-1120,18500,1180.0
478000.0,3,1.0,1280,2580,1.5,3,8,1280,0.0,1910,1410,3150,40974 days 16:47:18.662886,143,3.0,0.0,-130,-570,1280.0
195000.0,3,1.75,1380,7350,1.0,3,7,990,390.0,1981,1660,8400,15041 days 16:47:18.662886,141,1.7142857142857142,2.5384615384615383,-280,-1050,600.0
385000.0,4,3.0,2740,10925,1.0,3,8,1670,1070.0,1980,2330,9940,15407 days 16:47:18.662886,064,1.3333333333333333,1.560747663551402,410,985,600.0
401000.0,3,2.75,2020,9505,1.0,3,7,1260,760.0,1969,2080,11901,19424 days 16:47:18.662886,335,1.0909090909090908,1.6578947368421053,-60,-2396,500.0
522000.0,4,2.5,2835,6598,2.0,3,8,2835,0.0,2002,2770,6969,7371 days 16:47:18.662886,269,1.6,0.0,65,-371,2835.0
330000.0,4,1.75,1520,14417,1.0,4,7,1520,0.0,1968,1600,10716,19790 days 16:47:18.662886,055,2.2857142857142856,0.0,-80,3701,1520.0
503000.0,3,2.5,2190,4882,2.0,3,9,2190,0.0,1999,2190,7055,8467 days 16:47:18.662886,154,1.2,0.0,0,-2173,2190.0
175000.0,5,1.75,1680,8400,1.0,4,7,1680,0.0,1979,1800,8550,15772 days 16:47:18.662886,043,2.857142857142857,0.0,-120,-150,1680.0
963990.0,4,3.5,3915,6364,2.0,3,9,3915,0.0,2014,3830,6507,2988 days 16:47:18.662886,079,1.1428571428571428,0.0,85,-143,3915.0
845000.0,5,2.0,1720,9972,1.0,4,8,1720,0.0,1951,2700,9023,25999 days 16:47:18.662886,272,2.5,0.0,-980,949,1720.0
157500.0,2,1.0,670,4500,1.0,3,5,670,0.0,1905,1210,4500,42800 days 16:47:18.662886,022,2.0,0.0,-540,0,670.0
450000.0,2,3.0,1790,1709,2.0,3,7,1400,390.0,2001,1460,1462,7736 days 16:47:18.662886,339,0.6666666666666666,3.58974358974359,330,247,1010.0
925000.0,4,1.75,2440,11793,1.0,3,8,1420,1020.0,1950,2500,8028,26364 days 16:47:18.662886,261,2.2857142857142856,1.392156862745098,-60,3765,400.0
600000.0,2,1.0,920,5029,1.0,4,7,920,0.0,1938,1230,5029,30747 days 16:47:18.662886,005,2.0,0.0,-310,0,920.0
709000.0,4,1.0,1680,4087,1.5,3,7,1680,0.0,1911,1740,3745,40609 days 16:47:18.662886,261,4.0,0.0,-60,342,1680.0
1390000.0,5,3.75,3290,6480,2.0,5,1,2190,1100.0,1938,2010,7639,30747 days 16:47:18.662886,314,1.3333333333333333,1.990909090909091,1280,-1159,1090.0
248000.0,3,2.5,2120,6840,1.0,3,7,1220,900.0,1984,1820,8200,13946 days 16:47:18.662886,254,1.2,1.3555555555555556,300,-1360,320.0
245000.0,3,1.0,910,6630,1.0,4,6,910,0.0,1912,950,5100,40244 days 16:47:18.662886,131,3.0,0.0,-40,1530,910.0
332000.0,2,1.0,1000,4776,1.0,4,6,1000,0.0,1942,1500,4800,29286 days 16:47:18.662886,150,2.0,0.0,-500,-24,1000.0
459950.0,3,2.5,2340,4273,2.0,3,7,2340,0.0,2002,2400,4624,7371 days 16:47:18.662886,072,1.2,0.0,-60,-351,2340.0
425000.0,3,2.0,1180,1800,2.0,3,8,1180,0.0,1994,1500,1948,10293 days 16:47:18.662886,100,1.5,0.0,-320,-148,1180.0
460000.0,3,2.25,2080,50965,1.0,3,8,1590,490.0,1979,2270,51836,15772 days 16:47:18.662886,246,1.3333333333333333,3.2448979591836733,-190,-871,1100.0
838300.0,6,2.5,3760,12978,1.0,3,9,2360,1400.0,1967,2300,7362,20155 days 16:47:18.662886,247,2.4,1.6857142857142857,1460,5616,960.0
256000.0,3,2.5,1480,7200,2.0,5,7,1480,0.0,1995,1350,7200,9928 days 16:47:18.662886,315,1.2,0.0,130,0,1480.0
864000.0,3,2.75,3060,13554,2.0,3,1,3060,0.0,1984,3060,11455,13946 days 16:47:18.662886,020,1.0909090909090908,0.0,0,2099,3060.0
900000.0,4,3.5,3070,4440,2.0,3,9,2030,1040.0,1922,1780,4800,36591 days 16:47:18.662886,064,1.1428571428571428,1.9519230769230769,1290,-360,990.0
145600.0,3,1.0,1170,7560,1.0,3,6,1170,0.0,1958,1170,7560,23442 days 16:47:18.662886,091,3.0,0.0,0,0,1170.0
865000.0,5,3.0,2900,6730,1.0,5,8,1830,1070.0,1977,2370,6283,16502 days 16:47:18.662886,233,1.6666666666666667,1.7102803738317758,530,447,760.0
250250.0,3,2.25,2210,8000,2.0,4,8,2210,0.0,1969,1990,8000,19424 days 16:47:18.662886,160,1.3333333333333333,0.0,220,0,2210.0
162000.0,4,2.0,1440,7641,1.0,4,5,1440,0.0,1943,1440,7750,28921 days 16:47:18.662886,262,2.0,0.0,0,-109,1440.0
450000.0,4,1.75,1980,7350,1.0,3,7,1430,550.0,1973,1870,7920,17963 days 16:47:18.662886,212,2.2857142857142856,2.6,110,-570,880.0
675500.0,4,2.75,2060,21344,1.0,2,8,1460,600.0,1978,2060,16088,16137 days 16:47:18.662886,084,1.4545454545454546,2.433333333333333,0,5256,860.0
697000.0,3,2.25,2420,5304,1.5,5,7,1640,780.0,1947,1560,5304,27460 days 16:47:18.662886,307,1.3333333333333333,2.1025641025641026,860,0,860.0
1320000.0,3,3.25,3440,4080,2.0,3,9,2560,880.0,2005,3110,4080,6275 days 16:47:18.662886,315,0.9230769230769231,2.909090909090909,330,0,1680.0
490000.0,3,1.75,1600,16510,1.0,3,8,1600,0.0,1984,1510,10407,13946 days 16:47:18.662886,335,1.7142857142857142,0.0,90,6103,1600.0
590000.0,3,2.25,2210,5742,1.0,3,8,1460,750.0,1951,1900,4590,25999 days 16:47:18.662886,294,1.3333333333333333,1.9466666666666668,310,1152,710.0
280000.0,4,1.75,2250,16000,1.0,3,8,1450,800.0,1957,1930,16000,23807 days 16:47:18.662886,132,2.2857142857142856,1.8125,320,0,650.0
515000.0,2,1.0,1680,6500,1.0,4,7,1140,540.0,1941,1610,6500,29651 days 16:47:18.662886,143,2.0,2.111111111111111,70,0,600.0
576000.0,3,1.0,1140,5395,1.0,4,7,1010,130.0,1909,1700,5376,41339 days 16:47:18.662886,195,3.0,7.769230769230769,-560,19,880.0
375000.0,3,1.75,1430,10574,2.0,3,7,1430,0.0,1981,1900,10450,15041 days 16:47:18.662886,324,1.7142857142857142,0.0,-470,124,1430.0
478000.0,3,1.0,1440,7107,1.0,4,7,1000,440.0,1980,1540,7140,15407 days 16:47:18.662886,079,3.0,2.272727272727273,-100,-33,560.0
282000.0,3,1.0,1670,5200,1.0,5,7,1030,640.0,1977,1620,6696,16502 days 16:47:18.662886,028,3.0,1.609375,50,-1496,390.0
1400000.0,4,4.5,3080,10550,2.0,3,8,1940,1140.0,1976,2780,10550,16868 days 16:47:18.662886,304,0.8888888888888888,1.7017543859649122,300,0,800.0
593500.0,5,3.25,4300,50405,2.0,3,8,3220,1080.0,1972,2680,41684,18329 days 16:47:18.662886,041,1.5384615384615385,2.9814814814814814,1620,8721,2140.0
724950.0,4,3.5,3010,174240,2.0,3,9,3010,0.0,2004,2720,247856,6641 days 16:47:18.662886,293,1.1428571428571428,0.0,290,-73616,3010.0
306000.0,3,1.75,1560,7500,1.0,4,8,1560,0.0,1966,1600,7904,20520 days 16:47:18.662886,241,1.7142857142857142,0.0,-40,-404,1560.0
341000.0,4,1.75,1920,7665,1.0,4,8,1500,420.0,1975,2100,7344,17233 days 16:47:18.662886,160,2.2857142857142856,3.5714285714285716,-180,321,1080.0
399950.0,3,2.5,1400,4400,1.0,3,7,1400,0.0,1930,1060,4400,33669 days 16:47:18.662886,307,1.2,0.0,340,0,1400.0
534000.0,5,2.0,2280,3600,2.0,3,7,2280,0.0,1992,1740,1800,11024 days 16:47:18.662886,324,2.5,0.0,540,1800,2280.0
635000.0,6,2.5,3880,5700,2.0,3,7,3880,0.0,2003,2620,5070,7006 days 16:47:18.662886,202,2.4,0.0,1260,630,3880.0
350000.0,2,1.0,1350,3880,1.0,3,6,950,400.0,1927,1670,3920,34765 days 16:47:18.662886,083,2.0,2.375,-320,-40,550.0
856000.0,3,1.5,1480,2700,1.5,3,7,1480,0.0,1928,1970,4200,34400 days 16:47:18.662886,048,2.0,0.0,-490,-1500,1480.0
582000.0,4,3.0,1670,1189,3.0,3,8,1427,243.0,2000,1700,1401,8102 days 16:47:18.662886,266,1.3333333333333333,5.872427983539095,-30,-212,1184.0
799000.0,4,2.5,3400,6742,2.0,3,9,3400,0.0,2004,2970,6909,6641 days 16:47:18.662886,210,1.6,0.0,430,-167,3400.0
423700.0,3,2.5,2070,3986,2.0,3,8,2070,0.0,1999,2090,3986,8467 days 16:47:18.662886,251,1.2,0.0,-20,0,2070.0
1840000.0,4,3.5,4870,39190,2.0,3,1,4870,0.0,1995,5000,33880,9928 days 16:47:18.662886,027,1.1428571428571428,0.0,-130,5310,4870.0
322000.0,3,2.0,1760,43575,1.0,3,7,1160,600.0,1988,1760,46038,12485 days 16:47:18.662886,225,1.5,1.9333333333333333,0,-2463,560.0
929000.0,4,3.25,4030,57499,2.0,3,9,4030,0.0,2002,3470,57499,7371 days 16:47:18.662886,309,1.2307692307692308,0.0,560,0,4030.0
443000.0,2,1.0,1130,5413,1.0,3,7,880,250.0,1939,1250,5413,30382 days 16:47:18.662886,335,2.0,3.52,-120,0,630.0
441500.0,3,1.75,1510,7700,1.0,3,7,1510,0.0,1968,1440,7416,19790 days 16:47:18.662886,114,1.7142857142857142,0.0,70,284,1510.0
875000.0,4,3.5,3110,108464,2.0,4,8,3110,0.0,1979,2340,4938,15772 days 16:47:18.662886,189,1.1428571428571428,0.0,770,103526,3110.0
3600000.0,3,3.25,5020,12431,2.0,3,1,3420,1600.0,1941,3680,12620,29651 days 16:47:18.662886,322,0.9230769230769231,2.1375,1340,-189,1820.0
450000.0,2,1.0,740,5100,1.0,4,7,740,0.0,1947,920,5100,27460 days 16:47:18.662886,117,2.0,0.0,-180,0,740.0
425000.0,3,2.25,1630,10500,1.0,3,7,1100,530.0,1974,1640,9794,17598 days 16:47:18.662886,251,1.3333333333333333,2.0754716981132075,-10,706,570.0
660000.0,4,1.75,2780,9900,2.0,4,1,2780,0.0,1978,2600,12000,16137 days 16:47:18.662886,152,2.2857142857142856,0.0,180,-2100,2780.0
763101.0,3,1.75,1990,5560,1.0,4,7,1100,890.0,1939,1460,3706,30382 days 16:47:18.662886,167,1.7142857142857142,1.2359550561797752,530,1854,210.0
499000.0,4,2.75,2250,14149,2.0,3,9,2250,0.0,1992,2450,14027,11024 days 16:47:18.662886,097,1.4545454545454546,0.0,-200,122,2250.0
521000.0,3,1.75,1720,37363,1.0,4,8,1350,370.0,1974,2740,40635,17598 days 16:47:18.662886,062,1.7142857142857142,3.6486486486486487,-1020,-3272,980.0
302000.0,2,1.0,900,423838,1.0,5,6,900,0.0,1925,1810,94960,35495 days 16:47:18.662886,149,2.0,0.0,-910,328878,900.0
293000.0,4,2.25,2360,6260,2.0,3,7,2360,0.0,1998,2144,6773,8832 days 16:47:18.662886,098,1.7777777777777777,0.0,216,-513,2360.0
335000.0,3,2.25,1530,4580,2.0,3,7,1530,0.0,2011,2110,4094,4084 days 16:47:18.662886,193,1.3333333333333333,0.0,-580,486,1530.0
499000.0,2,1.0,1450,3090,2.0,3,7,1450,0.0,1919,1450,4635,37687 days 16:47:18.662886,349,2.0,0.0,0,-1545,1450.0
600000.0,3,1.75,2040,5000,1.5,3,7,1780,260.0,1924,1690,5000,35861 days 16:47:18.662886,125,1.7142857142857142,6.846153846153846,350,0,1520.0
720000.0,4,1.75,2620,11041,1.5,4,9,2620,0.0,1962,2230,11041,21981 days 16:47:18.662886,259,2.2857142857142856,0.0,390,0,2620.0
195000.0,2,2.0,1180,2553,2.0,3,6,1180,0.0,2005,1310,2687,6275 days 16:47:18.662886,056,1.0,0.0,-130,-134,1180.0
249000.0,3,1.0,1110,8423,1.0,3,7,1110,0.0,1952,1140,9083,25634 days 16:47:18.662886,127,3.0,0.0,-30,-660,1110.0
334000.0,3,2.25,1840,9781,2.0,3,7,1840,0.0,1989,1490,10101,12119 days 16:47:18.662886,033,1.3333333333333333,0.0,350,-320,1840.0
599950.0,4,1.75,2720,7810,1.0,3,8,1510,1210.0,1952,2120,7315,25634 days 16:47:18.662886,311,2.2857142857142856,1.2479338842975207,600,495,300.0
149900.0,2,1.75,1090,1950,1.0,4,8,1090,0.0,1982,1360,3426,14676 days 16:47:18.662886,048,1.1428571428571428,0.0,-270,-1476,1090.0
700000.0,4,1.75,1730,6500,1.0,3,7,1250,480.0,1945,1910,8100,28190 days 16:47:18.662886,329,2.2857142857142856,2.6041666666666665,-180,-1600,770.0
525000.0,4,1.5,1170,6240,1.0,4,6,1170,0.0,1960,2380,8846,22712 days 16:47:18.662886,219,2.6666666666666665,0.0,-1210,-2606,1170.0
1050000.0,4,3.75,4740,126759,2.0,4,1,4740,0.0,1991,3060,118047,11389 days 16:47:18.662886,189,1.0666666666666667,0.0,1680,8712,4740.0
402000.0,3,2.5,1960,8000,1.0,4,7,1290,670.0,1977,1960,8000,16502 days 16:47:18.662886,128,1.2,1.9253731343283582,0,0,620.0
450000.0,3,2.0,1430,3480,1.0,3,7,980,450.0,1947,1450,4650,27460 days 16:47:18.662886,171,1.5,2.1777777777777776,-20,-1170,530.0
520000.0,3,2.25,2510,43995,2.0,3,8,2510,0.0,1981,2470,48351,15041 days 16:47:18.662886,337,1.3333333333333333,0.0,40,-4356,2510.0
205000.0,3,1.75,1420,6980,1.0,5,7,820,600.0,1980,1470,7319,15407 days 16:47:18.662886,338,1.7142857142857142,1.3666666666666667,-50,-339,220.0
635000.0,3,2.25,2680,175982,1.0,3,9,2680,0.0,2004,3170,215186,6641 days 16:47:18.662886,245,1.3333333333333333,0.0,-490,-39204,2680.0
210500.0,3,1.0,1220,9600,1.0,5,7,1220,0.0,1958,1310,9600,23442 days 16:47:18.662886,063,3.0,0.0,-90,0,1220.0
406650.0,2,1.0,1070,6100,1.0,3,6,1070,0.0,1940,1770,5695,30017 days 16:47:18.662886,224,2.0,0.0,-700,405,1070.0
350000.0,3,1.75,1580,19998,1.0,4,7,1580,0.0,1968,1860,19998,19790 days 16:47:18.662886,098,1.7142857142857142,0.0,-280,0,1580.0
425000.0,4,1.75,1820,6000,1.0,3,7,930,890.0,1942,1590,6000,29286 days 16:47:18.662886,113,2.2857142857142856,1.0449438202247192,230,0,40.0
798000.0,3,3.5,3590,6402,2.0,3,1,3590,0.0,1999,3230,7305,8467 days 16:47:18.662886,156,0.8571428571428571,0.0,360,-903,3590.0
180000.0,3,1.0,1960,9583,2.0,2,5,1960,0.0,1908,1850,8324,41705 days 16:47:18.662886,335,3.0,0.0,110,1259,1960.0
1250000.0,5,3.25,3160,13238,2.0,5,8,3160,0.0,1972,2360,12042,18329 days 16:47:18.662886,153,1.5384615384615385,0.0,800,1196,3160.0
435000.0,4,2.0,2030,4033,2.0,4,7,1630,400.0,1925,1350,1340,35495 days 16:47:18.662886,062,2.0,4.075,680,2693,1230.0
355000.0,3,1.5,1240,15867,1.0,3,7,1240,0.0,1962,1570,9600,21981 days 16:47:18.662886,330,2.0,0.0,-330,6267,1240.0
3000000.0,5,3.25,5370,14091,2.0,3,1,3850,1520.0,1918,2410,12047,38052 days 16:47:18.662886,033,1.5384615384615385,2.5328947368421053,2960,2044,2330.0
685000.0,5,2.5,2670,14455,2.0,5,9,2670,0.0,1958,1810,14455,23442 days 16:47:18.662886,205,2.0,0.0,860,0,2670.0
311000.0,3,1.0,1640,12060,1.0,4,7,1640,0.0,1960,1680,9147,22712 days 16:47:18.662886,206,3.0,0.0,-40,2913,1640.0
305000.0,4,2.25,2130,9600,1.0,4,7,2130,0.0,1966,1710,9600,20520 days 16:47:18.662886,254,1.7777777777777777,0.0,420,0,2130.0
675000.0,3,2.5,2550,4954,1.5,4,7,1850,700.0,1924,1700,4954,35861 days 16:47:18.662886,206,1.2,2.642857142857143,850,0,1150.0
769000.0,4,2.75,3630,15405,1.0,4,8,1850,1780.0,1968,3380,11184,19790 days 16:47:18.662886,241,1.4545454545454546,1.0393258426966292,250,4221,70.0
430000.0,3,1.5,1690,9708,1.5,5,7,1690,0.0,1954,1570,9858,24903 days 16:47:18.662886,217,2.0,0.0,120,-150,1690.0
516250.0,6,2.0,2390,8660,1.5,4,7,2390,0.0,1925,2250,12942,35495 days 16:47:18.662886,266,3.0,0.0,140,-4282,2390.0
760000.0,3,3.5,2350,10739,1.0,5,7,1340,1010.0,1940,2580,11026,30017 days 16:47:18.662886,346,0.8571428571428571,1.3267326732673268,-230,-287,330.0
579950.0,3,3.5,1420,1217,2.0,3,8,1180,240.0,2003,1494,1264,7006 days 16:47:18.662886,280,0.8571428571428571,4.916666666666667,-74,-47,940.0
476000.0,3,2.25,1570,7187,1.0,4,8,1170,400.0,1980,1660,8775,15407 days 16:47:18.662886,042,1.3333333333333333,2.925,-90,-1588,770.0
510000.0,3,1.75,1600,19200,1.0,4,7,1600,0.0,1967,2010,14850,20155 days 16:47:18.662886,163,1.7142857142857142,0.0,-410,4350,1600.0
205000.0,2,1.0,720,5040,1.0,3,6,720,0.0,1955,1357,5120,24538 days 16:47:18.662886,128,2.0,0.0,-637,-80,720.0
240000.0,3,1.0,1470,7350,1.0,3,7,1470,0.0,1969,1720,8050,19424 days 16:47:18.662886,280,3.0,0.0,-250,-700,1470.0
738000.0,5,3.5,2790,16952,2.0,3,1,1970,820.0,1991,2980,17281,11389 days 16:47:18.662886,245,1.4285714285714286,2.402439024390244,-190,-329,1150.0
420000.0,3,1.75,1720,8102,1.0,5,6,860,860.0,1940,1440,8106,30017 days 16:47:18.662886,209,1.7142857142857142,1.0,280,-4,0.0
455000.0,3,1.75,1300,9600,1.0,4,7,1300,0.0,1969,2070,9775,19424 days 16:47:18.662886,318,1.7142857142857142,0.0,-770,-175,1300.0
765000.0,4,1.0,2520,5500,1.5,5,8,1820,700.0,1912,2350,5000,40244 days 16:47:18.662886,258,4.0,2.6,170,500,1120.0
372000.0,4,1.5,1780,7914,1.5,4,7,1780,0.0,1962,1350,8069,21981 days 16:47:18.662886,339,2.6666666666666665,0.0,430,-155,1780.0
160000.0,3,1.0,1200,8360,1.0,2,6,1200,0.0,1948,1570,6823,27095 days 16:47:18.662886,338,3.0,0.0,-370,1537,1200.0
772000.0,4,2.5,2990,9643,2.0,3,9,2990,0.0,2003,2990,8666,7006 days 16:47:18.662886,227,1.6,0.0,0,977,2990.0
1130000.0,5,1.75,1910,5640,2.0,4,9,1910,0.0,1906,2050,5400,42435 days 16:47:18.662886,315,2.857142857142857,0.0,-140,240,1910.0
479000.0,3,1.0,1370,3000,1.5,3,7,1370,0.0,1924,1510,2151,35861 days 16:47:18.662886,144,3.0,0.0,-140,849,1370.0
570000.0,3,2.5,1910,4941,2.0,3,8,1910,0.0,1999,1910,4941,8467 days 16:47:18.662886,125,1.2,0.0,0,0,1910.0
350000.0,4,1.0,1170,8147,1.5,3,6,1170,0.0,1959,1260,8147,23077 days 16:47:18.662886,191,4.0,0.0,-90,0,1170.0
699000.0,5,2.5,3340,24755,2.0,3,1,3340,0.0,2002,3420,23274,7371 days 16:47:18.662886,213,2.0,0.0,-80,1481,3340.0
265000.0,3,2.0,1380,8536,2.0,4,7,1380,0.0,1955,1260,8750,24538 days 16:47:18.662886,211,1.5,0.0,120,-214,1380.0
167000.0,1,1.0,780,10235,1.5,3,6,780,0.0,1989,930,10165,12119 days 16:47:18.662886,120,1.0,0.0,-150,70,780.0
500000.0,4,2.25,2080,8000,1.0,3,8,1390,690.0,1964,1800,7700,21251 days 16:47:18.662886,293,1.7777777777777777,2.0144927536231885,280,300,700.0
700000.0,3,1.0,1410,7200,2.0,4,6,1410,0.0,1901,1640,7200,44261 days 16:47:18.662886,190,3.0,0.0,-230,0,1410.0
295000.0,1,1.0,520,5600,1.0,3,6,520,0.0,1918,1030,5265,38052 days 16:47:18.662886,308,1.0,0.0,-510,335,520.0
1010000.0,4,3.5,3500,4080,2.0,3,9,2590,910.0,2004,2430,5100,6641 days 16:47:18.662886,070,1.1428571428571428,2.8461538461538463,1070,-1020,1680.0
209000.0,2,1.0,840,5265,1.0,5,6,840,0.0,1969,920,5100,19424 days 16:47:18.662886,128,2.0,0.0,-80,165,840.0
276000.0,3,1.75,2240,9200,1.0,4,7,1440,800.0,1968,1740,9600,19790 days 16:47:18.662886,028,1.7142857142857142,1.8,500,-400,640.0
380000.0,4,2.5,2100,5857,2.0,3,8,2100,0.0,2002,2090,7779,7371 days 16:47:18.662886,022,1.6,0.0,10,-1922,2100.0
315000.0,3,1.5,1750,12500,1.0,3,7,1150,600.0,1954,1680,13000,24903 days 16:47:18.662886,157,2.0,1.9166666666666667,70,-500,550.0
685530.0,4,2.5,3130,60467,2.0,3,9,3130,0.0,1996,2780,44224,9563 days 16:47:18.662886,069,1.6,0.0,350,16243,3130.0
254600.0,3,2.0,1470,20000,1.0,4,7,1470,0.0,1968,1390,30056,19790 days 16:47:18.662886,177,1.5,0.0,80,-10056,1470.0
230000.0,3,2.0,1440,5600,1.0,4,6,720,720.0,1942,1120,5700,29286 days 16:47:18.662886,154,1.5,1.0,320,-100,0.0
335000.0,3,3.0,1430,1249,3.0,3,8,1430,0.0,2003,1020,1112,7006 days 16:47:18.662886,198,1.0,0.0,410,137,1430.0
550000.0,4,2.5,2170,9600,1.0,3,7,1460,710.0,1980,1940,8400,15407 days 16:47:18.662886,154,1.6,2.056338028169014,230,1200,750.0
123300.0,3,1.0,1150,8050,1.5,4,7,1150,0.0,1956,1360,8050,24173 days 16:47:18.662886,360,3.0,0.0,-210,0,1150.0
275436.0,4,2.75,2170,9658,1.5,3,7,2170,0.0,1966,1490,9731,20520 days 16:47:18.662886,245,1.4545454545454546,0.0,680,-73,2170.0
325000.0,4,3.5,2630,3435,1.5,3,7,1640,990.0,1984,1920,2435,13946 days 16:47:18.662886,145,1.1428571428571428,1.6565656565656566,710,1000,650.0
635000.0,4,2.5,2490,40608,2.0,3,9,2490,0.0,1997,3170,45441,9197 days 16:47:18.662886,206,1.6,0.0,-680,-4833,2490.0
513000.0,3,1.75,1710,5000,1.0,4,7,1110,600.0,1944,920,5000,28556 days 16:47:18.662886,113,1.7142857142857142,1.85,790,0,510.0
580000.0,4,2.5,2130,35752,1.0,3,8,1490,640.0,1980,3030,34000,15407 days 16:47:18.662886,189,1.6,2.328125,-900,1752,850.0
225000.0,3,1.0,940,9272,1.0,3,7,940,0.0,1954,1270,9375,24903 days 16:47:18.662886,119,3.0,0.0,-330,-103,940.0
265000.0,3,1.0,1400,9460,1.0,3,7,1060,340.0,1961,1570,7700,22346 days 16:47:18.662886,265,3.0,3.1176470588235294,-170,1760,720.0
313000.0,4,1.75,1630,3000,1.0,3,7,930,700.0,1978,1630,3000,16137 days 16:47:18.662886,287,2.2857142857142856,1.3285714285714285,0,0,230.0
296000.0,2,1.0,1370,8400,1.0,3,7,1370,0.0,1948,1330,8396,27095 days 16:47:18.662886,104,2.0,0.0,40,4,1370.0
655500.0,4,2.75,2380,15800,1.0,3,8,1680,700.0,1957,1950,11751,23807 days 16:47:18.662886,293,1.4545454545454546,2.4,430,4049,980.0
250750.0,5,1.75,2140,12058,1.0,4,8,2140,0.0,1951,1640,10125,25999 days 16:47:18.662886,344,2.857142857142857,0.0,500,1933,2140.0
438000.0,4,2.5,1970,8545,2.0,3,8,1970,0.0,2004,2590,7200,6641 days 16:47:18.662886,247,1.6,0.0,-620,1345,1970.0
590000.0,3,2.75,2550,54014,2.0,4,8,1980,570.0,1967,2180,21600,20155 days 16:47:18.662886,213,1.0909090909090908,3.473684210526316,370,32414,1410.0
329500.0,3,1.0,1080,5250,1.0,4,7,1080,0.0,1947,1100,5250,27460 days 16:47:18.662886,279,3.0,0.0,-20,0,1080.0
1200000.0,3,2.25,3070,9645,2.0,3,1,2110,960.0,1987,3130,9450,12850 days 16:47:18.662886,075,1.3333333333333333,2.1979166666666665,-60,195,1150.0
415000.0,2,1.0,1470,6000,1.0,3,6,900,570.0,1944,1670,6000,28556 days 16:47:18.662886,079,2.0,1.5789473684210527,-200,0,330.0
900000.0,4,2.5,3620,42580,2.0,3,1,3620,0.0,1984,2950,33167,13946 days 16:47:18.662886,265,1.6,0.0,670,9413,3620.0
378000.0,3,1.5,1050,57499,1.0,3,7,1050,0.0,1975,1460,42688,17233 days 16:47:18.662886,124,2.0,0.0,-410,14811,1050.0
474000.0,2,1.0,1050,403365,1.0,5,6,1050,0.0,1905,1760,108900,42800 days 16:47:18.662886,224,2.0,0.0,-710,294465,1050.0
464000.0,3,1.0,1320,3625,2.0,3,7,1320,0.0,1900,1660,5438,44626 days 16:47:18.662886,170,3.0,0.0,-340,-1813,1320.0
310000.0,3,1.0,1210,7649,1.0,4,7,1210,0.0,1956,1210,6760,24173 days 16:47:18.662886,342,3.0,0.0,0,889,1210.0
580000.0,3,1.5,1860,7190,2.0,5,7,1860,0.0,1952,1670,5525,25634 days 16:47:18.662886,261,2.0,0.0,190,1665,1860.0
999000.0,3,2.75,2830,505166,1.0,4,8,1830,1000.0,1962,2120,21988,21981 days 16:47:18.662886,323,1.0909090909090908,1.83,710,483178,830.0
510000.0,2,1.0,810,6480,1.0,5,6,810,0.0,1942,1920,6000,29286 days 16:47:18.662886,076,2.0,0.0,-1110,480,810.0
650000.0,3,1.5,1630,7475,1.0,3,7,1160,470.0,1940,2320,7475,30017 days 16:47:18.662886,126,2.0,2.4680851063829787,-690,0,690.0
196000.0,3,1.0,880,19600,1.0,4,7,880,0.0,1978,880,10500,16137 days 16:47:18.662886,255,3.0,0.0,0,9100,880.0
220000.0,4,1.75,1660,11664,1.0,3,6,1010,650.0,1952,1670,9975,25634 days 16:47:18.662886,234,2.2857142857142856,1.5538461538461539,-10,1689,360.0
855000.0,3,2.25,3440,10628,2.0,3,1,3440,0.0,1985,3170,11434,13580 days 16:47:18.662886,281,1.3333333333333333,0.0,270,-806,3440.0
483000.0,3,1.75,2110,10454,1.0,4,8,1440,670.0,1978,1990,10890,16137 days 16:47:18.662886,241,1.7142857142857142,2.1492537313432836,120,-436,770.0
400000.0,3,1.0,1060,12000,1.0,3,7,1060,0.0,1952,1550,10500,25634 days 16:47:18.662886,097,3.0,0.0,-490,1500,1060.0
435000.0,3,2.5,1900,7984,2.0,3,8,1900,0.0,1993,2650,9352,10658 days 16:47:18.662886,183,1.2,0.0,-750,-1368,1900.0
219500.0,1,1.0,820,1060,1.0,3,8,760,60.0,2007,1770,1924,5545 days 16:47:18.662886,273,1.0,12.666666666666666,-950,-864,700.0
2950000.0,4,3.5,4860,23885,2.0,3,1,4860,0.0,1996,3580,16054,9563 days 16:47:18.662886,241,1.1428571428571428,0.0,1280,7831,4860.0
427000.0,3,2.5,2050,3218,3.0,3,7,2050,0.0,2008,2050,7200,5180 days 16:47:18.662886,259,1.2,0.0,0,-3982,2050.0
430000.0,2,1.5,1090,4013,1.5,3,7,1090,0.0,1900,1390,4013,44626 days 16:47:18.662886,335,1.3333333333333333,0.0,-300,0,1090.0
685000.0,2,1.5,1090,4013,1.5,3,7,1090,0.0,1900,1390,4013,44626 days 16:47:18.662886,132,1.3333333333333333,0.0,-300,0,1090.0
495000.0,2,1.5,1920,6250,1.0,3,7,1060,860.0,1937,2070,6250,31112 days 16:47:18.662886,246,1.3333333333333333,1.2325581395348837,-150,0,200.0
299950.0,3,2.5,1870,7942,2.0,3,7,1870,0.0,1990,1870,7392,11754 days 16:47:18.662886,176,1.2,0.0,0,550,1870.0
390000.0,4,1.75,2690,46609,1.5,3,7,2690,0.0,1940,1920,7302,30017 days 16:47:18.662886,325,2.2857142857142856,0.0,770,39307,2690.0
385000.0,3,1.75,2160,5863,1.5,4,7,1260,900.0,1928,1590,3000,34400 days 16:47:18.662886,224,1.7142857142857142,1.4,570,2863,360.0
740000.0,4,2.5,3000,10392,2.0,3,9,3000,0.0,1995,3140,9213,9928 days 16:47:18.662886,176,1.6,0.0,-140,1179,3000.0
991700.0,4,3.0,2290,2350,2.0,3,9,1610,680.0,1924,1610,3820,35861 days 16:47:18.662886,204,1.3333333333333333,2.3676470588235294,680,-1470,930.0
765000.0,3,2.75,2250,9600,2.5,4,9,1830,420.0,1909,2060,4980,41339 days 16:47:18.662886,225,1.0909090909090908,4.357142857142857,190,4620,1410.0
802000.0,4,2.25,2130,8734,2.0,4,8,2130,0.0,1961,2550,8800,22346 days 16:47:18.662886,247,1.7777777777777777,0.0,-420,-66,2130.0
950000.0,4,2.75,2500,20000,1.0,4,8,1700,800.0,1969,2650,20000,19424 days 16:47:18.662886,325,1.4545454545454546,2.125,-150,0,900.0
392000.0,4,2.5,2300,41167,2.0,3,7,2300,0.0,1988,2300,21765,12485 days 16:47:18.662886,308,1.6,0.0,0,19402,2300.0
590000.0,3,2.5,3360,218235,1.0,3,8,3360,0.0,1989,2650,220849,12119 days 16:47:18.662886,337,1.2,0.0,710,-2614,3360.0
425000.0,4,2.5,1920,9000,2.0,2,7,1920,0.0,1989,1530,10474,12119 days 16:47:18.662886,100,1.6,0.0,390,-1474,1920.0
765000.0,5,1.75,2440,15143,1.5,4,8,1740,700.0,1944,2390,10907,28556 days 16:47:18.662886,203,2.857142857142857,2.4857142857142858,50,4236,1040.0
313500.0,3,2.25,1440,3488,2.0,4,7,1440,0.0,1983,1390,3488,14311 days 16:47:18.662886,219,1.3333333333333333,0.0,50,0,1440.0
320000.0,3,1.0,1780,6840,2.0,4,6,1780,0.0,1947,1410,7200,27460 days 16:47:18.662886,232,3.0,0.0,370,-360,1780.0
604000.0,4,1.75,1490,4485,1.0,3,8,1350,140.0,1960,1380,4846,22712 days 16:47:18.662886,041,2.2857142857142856,9.642857142857142,110,-361,1210.0
570000.0,3,2.0,1400,1657,2.0,3,8,1060,340.0,2004,1540,2275,6641 days 16:47:18.662886,043,1.5,3.1176470588235294,-140,-618,720.0
639000.0,4,2.5,2150,12028,2.0,4,8,2150,0.0,1982,1800,11777,14676 days 16:47:18.662886,140,1.6,0.0,350,251,2150.0
335000.0,4,2.0,1910,10200,1.0,4,7,1910,0.0,1963,1820,15600,21616 days 16:47:18.662886,234,2.0,0.0,90,-5400,1910.0
896000.0,4,1.75,2660,3520,2.0,4,8,2080,580.0,1917,2100,4080,38417 days 16:47:18.662886,287,2.2857142857142856,3.586206896551724,560,-560,1500.0
259500.0,3,1.75,1650,12349,1.0,3,7,1650,0.0,1957,1470,10763,23807 days 16:47:18.662886,178,1.7142857142857142,0.0,180,1586,1650.0
637000.0,3,2.0,1980,6000,1.0,4,7,1380,600.0,1958,1260,6000,23442 days 16:47:18.662886,219,1.5,2.3,720,0,780.0
307450.0,4,2.75,2690,8874,1.0,3,8,1370,1320.0,1980,1990,7875,15407 days 16:47:18.662886,126,1.4545454545454546,1.0378787878787878,700,999,50.0
535000.0,3,1.75,1380,3561,1.0,4,7,860,520.0,1925,1820,4593,35495 days 16:47:18.662886,237,1.7142857142857142,1.6538461538461537,-440,-1032,340.0
669500.0,4,2.25,2500,4046,1.5,4,7,1520,980.0,1940,1410,4046,30017 days 16:47:18.662886,181,1.7777777777777777,1.5510204081632653,1090,0,540.0
259000.0,3,1.75,1590,7148,1.0,3,7,1590,0.0,1952,1150,7280,25634 days 16:47:18.662886,301,1.7142857142857142,0.0,440,-132,1590.0
441000.0,4,1.5,1100,3300,1.0,1,7,1100,0.0,1919,2020,4000,37687 days 16:47:18.662886,365,2.6666666666666665,0.0,-920,-700,1100.0
228800.0,4,2.5,1470,1612,2.0,3,7,980,490.0,2003,1460,5027,7006 days 16:47:18.662886,132,1.6,2.0,10,-3415,490.0
530000.0,2,2.0,1680,4950,1.0,3,8,1680,0.0,2006,1570,4800,5910 days 16:47:18.662886,133,1.0,0.0,110,150,1680.0
524000.0,2,2.0,1450,2272,1.0,4,6,750,700.0,1924,2170,4370,35861 days 16:47:18.662886,209,1.0,1.0714285714285714,-720,-2098,50.0
430000.0,4,2.25,2020,4840,1.5,5,8,1200,820.0,1925,1410,4840,35495 days 16:47:18.662886,345,1.7777777777777777,1.4634146341463414,610,0,380.0
1330000.0,4,3.25,2470,4760,1.5,5,9,1890,580.0,1906,2470,4760,42435 days 16:47:18.662886,274,1.2307692307692308,3.2586206896551726,0,0,1310.0
210000.0,3,1.0,1230,12201,1.0,3,7,1230,0.0,1969,1230,10780,19424 days 16:47:18.662886,307,3.0,0.0,0,1421,1230.0
449000.0,4,2.5,1850,5040,1.0,3,7,1230,620.0,1930,1010,5040,33669 days 16:47:18.662886,174,1.6,1.9838709677419355,840,0,610.0
945000.0,2,2.5,2540,7089,2.0,3,9,2540,0.0,2004,1330,7089,6641 days 16:47:18.662886,170,0.8,0.0,1210,0,2540.0
200450.0,3,1.0,970,9130,1.0,3,6,970,0.0,1957,1000,8886,23807 days 16:47:18.662886,077,3.0,0.0,-30,244,970.0
219950.0,3,1.5,1070,6601,1.0,3,6,1070,0.0,1985,1030,6614,13580 days 16:47:18.662886,107,2.0,0.0,40,-13,1070.0
659500.0,4,3.0,2620,18362,1.0,4,8,1870,750.0,1956,2630,16792,24173 days 16:47:18.662886,170,1.3333333333333333,2.493333333333333,-10,1570,1120.0
746000.0,4,2.75,2110,8190,1.5,5,8,2110,0.0,1966,2420,8400,20520 days 16:47:18.662886,330,1.4545454545454546,0.0,-310,-210,2110.0
540000.0,3,1.75,2110,7129,1.0,3,8,1280,830.0,1982,1810,8674,14676 days 16:47:18.662886,090,1.7142857142857142,1.5421686746987953,300,-1545,450.0
485000.0,5,2.0,1910,5508,1.0,3,7,1020,890.0,1968,1030,7440,19790 days 16:47:18.662886,253,2.5,1.146067415730337,880,-1932,130.0
502000.0,3,2.75,2010,11200,1.0,3,8,1360,650.0,1979,2200,10640,15772 days 16:47:18.662886,091,1.0909090909090908,2.0923076923076924,-190,560,710.0
279000.0,2,2.75,1770,10534,1.0,3,8,1210,560.0,2003,1600,17400,7006 days 16:47:18.662886,055,0.7272727272727273,2.1607142857142856,170,-6866,650.0
409500.0,3,1.0,1340,4120,1.0,4,7,1040,300.0,1921,1270,4635,36956 days 16:47:18.662886,321,3.0,3.466666666666667,70,-515,740.0
453000.0,3,2.0,1660,15050,1.0,3,7,1260,400.0,1983,1660,7320,14311 days 16:47:18.662886,183,1.5,3.15,0,7730,860.0
367000.0,4,1.0,1820,5500,1.5,3,6,1820,0.0,1947,1140,5500,27460 days 16:47:18.662886,058,4.0,0.0,680,0,1820.0
550000.0,3,2.5,2510,5400,2.0,3,9,2510,0.0,1992,1840,5400,11024 days 16:47:18.662886,143,1.2,0.0,670,0,2510.0
273500.0,3,1.5,1560,8314,1.0,3,7,1560,0.0,1962,1820,8925,21981 days 16:47:18.662886,027,2.0,0.0,-260,-611,1560.0
770000.0,3,2.5,2650,40705,2.0,3,9,2650,0.0,1994,2550,42625,10293 days 16:47:18.662886,170,1.2,0.0,100,-1920,2650.0
565000.0,4,2.25,2470,7447,2.0,3,8,2470,0.0,1984,2270,7400,13946 days 16:47:18.662886,129,1.7777777777777777,0.0,200,47,2470.0
316000.0,3,0.75,1270,10092,1.0,5,7,1270,0.0,1971,1300,10375,18694 days 16:47:18.662886,232,4.0,0.0,-30,-283,1270.0
160000.0,4,1.0,1520,7298,1.5,3,7,1520,0.0,1960,1520,7298,22712 days 16:47:18.662886,268,4.0,0.0,0,0,1520.0
170000.0,3,1.0,1310,9529,1.0,3,7,1310,0.0,1956,1330,9529,24173 days 16:47:18.662886,300,3.0,0.0,-20,0,1310.0
235000.0,3,1.0,1310,9529,1.0,3,7,1310,0.0,1956,1330,9529,24173 days 16:47:18.662886,078,3.0,0.0,-20,0,1310.0
1800000.0,4,3.5,3930,39098,2.0,3,1,3930,0.0,1999,4250,38682,8467 days 16:47:18.662886,353,1.1428571428571428,0.0,-320,416,3930.0
310000.0,3,1.0,990,7050,1.0,3,7,990,0.0,1967,1200,8125,20155 days 16:47:18.662886,261,3.0,0.0,-210,-1075,990.0
285000.0,4,1.75,2080,13629,1.0,4,7,1040,1040.0,1955,1780,14659,24538 days 16:47:18.662886,139,2.2857142857142856,1.0,300,-1030,0.0
280000.0,2,1.0,960,4920,1.0,3,6,960,0.0,1942,1010,5040,29286 days 16:47:18.662886,155,2.0,0.0,-50,-120,960.0
2300000.0,4,4.25,4070,13860,2.0,3,1,4070,0.0,2004,3430,9240,6641 days 16:47:18.662886,049,0.9411764705882353,0.0,640,4620,4070.0
763776.0,4,2.5,2750,16139,2.0,3,9,2750,0.0,1989,2810,13093,12119 days 16:47:18.662886,226,1.6,0.0,-60,3046,2750.0
530000.0,5,2.75,3230,13572,1.0,3,8,1880,1350.0,1965,2910,15292,20885 days 16:47:18.662886,048,1.8181818181818181,1.3925925925925926,320,-1720,530.0
362000.0,1,1.0,890,211576,1.5,3,7,890,0.0,1996,1670,217364,9563 days 16:47:18.662886,042,1.0,0.0,-780,-5788,890.0
430000.0,2,1.0,990,4920,1.0,3,6,990,0.0,1931,990,4960,33304 days 16:47:18.662886,206,2.0,0.0,0,-40,990.0
456500.0,3,1.0,1290,3880,1.5,4,7,1290,0.0,1919,1290,4850,37687 days 16:47:18.662886,206,3.0,0.0,0,-970,1290.0
445000.0,4,2.5,2170,5257,2.0,3,7,2170,0.0,1989,1430,7528,12119 days 16:47:18.662886,254,1.6,0.0,740,-2271,2170.0
386900.0,3,1.0,1330,10500,1.0,3,7,960,370.0,1963,1460,11550,21616 days 16:47:18.662886,069,3.0,2.5945945945945947,-130,-1050,590.0
479000.0,3,1.0,1340,13750,1.0,4,7,1340,0.0,1955,1430,11400,24538 days 16:47:18.662886,189,3.0,0.0,-90,2350,1340.0
525000.0,3,2.5,2200,4544,2.0,3,8,2200,0.0,2000,2400,5431,8102 days 16:47:18.662886,072,1.2,0.0,-200,-887,2200.0
272000.0,4,1.75,2520,10890,1.0,3,7,1260,1260.0,1979,2090,12375,15772 days 16:47:18.662886,006,2.2857142857142856,1.0,430,-1485,0.0
517000.0,4,1.0,1180,13500,1.5,3,7,1180,0.0,1950,1580,8976,26364 days 16:47:18.662886,057,4.0,0.0,-400,4524,1180.0
615000.0,3,1.75,2660,7800,1.0,4,8,1330,1330.0,1951,1950,6240,25999 days 16:47:18.662886,057,1.7142857142857142,1.0,710,1560,0.0
439000.0,3,1.75,1250,7030,1.0,3,7,1250,0.0,1965,1460,7210,20885 days 16:47:18.662886,240,1.7142857142857142,0.0,-210,-180,1250.0
716000.0,3,2.5,2270,7866,1.0,4,1,2270,0.0,1988,2580,8132,12485 days 16:47:18.662886,205,1.2,0.0,-310,-266,2270.0
308000.0,2,1.0,1080,6250,1.0,4,7,1080,0.0,1942,2100,6875,29286 days 16:47:18.662886,301,2.0,0.0,-1020,-625,1080.0
800000.0,3,2.25,1620,4500,2.0,4,8,1620,0.0,1926,1210,4320,35130 days 16:47:18.662886,161,1.3333333333333333,0.0,410,180,1620.0
575000.0,3,2.0,940,5000,1.0,3,7,880,60.0,1941,1420,5000,29651 days 16:47:18.662886,125,1.5,14.666666666666666,-480,0,820.0
219950.0,3,1.5,1620,9310,1.0,4,7,1620,0.0,1967,1610,10640,20155 days 16:47:18.662886,182,2.0,0.0,10,-1330,1620.0
770000.0,4,2.5,2350,8001,2.0,4,8,2350,0.0,1987,2460,8001,12850 days 16:47:18.662886,142,1.6,0.0,-110,0,2350.0
424950.0,3,1.75,2090,7505,1.0,3,7,2090,0.0,1967,1510,7416,20155 days 16:47:18.662886,364,1.7142857142857142,0.0,580,89,2090.0
387000.0,3,2.25,1760,45133,2.0,3,7,1760,0.0,1984,1910,51773,13946 days 16:47:18.662886,008,1.3333333333333333,0.0,-150,-6640,1760.0
790000.0,4,1.75,2050,10920,1.0,3,8,1450,600.0,1974,2440,10920,17598 days 16:47:18.662886,171,2.2857142857142856,2.4166666666666665,-390,0,850.0
156000.0,2,1.0,600,4000,1.0,3,5,600,0.0,1933,1290,6973,32573 days 16:47:18.662886,028,2.0,0.0,-690,-2973,600.0
580000.0,2,1.0,2540,7000,1.0,5,8,1320,1220.0,1942,2160,6000,29286 days 16:47:18.662886,125,2.0,1.0819672131147542,380,1000,100.0
490000.0,4,2.25,2090,10869,2.0,3,8,2090,0.0,1970,1800,17788,19059 days 16:47:18.662886,262,1.7777777777777777,0.0,290,-6919,2090.0
950000.0,5,3.25,2700,3650,2.0,3,9,2070,630.0,1926,1940,4000,35130 days 16:47:18.662886,197,1.5384615384615385,3.2857142857142856,760,-350,1440.0
400000.0,2,2.5,1410,1281,2.0,3,8,1090,320.0,2008,1410,2550,5180 days 16:47:18.662886,044,0.8,3.40625,0,-1269,770.0
325000.0,2,2.5,1170,1638,2.0,3,8,1170,0.0,2008,1350,1407,5180 days 16:47:18.662886,133,0.8,0.0,-180,231,1170.0
365000.0,4,2.5,2540,6688,2.0,3,9,2540,0.0,2002,2810,6776,7371 days 16:47:18.662886,272,1.6,0.0,-270,-88,2540.0
255000.0,3,1.75,2190,6000,1.5,4,7,2190,0.0,1920,1610,6000,37322 days 16:47:18.662886,097,1.7142857142857142,0.0,580,0,2190.0
985000.0,5,3.5,3890,13261,2.0,3,9,2870,1020.0,1984,3080,13261,13946 days 16:47:18.662886,082,1.4285714285714286,2.8137254901960786,810,0,1850.0
595000.0,4,2.5,2030,10722,1.0,3,7,1100,930.0,1967,1610,9134,20155 days 16:47:18.662886,113,1.6,1.1827956989247312,420,1588,170.0
427500.0,3,1.0,1350,7085,1.0,5,7,1350,0.0,1944,1350,7085,28556 days 16:47:18.662886,197,3.0,0.0,0,0,1350.0
728000.0,3,1.5,1940,4000,1.5,3,8,1310,630.0,1915,1940,4000,39148 days 16:47:18.662886,289,2.0,2.0793650793650795,0,0,680.0
549950.0,2,1.0,1260,4000,1.0,3,7,1000,260.0,1940,1780,4000,30017 days 16:47:18.662886,253,2.0,3.8461538461538463,-520,0,740.0
650000.0,3,2.0,2800,10501,1.0,3,7,1400,1400.0,1954,2260,6534,24903 days 16:47:18.662886,342,1.5,1.0,540,3967,0.0
203000.0,3,1.0,840,6500,1.0,5,6,840,0.0,1969,920,4680,19424 days 16:47:18.662886,124,3.0,0.0,-80,1820,840.0
311000.0,2,1.0,860,3300,1.0,5,6,860,0.0,1903,1380,4400,43531 days 16:47:18.662886,219,2.0,0.0,-520,-1100,860.0
387500.0,6,2.0,2400,7684,1.0,3,6,1200,1200.0,1932,1290,9800,32939 days 16:47:18.662886,118,3.0,1.0,1110,-2116,0.0
370000.0,4,2.0,1640,7200,1.0,3,7,1640,0.0,1963,1500,9000,21616 days 16:47:18.662886,077,2.0,0.0,140,-1800,1640.0
228000.0,2,1.0,1060,6100,1.0,3,6,1060,0.0,1951,1550,9150,25999 days 16:47:18.662886,205,2.0,0.0,-490,-3050,1060.0
740000.0,2,1.75,2080,4800,1.0,5,7,1080,1000.0,1923,1310,4800,36226 days 16:47:18.662886,148,1.1428571428571428,1.08,770,0,80.0
200000.0,4,2.0,2090,6630,1.0,3,7,1070,1020.0,1974,1550,7980,17598 days 16:47:18.662886,191,2.0,1.0490196078431373,540,-1350,50.0
660000.0,3,1.0,1240,3500,1.0,4,7,1240,0.0,1927,1650,3360,34765 days 16:47:18.662886,190,3.0,0.0,-410,140,1240.0
275000.0,4,2.0,2030,8426,2.0,3,7,2030,0.0,1944,1190,7007,28556 days 16:47:18.662886,190,2.0,0.0,840,1419,2030.0
708000.0,2,1.0,1120,5250,1.0,3,7,950,170.0,1938,1510,5250,30747 days 16:47:18.662886,119,2.0,5.588235294117647,-390,0,780.0
280000.0,3,2.5,1270,9675,2.0,3,8,1270,0.0,1993,1270,11700,10658 days 16:47:18.662886,139,1.2,0.0,0,-2025,1270.0
325000.0,4,2.5,2260,5702,2.0,3,8,2260,0.0,2002,2450,6381,7371 days 16:47:18.662886,006,1.6,0.0,-190,-679,2260.0
495000.0,3,2.5,1780,47480,2.0,3,7,1780,0.0,1995,1890,51836,9928 days 16:47:18.662886,232,1.2,0.0,-110,-4356,1780.0
691000.0,2,2.0,1780,3810,1.5,3,7,980,800.0,1922,1690,3810,36591 days 16:47:18.662886,265,1.0,1.225,90,0,180.0
2290000.0,4,2.5,4080,18362,2.0,4,1,4080,0.0,1983,4080,19991,14311 days 16:47:18.662886,183,1.6,0.0,0,-1629,4080.0
329500.0,3,2.5,2120,22482,1.0,5,7,1360,760.0,1979,2330,16016,15772 days 16:47:18.662886,118,1.2,1.7894736842105263,-210,6466,600.0
348000.0,3,2.5,2060,7458,2.0,3,9,2060,0.0,1989,2480,7743,12119 days 16:47:18.662886,217,1.2,0.0,-420,-285,2060.0
425000.0,2,1.0,1670,6212,1.0,4,7,1670,0.0,1947,1670,7272,27460 days 16:47:18.662886,318,2.0,0.0,0,-1060,1670.0
210000.0,3,1.0,1080,21043,1.0,3,6,1080,0.0,1942,1380,7620,29286 days 16:47:18.662886,139,3.0,0.0,-300,13423,1080.0
285000.0,2,1.0,1210,4895,1.0,3,6,710,500.0,1951,1100,6000,25999 days 16:47:18.662886,354,2.0,1.42,110,-1105,210.0
200000.0,4,2.5,1720,9600,1.0,3,7,1120,600.0,1961,1520,9400,22346 days 16:47:18.662886,147,1.6,1.8666666666666667,200,200,520.0
247500.0,3,2.0,1530,8749,1.0,3,7,1530,0.0,1995,1750,8749,9928 days 16:47:18.662886,275,1.5,0.0,-220,0,1530.0
1500000.0,4,5.5,6550,217374,1.0,3,1,5400,1150.0,2006,4110,50378,5910 days 16:47:18.662886,232,0.7272727272727273,4.695652173913044,2440,166996,4250.0
190000.0,3,1.75,1100,9452,1.0,3,6,1100,0.0,1942,1350,9452,29286 days 16:47:18.662886,324,1.7142857142857142,0.0,-250,0,1100.0
975000.0,4,2.5,3020,4950,1.5,4,9,2020,1000.0,1921,2300,5450,36956 days 16:47:18.662886,349,1.6,2.02,720,-500,1020.0
1130000.0,4,3.0,3180,4649,2.0,4,9,2070,1110.0,1925,2720,5980,35495 days 16:47:18.662886,357,1.3333333333333333,1.864864864864865,460,-1331,960.0
283200.0,4,1.75,1830,12540,1.0,4,8,1130,700.0,1958,2020,12540,23442 days 16:47:18.662886,124,2.2857142857142856,1.6142857142857143,-190,0,430.0
650000.0,3,2.5,2540,8073,1.0,4,8,1880,660.0,1937,2110,7702,31112 days 16:47:18.662886,195,1.2,2.8484848484848486,430,371,1220.0
449500.0,3,2.0,1770,6610,1.0,4,7,960,810.0,1954,2010,4361,24903 days 16:47:18.662886,133,1.5,1.1851851851851851,-240,2249,150.0
400000.0,3,1.75,1470,6682,1.0,3,7,1470,0.0,1987,1790,7379,12850 days 16:47:18.662886,295,1.7142857142857142,0.0,-320,-697,1470.0
89950.0,1,1.0,570,4080,1.0,3,5,570,0.0,1942,890,5100,29286 days 16:47:18.662886,050,1.0,0.0,-320,-1020,570.0
158800.0,3,1.0,960,8291,1.0,3,6,960,0.0,1950,1110,8231,26364 days 16:47:18.662886,328,3.0,0.0,-150,60,960.0
870000.0,4,3.0,2940,7108,2.0,3,9,2220,720.0,2011,2240,7950,4084 days 16:47:18.662886,260,1.3333333333333333,3.0833333333333335,700,-842,1500.0
196000.0,3,1.5,1000,18568,1.0,3,6,1000,0.0,1989,1610,17420,12119 days 16:47:18.662886,065,2.0,0.0,-610,1148,1000.0
850000.0,3,1.75,2450,8603,1.0,5,8,1340,1110.0,1940,2280,5779,30017 days 16:47:18.662886,212,1.7142857142857142,1.2072072072072073,170,2824,230.0
775000.0,4,2.5,3310,5101,2.0,3,9,3310,0.0,2005,3010,5176,6275 days 16:47:18.662886,266,1.6,0.0,300,-75,3310.0
483500.0,3,2.5,1670,4308,2.0,3,8,1670,0.0,2001,1670,2897,7736 days 16:47:18.662886,213,1.2,0.0,0,1411,1670.0
387000.0,3,1.5,1620,21929,2.0,3,7,1620,0.0,1990,1600,21679,11754 days 16:47:18.662886,092,2.0,0.0,20,250,1620.0
900000.0,3,3.0,2990,30869,2.0,3,1,2990,0.0,1951,1750,15802,25999 days 16:47:18.662886,024,1.0,0.0,1240,15067,2990.0
336000.0,3,1.5,1240,5000,1.0,3,7,1240,0.0,1964,1050,5000,21251 days 16:47:18.662886,097,2.0,0.0,190,0,1240.0
415000.0,2,1.0,670,6000,1.0,5,6,670,0.0,1949,1240,5040,26729 days 16:47:18.662886,107,2.0,0.0,-570,960,670.0
350000.0,3,1.5,1320,4400,1.0,3,6,1320,0.0,1909,1350,4400,41339 days 16:47:18.662886,223,2.0,0.0,-30,0,1320.0
1320000.0,4,5.25,6110,10369,2.0,3,1,6110,0.0,2005,4190,10762,6275 days 16:47:18.662886,321,0.7619047619047619,0.0,1920,-393,6110.0
765000.0,3,1.75,2440,5800,1.0,4,8,1320,1120.0,1945,2530,5800,28190 days 16:47:18.662886,218,1.7142857142857142,1.1785714285714286,-90,0,200.0
527000.0,4,2.5,2900,6736,2.0,3,8,2900,0.0,2013,2900,6736,3353 days 16:47:18.662886,293,1.6,0.0,0,0,2900.0
524000.0,4,2.75,2310,5000,1.5,5,8,1480,830.0,1908,1100,5000,41705 days 16:47:18.662886,199,1.4545454545454546,1.783132530120482,1210,0,650.0
448000.0,2,1.0,1110,5413,1.0,3,6,890,220.0,1937,1300,5413,31112 days 16:47:18.662886,196,2.0,4.045454545454546,-190,0,670.0
775000.0,4,3.25,4100,241322,2.0,3,9,2500,1600.0,1981,3770,87821,15041 days 16:47:18.662886,188,1.2307692307692308,1.5625,330,153501,900.0
176500.0,3,1.0,930,9900,1.5,4,5,930,0.0,1910,930,7200,40974 days 16:47:18.662886,016,3.0,0.0,0,2700,930.0
750000.0,4,2.25,2420,11120,1.0,4,8,1620,800.0,1952,2210,8497,25634 days 16:47:18.662886,106,1.7777777777777777,2.025,210,2623,820.0
1270000.0,4,2.25,2870,6000,1.0,5,8,1730,1140.0,1951,2370,5500,25999 days 16:47:18.662886,336,1.7777777777777777,1.5175438596491229,500,500,590.0
250000.0,3,1.0,1480,6750,1.0,3,7,1480,0.0,1958,1480,7594,23442 days 16:47:18.662886,057,3.0,0.0,0,-844,1480.0
759000.0,3,2.75,1960,6390,1.5,5,8,1960,0.0,1900,2440,5870,44626 days 16:47:18.662886,301,1.0909090909090908,0.0,-480,520,1960.0
640000.0,3,2.0,1470,4640,1.5,4,7,1470,0.0,1926,1700,5000,35130 days 16:47:18.662886,345,1.5,0.0,-230,-360,1470.0
990000.0,3,3.25,2460,4182,2.0,5,8,2100,360.0,1910,2370,4284,40974 days 16:47:18.662886,117,0.9230769230769231,5.833333333333333,90,-102,1740.0
395000.0,4,1.75,1960,7945,1.0,4,7,980,980.0,1946,1290,7945,27825 days 16:47:18.662886,281,2.2857142857142856,1.0,670,0,0.0
275000.0,2,1.5,1160,1103,2.0,3,7,890,270.0,2006,1160,1086,5910 days 16:47:18.662886,111,1.3333333333333333,3.2962962962962963,0,17,620.0
390000.0,3,2.5,1910,4755,2.0,3,8,1910,0.0,1997,2460,6099,9197 days 16:47:18.662886,036,1.2,0.0,-550,-1344,1910.0
450000.0,2,1.0,1020,5000,1.5,4,6,1020,0.0,1906,1490,5000,42435 days 16:47:18.662886,058,2.0,0.0,-470,0,1020.0
473000.0,2,1.0,900,5100,1.0,4,7,900,0.0,1909,1400,5100,41339 days 16:47:18.662886,168,2.0,0.0,-500,0,900.0
178500.0,3,1.75,1120,10450,1.0,3,7,1120,0.0,1973,1250,10414,17963 days 16:47:18.662886,082,1.7142857142857142,0.0,-130,36,1120.0
215000.0,3,1.5,1410,8415,1.0,4,7,780,630.0,1982,1440,7361,14676 days 16:47:18.662886,086,2.0,1.2380952380952381,-30,1054,150.0
589000.0,4,1.75,1920,4862,1.0,5,7,1060,860.0,1919,1840,4862,37687 days 16:47:18.662886,224,2.2857142857142856,1.2325581395348837,80,0,200.0
325000.0,4,1.75,1370,9993,1.0,3,6,1370,0.0,1918,1650,11592,38052 days 16:47:18.662886,107,2.2857142857142856,0.0,-280,-1599,1370.0
580000.0,3,2.5,1590,1937,2.5,3,8,1590,0.0,2004,1620,2022,6641 days 16:47:18.662886,232,1.2,0.0,-30,-85,1590.0
181100.0,4,1.75,1850,7500,1.0,3,7,1850,0.0,1954,1460,7500,24903 days 16:47:18.662886,197,2.2857142857142856,0.0,390,0,1850.0
345000.0,3,2.0,1430,4200,1.0,4,7,830,600.0,1908,1540,5000,41705 days 16:47:18.662886,055,1.5,1.3833333333333333,-110,-800,230.0
781000.0,3,1.75,1940,8729,1.0,3,8,1460,480.0,1960,2250,9165,22712 days 16:47:18.662886,089,1.7142857142857142,3.0416666666666665,-310,-436,980.0
402500.0,4,1.0,1270,3630,1.5,3,7,1270,0.0,1903,1420,4848,43531 days 16:47:18.662886,296,4.0,0.0,-150,-1218,1270.0
426000.0,3,1.5,1380,7200,1.0,3,7,1080,300.0,1948,1220,7200,27095 days 16:47:18.662886,110,2.0,3.6,160,0,780.0
389000.0,3,2.5,1720,4515,2.0,3,7,1720,0.0,2005,2220,4618,6275 days 16:47:18.662886,248,1.2,0.0,-500,-103,1720.0
670000.0,6,3.0,4050,36171,2.0,4,8,2620,1430.0,1970,3660,42874,19059 days 16:47:18.662886,188,2.0,1.832167832167832,390,-6703,1190.0
1510000.0,4,3.25,3660,5800,2.5,3,1,3360,300.0,1909,3240,5800,41339 days 16:47:18.662886,141,1.2307692307692308,11.2,420,0,3060.0
288400.0,3,2.25,1870,3230,2.0,3,7,1870,0.0,1997,1620,3363,9197 days 16:47:18.662886,141,1.3333333333333333,0.0,250,-133,1870.0
700000.0,4,2.0,2230,4635,1.5,5,7,1510,720.0,1908,1520,4635,41705 days 16:47:18.662886,050,2.0,2.0972222222222223,710,0,790.0
830000.0,4,3.0,2020,6000,1.0,3,8,1220,800.0,1968,1400,6000,19790 days 16:47:18.662886,090,1.3333333333333333,1.525,620,0,420.0
1900000.0,2,2.75,3690,32044,2.0,3,1,3690,0.0,1989,2310,26988,12119 days 16:47:18.662886,254,0.7272727272727273,0.0,1380,5056,3690.0
350500.0,2,1.0,1450,6380,1.0,3,7,1450,0.0,1967,1240,6380,20155 days 16:47:18.662886,282,2.0,0.0,210,0,1450.0
431000.0,3,1.75,1630,9000,1.0,4,7,1630,0.0,1956,1600,11120,24173 days 16:47:18.662886,123,1.7142857142857142,0.0,30,-2120,1630.0
485000.0,3,2.5,1840,8250,1.0,3,8,1340,500.0,1958,1970,7920,23442 days 16:47:18.662886,304,1.2,2.68,-130,330,840.0
780000.0,3,1.5,1620,7500,1.0,4,8,1620,0.0,1949,2440,7800,26729 days 16:47:18.662886,283,2.0,0.0,-820,-300,1620.0
720000.0,2,1.5,1840,9000,1.0,3,8,1340,500.0,1957,1880,7560,23807 days 16:47:18.662886,213,1.3333333333333333,2.68,-40,1440,840.0
415000.0,3,1.0,1360,73616,1.0,3,7,1360,0.0,1971,2040,50965,18694 days 16:47:18.662886,051,3.0,0.0,-680,22651,1360.0
480000.0,4,1.0,2080,5500,1.0,3,7,1040,1040.0,1941,1280,4000,29651 days 16:47:18.662886,171,4.0,1.0,800,1500,0.0
452250.0,4,2.25,2550,10000,1.0,4,7,1560,990.0,1979,2440,10000,15772 days 16:47:18.662886,259,1.7777777777777777,1.5757575757575757,110,0,570.0
316000.0,3,2.5,2550,8170,2.0,3,8,2550,0.0,1985,1840,8823,13580 days 16:47:18.662886,096,1.2,0.0,710,-653,2550.0
700000.0,2,1.0,1160,17635,1.0,3,6,1160,0.0,1945,1510,13122,28190 days 16:47:18.662886,283,2.0,0.0,-350,4513,1160.0
285000.0,4,2.0,1760,5500,1.0,3,7,780,980.0,1925,1510,5500,35495 days 16:47:18.662886,210,2.0,0.7959183673469388,250,0,-200.0
575000.0,3,1.75,1720,4050,1.0,5,7,860,860.0,1906,1720,4410,42435 days 16:47:18.662886,261,1.7142857142857142,1.0,0,-360,0.0
590000.0,3,2.25,2300,12430,1.0,4,8,1580,720.0,1960,2500,12430,22712 days 16:47:18.662886,203,1.3333333333333333,2.1944444444444446,-200,0,860.0
587500.0,4,1.75,2500,20868,1.0,3,8,1600,900.0,1956,2170,15026,24173 days 16:47:18.662886,057,2.2857142857142856,1.7777777777777777,330,5842,700.0
364000.0,4,2.25,1750,10270,1.5,4,8,1750,0.0,1968,1750,10127,19790 days 16:47:18.662886,265,1.7777777777777777,0.0,0,143,1750.0
490000.0,3,2.5,1890,10190,2.0,3,8,1890,0.0,1986,2080,9794,13215 days 16:47:18.662886,351,1.2,0.0,-190,396,1890.0
410000.0,3,2.25,1800,36704,1.0,4,8,1360,440.0,1978,2730,36404,16137 days 16:47:18.662886,125,1.3333333333333333,3.090909090909091,-930,300,920.0
520000.0,3,2.5,2160,4297,2.0,3,9,2160,0.0,1999,2160,3968,8467 days 16:47:18.662886,301,1.2,0.0,0,329,2160.0
389000.0,3,1.0,1380,6591,1.0,4,7,1380,0.0,1947,1610,6594,27460 days 16:47:18.662886,281,3.0,0.0,-230,-3,1380.0
450000.0,2,1.0,1180,6000,1.0,3,7,1180,0.0,1910,1600,6000,40974 days 16:47:18.662886,322,2.0,0.0,-420,0,1180.0
325000.0,3,2.5,2550,4240,2.0,3,7,2550,0.0,2006,2550,4240,5910 days 16:47:18.662886,339,1.2,0.0,0,0,2550.0
660000.0,2,1.0,1070,5000,1.0,3,7,1070,0.0,1924,1400,4000,35861 days 16:47:18.662886,072,2.0,0.0,-330,1000,1070.0
850000.0,3,2.25,2870,8170,2.0,3,1,2250,620.0,1995,1310,8170,9928 days 16:47:18.662886,171,1.3333333333333333,3.629032258064516,1560,0,1630.0
285000.0,3,2.5,1940,9874,2.0,3,7,1940,0.0,1990,1860,8875,11754 days 16:47:18.662886,218,1.2,0.0,80,999,1940.0
395000.0,2,1.0,870,3121,1.0,4,7,870,0.0,1923,1570,1777,36226 days 16:47:18.662886,345,2.0,0.0,-700,1344,870.0
440000.0,3,2.0,1550,2401,2.0,3,7,1550,0.0,1996,1550,3446,9563 days 16:47:18.662886,198,1.5,0.0,0,-1045,1550.0
249000.0,3,1.75,1400,5648,1.5,5,6,1400,0.0,1917,2320,9420,38417 days 16:47:18.662886,072,1.7142857142857142,0.0,-920,-3772,1400.0
635000.0,3,1.75,1210,4400,1.5,4,8,1210,0.0,1930,2020,3750,33669 days 16:47:18.662886,058,1.7142857142857142,0.0,-810,650,1210.0
515000.0,3,2.5,3430,48993,2.0,3,9,3430,0.0,2001,2460,36256,7736 days 16:47:18.663882,223,1.2,0.0,970,12737,3430.0
1400000.0,3,3.25,3020,6073,2.0,4,9,3020,0.0,1954,3020,7700,24903 days 16:47:18.663882,030,0.9230769230769231,0.0,0,-1627,3020.0
200000.0,2,1.0,950,8100,1.0,3,6,950,0.0,1955,1620,7630,24538 days 16:47:18.663882,063,2.0,0.0,-670,470,950.0
1140000.0,4,2.75,3370,8103,1.0,3,9,1970,1400.0,1970,2120,6360,19059 days 16:47:18.663882,126,1.4545454545454546,1.4071428571428573,1250,1743,570.0
445000.0,4,1.0,1460,4600,1.0,3,6,780,680.0,1946,1560,4600,27825 days 16:47:18.663882,321,4.0,1.1470588235294117,-100,0,100.0
555000.0,3,1.5,1740,4200,1.5,4,7,1640,100.0,1920,1660,3750,37322 days 16:47:18.663882,188,2.0,16.4,80,450,1540.0
537000.0,4,2.0,1720,6413,1.0,4,7,860,860.0,1950,1280,6413,26364 days 16:47:18.663882,267,2.0,1.0,440,0,0.0
315000.0,3,1.75,1480,7500,1.0,4,7,1480,0.0,1968,1480,7500,19790 days 16:47:18.663882,027,1.7142857142857142,0.0,0,0,1480.0
805000.0,5,2.5,3320,7266,2.0,3,9,3320,0.0,2000,3060,10269,8102 days 16:47:18.663882,029,2.0,0.0,260,-3003,3320.0
414000.0,4,2.5,3490,9030,1.5,4,8,3490,0.0,1969,2540,8400,19424 days 16:47:18.663882,238,1.6,0.0,950,630,3490.0
375000.0,2,1.5,1160,1648,2.0,3,7,1160,0.0,2002,1458,2351,7371 days 16:47:18.663882,227,1.3333333333333333,0.0,-298,-703,1160.0
401000.0,4,1.75,3010,12523,1.0,3,8,1780,1230.0,1952,2040,7560,25634 days 16:47:18.663882,063,2.2857142857142856,1.4471544715447155,970,4963,550.0
210000.0,3,1.0,1030,4583,1.0,3,7,1030,0.0,1967,1730,8023,20155 days 16:47:18.663882,028,3.0,0.0,-700,-3440,1030.0
365000.0,2,1.0,980,5110,1.0,4,7,780,200.0,1939,1430,5110,30382 days 16:47:18.663882,203,2.0,3.9,-450,0,580.0
178000.0,5,1.5,1990,18200,1.0,3,7,1990,0.0,1960,1860,8658,22712 days 16:47:18.663882,055,3.3333333333333335,0.0,130,9542,1990.0
710000.0,2,1.0,1790,4000,1.0,4,7,1040,750.0,1923,1310,4000,36226 days 16:47:18.663882,140,2.0,1.3866666666666667,480,0,290.0
255000.0,2,1.0,810,7980,1.0,1,6,810,0.0,1928,1440,7980,34400 days 16:47:18.663882,129,2.0,0.0,-630,0,810.0
528000.0,5,2.25,2940,38009,1.0,3,8,1700,1240.0,1977,2620,38300,16502 days 16:47:18.663882,338,2.2222222222222223,1.3709677419354838,320,-291,460.0
537000.0,4,4.25,4883,26040,2.0,3,1,3859,1024.0,2006,3736,9870,5910 days 16:47:18.663882,097,0.9411764705882353,3.7685546875,1147,16170,2835.0
442000.0,4,1.5,1360,6110,1.0,3,7,1010,350.0,1955,1520,6110,24538 days 16:47:18.663882,216,2.6666666666666665,2.8857142857142857,-160,0,660.0
375000.0,3,1.75,1370,19550,1.0,3,7,1370,0.0,1978,1430,17550,16137 days 16:47:18.663882,104,1.7142857142857142,0.0,-60,2000,1370.0
427500.0,3,1.75,1240,7200,1.0,5,7,1240,0.0,1942,1640,7200,29286 days 16:47:18.663882,089,1.7142857142857142,0.0,-400,0,1240.0
700000.0,4,2.5,2770,89298,2.0,3,8,2770,0.0,2004,2650,89298,6641 days 16:47:18.663882,090,1.6,0.0,120,0,2770.0
680000.0,3,1.75,1660,5750,1.0,4,7,1080,580.0,1909,2060,5560,41339 days 16:47:18.663882,078,1.7142857142857142,1.8620689655172413,-400,190,500.0
393820.0,2,2.0,1170,8251,1.0,3,7,1170,0.0,1941,1360,6798,29651 days 16:47:18.663882,240,1.0,0.0,-190,1453,1170.0
525000.0,4,2.75,2470,7200,1.0,5,7,1350,1120.0,1940,1500,6000,30017 days 16:47:18.663882,232,1.4545454545454546,1.2053571428571428,970,1200,230.0
505000.0,2,1.75,1310,3816,1.0,2,7,1110,200.0,1929,1510,3816,34034 days 16:47:18.663882,015,1.1428571428571428,5.55,-200,0,910.0
555565.0,3,2.0,1670,11337,1.0,4,7,1670,0.0,1959,2210,11337,23077 days 16:47:18.663882,315,1.5,0.0,-540,0,1670.0
650000.0,3,1.75,1660,10819,1.0,4,7,1240,420.0,1942,3110,11853,29286 days 16:47:18.663882,302,1.7142857142857142,2.9523809523809526,-1450,-1034,820.0
632500.0,5,3.25,3500,7254,2.0,3,8,2760,740.0,2005,2820,6317,6275 days 16:47:18.663882,260,1.5384615384615385,3.72972972972973,680,937,2020.0
269000.0,3,2.5,1440,3800,2.0,3,7,1440,0.0,2005,1890,3819,6275 days 16:47:18.663882,205,1.2,0.0,-450,-19,1440.0
405000.0,4,2.75,2360,7716,1.0,3,7,1390,970.0,1978,2160,8794,16137 days 16:47:18.663882,329,1.4545454545454546,1.4329896907216495,200,-1078,420.0
845000.0,3,3.5,3460,15745,2.0,3,1,3460,0.0,1986,3350,14825,13215 days 16:47:18.663882,205,0.8571428571428571,0.0,110,920,3460.0
234000.0,3,1.0,1750,8820,1.0,4,7,1750,0.0,1961,1400,9600,22346 days 16:47:18.663882,206,3.0,0.0,350,-780,1750.0
638000.0,4,1.75,1470,4236,1.5,4,7,1470,0.0,1946,1480,5400,27825 days 16:47:18.663882,112,2.2857142857142856,0.0,-10,-1164,1470.0
290000.0,3,1.75,1710,10950,1.0,3,7,1060,650.0,1967,1180,10950,20155 days 16:47:18.663882,216,1.7142857142857142,1.6307692307692307,530,0,410.0
262000.0,1,0.75,520,12981,1.0,5,3,520,0.0,1920,1340,12233,37322 days 16:47:18.663882,056,1.3333333333333333,0.0,-820,748,520.0
270000.0,4,2.5,2350,5835,2.0,3,8,2350,0.0,2003,3010,5772,7006 days 16:47:18.663882,049,1.6,0.0,-660,63,2350.0
875000.0,4,2.25,2380,4876,2.0,4,9,2240,140.0,1948,1780,4559,27095 days 16:47:18.663882,322,1.7777777777777777,16.0,600,317,2100.0
299000.0,3,2.25,1920,7840,2.0,4,8,1920,0.0,1982,2170,7210,14676 days 16:47:18.663882,198,1.3333333333333333,0.0,-250,630,1920.0
551000.0,3,1.0,1580,6000,1.0,5,7,1580,0.0,1947,1580,6000,27460 days 16:47:18.663882,062,3.0,0.0,0,0,1580.0
350000.0,3,2.75,3070,5280,2.0,3,7,2360,710.0,1950,2570,18983,26364 days 16:47:18.663882,259,1.0909090909090908,3.323943661971831,500,-13703,1650.0
1900000.0,3,2.5,2660,13367,2.0,3,1,2660,0.0,1992,2660,13367,11024 days 16:47:18.663882,155,1.2,0.0,0,0,2660.0
511718.0,2,1.75,1700,5000,1.0,3,6,850,850.0,1915,1690,5000,39148 days 16:47:18.663882,300,1.1428571428571428,1.0,10,0,0.0
965000.0,4,3.25,5010,49222,2.0,5,9,3710,1300.0,1978,3140,54014,16137 days 16:47:18.663882,283,1.2307692307692308,2.853846153846154,1870,-4792,2410.0
475000.0,4,2.25,2680,4673,2.0,3,7,2680,0.0,1999,2460,4645,8467 days 16:47:18.663882,350,1.7777777777777777,0.0,220,28,2680.0
1060000.0,4,2.75,2720,4000,1.5,5,8,1840,880.0,1928,1600,4000,34400 days 16:47:18.663882,105,1.4545454545454546,2.090909090909091,1120,0,960.0
252000.0,2,1.0,940,15450,1.0,4,6,940,0.0,1926,1370,34820,35130 days 16:47:18.663882,196,2.0,0.0,-430,-19370,940.0
580000.0,6,2.5,3596,13700,1.0,5,8,1798,1798.0,1964,1894,10500,21251 days 16:47:18.663882,076,2.4,1.0,1702,3200,0.0
374950.0,2,2.25,1240,1172,2.0,3,8,1000,240.0,2008,1260,1111,5180 days 16:47:18.663882,293,0.8888888888888888,4.166666666666667,-20,61,760.0
739000.0,5,4.0,4660,9900,2.0,4,9,2600,2060.0,1979,3380,9900,15772 days 16:47:18.663882,350,1.25,1.2621359223300972,1280,0,540.0
271000.0,4,1.75,1710,7200,1.0,5,7,910,800.0,1975,1730,7200,17233 days 16:47:18.663882,351,2.2857142857142856,1.1375,-20,0,110.0
230000.0,2,1.0,930,7550,1.0,3,6,930,0.0,1986,1370,10176,13215 days 16:47:18.663882,164,2.0,0.0,-440,-2626,930.0
210000.0,3,2.25,1430,9150,1.0,3,7,1070,360.0,1984,1430,6364,13946 days 16:47:18.663882,117,1.3333333333333333,2.9722222222222223,0,2786,710.0
350000.0,3,2.75,1650,5700,2.0,4,7,1650,0.0,1988,1320,7620,12485 days 16:47:18.663882,055,1.0909090909090908,0.0,330,-1920,1650.0
491500.0,3,2.25,1560,12000,1.0,4,7,1110,450.0,1968,2190,4612,19790 days 16:47:18.663882,126,1.3333333333333333,2.466666666666667,-630,7388,660.0
325000.0,3,2.5,1870,9825,1.0,4,7,1250,620.0,1994,1380,11475,10293 days 16:47:18.663882,252,1.2,2.0161290322580645,490,-1650,630.0
190000.0,3,2.0,1320,7625,1.0,3,7,1320,0.0,1987,1420,7500,12850 days 16:47:18.663882,279,1.5,0.0,-100,125,1320.0
658600.0,4,2.0,1400,4690,1.5,4,7,1400,0.0,1945,1400,4690,28190 days 16:47:18.663882,124,2.0,0.0,0,0,1400.0
299950.0,3,1.5,1940,8951,1.0,3,7,1300,640.0,1958,2000,8319,23442 days 16:47:18.663882,086,2.0,2.03125,-60,632,660.0
464000.0,5,2.0,2000,3000,1.5,3,6,1200,800.0,1931,1330,4000,33304 days 16:47:18.663882,089,2.5,1.5,670,-1000,400.0
308000.0,3,1.0,1640,18144,1.5,3,6,1640,0.0,1942,1500,9065,29286 days 16:47:18.663882,176,3.0,0.0,140,9079,1640.0
625000.0,3,1.0,1020,7650,1.0,3,6,1020,0.0,1919,1870,5500,37687 days 16:47:18.663882,029,3.0,0.0,-850,2150,1020.0
240000.0,3,1.75,1630,9450,1.0,4,7,1080,550.0,1977,1280,9100,16502 days 16:47:18.663882,036,1.7142857142857142,1.9636363636363636,350,350,530.0
530000.0,4,2.5,2940,35996,2.0,3,9,2940,0.0,1995,2890,35089,9928 days 16:47:18.663882,124,1.6,0.0,50,907,2940.0
1000000.0,5,4.5,2120,8944,2.0,5,8,2120,0.0,1939,2870,8944,30382 days 16:47:18.663882,293,1.1111111111111112,0.0,-750,0,2120.0
439000.0,1,1.0,790,2400,1.0,3,7,790,0.0,1918,1580,2566,38052 days 16:47:18.663882,268,1.0,0.0,-790,-166,790.0
575000.0,4,1.75,2020,6200,1.0,4,6,1010,1010.0,1948,1440,4158,27095 days 16:47:18.663882,131,2.2857142857142856,1.0,580,2042,0.0
418000.0,3,1.75,1530,7238,1.0,3,7,1530,0.0,1959,1580,7238,23077 days 16:47:18.663882,294,1.7142857142857142,0.0,-50,0,1530.0
1210000.0,4,3.75,3250,10949,2.0,4,9,2940,310.0,1930,2340,15234,33669 days 16:47:18.663882,118,1.0666666666666667,9.483870967741936,910,-4285,2630.0
1100000.0,4,3.75,2930,3200,1.5,5,9,2130,800.0,1925,1900,4320,35495 days 16:47:18.663882,154,1.0666666666666667,2.6625,1030,-1120,1330.0
1900000.0,3,3.75,3150,8550,2.0,3,1,3150,0.0,2007,2510,8550,5545 days 16:47:18.663882,105,0.8,0.0,640,0,3150.0
580000.0,3,2.5,2180,40278,2.0,3,9,2180,0.0,1985,2630,40000,13580 days 16:47:18.663882,330,1.2,0.0,-450,278,2180.0
380000.0,2,1.0,1040,7372,1.0,5,7,840,200.0,1939,1930,5150,30382 days 16:47:18.663882,070,2.0,4.2,-890,2222,640.0
256000.0,3,1.0,880,5375,1.0,4,5,880,0.0,1924,980,4838,35861 days 16:47:18.663882,204,3.0,0.0,-100,537,880.0
349950.0,3,1.0,1400,7066,1.0,3,8,1400,0.0,1957,1400,7320,23807 days 16:47:18.663882,135,3.0,0.0,0,-254,1400.0
691500.0,4,2.5,2600,7200,2.0,3,7,2600,0.0,1962,1790,6175,21981 days 16:47:18.663882,182,1.6,0.0,810,1025,2600.0
556000.0,3,1.75,1590,2500,1.5,4,7,1190,400.0,1908,1420,3800,41705 days 16:47:18.663882,304,1.7142857142857142,2.975,170,-1300,790.0
218000.0,3,2.25,1610,7084,1.0,4,8,1280,330.0,1968,2170,8505,19790 days 16:47:18.663882,324,1.3333333333333333,3.878787878787879,-560,-1421,950.0
425000.0,4,2.0,1390,4500,1.5,5,7,1390,0.0,1908,1900,5460,41705 days 16:47:18.663882,339,2.0,0.0,-510,-960,1390.0
935000.0,3,3.25,3710,38509,2.0,3,1,3710,0.0,1998,1680,25865,8832 days 16:47:18.663882,234,0.9230769230769231,0.0,2030,12644,3710.0
732000.0,4,1.75,2360,11300,1.0,4,9,2360,0.0,1974,2290,11951,17598 days 16:47:18.663882,280,2.2857142857142856,0.0,70,-651,2360.0
805500.0,3,1.0,1440,10330,1.0,4,7,1440,0.0,1952,2080,10327,25634 days 16:47:18.663882,027,3.0,0.0,-640,3,1440.0
507250.0,3,1.75,1400,5750,1.0,3,6,1100,300.0,1915,1500,5175,39148 days 16:47:18.663882,035,1.7142857142857142,3.6666666666666665,-100,575,800.0
800000.0,4,2.5,4600,67369,2.0,3,1,4600,0.0,1990,4600,67369,11754 days 16:47:18.663882,336,1.6,0.0,0,0,4600.0
600000.0,3,2.25,2100,8276,2.0,4,8,2100,0.0,1979,2420,18135,15772 days 16:47:18.663882,246,1.3333333333333333,0.0,-320,-9859,2100.0
627800.0,4,1.75,2010,12044,1.0,3,9,2010,0.0,1982,2200,11144,14676 days 16:47:18.663882,076,2.2857142857142856,0.0,-190,900,2010.0
660000.0,2,2.25,2550,6000,2.0,5,7,1860,690.0,1902,2010,4000,43896 days 16:47:18.663882,175,0.8888888888888888,2.6956521739130435,540,2000,1170.0
153503.0,2,2.5,1240,3649,2.0,3,7,1240,0.0,1986,1400,3721,13215 days 16:47:18.663882,282,0.8,0.0,-160,-72,1240.0
456500.0,3,2.25,2090,9163,1.0,3,7,1460,630.0,1975,1960,7713,17233 days 16:47:18.663882,020,1.3333333333333333,2.3174603174603177,130,1450,830.0
1310000.0,5,2.5,2770,8100,2.0,3,9,2770,0.0,2002,2070,8100,7371 days 16:47:18.663882,213,2.0,0.0,700,0,2770.0
843500.0,3,2.5,3560,11448,2.0,3,1,3560,0.0,1997,3290,11506,9197 days 16:47:18.663882,341,1.2,0.0,270,-58,3560.0
625000.0,3,1.0,1240,4080,1.0,3,7,1240,0.0,1925,2060,4080,35495 days 16:47:18.663882,230,3.0,0.0,-820,0,1240.0
527000.0,2,1.75,1640,4080,1.0,3,7,840,800.0,1921,1980,4080,36956 days 16:47:18.663882,162,1.1428571428571428,1.05,-340,0,40.0
1970000.0,5,3.75,3940,13738,1.5,4,9,3940,0.0,1951,2370,13320,25999 days 16:47:18.663882,057,1.3333333333333333,0.0,1570,418,3940.0
1000000.0,5,2.5,3150,50094,2.0,4,9,3150,0.0,1969,3600,48787,19424 days 16:47:18.663882,085,2.0,0.0,-450,1307,3150.0
855000.0,4,3.0,2550,5300,2.0,3,8,1720,830.0,1908,1590,4505,41705 days 16:47:18.663882,056,1.3333333333333333,2.072289156626506,960,795,890.0
725000.0,4,3.25,3940,27591,2.0,3,9,3440,500.0,2000,3420,29170,8102 days 16:47:18.663882,171,1.2307692307692308,6.88,520,-1579,2940.0
315000.0,1,1.0,580,7200,1.0,3,6,580,0.0,2000,1360,7560,8102 days 16:47:18.663882,288,1.0,0.0,-780,-360,580.0
180000.0,3,1.75,1330,16000,1.0,3,7,1330,0.0,1978,1330,14374,16137 days 16:47:18.663882,267,1.7142857142857142,0.0,0,1626,1330.0
700000.0,2,1.0,930,5000,1.0,3,7,930,0.0,1926,1760,5228,35130 days 16:47:18.663882,072,2.0,0.0,-830,-228,930.0
476500.0,3,1.0,1060,8625,2.0,4,7,1060,0.0,1962,2010,8901,21981 days 16:47:18.663882,223,3.0,0.0,-950,-276,1060.0
193000.0,3,1.5,1180,9048,1.0,3,7,1180,0.0,1960,1460,8942,22712 days 16:47:18.663882,154,2.0,0.0,-280,106,1180.0
295000.0,4,2.5,1850,6663,2.0,3,7,1850,0.0,1990,1850,6417,11754 days 16:47:18.663882,231,1.6,0.0,0,246,1850.0
363000.0,2,1.0,820,4880,1.0,4,6,820,0.0,1925,1320,4880,35495 days 16:47:18.663882,212,2.0,0.0,-500,0,820.0
875000.0,4,2.5,3600,21794,2.0,4,1,3600,0.0,1990,3410,19864,11754 days 16:47:18.663882,029,1.6,0.0,190,1930,3600.0
257200.0,3,2.0,1850,8250,1.0,4,7,1150,700.0,1952,1580,7153,25634 days 16:47:18.663882,134,1.5,1.6428571428571428,270,1097,450.0
555000.0,3,2.0,2240,11250,1.0,3,8,2240,0.0,1968,2200,12500,19790 days 16:47:18.663882,272,1.5,0.0,40,-1250,2240.0
380000.0,3,2.25,1860,15559,2.0,4,7,1860,0.0,1963,1110,11586,21616 days 16:47:18.663882,175,1.3333333333333333,0.0,750,3973,1860.0
282000.0,4,2.75,2390,7330,2.0,3,7,2390,0.0,1989,1980,6735,12119 days 16:47:18.663882,206,1.4545454545454546,0.0,410,595,2390.0
545000.0,4,2.5,2040,6034,2.0,3,7,2040,0.0,1990,1380,5986,11754 days 16:47:18.663882,157,1.6,0.0,660,48,2040.0
550000.0,3,1.5,1900,5000,1.5,3,7,1640,260.0,1926,2090,5000,35130 days 16:47:18.663882,157,2.0,6.3076923076923075,-190,0,1380.0
921500.0,3,1.5,1900,5000,1.5,3,7,1640,260.0,1926,2090,5000,35130 days 16:47:18.663882,072,2.0,6.3076923076923075,-190,0,1380.0
885000.0,3,1.5,2200,2880,2.0,5,7,1440,760.0,1904,2440,4640,43166 days 16:47:18.663882,132,2.0,1.894736842105263,-240,-1760,680.0
820000.0,4,2.25,2280,6660,1.5,3,8,1960,320.0,1940,1720,5336,30017 days 16:47:18.663882,149,1.7777777777777777,6.125,560,1324,1640.0
289000.0,3,1.0,1090,7315,1.0,5,6,1090,0.0,1981,1090,5800,15041 days 16:47:18.663882,133,3.0,0.0,0,1515,1090.0
334000.0,1,1.0,670,5750,1.0,3,7,670,0.0,1942,1170,5750,29286 days 16:47:18.663882,044,1.0,0.0,-500,0,670.0
206000.0,3,1.0,1050,5233,1.0,5,5,1050,0.0,1906,970,7500,42435 days 16:47:18.663882,301,3.0,0.0,80,-2267,1050.0
491950.0,3,2.25,2090,10733,1.0,3,7,1440,650.0,1958,1740,8100,23442 days 16:47:18.663882,181,1.3333333333333333,2.2153846153846155,350,2633,790.0
430000.0,3,2.5,2030,7770,2.0,3,8,2030,0.0,2003,1360,10782,7006 days 16:47:18.663882,317,1.2,0.0,670,-3012,2030.0
208000.0,3,2.0,1250,7995,1.0,4,7,1250,0.0,1980,1540,7650,15407 days 16:47:18.663882,199,1.5,0.0,-290,345,1250.0
245000.0,4,2.25,2600,6390,1.0,3,8,1390,1210.0,1978,2110,6700,16137 days 16:47:18.663882,189,1.7777777777777777,1.1487603305785123,490,-310,180.0
426000.0,2,1.0,640,2500,1.0,4,6,640,0.0,1918,1460,4200,38052 days 16:47:18.663882,077,2.0,0.0,-820,-1700,640.0
400000.0,3,2.5,2120,3742,2.0,3,7,2120,0.0,2006,2250,4696,5910 days 16:47:18.663882,213,1.2,0.0,-130,-954,2120.0
553000.0,3,1.0,1330,5100,1.0,3,7,900,430.0,1942,1500,5100,29286 days 16:47:18.663882,104,3.0,2.0930232558139537,-170,0,470.0
296000.0,2,1.0,750,4680,1.0,3,5,750,0.0,1948,1450,4400,27095 days 16:47:18.663882,090,2.0,0.0,-700,280,750.0
428000.0,3,2.5,2230,32660,1.0,4,8,2230,0.0,1977,2400,33120,16502 days 16:47:18.663882,048,1.2,0.0,-170,-460,2230.0
325000.0,4,2.5,1890,6156,1.0,3,7,980,910.0,1980,1590,6954,15407 days 16:47:18.663882,126,1.6,1.0769230769230769,300,-798,70.0
294000.0,2,1.0,820,6366,1.0,5,6,820,0.0,1952,1580,10169,25634 days 16:47:18.663882,202,2.0,0.0,-760,-3803,820.0
410000.0,3,1.75,1880,8424,1.0,4,7,1380,500.0,1977,1970,8523,16502 days 16:47:18.663882,078,1.7142857142857142,2.76,-90,-99,880.0
590000.0,4,4.25,2360,57514,2.0,4,8,2360,0.0,1939,2037,35733,30382 days 16:47:18.663882,154,0.9411764705882353,0.0,323,21781,2360.0
445000.0,3,2.25,1850,4050,2.0,4,7,1850,0.0,1985,1650,4468,13580 days 16:47:18.663882,324,1.3333333333333333,0.0,200,-418,1850.0
921000.0,4,2.5,2310,5362,2.0,4,8,2010,300.0,1928,2530,5960,34400 days 16:47:18.663882,084,1.6,6.7,-220,-598,1710.0
496000.0,3,1.5,2520,37616,1.0,3,8,2520,0.0,1955,1470,33750,24538 days 16:47:18.663882,063,2.0,0.0,1050,3866,2520.0
95000.0,2,1.0,800,8550,1.0,3,7,800,0.0,1947,1490,8550,27460 days 16:47:18.663882,346,2.0,0.0,-690,0,800.0
359000.0,4,1.75,1580,6396,1.0,4,6,790,790.0,1945,1180,6396,28190 days 16:47:18.663882,268,2.2857142857142856,1.0,400,0,0.0
452500.0,3,2.5,2430,88426,1.0,4,7,1570,860.0,1985,1560,56827,13580 days 16:47:18.663882,122,1.2,1.8255813953488371,870,31599,710.0
555000.0,4,1.75,2350,6200,1.5,4,7,1410,940.0,1946,1800,6150,27825 days 16:47:18.663882,336,2.2857142857142856,1.5,550,50,470.0
549900.0,5,3.0,3800,42316,1.5,4,9,3800,0.0,1984,2580,35775,13946 days 16:47:18.663882,267,1.6666666666666667,0.0,1220,6541,3800.0
569000.0,5,3.0,3670,10583,1.0,5,8,2060,1610.0,1952,2720,13865,25634 days 16:47:18.663882,161,1.6666666666666667,1.279503105590062,950,-3282,450.0
318500.0,4,2.0,1780,7350,1.0,5,7,900,880.0,1974,1480,7350,17598 days 16:47:18.663882,197,2.0,1.0227272727272727,300,0,20.0
487028.0,2,1.5,1295,1093,2.0,3,9,1105,190.0,2007,1295,1413,5545 days 16:47:18.663882,162,1.3333333333333333,5.815789473684211,0,-320,915.0
240000.0,3,1.0,1350,7560,1.0,4,7,950,400.0,1959,1470,7560,23077 days 16:47:18.663882,288,3.0,2.375,-120,0,550.0
380000.0,5,1.75,1320,38125,1.0,4,7,1120,200.0,1947,2360,15070,27460 days 16:47:18.663882,243,2.857142857142857,5.6,-1040,23055,920.0
250000.0,2,0.75,700,16828,1.0,4,6,700,0.0,1958,2010,29316,23442 days 16:47:18.663882,096,2.6666666666666665,0.0,-1310,-12488,700.0
368500.0,2,1.75,2510,19141,2.0,3,9,2510,0.0,1977,2400,13030,16502 days 16:47:18.663882,283,1.1428571428571428,0.0,110,6111,2510.0
340000.0,3,1.0,3180,27586,1.0,3,8,1400,1780.0,1969,2180,27586,19424 days 16:47:18.663882,042,3.0,0.7865168539325843,1000,0,-380.0
400000.0,2,1.0,910,4000,1.0,3,7,910,0.0,1918,1060,1346,38052 days 16:47:18.663882,117,2.0,0.0,-150,2654,910.0
835000.0,3,2.0,1570,4625,1.5,5,8,1570,0.0,1927,1760,4625,34765 days 16:47:18.663882,259,1.5,0.0,-190,0,1570.0
299000.0,3,2.5,2450,7062,2.0,3,8,2450,0.0,1993,1960,7200,10658 days 16:47:18.663882,335,1.2,0.0,490,-138,2450.0
1680000.0,6,2.25,4910,6600,2.5,5,1,3580,1330.0,1910,3280,5500,40974 days 16:47:18.663882,311,2.6666666666666665,2.691729323308271,1630,1100,2250.0
265000.0,3,2.0,1570,5706,1.0,3,7,1570,0.0,1998,1570,5706,8832 days 16:47:18.663882,134,1.5,0.0,0,0,1570.0
437500.0,4,2.5,2680,7513,2.0,3,8,2680,0.0,1998,2640,7243,8832 days 16:47:18.663882,315,1.6,0.0,40,270,2680.0
865000.0,3,1.75,2090,4725,2.0,3,7,1610,480.0,1947,1280,4725,27460 days 16:47:18.663882,155,1.7142857142857142,3.3541666666666665,810,0,1130.0
626000.0,3,2.0,2150,7200,1.0,3,8,2150,0.0,1988,2510,7222,12485 days 16:47:18.663882,070,1.5,0.0,-360,-22,2150.0
247300.0,2,2.0,1140,1118,2.0,3,7,1040,100.0,2009,1140,1118,4814 days 16:47:18.663882,301,1.0,10.4,0,0,940.0
2080000.0,4,3.5,4230,20377,2.0,3,1,4230,0.0,1997,3980,20489,9197 days 16:47:18.663882,174,1.1428571428571428,0.0,250,-112,4230.0
425000.0,3,1.0,1790,6000,1.5,2,8,1790,0.0,1937,1060,4000,31112 days 16:47:18.663882,274,3.0,0.0,730,2000,1790.0
905000.0,5,3.5,3100,10200,1.0,3,9,1660,1440.0,1970,2700,10455,19059 days 16:47:18.663882,176,1.4285714285714286,1.1527777777777777,400,-255,220.0
641250.0,3,2.5,2220,2550,3.0,3,1,2220,0.0,1990,2200,5610,11754 days 16:47:18.663882,239,1.2,0.0,20,-3060,2220.0
675000.0,4,2.5,2370,9679,2.0,3,8,2370,0.0,1984,2290,7944,13946 days 16:47:18.663882,090,1.6,0.0,80,1735,2370.0
845000.0,4,2.75,4070,115434,2.0,3,9,4070,0.0,2002,2970,95832,7371 days 16:47:18.663882,164,1.4545454545454546,0.0,1100,19602,4070.0
401500.0,4,1.0,1790,8400,1.0,4,7,1260,530.0,1954,1470,8400,24903 days 16:47:18.663882,250,4.0,2.3773584905660377,320,0,730.0
395000.0,3,2.5,1610,3755,2.0,3,7,1610,0.0,1987,1300,3823,12850 days 16:47:18.663882,266,1.2,0.0,310,-68,1610.0
1100000.0,5,2.75,2830,18050,1.0,5,7,1630,1200.0,1958,2370,14250,23442 days 16:47:18.663882,065,1.8181818181818181,1.3583333333333334,460,3800,430.0
145000.0,3,1.0,1010,5490,1.0,3,6,1010,0.0,1954,1740,10658,24903 days 16:47:18.663882,149,3.0,0.0,-730,-5168,1010.0
900000.0,3,1.0,1560,3825,1.5,3,8,1390,170.0,1930,1700,5100,33669 days 16:47:18.663882,106,3.0,8.176470588235293,-140,-1275,1220.0
374500.0,3,1.5,1330,8636,1.0,4,7,1330,0.0,1968,1370,7475,19790 days 16:47:18.663882,012,2.0,0.0,-40,1161,1330.0
850000.0,4,2.25,2330,10451,2.0,4,8,2330,0.0,1965,1880,8400,20885 days 16:47:18.663882,322,1.7777777777777777,0.0,450,2051,2330.0
490000.0,3,1.0,960,5750,1.0,3,7,960,0.0,1951,1520,5750,25999 days 16:47:18.663882,115,3.0,0.0,-560,0,960.0
304000.0,3,2.5,1710,6773,2.0,3,8,1710,0.0,1993,2220,7551,10658 days 16:47:18.663882,117,1.2,0.0,-510,-778,1710.0
400000.0,4,2.25,2230,7200,1.0,4,7,1300,930.0,1963,2010,7752,21616 days 16:47:18.663882,184,1.7777777777777777,1.3978494623655915,220,-552,370.0
454000.0,3,2.0,1700,10000,2.0,3,8,1700,0.0,1992,1460,9621,11024 days 16:47:18.663882,318,1.5,0.0,240,379,1700.0
160000.0,2,2.0,1040,4750,1.0,2,6,850,190.0,1950,1350,5000,26364 days 16:47:18.663882,358,1.0,4.473684210526316,-310,-250,660.0
542000.0,3,1.75,1070,8030,1.0,3,7,1070,0.0,1966,1540,7875,20520 days 16:47:18.663882,189,1.7142857142857142,0.0,-470,155,1070.0
403500.0,5,2.5,3600,17300,1.0,4,8,2410,1190.0,1968,2620,30200,19790 days 16:47:18.663882,169,2.0,2.0252100840336134,980,-12900,1220.0
418000.0,4,2.5,2750,8471,2.0,3,7,2750,0.0,2003,2610,7482,7006 days 16:47:18.663882,075,1.6,0.0,140,989,2750.0
406000.0,4,1.5,1920,6000,2.0,3,7,1920,0.0,1951,1920,6000,25999 days 16:47:18.663882,085,2.6666666666666665,0.0,0,0,1920.0
242500.0,3,2.25,1770,10000,1.0,3,7,1340,430.0,1978,1270,5055,16137 days 16:47:18.663882,266,1.3333333333333333,3.116279069767442,500,4945,910.0
425000.0,4,2.5,2460,5440,2.0,3,9,2460,0.0,2003,2460,5124,7006 days 16:47:18.663882,097,1.6,0.0,0,316,2460.0
613000.0,4,2.0,1550,4815,1.5,3,7,1550,0.0,1909,1680,4013,41339 days 16:47:18.663882,135,2.0,0.0,-130,802,1550.0
189000.0,3,2.0,1460,11481,1.0,2,7,1170,290.0,1995,1540,9680,9928 days 16:47:18.663882,364,1.5,4.0344827586206895,-80,1801,880.0
700000.0,4,2.25,2440,9450,1.5,3,7,2440,0.0,1947,1720,7503,27460 days 16:47:18.663882,303,1.7777777777777777,0.0,720,1947,2440.0
750000.0,3,1.0,1640,6516,1.5,4,7,1440,200.0,1935,1770,4000,31843 days 16:47:18.663882,245,3.0,7.2,-130,2516,1240.0
494000.0,2,1.0,1290,4650,1.0,4,7,1290,0.0,1906,1640,3900,42435 days 16:47:18.663882,188,2.0,0.0,-350,750,1290.0
700000.0,4,3.0,3150,7778,2.0,3,9,3150,0.0,2000,2970,6500,8102 days 16:47:18.663882,160,1.3333333333333333,0.0,180,1278,3150.0
705000.0,2,2.5,2305,5580,1.0,3,8,2305,0.0,2007,1440,5748,5545 days 16:47:18.663882,093,0.8,0.0,865,-168,2305.0
356000.0,2,1.75,1060,16470,1.0,3,7,1060,0.0,1977,1790,16748,16502 days 16:47:18.663882,142,1.1428571428571428,0.0,-730,-278,1060.0
625000.0,3,1.75,2060,12558,1.0,4,7,1350,710.0,1984,1850,8722,13946 days 16:47:18.663882,142,1.7142857142857142,1.9014084507042253,210,3836,640.0
144975.0,2,1.0,900,7500,1.0,3,5,900,0.0,1940,1350,7500,30017 days 16:47:18.663882,071,2.0,0.0,-450,0,900.0
415000.0,3,1.75,1910,12596,1.0,3,7,1340,570.0,1977,1550,13310,16502 days 16:47:18.663882,157,1.7142857142857142,2.3508771929824563,360,-714,770.0
485000.0,4,3.0,2340,7048,1.0,4,8,1340,1000.0,1979,1440,8088,15772 days 16:47:18.663882,125,1.3333333333333333,1.34,900,-1040,340.0
799950.0,3,3.0,2900,11769,2.0,3,1,2900,0.0,1997,2900,9611,9197 days 16:47:18.663882,311,1.0,0.0,0,2158,2900.0
783350.0,4,2.5,3290,35001,2.0,3,1,3290,0.0,1991,4090,40371,11389 days 16:47:18.663882,119,1.6,0.0,-800,-5370,3290.0
430000.0,1,1.0,630,1362,1.0,3,7,630,0.0,1943,1090,1376,28921 days 16:47:18.663882,353,1.0,0.0,-460,-14,630.0
2540000.0,5,4.75,5410,13431,2.0,4,1,5050,360.0,1941,3750,11596,29651 days 16:47:18.663882,328,1.0526315789473684,14.027777777777779,1660,1835,4690.0
975000.0,4,2.5,4270,43386,1.0,3,1,2680,1590.0,1991,3630,36180,11389 days 16:47:18.663882,169,1.6,1.6855345911949686,640,7206,1090.0
950000.0,3,1.5,1700,8050,1.0,3,7,1130,570.0,1950,2920,12239,26364 days 16:47:18.663882,125,2.0,1.9824561403508771,-1220,-4189,560.0
350000.0,2,1.0,1430,8157,1.5,3,7,1150,280.0,1944,1820,8157,28556 days 16:47:18.663882,218,2.0,4.107142857142857,-390,0,870.0
637000.0,4,2.75,2850,7510,2.0,3,8,2850,0.0,2008,1510,8833,5180 days 16:47:18.663882,307,1.4545454545454546,0.0,1340,-1323,2850.0
895000.0,3,2.0,2160,105415,1.0,3,1,2160,0.0,1991,2760,9620,11389 days 16:47:18.663882,050,1.5,0.0,-600,95795,2160.0
579000.0,2,2.0,1760,7200,1.0,5,7,880,880.0,1946,1760,7200,27825 days 16:47:18.663882,339,1.0,1.0,0,0,0.0
314900.0,4,1.75,2700,27072,1.0,3,7,1380,1320.0,1958,2460,34850,23442 days 16:47:18.663882,175,2.2857142857142856,1.0454545454545454,240,-7778,60.0
122000.0,2,1.0,860,6000,1.0,3,6,860,0.0,1945,1300,6000,28190 days 16:47:18.663882,027,2.0,0.0,-440,0,860.0
405000.0,2,1.0,880,3000,1.0,5,7,880,0.0,1927,1300,3000,34765 days 16:47:18.663882,220,2.0,0.0,-420,0,880.0
553650.0,2,2.5,1360,1349,2.0,3,8,1050,310.0,1997,1430,4400,9197 days 16:47:18.663882,128,0.8,3.3870967741935485,-70,-3051,740.0
369900.0,2,2.5,1770,1853,3.0,3,8,1770,0.0,2007,1770,1924,5545 days 16:47:18.663882,034,0.8,0.0,0,-71,1770.0
225000.0,3,2.0,2030,24829,1.0,4,7,1220,810.0,1979,1980,15204,15772 days 16:47:18.663882,148,1.5,1.5061728395061729,50,9625,410.0
160000.0,2,1.0,1180,9350,1.0,3,6,1180,0.0,1918,1780,9306,38052 days 16:47:18.663882,147,2.0,0.0,-600,44,1180.0
449500.0,4,2.0,2430,199940,1.0,3,8,1310,1120.0,1961,2220,150282,22346 days 16:47:18.663882,282,2.0,1.1696428571428572,210,49658,190.0
650000.0,3,1.0,1300,8266,1.0,4,7,1300,0.0,1953,1300,8707,25268 days 16:47:18.663882,240,3.0,0.0,0,-441,1300.0
542126.0,4,2.5,2360,43088,2.0,3,8,2360,0.0,1977,2850,39216,16502 days 16:47:18.663882,197,1.6,0.0,-490,3872,2360.0
309950.0,3,1.5,1200,15606,1.0,3,7,1200,0.0,1985,1210,15606,13580 days 16:47:18.663882,262,2.0,0.0,-10,0,1200.0
115000.0,2,1.0,1000,16524,1.0,3,5,1000,0.0,1913,1350,10208,39878 days 16:47:18.663882,339,2.0,0.0,-350,6316,1000.0
221700.0,2,1.5,1556,20000,1.0,4,7,1556,0.0,1957,2250,17286,23807 days 16:47:18.663882,365,1.3333333333333333,0.0,-694,2714,1556.0
726000.0,3,2.5,1890,3880,1.5,4,8,1460,430.0,1915,1010,3880,39148 days 16:47:18.663882,027,1.2,3.395348837209302,880,0,1030.0
515000.0,3,1.75,1810,5733,1.0,4,7,1010,800.0,1926,1260,4680,35130 days 16:47:18.663882,323,1.7142857142857142,1.2625,550,1053,210.0
756000.0,4,2.5,2730,10753,2.0,3,9,2730,0.0,1991,3090,10740,11389 days 16:47:18.663882,238,1.6,0.0,-360,13,2730.0
1570000.0,4,3.75,3070,5850,2.0,5,9,2400,670.0,1927,2940,5573,34765 days 16:47:18.663882,147,1.0666666666666667,3.582089552238806,130,277,1730.0
442000.0,4,2.25,2080,12007,1.0,4,8,1220,860.0,1979,2110,12459,15772 days 16:47:18.663882,141,1.7777777777777777,1.4186046511627908,-30,-452,360.0
260000.0,4,2.0,1620,7992,2.0,4,7,1620,0.0,1975,1710,7500,17233 days 16:47:18.663882,183,2.0,0.0,-90,492,1620.0
390000.0,2,1.75,1150,2723,1.0,4,7,770,380.0,1923,1440,4000,36226 days 16:47:18.663882,253,1.1428571428571428,2.026315789473684,-290,-1277,390.0
459500.0,2,1.0,1250,3825,1.0,3,7,850,400.0,1929,1370,4998,34034 days 16:47:18.663882,182,2.0,2.125,-120,-1173,450.0
330000.0,3,1.5,1430,8000,1.0,5,7,1430,0.0,1948,1410,9820,27095 days 16:47:18.663882,273,2.0,0.0,20,-1820,1430.0
189000.0,2,1.0,790,7128,1.0,3,6,790,0.0,1944,1110,7150,28556 days 16:47:18.663882,307,2.0,0.0,-320,-22,790.0
280000.0,3,1.0,1200,9322,1.5,4,7,1200,0.0,1954,1540,9677,24903 days 16:47:18.663882,345,3.0,0.0,-340,-355,1200.0
400000.0,2,1.75,2110,9519,1.0,2,7,2110,0.0,1948,1480,9519,27095 days 16:47:18.663882,125,1.1428571428571428,0.0,630,0,2110.0
368000.0,4,2.0,3160,11193,1.0,5,6,2410,750.0,1942,1020,5940,29286 days 16:47:18.663882,084,2.0,3.2133333333333334,2140,5253,1660.0
390000.0,4,1.75,2700,7875,1.5,4,8,2700,0.0,1968,2220,7875,19790 days 16:47:18.663882,160,2.2857142857142856,0.0,480,0,2700.0
245000.0,2,1.0,820,7475,1.0,3,6,820,0.0,1945,1030,5720,28190 days 16:47:18.663882,273,2.0,0.0,-210,1755,820.0
375000.0,4,2.5,1800,8432,1.0,4,7,1200,600.0,1960,1780,8432,22712 days 16:47:18.663882,218,1.6,2.0,20,0,600.0
465000.0,5,1.5,1750,12491,1.0,3,6,1390,360.0,1961,1560,12473,22346 days 16:47:18.663882,030,3.3333333333333335,3.861111111111111,190,18,1030.0
445000.0,3,2.0,1540,67953,1.0,3,7,1540,0.0,1997,1250,9100,9197 days 16:47:18.663882,071,1.5,0.0,290,58853,1540.0
250000.0,3,1.0,1130,7800,1.0,3,7,1130,0.0,1952,1170,7800,25634 days 16:47:18.663882,064,3.0,0.0,-40,0,1130.0
475500.0,3,1.0,1500,9416,1.0,4,8,1500,0.0,1952,1440,7200,25634 days 16:47:18.663882,276,3.0,0.0,60,2216,1500.0
672324.0,2,1.75,1600,5795,1.5,3,8,1600,0.0,1940,2310,6301,30017 days 16:47:18.663882,216,1.1428571428571428,0.0,-710,-506,1600.0
420000.0,3,2.0,1200,5029,1.0,3,6,880,320.0,1937,1510,5854,31112 days 16:47:18.663882,174,1.5,2.75,-310,-825,560.0
515000.0,3,2.0,1690,5100,1.5,5,7,1690,0.0,1907,1690,5100,42070 days 16:47:18.663882,363,1.5,0.0,0,0,1690.0
732350.0,4,2.5,2270,7665,2.0,3,9,2270,0.0,1986,2450,8706,13215 days 16:47:18.663882,309,1.6,0.0,-180,-1041,2270.0
297500.0,4,2.5,1910,5000,2.0,3,7,1910,0.0,2005,2020,5000,6275 days 16:47:18.663882,156,1.6,0.0,-110,0,1910.0
475000.0,3,1.5,1640,2720,1.5,3,8,1640,0.0,1929,1490,4375,34034 days 16:47:18.663882,281,2.0,0.0,150,-1655,1640.0
414000.0,4,2.5,2120,6497,2.0,3,7,2120,0.0,2003,2230,6300,7006 days 16:47:18.663882,125,1.6,0.0,-110,197,2120.0
357250.0,3,1.5,1400,8840,1.0,4,6,1400,0.0,1952,1260,8840,25634 days 16:47:18.663882,177,2.0,0.0,140,0,1400.0
289950.0,2,1.0,760,6000,1.0,4,6,760,0.0,1950,950,6000,26364 days 16:47:18.663882,303,2.0,0.0,-190,0,760.0
550000.0,3,1.0,1070,3713,1.0,4,6,1070,0.0,1917,1290,3960,38417 days 16:47:18.663882,125,3.0,0.0,-220,-247,1070.0
446000.0,3,1.75,1460,9998,1.0,3,7,960,500.0,1958,1460,9998,23442 days 16:47:18.663882,113,1.7142857142857142,1.92,0,0,460.0
279000.0,3,1.5,1280,16738,1.5,4,5,1280,0.0,1932,1590,16317,32939 days 16:47:18.663882,288,2.0,0.0,-310,421,1280.0
370000.0,3,2.25,1650,4859,2.0,3,7,1650,0.0,1988,1890,5018,12485 days 16:47:18.663882,233,1.3333333333333333,0.0,-240,-159,1650.0
216000.0,3,2.0,1260,4125,1.0,3,6,1260,0.0,1998,1300,9091,8832 days 16:47:18.663882,290,1.5,0.0,-40,-4966,1260.0
1100000.0,3,2.5,2200,20000,1.0,3,7,1400,800.0,1952,3050,11775,25634 days 16:47:18.663882,172,1.2,1.75,-850,8225,600.0
1280000.0,4,2.5,3560,15450,1.0,5,8,2060,1500.0,1977,3680,17314,16502 days 16:47:18.663882,293,1.6,1.3733333333333333,-120,-1864,560.0
355000.0,2,1.5,1140,2500,1.0,3,7,630,510.0,1988,1500,5000,12485 days 16:47:18.663882,048,1.3333333333333333,1.2352941176470589,-360,-2500,120.0
699000.0,4,2.5,2550,7312,2.0,3,9,2550,0.0,1988,2330,7480,12485 days 16:47:18.663882,254,1.6,0.0,220,-168,2550.0
412000.0,3,2.5,1553,1991,3.0,3,8,1553,0.0,2014,1509,2431,2988 days 16:47:18.663882,245,1.2,0.0,44,-440,1553.0
276000.0,2,1.0,1140,7200,1.0,3,6,1140,0.0,1923,1110,7200,36226 days 16:47:18.663882,036,2.0,0.0,30,0,1140.0
100000.0,2,1.0,790,6426,1.0,3,6,790,0.0,1944,1380,6946,28556 days 16:47:18.663882,247,2.0,0.0,-590,-520,790.0
955500.0,4,1.75,2130,5080,1.5,3,8,2130,0.0,1914,1900,5080,39513 days 16:47:18.663882,182,2.2857142857142856,0.0,230,0,2130.0
199000.0,3,1.0,1390,21262,1.0,3,7,1390,0.0,1958,1560,10800,23442 days 16:47:18.663882,088,3.0,0.0,-170,10462,1390.0
762000.0,4,3.5,4000,15253,2.0,3,9,4000,0.0,2007,3550,8747,5545 days 16:47:18.663882,176,1.1428571428571428,0.0,450,6506,4000.0
425000.0,4,2.0,1520,7983,1.0,5,7,1520,0.0,1967,1520,7783,20155 days 16:47:18.663882,126,2.0,0.0,0,200,1520.0
546000.0,2,1.0,1657,5031,2.0,3,7,1657,0.0,1910,2050,6201,40974 days 16:47:18.663882,308,2.0,0.0,-393,-1170,1657.0
419600.0,3,1.75,1680,8460,1.0,3,7,1180,500.0,1976,1890,9529,16868 days 16:47:18.663882,110,1.7142857142857142,2.36,-210,-1069,680.0
735000.0,4,2.25,2270,5102,1.0,5,8,1340,930.0,1954,1800,5102,24903 days 16:47:18.663882,174,1.7777777777777777,1.4408602150537635,470,0,410.0
1230000.0,2,2.5,2470,609,3.0,3,1,1910,560.0,2011,2440,1229,4084 days 16:47:18.663882,112,0.8,3.4107142857142856,30,-620,1350.0
445000.0,2,2.0,1240,2500,2.0,3,7,1240,0.0,1985,1660,5000,13580 days 16:47:18.663882,188,1.0,0.0,-420,-2500,1240.0
665000.0,3,2.0,1740,41275,1.0,3,8,1740,0.0,1974,2630,41275,17598 days 16:47:18.663882,006,1.5,0.0,-890,0,1740.0
1290000.0,5,3.5,4090,290980,1.0,3,1,2920,1170.0,2002,1880,9255,7371 days 16:47:18.663882,076,1.4285714285714286,2.4957264957264957,2210,281725,1750.0
508500.0,4,2.75,2520,12500,2.0,3,8,1720,800.0,1979,2520,13000,15772 days 16:47:18.663882,342,1.4545454545454546,2.15,0,-500,920.0
345950.0,5,1.0,1340,11198,1.5,3,8,1340,0.0,1934,1390,8020,32208 days 16:47:18.663882,344,5.0,0.0,-50,3178,1340.0
207500.0,3,1.0,1640,9750,1.0,3,7,1640,0.0,1968,1200,9750,19790 days 16:47:18.663882,013,3.0,0.0,440,0,1640.0
1080000.0,4,2.5,3000,10920,1.0,4,8,1550,1450.0,1969,2380,10920,19424 days 16:47:18.663882,338,1.6,1.0689655172413792,620,0,100.0
640000.0,3,1.0,1210,3720,2.0,4,8,1210,0.0,1930,1560,6000,33669 days 16:47:18.663882,314,3.0,0.0,-350,-2280,1210.0
329500.0,3,1.0,1810,13068,1.0,4,7,1360,450.0,1941,1400,13068,29651 days 16:47:18.663882,082,3.0,3.022222222222222,410,0,910.0
460000.0,4,2.75,2200,9676,1.0,3,8,1500,700.0,1979,2120,9585,15772 days 16:47:18.663882,294,1.4545454545454546,2.142857142857143,80,91,800.0
1230000.0,3,1.75,2200,14630,1.5,3,8,2200,0.0,1948,2850,15803,27095 days 16:47:18.663882,181,1.7142857142857142,0.0,-650,-1173,2200.0
805000.0,5,3.0,2350,6480,2.0,4,7,1650,700.0,1924,1840,7200,35861 days 16:47:18.663882,324,1.6666666666666667,2.357142857142857,510,-720,950.0
200000.0,3,1.5,1090,10454,1.0,3,6,1090,0.0,1963,1230,12196,21616 days 16:47:18.663882,352,2.0,0.0,-140,-1742,1090.0
749700.0,3,1.75,2280,77972,1.0,3,8,1460,820.0,1977,2460,14430,16502 days 16:47:18.663882,048,1.7142857142857142,1.7804878048780488,-180,63542,640.0
535000.0,2,1.0,1520,3360,1.0,4,7,830,690.0,1927,1470,3774,34765 days 16:47:18.663882,349,2.0,1.2028985507246377,50,-414,140.0
330000.0,3,2.25,1620,7150,1.0,4,7,1280,340.0,1950,1620,6930,26364 days 16:47:18.663882,301,1.3333333333333333,3.764705882352941,0,220,940.0
479200.0,3,2.0,1510,3750,1.5,4,7,1510,0.0,1928,1500,5000,34400 days 16:47:18.663882,211,1.5,0.0,10,-1250,1510.0
373000.0,5,2.5,3001,5710,2.0,3,8,3001,0.0,2006,2340,5980,5910 days 16:47:18.663882,133,2.0,0.0,661,-270,3001.0
355000.0,4,1.5,2020,6000,1.0,4,7,1010,1010.0,1953,1710,6000,25268 days 16:47:18.663882,078,2.6666666666666665,1.0,310,0,0.0
275000.0,3,2.0,1380,4500,1.0,3,7,1380,0.0,2008,1620,4000,5180 days 16:47:18.663882,153,1.5,0.0,-240,500,1380.0
380000.0,3,1.5,1520,4288,1.0,3,7,1020,500.0,1949,1660,4288,26729 days 16:47:18.663882,171,2.0,2.04,-140,0,520.0
417000.0,2,1.75,1090,4590,1.0,4,7,790,300.0,1915,1390,4080,39148 days 16:47:18.663882,040,1.1428571428571428,2.6333333333333333,-300,510,490.0
1170000.0,5,3.75,4220,15959,2.0,3,1,4220,0.0,2004,4630,16531,6641 days 16:47:18.663882,294,1.3333333333333333,0.0,-410,-572,4220.0
598500.0,3,2.25,2520,12000,1.0,3,1,2520,0.0,1978,2510,12000,16137 days 16:47:18.663882,269,1.3333333333333333,0.0,10,0,2520.0
629000.0,3,2.0,1760,5000,1.0,5,7,960,800.0,1920,1380,5000,37322 days 16:47:18.663882,153,1.5,1.2,380,0,160.0
226950.0,2,1.0,930,6600,1.0,3,6,930,0.0,1957,1250,6600,23807 days 16:47:18.663882,282,2.0,0.0,-320,0,930.0
1230000.0,4,2.5,2600,11542,1.5,4,9,2200,400.0,1939,2840,10960,30382 days 16:47:18.663882,365,1.6,5.5,-240,582,1800.0
415000.0,3,2.25,2180,11100,1.0,5,8,1700,480.0,1979,2350,11397,15772 days 16:47:18.663882,034,1.3333333333333333,3.5416666666666665,-170,-297,1220.0
595000.0,3,2.5,1910,3075,2.0,3,8,1910,0.0,2001,1940,3485,7736 days 16:47:18.663882,112,1.2,0.0,-30,-410,1910.0
209950.0,3,1.75,1100,5525,1.0,5,6,1100,0.0,1968,1050,5200,19790 days 16:47:18.663882,301,1.7142857142857142,0.0,50,325,1100.0
568000.0,3,1.75,1760,235224,1.0,3,7,1760,0.0,1973,2320,87120,17963 days 16:47:18.663882,127,1.7142857142857142,0.0,-560,148104,1760.0
119900.0,2,1.0,700,3180,1.0,3,6,480,220.0,1951,1760,6360,25999 days 16:47:18.663882,294,2.0,2.1818181818181817,-1060,-3180,260.0
207000.0,3,1.0,1080,10200,1.0,4,7,1080,0.0,1962,1230,10400,21981 days 16:47:18.663882,238,3.0,0.0,-150,-200,1080.0
195000.0,3,1.0,1070,22489,1.0,3,7,1070,0.0,1967,1880,20250,20155 days 16:47:18.663882,349,3.0,0.0,-810,2239,1070.0
324950.0,3,1.5,1460,8710,1.0,3,7,1460,0.0,1955,1400,8645,24538 days 16:47:18.663882,175,2.0,0.0,60,65,1460.0
210000.0,1,1.0,1050,7583,1.0,4,6,1050,0.0,1947,1420,7560,27460 days 16:47:18.663882,356,1.0,0.0,-370,23,1050.0
1080000.0,4,2.75,3160,42733,2.0,3,9,3160,0.0,1995,1890,24000,9928 days 16:47:18.663882,115,1.4545454545454546,0.0,1270,18733,3160.0
325088.0,4,1.0,1400,6739,1.0,3,7,1000,400.0,1954,1500,6380,24903 days 16:47:18.663882,338,4.0,2.5,-100,359,600.0
790000.0,4,3.0,3120,157875,2.0,4,8,3120,0.0,1977,1580,7050,16502 days 16:47:18.663882,016,1.3333333333333333,0.0,1540,150825,3120.0
790000.0,3,3.0,2840,206910,2.0,3,1,2840,0.0,1999,2070,25067,8467 days 16:47:18.663882,303,1.0,0.0,770,181843,2840.0
255000.0,2,1.0,1220,2500,1.0,3,6,770,450.0,1910,1540,3000,40974 days 16:47:18.663882,132,2.0,1.711111111111111,-320,-500,320.0
697000.0,4,3.0,2820,2850,1.5,5,7,1860,960.0,1928,1570,4500,34400 days 16:47:18.663882,311,1.3333333333333333,1.9375,1250,-1650,900.0
457500.0,2,1.0,840,5000,1.0,4,7,840,0.0,1908,1240,5000,41705 days 16:47:18.663882,308,2.0,0.0,-400,0,840.0
690000.0,3,2.0,1610,5100,1.5,5,8,1610,0.0,1940,1740,5100,30017 days 16:47:18.663882,139,1.5,0.0,-130,0,1610.0
967000.0,4,3.25,1860,4356,2.0,3,9,1860,0.0,1917,1860,4356,38417 days 16:47:18.663882,070,1.2307692307692308,0.0,0,0,1860.0
980000.0,4,1.75,2260,17711,1.0,4,9,2260,0.0,1968,2880,16594,19790 days 16:47:18.663882,119,2.2857142857142856,0.0,-620,1117,2260.0
619420.0,4,2.75,2450,14803,2.0,4,9,2450,0.0,1988,2330,14803,12485 days 16:47:18.663882,141,1.4545454545454546,0.0,120,0,2450.0
389000.0,2,1.0,850,3276,1.0,3,6,850,0.0,1910,1460,4100,40974 days 16:47:18.663882,286,2.0,0.0,-610,-824,850.0
500000.0,3,1.0,1800,7200,1.0,3,7,1020,780.0,1964,1740,5475,21251 days 16:47:18.663882,344,3.0,1.3076923076923077,60,1725,240.0
569000.0,4,1.75,1230,7890,1.0,4,7,1090,140.0,1950,2380,13176,26364 days 16:47:18.663882,269,2.2857142857142856,7.785714285714286,-1150,-5286,950.0
425000.0,4,2.25,2060,8540,1.0,4,7,1540,520.0,1967,1560,7700,20155 days 16:47:18.663882,209,1.7777777777777777,2.9615384615384617,500,840,1020.0
635000.0,4,2.25,2750,6180,1.0,4,8,1500,1250.0,1948,1740,6180,27095 days 16:47:18.663882,141,1.7777777777777777,1.2,1010,0,250.0
256500.0,2,1.0,1120,9912,1.0,4,6,1120,0.0,1980,1540,9750,15407 days 16:47:18.663882,139,2.0,0.0,-420,162,1120.0
695000.0,4,2.5,3010,11393,2.0,3,8,3010,0.0,2005,2810,11282,6275 days 16:47:18.664879,023,1.6,0.0,200,111,3010.0
535000.0,4,1.5,1580,5000,1.5,3,7,1390,190.0,1945,1580,5000,28190 days 16:47:18.664879,211,2.6666666666666665,7.315789473684211,0,0,1200.0
454200.0,4,2.5,2630,5379,2.0,3,8,2630,0.0,2004,2630,5379,6641 days 16:47:18.664879,100,1.6,0.0,0,0,2630.0
418500.0,2,1.0,790,5800,1.0,3,6,790,0.0,1943,1460,5800,28921 days 16:47:18.664879,023,2.0,0.0,-670,0,790.0
749950.0,4,2.75,3110,35235,2.0,4,9,3110,0.0,1983,2790,35445,14311 days 16:47:18.664879,156,1.4545454545454546,0.0,320,-210,3110.0
338500.0,3,1.75,2130,5489,1.0,3,8,1370,760.0,1999,1750,7200,8467 days 16:47:18.664879,292,1.7142857142857142,1.8026315789473684,380,-1711,610.0
1250000.0,4,3.75,4520,9240,1.5,3,1,3270,1250.0,1992,3380,9240,11024 days 16:47:18.664879,203,1.0666666666666667,2.616,1140,0,2020.0
299950.0,3,2.5,1600,9830,2.0,4,8,1600,0.0,1993,1890,8910,10658 days 16:47:18.664879,192,1.2,0.0,-290,920,1600.0
325000.0,4,1.75,1950,12500,1.0,3,7,1330,620.0,1963,1760,11520,21616 days 16:47:18.664879,212,2.2857142857142856,2.1451612903225805,190,980,710.0
434000.0,4,3.0,2010,8171,2.0,3,8,2010,0.0,1973,2090,8203,17963 days 16:47:18.664879,238,1.3333333333333333,0.0,-80,-32,2010.0
328950.0,4,1.75,2550,8976,1.0,5,7,1300,1250.0,1978,2220,9477,16137 days 16:47:18.664879,182,2.2857142857142856,1.04,330,-501,50.0
2100000.0,5,3.75,5340,10655,2.5,4,1,3740,1600.0,1912,3910,9418,40244 days 16:47:18.664879,139,1.3333333333333333,2.3375,1430,1237,2140.0
570000.0,4,2.0,2000,46902,2.0,3,8,2000,0.0,1978,2420,38130,16137 days 16:47:18.664879,119,2.0,0.0,-420,8772,2000.0
802000.0,3,2.25,2170,5001,2.0,3,8,2170,0.0,2014,1700,6991,2988 days 16:47:18.664879,259,1.3333333333333333,0.0,470,-1990,2170.0
525000.0,3,1.0,1550,6840,1.5,3,7,1550,0.0,1918,2370,4560,38052 days 16:47:18.664879,297,3.0,0.0,-820,2280,1550.0
700000.0,6,3.0,2790,4550,2.5,4,8,2790,0.0,1907,2590,4550,42070 days 16:47:18.664879,033,2.0,0.0,200,0,2790.0
350000.0,3,1.75,1980,273556,1.0,3,6,1040,940.0,1956,2180,217799,24173 days 16:47:18.664879,078,1.7142857142857142,1.1063829787234043,-200,55757,100.0
277500.0,2,1.5,1190,1236,3.0,3,7,1190,0.0,2005,1390,1756,6275 days 16:47:18.664879,049,1.3333333333333333,0.0,-200,-520,1190.0
1580000.0,5,2.75,3650,20150,1.0,4,1,2360,1290.0,1975,3220,19800,17233 days 16:47:18.664879,132,1.8181818181818181,1.8294573643410852,430,350,1070.0
195000.0,3,1.0,1510,4350,1.5,5,6,1510,0.0,1913,1210,5500,39878 days 16:47:18.664879,262,3.0,0.0,300,-1150,1510.0
222000.0,3,2.0,1200,6074,1.0,3,7,1200,0.0,1968,1430,6338,19790 days 16:47:18.664879,233,1.5,0.0,-230,-264,1200.0
865000.0,5,3.0,2830,8854,1.0,4,8,1500,1330.0,1979,2260,8604,15772 days 16:47:18.664879,106,1.6666666666666667,1.1278195488721805,570,250,170.0
445000.0,4,2.0,1650,6000,1.0,5,7,1000,650.0,1959,1540,6000,23077 days 16:47:18.664879,129,2.0,1.5384615384615385,110,0,350.0
495800.0,4,1.5,1710,4600,1.5,3,7,1710,0.0,1924,1740,4455,35861 days 16:47:18.664879,343,2.6666666666666665,0.0,-30,145,1710.0
548500.0,3,1.0,1740,4400,1.5,3,7,1740,0.0,1924,1720,4400,35861 days 16:47:18.664879,093,3.0,0.0,20,0,1740.0
310000.0,3,1.75,1840,10723,1.0,4,7,1220,620.0,1974,1590,9820,17598 days 16:47:18.664879,127,1.7142857142857142,1.967741935483871,250,903,600.0
205000.0,3,1.5,1820,8585,1.0,4,7,1820,0.0,1962,1740,10088,21981 days 16:47:18.664879,192,2.0,0.0,80,-1503,1820.0
470000.0,5,3.75,3860,6901,2.0,3,7,3860,0.0,2003,3000,8584,7006 days 16:47:18.664879,253,1.3333333333333333,0.0,860,-1683,3860.0
430000.0,3,1.5,1810,349351,1.5,3,7,1810,0.0,2002,2480,339332,7371 days 16:47:18.664879,113,2.0,0.0,-670,10019,1810.0
310000.0,2,2.0,1030,2271,3.0,3,7,1030,0.0,1999,1439,1387,8467 days 16:47:18.664879,121,1.0,0.0,-409,884,1030.0
355000.0,4,1.0,1410,7693,1.5,4,7,1410,0.0,1953,1330,8395,25268 days 16:47:18.664879,084,4.0,0.0,80,-702,1410.0
621500.0,5,2.5,2140,15950,1.0,4,8,1370,770.0,1968,2600,14273,19790 days 16:47:18.664879,027,2.0,1.7792207792207793,-460,1677,600.0
175000.0,6,1.5,1930,8400,1.0,3,7,1030,900.0,1971,1780,9520,18694 days 16:47:18.664879,161,4.0,1.1444444444444444,150,-1120,130.0
326000.0,6,1.5,1930,8400,1.0,3,7,1030,900.0,1971,1780,9520,18694 days 16:47:18.664879,007,4.0,1.1444444444444444,150,-1120,130.0
690000.0,4,3.5,1930,5400,1.5,3,7,1930,0.0,1920,1500,3340,37322 days 16:47:18.664879,255,1.1428571428571428,0.0,430,2060,1930.0
335000.0,4,2.5,2210,7214,2.0,3,8,2210,0.0,2003,2270,7246,7006 days 16:47:18.664879,231,1.6,0.0,-60,-32,2210.0
197000.0,4,1.0,1360,11175,1.0,3,7,1360,0.0,1961,1340,9702,22346 days 16:47:18.664879,055,4.0,0.0,20,1473,1360.0
312500.0,3,1.75,1830,7969,1.0,3,7,930,900.0,1950,1790,7425,26364 days 16:47:18.664879,184,1.7142857142857142,1.0333333333333334,40,544,30.0
436000.0,3,2.25,2120,6710,1.0,5,7,1420,700.0,1959,1880,6960,23077 days 16:47:18.664879,302,1.3333333333333333,2.0285714285714285,240,-250,720.0
1020000.0,4,2.5,2700,4590,2.0,3,8,2700,0.0,2002,2080,3570,7371 days 16:47:18.664879,274,1.6,0.0,620,1020,2700.0
805000.0,4,2.5,3160,35225,2.0,3,9,2250,910.0,1992,3460,17223,11024 days 16:47:18.664879,238,1.6,2.4725274725274726,-300,18002,1340.0
652427.0,4,2.25,2770,13129,2.0,4,8,2770,0.0,1979,2400,13129,15772 days 16:47:18.664879,005,1.7777777777777777,0.0,370,0,2770.0
1010000.0,3,2.5,2240,41339,1.0,4,9,2240,0.0,1945,2900,45738,28190 days 16:47:18.664879,291,1.2,0.0,-660,-4399,2240.0
355000.0,4,2.5,2570,6466,2.0,3,9,2570,0.0,1999,2520,6667,8467 days 16:47:18.664879,310,1.6,0.0,50,-201,2570.0
334550.0,2,1.0,880,12000,1.0,3,7,880,0.0,1939,1960,9395,30382 days 16:47:18.664879,210,2.0,0.0,-1080,2605,880.0
557500.0,3,2.25,1820,9670,2.0,3,8,1820,0.0,1984,2160,11424,13946 days 16:47:18.664879,189,1.3333333333333333,0.0,-340,-1754,1820.0
277500.0,4,2.25,1660,7184,1.0,3,7,1110,550.0,1963,1640,7200,21616 days 16:47:18.664879,307,1.7777777777777777,2.018181818181818,20,-16,560.0
300000.0,4,3.0,2200,10800,1.0,3,6,2200,0.0,1960,1430,10800,22712 days 16:47:18.664879,188,1.3333333333333333,0.0,770,0,2200.0
325000.0,4,1.0,1640,3844,1.5,4,7,1460,180.0,1928,1230,3844,34400 days 16:47:18.664879,056,4.0,8.11111111111111,410,0,1280.0
402500.0,4,2.0,1650,3504,1.0,3,7,760,890.0,1951,1480,3504,25999 days 16:47:18.664879,078,2.0,0.8539325842696629,170,0,-130.0
461000.0,3,1.75,1420,5170,1.0,4,7,1420,0.0,1963,2250,7700,21616 days 16:47:18.664879,232,1.7142857142857142,0.0,-830,-2530,1420.0
540000.0,3,1.0,1270,3840,1.5,3,7,1270,0.0,1926,1270,4175,35130 days 16:47:18.664879,086,3.0,0.0,0,-335,1270.0
385000.0,3,1.0,1070,4000,1.0,4,7,1070,0.0,1971,1090,4000,18694 days 16:47:18.664879,075,3.0,0.0,-20,0,1070.0
480000.0,2,1.0,1060,3040,1.0,3,7,860,200.0,1924,1470,3814,35861 days 16:47:18.664879,189,2.0,4.3,-410,-774,660.0
539950.0,3,2.25,2190,7149,1.0,4,8,1240,950.0,1963,3500,7149,21616 days 16:47:18.664879,160,1.3333333333333333,1.305263157894737,-1310,0,290.0
529000.0,3,2.25,1940,217800,2.0,3,9,1940,0.0,1990,2580,83558,11754 days 16:47:18.664879,199,1.3333333333333333,0.0,-640,134242,1940.0
417000.0,3,2.5,1300,877,2.0,3,7,1060,240.0,2008,1320,1414,5180 days 16:47:18.664879,232,1.2,4.416666666666667,-20,-537,820.0
405000.0,3,1.5,1330,12500,1.0,3,7,1330,0.0,1966,2310,12500,20520 days 16:47:18.664879,048,2.0,0.0,-980,0,1330.0
299000.0,3,2.25,1940,9100,1.0,4,8,1630,310.0,1966,2080,9100,20520 days 16:47:18.664879,204,1.3333333333333333,5.258064516129032,-140,0,1320.0
299000.0,3,1.75,2100,15480,1.0,3,7,2100,0.0,1983,1330,15657,14311 days 16:47:18.664879,225,1.7142857142857142,0.0,770,-177,2100.0
372220.0,3,1.0,1290,5500,1.0,3,7,980,310.0,1951,1680,5000,25999 days 16:47:18.664879,134,3.0,3.161290322580645,-390,500,670.0
494400.0,2,1.75,1560,1750,1.0,4,6,780,780.0,1904,1850,3600,43166 days 16:47:18.664879,142,1.1428571428571428,1.0,-290,-1850,0.0
280000.0,3,1.75,2630,6500,1.0,3,7,1330,1300.0,1958,2520,6500,23442 days 16:47:18.664879,267,1.7142857142857142,1.023076923076923,110,0,30.0
277950.0,3,2.5,2100,6021,2.0,3,7,2100,0.0,1992,2091,7547,11024 days 16:47:18.664879,325,1.2,0.0,9,-1526,2100.0
770000.0,3,2.75,2070,54557,2.0,3,8,2070,0.0,1996,2190,49658,9563 days 16:47:18.664879,353,1.0909090909090908,0.0,-120,4899,2070.0
760000.0,4,2.5,2960,28005,2.0,3,1,2960,0.0,1989,3510,35248,12119 days 16:47:18.664879,281,1.6,0.0,-550,-7243,2960.0
230000.0,2,2.0,1300,3608,1.0,3,7,1300,0.0,2004,1510,3608,6641 days 16:47:18.664879,026,1.0,0.0,-210,0,1300.0
525000.0,4,2.5,2520,7731,2.0,3,9,2520,0.0,1994,2000,7704,10293 days 16:47:18.664879,275,1.6,0.0,520,27,2520.0
307000.0,3,1.0,1150,6000,1.5,3,7,1150,0.0,1927,1210,7700,34765 days 16:47:18.664879,182,3.0,0.0,-60,-1700,1150.0
253779.0,4,2.0,2030,9600,1.5,3,6,1430,600.0,1947,1820,14600,27460 days 16:47:18.664879,169,2.0,2.3833333333333333,210,-5000,830.0
405000.0,3,1.5,1880,7400,1.0,3,8,1480,400.0,1968,1820,8660,19790 days 16:47:18.664879,168,2.0,3.7,60,-1260,1080.0
360000.0,2,1.0,2320,11250,2.0,4,6,2320,0.0,1942,1620,11250,29286 days 16:47:18.664879,071,2.0,0.0,700,0,2320.0
521000.0,2,1.0,1050,7500,1.5,4,6,1050,0.0,1910,2540,13680,40974 days 16:47:18.664879,131,2.0,0.0,-1490,-6180,1050.0
680000.0,4,2.5,3030,13068,2.0,3,9,3030,0.0,1978,2940,11999,16137 days 16:47:18.664879,269,1.6,0.0,90,1069,3030.0
355000.0,1,0.75,530,33278,1.0,4,4,530,0.0,1950,2830,14311,26364 days 16:47:18.664879,337,1.3333333333333333,0.0,-2300,18967,530.0
200000.0,3,1.5,1090,9600,1.0,4,7,1090,0.0,1968,1240,9620,19790 days 16:47:18.664879,174,2.0,0.0,-150,-20,1090.0
330000.0,3,2.25,2220,4060,1.0,3,7,1330,890.0,1993,1930,5625,10658 days 16:47:18.664879,189,1.3333333333333333,1.4943820224719102,290,-1565,440.0
221000.0,3,2.25,1430,5999,2.0,3,7,1430,0.0,1987,1600,5999,12850 days 16:47:18.664879,224,1.3333333333333333,0.0,-170,0,1430.0
1600000.0,4,4.5,3780,6000,2.0,4,1,2770,1010.0,1910,2660,6000,40974 days 16:47:18.664879,035,0.8888888888888888,2.742574257425743,1120,0,1760.0
310000.0,2,1.0,1560,4920,1.0,4,6,780,780.0,1947,1760,7510,27460 days 16:47:18.664879,204,2.0,1.0,-200,-2590,0.0
862000.0,4,2.25,2220,4200,1.5,5,8,1310,910.0,1932,2020,4940,32939 days 16:47:18.664879,099,1.7777777777777777,1.4395604395604396,200,-740,400.0
200000.0,3,1.5,1140,8340,1.0,3,7,1140,0.0,1960,1140,8340,22712 days 16:47:18.664879,170,2.0,0.0,0,0,1140.0
630000.0,4,2.5,2540,11100,1.0,5,7,2540,0.0,1957,1560,11100,23807 days 16:47:18.664879,273,1.6,0.0,980,0,2540.0
432250.0,3,2.25,1440,6232,2.0,3,7,1440,0.0,1985,1740,5999,13580 days 16:47:18.664879,079,1.3333333333333333,0.0,-300,233,1440.0
478000.0,3,2.25,1570,9500,1.0,4,7,1070,500.0,1977,2250,9583,16502 days 16:47:18.664879,023,1.3333333333333333,2.14,-680,-83,570.0
249000.0,4,2.25,1860,9576,1.0,3,7,1400,460.0,1962,1860,9576,21981 days 16:47:18.664879,204,1.7777777777777777,3.0434782608695654,0,0,940.0
495000.0,5,3.0,2440,4750,1.0,3,9,1450,990.0,2006,1420,5940,5910 days 16:47:18.664879,156,1.6666666666666667,1.4646464646464648,1020,-1190,460.0
630000.0,4,2.5,2100,8800,1.0,4,7,1240,860.0,1960,2000,8800,22712 days 16:47:18.664879,317,1.6,1.441860465116279,100,0,380.0
550000.0,4,2.5,2150,27540,2.0,3,8,2150,0.0,1997,2150,27540,9197 days 16:47:18.664879,177,1.6,0.0,0,0,2150.0
350000.0,3,2.5,2440,18674,2.0,4,8,2440,0.0,1994,2530,10603,10293 days 16:47:18.664879,262,1.2,0.0,-90,8071,2440.0
270000.0,5,1.5,1930,7480,2.0,3,7,1930,0.0,1966,1480,7705,20520 days 16:47:18.664879,336,3.3333333333333335,0.0,450,-225,1930.0
488250.0,4,2.0,1830,9610,1.0,3,7,1830,0.0,1963,1970,10754,21616 days 16:47:18.664879,280,2.0,0.0,-140,-1144,1830.0
248000.0,4,3.5,1850,6519,2.0,3,7,1130,720.0,1986,1280,6664,13215 days 16:47:18.664879,136,1.1428571428571428,1.5694444444444444,570,-145,410.0
889000.0,4,3.5,3210,5000,3.0,3,9,3210,0.0,2014,1360,5000,2988 days 16:47:18.664879,226,1.1428571428571428,0.0,1850,0,3210.0
375000.0,1,1.0,1090,5250,1.0,3,6,980,110.0,1927,2160,5250,34765 days 16:47:18.664879,239,1.0,8.909090909090908,-1070,0,870.0
933000.0,3,1.5,1870,3300,2.0,3,7,1870,0.0,1906,1820,2460,42435 days 16:47:18.664879,330,2.0,0.0,50,840,1870.0
625000.0,3,2.25,1920,8412,1.0,3,8,1460,460.0,1977,2490,8700,16502 days 16:47:18.664879,002,1.3333333333333333,3.1739130434782608,-570,-288,1000.0
328000.0,2,1.0,700,4350,1.0,3,6,700,0.0,1943,1620,5100,28921 days 16:47:18.664879,209,2.0,0.0,-920,-750,700.0
470000.0,4,2.25,3380,9900,1.0,4,8,1690,1690.0,1969,2390,9900,19424 days 16:47:18.664879,199,1.7777777777777777,1.0,990,0,0.0
502500.0,5,2.5,2430,6168,2.0,3,8,2430,0.0,2007,2150,8400,5545 days 16:47:18.664879,044,2.0,0.0,280,-2232,2430.0
484000.0,3,1.75,1950,17400,1.0,3,7,1210,740.0,1976,1900,17250,16868 days 16:47:18.664879,097,1.7142857142857142,1.635135135135135,50,150,470.0
252500.0,2,1.0,900,7500,1.0,4,6,900,0.0,1961,1190,10000,22346 days 16:47:18.664879,219,2.0,0.0,-290,-2500,900.0
610000.0,3,2.5,2060,8893,2.0,3,8,2060,0.0,1987,2650,8500,12850 days 16:47:18.664879,233,1.2,0.0,-590,393,2060.0
419000.0,4,2.0,2180,10447,1.0,4,8,1280,900.0,1969,2190,10987,19424 days 16:47:18.664879,206,2.0,1.4222222222222223,-10,-540,380.0
322500.0,4,2.25,2140,9377,2.0,4,8,2140,0.0,1986,2030,7846,13215 days 16:47:18.664879,198,1.7777777777777777,0.0,110,1531,2140.0
563000.0,6,1.0,1730,2760,1.5,3,7,1250,480.0,1918,1630,3200,38052 days 16:47:18.664879,006,6.0,2.6041666666666665,100,-440,770.0
464000.0,4,2.5,3140,12591,2.0,3,9,3140,0.0,1993,2650,11720,10658 days 16:47:18.664879,083,1.6,0.0,490,871,3140.0
870000.0,4,4.25,3010,4887,2.0,4,1,1940,1070.0,1951,2540,9375,25999 days 16:47:18.664879,168,0.9411764705882353,1.8130841121495327,470,-4488,870.0
280000.0,2,1.5,800,1196,2.0,3,8,800,0.0,2003,1020,1087,7006 days 16:47:18.664879,034,1.3333333333333333,0.0,-220,109,800.0
850000.0,3,2.5,3300,11570,2.0,3,9,3300,0.0,1994,3280,11446,10293 days 16:47:18.664879,255,1.2,0.0,20,124,3300.0
458950.0,2,1.0,1530,4370,1.0,3,7,1130,400.0,1946,1580,4275,27825 days 16:47:18.664879,295,2.0,2.825,-50,95,730.0
525000.0,5,3.0,2450,4591,2.0,3,7,2450,0.0,1994,1060,5500,10293 days 16:47:18.664879,133,1.6666666666666667,0.0,1390,-909,2450.0
286300.0,2,1.0,1000,31838,1.0,3,7,1000,0.0,1962,1490,39747,21981 days 16:47:18.664879,197,2.0,0.0,-490,-7909,1000.0
218450.0,2,1.0,840,7425,1.0,4,6,840,0.0,1952,1300,11674,25634 days 16:47:18.664879,199,2.0,0.0,-460,-4249,840.0
525000.0,3,1.5,1380,4290,1.0,3,7,1080,300.0,1955,1510,3900,24538 days 16:47:18.664879,248,2.0,3.6,-130,390,780.0
650000.0,3,1.5,1380,4290,1.0,3,7,1080,300.0,1955,1510,3900,24538 days 16:47:18.664879,356,2.0,3.6,-130,390,780.0
356000.0,4,2.0,2020,48693,1.5,3,7,2020,0.0,1949,1610,34900,26729 days 16:47:18.664879,176,2.0,0.0,410,13793,2020.0
436500.0,2,1.0,1260,5000,1.0,3,7,1040,220.0,1951,1510,5000,25999 days 16:47:18.664879,149,2.0,4.7272727272727275,-250,0,820.0
410000.0,3,1.75,1440,7112,1.0,3,7,1180,260.0,1979,1570,9152,15772 days 16:47:18.664879,219,1.7142857142857142,4.538461538461538,-130,-2040,920.0
512500.0,4,1.75,1540,8311,1.0,4,7,1540,0.0,1950,1890,7996,26364 days 16:47:18.664879,254,2.2857142857142856,0.0,-350,315,1540.0
510000.0,4,1.0,1060,7200,1.0,3,6,880,180.0,1925,1910,7200,35495 days 16:47:18.664879,230,4.0,4.888888888888889,-850,0,700.0
566000.0,4,1.75,1900,10297,1.0,4,8,1900,0.0,1966,2220,9612,20520 days 16:47:18.664879,261,2.2857142857142856,0.0,-320,685,1900.0
525000.0,3,1.75,2870,26500,1.5,3,8,2870,0.0,1948,2420,20500,27095 days 16:47:18.664879,253,1.7142857142857142,0.0,450,6000,2870.0
435000.0,3,1.0,1050,5500,1.0,3,6,930,120.0,1920,1410,5834,37322 days 16:47:18.664879,219,3.0,7.75,-360,-334,810.0
406500.0,3,2.75,1840,68479,1.0,3,8,1340,500.0,1989,2060,61903,12119 days 16:47:18.664879,365,1.0909090909090908,2.68,-220,6576,840.0
550000.0,5,2.75,3000,9473,1.0,3,8,1500,1500.0,1966,2050,8820,20520 days 16:47:18.664879,280,1.8181818181818181,1.0,950,653,0.0
251000.0,3,2.0,1200,10212,1.5,5,6,1200,0.0,1949,1280,10212,26729 days 16:47:18.664879,057,1.5,0.0,-80,0,1200.0
830000.0,3,1.5,1840,10125,1.0,4,8,1220,620.0,1959,2320,10160,23077 days 16:47:18.664879,345,2.0,1.967741935483871,-480,-35,600.0
803000.0,4,2.5,2790,7673,2.0,3,9,2790,0.0,1989,2740,7837,12119 days 16:47:18.664879,104,1.6,0.0,50,-164,2790.0
206000.0,3,1.0,970,9360,1.0,4,5,970,0.0,1942,1050,11348,29286 days 16:47:18.664879,097,3.0,0.0,-80,-1988,970.0
200000.0,4,1.0,1070,7467,1.5,3,7,1070,0.0,1944,1160,7467,28556 days 16:47:18.664879,211,4.0,0.0,-90,0,1070.0
219000.0,2,1.0,900,5160,1.0,3,6,900,0.0,1952,900,5160,25634 days 16:47:18.664879,126,2.0,0.0,0,0,900.0
777000.0,4,4.0,2680,6000,1.0,3,7,1380,1300.0,1962,1930,6000,21981 days 16:47:18.664879,248,1.0,1.0615384615384615,750,0,80.0
593700.0,3,2.5,2000,22000,2.0,3,8,2000,0.0,1979,2180,19800,15772 days 16:47:18.664879,049,1.2,0.0,-180,2200,2000.0
712500.0,3,1.5,1660,8797,1.0,4,7,1660,0.0,1956,2350,10053,24173 days 16:47:18.664879,154,2.0,0.0,-690,-1256,1660.0
600000.0,4,1.5,1770,6014,1.5,4,7,1240,530.0,1946,1740,6014,27825 days 16:47:18.664879,195,2.6666666666666665,2.339622641509434,30,0,710.0
554663.0,3,2.0,1230,6802,1.5,3,7,1230,0.0,1940,1850,6398,30017 days 16:47:18.664879,089,1.5,0.0,-620,404,1230.0
267000.0,3,1.0,1740,10875,1.0,4,7,1020,720.0,1962,1470,8532,21981 days 16:47:18.664879,184,3.0,1.4166666666666667,270,2343,300.0
390000.0,3,2.0,1710,8910,1.0,5,7,1710,0.0,1953,1430,8493,25268 days 16:47:18.664879,267,1.5,0.0,280,417,1710.0
335000.0,6,2.0,2020,7071,1.0,3,7,1010,1010.0,1979,2020,5000,15772 days 16:47:18.664879,091,3.0,1.0,0,2071,0.0
938000.0,4,2.5,2410,9886,1.0,5,8,1990,420.0,1975,2530,10658,17233 days 16:47:18.664879,113,1.6,4.738095238095238,-120,-772,1570.0
370000.0,4,2.75,2310,14745,1.0,3,7,1410,900.0,1993,2060,9678,10658 days 16:47:18.664879,097,1.4545454545454546,1.5666666666666667,250,5067,510.0
335000.0,5,2.5,2400,4548,2.0,3,7,2400,0.0,2003,2200,4465,7006 days 16:47:18.664879,092,2.0,0.0,200,83,2400.0
695000.0,5,2.0,3160,3990,1.5,3,7,1870,1290.0,1923,1780,4240,36226 days 16:47:18.664879,111,2.5,1.449612403100775,1380,-250,580.0
387500.0,3,1.0,1560,14333,1.0,4,7,1560,0.0,1953,1640,14333,25268 days 16:47:18.664879,157,3.0,0.0,-80,0,1560.0
245000.0,3,2.5,1770,6187,2.0,3,7,1770,0.0,1992,1650,7200,11024 days 16:47:18.664879,077,1.2,0.0,120,-1013,1770.0
308550.0,3,2.0,1600,13200,1.0,3,7,1600,0.0,1990,1360,11520,11754 days 16:47:18.664879,210,1.5,0.0,240,1680,1600.0
225000.0,3,1.75,1330,13102,1.0,3,7,1330,0.0,1968,1270,11475,19790 days 16:47:18.664879,175,1.7142857142857142,0.0,60,1627,1330.0
715000.0,4,2.5,2970,29163,2.0,3,9,2970,0.0,1993,3100,31105,10658 days 16:47:18.664879,246,1.6,0.0,-130,-1942,2970.0
335000.0,3,1.0,1020,10200,1.0,4,7,1020,0.0,1954,1170,8188,24903 days 16:47:18.664879,126,3.0,0.0,-150,2012,1020.0
634000.0,3,2.5,2490,4904,2.0,3,9,2490,0.0,2003,2370,4050,7006 days 16:47:18.664879,233,1.2,0.0,120,854,2490.0
337500.0,5,2.0,1700,7314,1.0,3,7,1000,700.0,1956,2000,7176,24173 days 16:47:18.664879,134,2.5,1.4285714285714286,-300,138,300.0
440000.0,1,1.0,850,6567,1.0,4,6,850,0.0,1940,2160,9794,30017 days 16:47:18.664879,247,1.0,0.0,-1310,-3227,850.0
350000.0,3,1.75,1250,13775,1.0,3,7,1250,0.0,1990,1260,13707,11754 days 16:47:18.664879,198,1.7142857142857142,0.0,-10,68,1250.0
400000.0,2,1.0,610,4560,1.0,3,5,610,0.0,1918,930,1392,38052 days 16:47:18.664879,014,2.0,0.0,-320,3168,610.0
1290000.0,4,3.5,3700,13175,2.0,4,1,3700,0.0,1989,3880,15508,12119 days 16:47:18.664879,227,1.1428571428571428,0.0,-180,-2333,3700.0
435000.0,3,1.0,950,10080,1.0,4,7,950,0.0,1954,1060,10000,24903 days 16:47:18.664879,096,3.0,0.0,-110,80,950.0
681000.0,4,2.5,3860,5130,2.0,3,8,2930,930.0,2004,3130,6163,6641 days 16:47:18.664879,272,1.6,3.150537634408602,730,-1033,2000.0
397000.0,3,3.5,1360,1275,2.0,3,8,1240,120.0,2007,1360,1275,5545 days 16:47:18.664879,180,0.8571428571428571,10.333333333333334,0,0,1120.0
775000.0,4,2.5,3890,34513,2.0,3,1,3890,0.0,1996,3600,28435,9563 days 16:47:18.664879,269,1.6,0.0,290,6078,3890.0
480000.0,3,2.25,1680,9090,1.0,4,7,1130,550.0,1959,1960,9090,23077 days 16:47:18.664879,188,1.3333333333333333,2.0545454545454547,-280,0,580.0
158000.0,3,2.5,1520,7200,2.0,4,7,1520,0.0,1985,1780,7210,13580 days 16:47:18.664879,252,1.2,0.0,-260,-10,1520.0
590000.0,3,2.0,2420,208652,1.5,3,8,2420,0.0,2005,3180,212137,6275 days 16:47:18.664879,204,1.5,0.0,-760,-3485,2420.0
772500.0,5,2.75,3890,9130,2.0,3,9,3890,0.0,2004,3450,8361,6641 days 16:47:18.664879,245,1.8181818181818181,0.0,440,769,3890.0
464500.0,5,1.5,2940,13425,1.0,3,8,1470,1470.0,1955,1580,8200,24538 days 16:47:18.664879,048,3.3333333333333335,1.0,1360,5225,0.0
281000.0,3,1.75,1350,8737,1.0,3,7,1350,0.0,1966,1600,8928,20520 days 16:47:18.664879,114,1.7142857142857142,0.0,-250,-191,1350.0
620000.0,3,2.25,2190,45738,1.0,3,8,2190,0.0,1990,2970,4496,11754 days 16:47:18.664879,203,1.3333333333333333,0.0,-780,41242,2190.0
475000.0,3,2.25,2280,5750,1.0,4,7,1150,1130.0,1985,1500,5060,13580 days 16:47:18.664879,168,1.3333333333333333,1.0176991150442478,780,690,20.0
245000.0,2,2.0,1070,4500,1.0,4,6,910,160.0,1932,1280,4500,32939 days 16:47:18.664879,290,1.0,5.6875,-210,0,750.0
660000.0,5,2.25,2540,3750,1.5,4,7,1510,1030.0,1925,1780,3750,35495 days 16:47:18.664879,210,2.2222222222222223,1.4660194174757282,760,0,480.0
527500.0,4,2.25,2270,8480,1.0,5,8,1310,960.0,1973,1910,9050,17963 days 16:47:18.664879,338,1.7777777777777777,1.3645833333333333,360,-570,350.0
135000.0,2,1.0,1220,7250,1.0,4,6,1220,0.0,1914,1350,20250,39513 days 16:47:18.664879,300,2.0,0.0,-130,-13000,1220.0
275000.0,3,1.75,1890,5000,1.0,3,7,1890,0.0,2003,2960,5421,7006 days 16:47:18.664879,126,1.7142857142857142,0.0,-1070,-421,1890.0
430000.0,4,2.0,1990,4740,1.0,3,7,1080,910.0,1926,1560,2370,35130 days 16:47:18.664879,041,2.0,1.1868131868131868,430,2370,170.0
213500.0,3,1.0,1220,6000,1.0,4,7,1220,0.0,1968,1420,6000,19790 days 16:47:18.664879,237,3.0,0.0,-200,0,1220.0
535000.0,3,3.0,2640,5978,2.0,3,9,2640,0.0,2012,2680,6060,3719 days 16:47:18.664879,255,1.0,0.0,-40,-82,2640.0
641000.0,3,1.75,1480,9603,1.0,3,7,1480,0.0,1952,2660,10766,25634 days 16:47:18.664879,044,1.7142857142857142,0.0,-1180,-1163,1480.0
436300.0,3,2.0,2320,9420,1.0,5,7,2320,0.0,1952,2030,9420,25634 days 16:47:18.664879,301,1.5,0.0,290,0,2320.0
1440000.0,4,1.75,2410,6000,1.5,3,8,2410,0.0,1911,1280,4000,40609 days 16:47:18.664879,287,2.2857142857142856,0.0,1130,2000,2410.0
830000.0,4,2.75,2090,13500,1.0,4,8,2090,0.0,1949,2130,13500,26729 days 16:47:18.664879,086,1.4545454545454546,0.0,-40,0,2090.0
380000.0,3,1.0,920,3532,1.0,3,6,920,0.0,1910,1250,4000,40974 days 16:47:18.664879,203,3.0,0.0,-330,-468,920.0
132500.0,3,0.75,850,8573,1.0,3,6,600,250.0,1945,850,8382,28190 days 16:47:18.664879,051,4.0,2.4,0,191,350.0
179950.0,3,1.0,1130,9907,1.0,3,7,1130,0.0,1954,1320,9907,24903 days 16:47:18.664879,335,3.0,0.0,-190,0,1130.0
188200.0,3,1.0,1260,7265,1.0,4,7,1260,0.0,1954,940,7200,24903 days 16:47:18.664879,110,3.0,0.0,320,65,1260.0
659000.0,4,2.0,2090,10800,1.0,4,7,2090,0.0,1951,2090,10800,25999 days 16:47:18.664879,183,2.0,0.0,0,0,2090.0
317000.0,3,2.0,2020,7260,1.5,3,7,1180,840.0,1926,1400,5950,35130 days 16:47:18.664879,295,1.5,1.4047619047619047,620,1310,340.0
625000.0,3,2.25,1970,4564,1.0,3,8,1470,500.0,1959,1980,5000,23077 days 16:47:18.664879,328,1.3333333333333333,2.94,-10,-436,970.0
350000.0,3,1.75,1820,9545,1.0,3,7,1230,590.0,1976,1790,9530,16868 days 16:47:18.664879,164,1.7142857142857142,2.0847457627118646,30,15,640.0
750000.0,3,1.5,1840,5000,1.5,5,7,1340,500.0,1915,1840,5000,39148 days 16:47:18.664879,176,2.0,2.68,0,0,840.0
457000.0,4,1.75,2100,10358,1.0,5,8,1280,820.0,1959,2080,9000,23077 days 16:47:18.664879,239,2.2857142857142856,1.5609756097560976,20,1358,460.0
632500.0,4,2.0,1770,5000,2.0,4,7,1770,0.0,1906,1550,5000,42435 days 16:47:18.664879,063,2.0,0.0,220,0,1770.0
223000.0,3,2.0,1110,7231,1.0,4,7,1110,0.0,1991,1550,7245,11389 days 16:47:18.664879,183,1.5,0.0,-440,-14,1110.0
610000.0,4,2.75,2090,8400,1.0,4,8,1240,850.0,1976,2340,9000,16868 days 16:47:18.664879,245,1.4545454545454546,1.4588235294117646,-250,-600,390.0
385000.0,4,1.75,2080,8215,2.0,4,7,2080,0.0,1948,1550,8215,27095 days 16:47:18.664879,297,2.2857142857142856,0.0,530,0,2080.0
367500.0,3,3.25,1400,1343,2.0,3,7,1160,240.0,2005,1400,1326,6275 days 16:47:18.664879,083,0.9230769230769231,4.833333333333333,0,17,920.0
385100.0,3,1.0,1060,8040,1.0,4,6,1060,0.0,1949,1300,7620,26729 days 16:47:18.664879,216,3.0,0.0,-240,420,1060.0
230000.0,2,1.0,720,5913,1.0,3,6,720,0.0,1920,1560,6600,37322 days 16:47:18.664879,363,2.0,0.0,-840,-687,720.0
286000.0,3,2.75,1100,750,2.0,3,7,780,320.0,2008,1170,4800,5180 days 16:47:18.664879,174,1.0909090909090908,2.4375,-70,-4050,460.0
201700.0,3,1.0,1010,9576,1.0,4,7,1010,0.0,1967,1540,9576,20155 days 16:47:18.664879,085,3.0,0.0,-530,0,1010.0
1350000.0,4,4.75,5230,89298,2.5,3,1,5230,0.0,2002,4110,107153,7371 days 16:47:18.664879,113,0.8421052631578947,0.0,1120,-17855,5230.0
525000.0,4,1.75,2420,7672,1.0,3,8,1480,940.0,1979,2370,7699,15772 days 16:47:18.664879,139,2.2857142857142856,1.574468085106383,50,-27,540.0
361000.0,3,1.5,1200,7236,1.0,3,7,1200,0.0,1975,1680,7800,17233 days 16:47:18.664879,033,2.0,0.0,-480,-564,1200.0
530000.0,3,1.5,1950,1963,3.0,3,8,1950,0.0,2002,1590,2028,7371 days 16:47:18.664879,266,2.0,0.0,360,-65,1950.0
455000.0,3,2.25,1870,7403,1.0,3,7,1870,0.0,1950,1630,7440,26364 days 16:47:18.664879,281,1.3333333333333333,0.0,240,-37,1870.0
421000.0,4,2.25,1310,8400,1.0,4,7,1310,0.0,1966,1600,8400,20520 days 16:47:18.664879,324,1.7777777777777777,0.0,-290,0,1310.0
640000.0,4,2.0,1520,6200,1.5,3,7,1520,0.0,1945,1910,6200,28190 days 16:47:18.664879,122,2.0,0.0,-390,0,1520.0
240000.0,3,1.0,1270,12733,1.0,3,7,1270,0.0,1955,1660,11536,24538 days 16:47:18.664879,090,3.0,0.0,-390,1197,1270.0
360000.0,2,1.0,840,7414,1.0,4,6,840,0.0,1928,1740,9784,34400 days 16:47:18.664879,297,2.0,0.0,-900,-2370,840.0
157340.0,2,1.0,900,23000,1.0,2,7,900,0.0,1953,1460,8265,25268 days 16:47:18.664879,083,2.0,0.0,-560,14735,900.0
1240000.0,4,3.0,3010,6139,2.0,5,8,2560,450.0,1950,2100,6798,26364 days 16:47:18.664879,105,1.3333333333333333,5.688888888888889,910,-659,2110.0
250000.0,3,1.0,1050,6874,1.0,3,6,1050,0.0,1954,1500,8954,24903 days 16:47:18.664879,126,3.0,0.0,-450,-2080,1050.0
735000.0,6,2.75,3360,84506,1.0,5,7,2040,1320.0,1962,2190,43124,21981 days 16:47:18.664879,056,2.1818181818181817,1.5454545454545454,1170,41382,720.0
884900.0,7,4.75,5370,10800,1.5,3,8,5370,0.0,1967,2310,10910,20155 days 16:47:18.664879,015,1.4736842105263157,0.0,3060,-110,5370.0
775000.0,3,3.5,2690,104544,2.0,3,8,2690,0.0,1948,2300,81698,27095 days 16:47:18.664879,296,0.8571428571428571,0.0,390,22846,2690.0
463000.0,3,1.75,1710,7320,1.0,3,7,1710,0.0,1948,2260,8839,27095 days 16:47:18.664879,122,1.7142857142857142,0.0,-550,-1519,1710.0
579000.0,3,2.5,1640,1269,3.0,3,8,1640,0.0,2009,1590,1231,4814 days 16:47:18.664879,174,1.2,0.0,50,38,1640.0
570000.0,6,3.75,4000,6015,2.0,3,1,3080,920.0,2004,3180,5700,6641 days 16:47:18.664879,190,1.6,3.347826086956522,820,315,2160.0
1060000.0,5,4.5,4140,7924,2.0,3,1,4140,0.0,2005,3960,8410,6275 days 16:47:18.664879,090,1.1111111111111112,0.0,180,-486,4140.0
375000.0,4,2.75,3140,24800,1.0,4,8,2080,1060.0,1971,2850,12900,18694 days 16:47:18.664879,252,1.4545454545454546,1.9622641509433962,290,11900,1020.0
422000.0,2,1.75,1320,2609,1.0,4,7,920,400.0,1938,1200,4220,30747 days 16:47:18.664879,343,1.1428571428571428,2.3,120,-1611,520.0
866500.0,4,3.5,3080,4945,2.0,3,9,2010,1070.0,2014,1220,4945,2988 days 16:47:18.664879,040,1.1428571428571428,1.8785046728971964,1860,0,940.0
705000.0,3,2.5,2500,10359,2.0,3,1,2500,0.0,1986,2580,10142,13215 days 16:47:18.664879,103,1.2,0.0,-80,217,2500.0
470000.0,4,2.5,2520,9684,2.0,3,8,2520,0.0,1994,2090,10133,10293 days 16:47:18.664879,302,1.6,0.0,430,-449,2520.0
360000.0,3,1.25,2350,6200,1.0,4,7,1320,1030.0,1966,2140,9543,20520 days 16:47:18.664879,352,2.4,1.2815533980582525,210,-3343,290.0
795000.0,4,2.5,2570,13450,1.0,3,8,1510,1060.0,1948,3470,12615,27095 days 16:47:18.664879,119,1.6,1.4245283018867925,-900,835,450.0
800000.0,4,2.5,3100,7807,2.0,3,9,3100,0.0,2003,3100,7807,7006 days 16:47:18.664879,089,1.6,0.0,0,0,3100.0
2450000.0,4,3.5,4730,13586,1.5,5,1,4270,460.0,1935,3710,8828,31843 days 16:47:18.664879,149,1.1428571428571428,9.282608695652174,1020,4758,3810.0
277284.0,3,1.75,1030,4800,1.0,3,6,930,100.0,1927,1540,4800,34765 days 16:47:18.664879,098,1.7142857142857142,9.3,-510,0,830.0
460000.0,2,1.0,1020,4002,1.0,5,7,1020,0.0,1953,1780,5000,25268 days 16:47:18.664879,103,2.0,0.0,-760,-998,1020.0
898888.0,3,2.5,2080,3729,2.0,3,9,2080,0.0,1996,2080,4000,9563 days 16:47:18.664879,124,1.2,0.0,0,-271,2080.0
211000.0,3,1.0,1410,47916,1.0,3,7,1410,0.0,1981,1810,215622,15041 days 16:47:18.664879,218,3.0,0.0,-400,-167706,1410.0
222000.0,2,2.0,1360,3300,2.0,3,6,1360,0.0,2004,1310,3300,6641 days 16:47:18.664879,240,1.0,0.0,50,0,1360.0
672000.0,3,2.5,2620,21587,2.0,3,7,2620,0.0,1992,2570,23650,11024 days 16:47:18.664879,149,1.2,0.0,50,-2063,2620.0
778000.0,3,2.25,2260,33080,1.0,5,9,1690,570.0,1974,3020,35291,17598 days 16:47:18.664879,293,1.3333333333333333,2.9649122807017543,-760,-2211,1120.0
312500.0,3,1.75,1490,9493,1.0,4,8,1490,0.0,1976,2440,9600,16868 days 16:47:18.664879,021,1.7142857142857142,0.0,-950,-107,1490.0
650000.0,4,2.5,2530,6500,1.5,3,8,1720,810.0,1975,2150,5280,17233 days 16:47:18.664879,195,1.6,2.123456790123457,380,1220,910.0
740000.0,6,2.25,3140,10250,1.0,4,8,1570,1570.0,1959,2320,10250,23077 days 16:47:18.664879,238,2.6666666666666665,1.0,820,0,0.0
320000.0,3,2.0,1820,17600,1.0,5,7,1820,0.0,1972,2190,17440,18329 days 16:47:18.664879,238,1.5,0.0,-370,160,1820.0
455000.0,4,2.5,1770,13168,2.0,3,7,1770,0.0,1990,2050,14859,11754 days 16:47:18.664879,128,1.6,0.0,-280,-1691,1770.0
2450000.0,5,4.0,4430,9000,2.0,3,1,4430,0.0,2013,2470,9490,3353 days 16:47:18.664879,133,1.25,0.0,1960,-490,4430.0
500000.0,3,3.25,1490,902,3.0,3,8,1220,270.0,2001,1550,1092,7736 days 16:47:18.664879,337,0.9230769230769231,4.518518518518518,-60,-190,950.0
325000.0,3,1.75,1790,27427,1.0,3,7,1130,660.0,1978,1610,16684,16137 days 16:47:18.664879,162,1.7142857142857142,1.7121212121212122,180,10743,470.0
416000.0,3,2.5,1710,1296,3.0,3,8,1510,200.0,2004,1610,1282,6641 days 16:47:18.664879,255,1.2,7.55,100,14,1310.0
495000.0,4,2.25,2070,20280,2.0,4,7,2070,0.0,1968,2190,21560,19790 days 16:47:18.664879,077,1.7777777777777777,0.0,-120,-1280,2070.0
549000.0,2,1.0,1140,5400,1.0,5,7,1140,0.0,1908,1520,4800,41705 days 16:47:18.664879,125,2.0,0.0,-380,600,1140.0
589000.0,5,2.0,3930,10150,1.5,4,8,3070,860.0,1968,2200,8190,19790 days 16:47:18.664879,237,2.5,3.5697674418604652,1730,1960,2210.0
194820.0,3,1.5,1100,32700,1.0,3,7,1100,0.0,1967,1616,32700,20155 days 16:47:18.664879,325,2.0,0.0,-516,0,1100.0
405000.0,3,2.5,2260,5500,1.5,3,7,1280,980.0,1910,1790,5355,40974 days 16:47:18.664879,350,1.2,1.3061224489795917,470,145,300.0
625000.0,3,2.5,2260,5500,1.5,3,7,1280,980.0,1910,1790,5355,40974 days 16:47:18.664879,098,1.2,1.3061224489795917,470,145,300.0
205000.0,3,1.0,1130,7014,1.0,3,7,1130,0.0,1954,1440,9350,24903 days 16:47:18.664879,317,3.0,0.0,-310,-2336,1130.0
345100.0,3,3.75,1950,8625,1.0,3,8,1360,590.0,1959,1950,6670,23077 days 16:47:18.664879,174,0.8,2.305084745762712,0,1955,770.0
200000.0,3,1.0,960,7500,1.0,3,6,960,0.0,1953,1250,6000,25268 days 16:47:18.664879,293,3.0,0.0,-290,1500,960.0
1910000.0,4,3.5,4210,18564,2.0,3,1,4210,0.0,2001,3520,18564,7736 days 16:47:18.664879,043,1.1428571428571428,0.0,690,0,4210.0
524500.0,3,1.5,3430,264844,1.0,3,7,2230,1200.0,1988,1660,145926,12485 days 16:47:18.664879,302,2.0,1.8583333333333334,1770,118918,1030.0
598600.0,4,2.75,3470,212639,2.0,3,7,2070,1400.0,1993,2370,233917,10658 days 16:47:18.664879,238,1.4545454545454546,1.4785714285714286,1100,-21278,670.0
367777.0,5,3.0,2140,5937,1.0,3,7,1280,860.0,1978,1820,6710,16137 days 16:47:18.664879,343,1.6666666666666667,1.4883720930232558,320,-773,420.0
750000.0,3,2.75,2520,5401,1.0,4,7,1360,1160.0,1946,1800,5036,27825 days 16:47:18.664879,127,1.0909090909090908,1.1724137931034482,720,365,200.0
575000.0,5,2.25,3550,7992,2.0,3,8,3550,0.0,1968,2110,7992,19790 days 16:47:18.664879,309,2.2222222222222223,0.0,1440,0,3550.0
84000.0,2,1.0,700,20130,1.0,3,6,700,0.0,1949,1490,18630,26729 days 16:47:18.664879,120,2.0,0.0,-790,1500,700.0
255000.0,2,1.0,740,5000,1.0,4,6,740,0.0,1926,1170,4968,35130 days 16:47:18.664879,352,2.0,0.0,-430,32,740.0
1740000.0,4,3.75,3300,4545,1.5,3,1,2600,700.0,1926,3300,5000,35130 days 16:47:18.664879,140,1.0666666666666667,3.7142857142857144,0,-455,1900.0
415000.0,3,2.25,1640,5880,1.0,3,7,1240,400.0,1977,1200,4760,16502 days 16:47:18.664879,133,1.3333333333333333,3.1,440,1120,840.0
449900.0,3,2.5,2780,8225,2.0,3,9,2780,0.0,1990,720,9736,11754 days 16:47:18.664879,127,1.2,0.0,2060,-1511,2780.0
220000.0,5,1.5,1830,94960,1.5,3,7,1830,0.0,1929,1440,16365,34034 days 16:47:18.664879,262,3.3333333333333335,0.0,390,78595,1830.0
899000.0,4,2.5,3540,9349,2.0,3,1,3540,0.0,2003,3280,7546,7006 days 16:47:18.664879,100,1.6,0.0,260,1803,3540.0
430000.0,3,2.5,1440,7320,1.0,5,7,1440,0.0,1954,1160,6941,24903 days 16:47:18.664879,195,1.2,0.0,280,379,1440.0
472500.0,4,2.5,2960,223462,2.0,3,1,2960,0.0,2001,2770,16482,7736 days 16:47:18.664879,030,1.6,0.0,190,206980,2960.0
680000.0,6,2.5,3180,9375,1.0,4,8,1590,1590.0,1967,2670,9625,20155 days 16:47:18.664879,363,2.4,1.0,510,-250,0.0
1650000.0,5,4.0,3310,8400,2.0,3,1,3310,0.0,2000,3430,8400,8102 days 16:47:18.664879,064,1.25,0.0,-120,0,3310.0
810000.0,3,2.0,2390,8025,2.0,5,7,2390,0.0,1921,1920,5350,36956 days 16:47:18.664879,322,1.5,0.0,470,2675,2390.0
605000.0,3,2.5,2460,138085,2.0,4,9,2460,0.0,1977,2090,219542,16502 days 16:47:18.664879,064,1.2,0.0,370,-81457,2460.0
522000.0,3,1.75,1630,15600,1.0,3,7,1630,0.0,1958,1830,10850,23442 days 16:47:18.664879,206,1.7142857142857142,0.0,-200,4750,1630.0
759000.0,5,2.75,3490,8230,2.0,3,1,3490,0.0,2005,3480,7331,6275 days 16:47:18.664879,034,1.8181818181818181,0.0,10,899,3490.0
411000.0,4,2.75,2500,5257,2.0,3,8,2500,0.0,1966,1660,5970,20520 days 16:47:18.664879,139,1.4545454545454546,0.0,840,-713,2500.0
286950.0,4,2.5,2080,9846,1.0,3,7,1240,840.0,1984,1890,7977,13946 days 16:47:18.664879,065,1.6,1.4761904761904763,190,1869,400.0
440000.0,3,1.5,1290,1286,3.0,3,7,1290,0.0,2000,1720,1286,8102 days 16:47:18.664879,161,2.0,0.0,-430,0,1290.0
149000.0,3,1.0,1700,8645,1.0,3,6,1700,0.0,1955,1500,7980,24538 days 16:47:18.664879,143,3.0,0.0,200,665,1700.0
284700.0,3,1.0,1700,8645,1.0,3,6,1700,0.0,1955,1500,7980,24538 days 16:47:18.664879,316,3.0,0.0,200,665,1700.0
374950.0,3,2.5,2540,11562,1.0,3,8,1290,1250.0,1964,2230,10310,21251 days 16:47:18.664879,252,1.2,1.032,310,1252,40.0
816000.0,3,1.5,1180,8545,1.0,3,8,1180,0.0,1952,1660,9000,25634 days 16:47:18.664879,259,2.0,0.0,-480,-455,1180.0
533250.0,4,1.75,1520,15398,1.0,4,7,1370,150.0,1960,1840,12500,22712 days 16:47:18.664879,325,2.2857142857142856,9.133333333333333,-320,2898,1220.0
689800.0,3,2.75,2390,9313,1.0,5,8,1390,1000.0,1942,2390,12712,29286 days 16:47:18.664879,154,1.0909090909090908,1.39,0,-3399,390.0
775000.0,4,2.75,2740,6200,1.5,4,8,1820,920.0,1947,2430,6000,27460 days 16:47:18.664879,225,1.4545454545454546,1.9782608695652173,310,200,900.0
702000.0,3,2.5,2190,8528,1.0,3,8,1760,430.0,1991,2060,9811,11389 days 16:47:18.664879,126,1.2,4.093023255813954,130,-1283,1330.0
160000.0,3,1.0,1350,8700,1.5,3,6,1350,0.0,1942,1300,8700,29286 days 16:47:18.664879,189,3.0,0.0,50,0,1350.0
255500.0,3,1.0,1350,8700,1.5,3,6,1350,0.0,1942,1300,8700,29286 days 16:47:18.664879,068,3.0,0.0,50,0,1350.0
949000.0,4,2.75,2980,42253,1.0,4,9,1860,1120.0,1973,2980,42253,17963 days 16:47:18.664879,336,1.4545454545454546,1.6607142857142858,0,0,740.0
169500.0,2,1.0,790,7450,1.0,4,6,790,0.0,1944,800,7450,28556 days 16:47:18.664879,212,2.0,0.0,-10,0,790.0
586000.0,4,2.25,2130,9000,2.0,4,8,2130,0.0,1965,2110,10431,20885 days 16:47:18.664879,258,1.7777777777777777,0.0,20,-1431,2130.0
680000.0,4,2.5,2700,37431,1.0,4,8,1600,1100.0,1978,2290,37431,16137 days 16:47:18.664879,034,1.6,1.4545454545454546,410,0,500.0
851500.0,3,2.0,3200,18184,1.0,5,8,2000,1200.0,1977,1670,7416,16502 days 16:47:18.664879,342,1.5,1.6666666666666667,1530,10768,800.0
582500.0,2,1.5,1159,4800,1.0,3,7,1159,0.0,1948,1640,4800,27095 days 16:47:18.664879,134,1.3333333333333333,0.0,-481,0,1159.0
637000.0,4,3.5,3080,118918,2.0,3,9,3080,0.0,2008,1830,434728,5180 days 16:47:18.664879,238,1.1428571428571428,0.0,1250,-315810,3080.0
225000.0,3,1.0,1000,9295,1.0,3,7,1000,0.0,1955,1320,13500,24538 days 16:47:18.664879,028,3.0,0.0,-320,-4205,1000.0
795000.0,3,3.25,2260,3727,2.0,3,8,1880,380.0,2003,1600,4800,7006 days 16:47:18.664879,365,0.9230769230769231,4.947368421052632,660,-1073,1500.0
304999.0,4,2.25,2270,9600,1.0,3,7,1290,980.0,1976,1930,15000,16868 days 16:47:18.664879,230,1.7777777777777777,1.316326530612245,340,-5400,310.0
95000.0,1,0.75,760,5746,1.0,4,5,760,0.0,1915,970,6696,39148 days 16:47:18.664879,125,1.3333333333333333,0.0,-210,-950,760.0
240000.0,4,1.75,1420,5382,1.0,5,5,1040,380.0,1942,1150,5382,29286 days 16:47:18.664879,289,2.2857142857142856,2.736842105263158,270,0,660.0
772000.0,4,2.5,2500,8680,1.0,4,7,1250,1250.0,1958,2140,8680,23442 days 16:47:18.664879,225,1.6,1.0,360,0,0.0
430000.0,5,3.0,2500,5750,1.0,3,8,1430,1070.0,1999,1980,7130,8467 days 16:47:18.664879,339,1.6666666666666667,1.3364485981308412,520,-1380,360.0
799000.0,3,1.5,2210,6300,1.5,5,8,2210,0.0,1916,2700,6300,38783 days 16:47:18.664879,162,2.0,0.0,-490,0,2210.0
880000.0,5,2.75,3020,9187,2.0,3,9,3020,0.0,2007,2250,9675,5545 days 16:47:18.664879,107,1.8181818181818181,0.0,770,-488,3020.0
750000.0,4,2.5,3290,7538,2.0,3,9,3290,0.0,2004,3450,7538,6641 days 16:47:18.664879,342,1.6,0.0,-160,0,3290.0
2890000.0,4,4.0,5780,7173,2.0,3,1,4130,1650.0,2008,3930,7994,5180 days 16:47:18.664879,353,1.0,2.503030303030303,1850,-821,2480.0
532000.0,3,2.5,1820,4910,2.0,3,8,1820,0.0,1993,2090,6668,10658 days 16:47:18.664879,155,1.2,0.0,-270,-1758,1820.0
525000.0,4,2.75,2500,10330,1.0,4,8,1380,1120.0,1978,2270,10430,16137 days 16:47:18.664879,217,1.4545454545454546,1.2321428571428572,230,-100,260.0
239000.0,2,1.0,1210,9375,1.0,4,7,1210,0.0,1952,1680,8400,25634 days 16:47:18.664879,321,2.0,0.0,-470,975,1210.0
460000.0,2,1.5,1090,4000,1.0,3,8,970,120.0,1951,1700,4000,25999 days 16:47:18.664879,167,1.3333333333333333,8.083333333333334,-610,0,850.0
540000.0,4,2.25,1330,8400,1.5,3,8,1330,0.0,1962,2270,10146,21981 days 16:47:18.664879,156,1.7777777777777777,0.0,-940,-1746,1330.0
475000.0,2,1.0,890,4590,1.0,3,7,890,0.0,1923,1310,4590,36226 days 16:47:18.664879,157,2.0,0.0,-420,0,890.0
445000.0,3,1.75,1360,4998,1.0,3,8,1360,0.0,1968,1350,4998,19790 days 16:47:18.664879,111,1.7142857142857142,0.0,10,0,1360.0
1580000.0,5,3.75,4220,9240,2.0,5,1,3420,800.0,1991,3380,9240,11389 days 16:47:18.664879,248,1.3333333333333333,4.275,840,0,2620.0
549950.0,4,2.5,3780,6800,2.0,3,8,3780,0.0,2004,3640,7326,6641 days 16:47:18.664879,099,1.6,0.0,140,-526,3780.0
294950.0,4,2.0,2610,14321,1.5,4,6,1690,920.0,1940,1630,8599,30017 days 16:47:18.664879,290,2.0,1.8369565217391304,980,5722,770.0
736000.0,3,2.5,1980,2975,3.0,3,8,1980,0.0,1993,1980,3144,10658 days 16:47:18.664879,294,1.2,0.0,0,-169,1980.0
214946.0,3,1.75,1290,8688,1.0,4,7,1290,0.0,1980,1750,9090,15407 days 16:47:18.664879,120,1.7142857142857142,0.0,-460,-402,1290.0
856000.0,5,3.25,3620,5500,2.0,3,9,3620,0.0,2003,3260,5500,7006 days 16:47:18.664879,303,1.5384615384615385,0.0,360,0,3620.0
775000.0,2,2.5,2680,7392,1.0,3,9,2680,0.0,2004,2315,7045,6641 days 16:47:18.664879,124,0.8,0.0,365,347,2680.0
205000.0,3,1.75,1200,8631,1.0,3,7,1200,0.0,1959,1564,8115,23077 days 16:47:18.664879,034,1.7142857142857142,0.0,-364,516,1200.0
429592.0,2,2.75,1992,10946,1.5,5,6,1288,704.0,1903,1110,8328,43531 days 16:47:18.664879,274,0.7272727272727273,1.8295454545454546,882,2618,584.0
414250.0,4,1.75,1640,13566,1.0,4,7,1120,520.0,1977,1470,13530,16502 days 16:47:18.664879,037,2.2857142857142856,2.1538461538461537,170,36,600.0
399950.0,4,2.75,1920,4400,1.0,4,6,960,960.0,1906,1040,4400,42435 days 16:47:18.664879,033,1.4545454545454546,1.0,880,0,0.0
319990.0,3,2.25,1840,7326,1.0,5,7,1370,470.0,1979,2050,7475,15772 days 16:47:18.664879,287,1.3333333333333333,2.9148936170212765,-210,-149,900.0
524000.0,3,1.5,1310,9471,1.0,4,8,1310,0.0,1970,2100,9449,19059 days 16:47:18.664879,009,2.0,0.0,-790,22,1310.0
349950.0,2,1.0,1050,6317,1.5,4,7,1050,0.0,1913,1600,9616,39878 days 16:47:18.664879,008,2.0,0.0,-550,-3299,1050.0
889000.0,4,2.5,2570,4480,1.5,4,8,1580,990.0,1927,2070,4480,34765 days 16:47:18.664879,304,1.6,1.595959595959596,500,0,590.0
300000.0,3,1.0,930,5160,1.5,5,6,930,0.0,1919,1060,5160,37687 days 16:47:18.664879,188,3.0,0.0,-130,0,930.0
395000.0,1,1.0,730,3000,1.0,3,7,730,0.0,1911,1520,5000,40609 days 16:47:18.664879,153,1.0,0.0,-790,-2000,730.0
348000.0,2,2.5,1270,1242,3.0,3,7,1270,0.0,2008,1280,1199,5180 days 16:47:18.664879,034,0.8,0.0,-10,43,1270.0
830000.0,2,1.0,1150,6000,1.0,4,7,710,440.0,1921,2450,7200,36956 days 16:47:18.665876,057,2.0,1.6136363636363635,-1300,-1200,270.0
173000.0,2,1.0,820,10450,1.0,4,7,820,0.0,1965,1240,11200,20885 days 16:47:18.665876,163,2.0,0.0,-420,-750,820.0
585000.0,4,1.75,3000,42200,1.0,3,7,1500,1500.0,1950,2500,9821,26364 days 16:47:18.665876,142,2.2857142857142856,1.0,500,32379,0.0
576750.0,3,2.0,2220,5000,1.0,4,7,1110,1110.0,1966,1450,5000,20520 days 16:47:18.665876,044,1.5,1.0,770,0,0.0
495000.0,5,3.25,2500,7620,1.0,3,7,1250,1250.0,1962,2020,7620,21981 days 16:47:18.665876,124,1.5384615384615385,1.0,480,0,0.0
216650.0,3,3.5,1540,1427,2.0,3,7,1360,180.0,2007,1220,4000,5545 days 16:47:18.665876,288,0.8571428571428571,7.555555555555555,320,-2573,1180.0
615000.0,4,2.75,2750,15450,1.0,3,8,1800,950.0,1978,2750,10620,16137 days 16:47:18.665876,103,1.4545454545454546,1.894736842105263,0,4830,850.0
675000.0,4,2.5,3130,12463,1.0,4,8,1620,1510.0,1978,2740,11779,16137 days 16:47:18.665876,297,1.6,1.0728476821192052,390,684,110.0
510000.0,3,2.0,1430,9250,1.0,4,8,990,440.0,1983,1830,8003,14311 days 16:47:18.665876,091,1.5,2.25,-400,1247,550.0
630000.0,3,2.5,2680,327135,2.0,3,8,2680,0.0,1995,2020,60080,9928 days 16:47:18.665876,127,1.2,0.0,660,267055,2680.0
359950.0,4,2.5,3010,5701,2.0,3,8,3010,0.0,2003,3010,5772,7006 days 16:47:18.665876,213,1.6,0.0,0,-71,3010.0
265000.0,3,1.5,1530,7500,1.5,3,7,1530,0.0,1986,2080,11250,13215 days 16:47:18.665876,276,2.0,0.0,-550,-3750,1530.0
210000.0,3,1.0,1240,4842,1.0,4,6,1240,0.0,1916,1540,5110,38783 days 16:47:18.665876,141,3.0,0.0,-300,-268,1240.0
367000.0,3,2.5,2260,93218,1.0,4,6,2260,0.0,1998,2180,111078,8832 days 16:47:18.665876,084,1.2,0.0,80,-17860,2260.0
1080000.0,4,2.25,2820,5000,1.5,4,9,1800,1020.0,1926,2880,6000,35130 days 16:47:18.665876,103,1.7777777777777777,1.7647058823529411,-60,-1000,780.0
756000.0,3,2.5,3560,8297,1.0,4,8,1650,1910.0,1948,2760,8297,27095 days 16:47:18.665876,042,1.2,0.8638743455497382,800,0,-260.0
203000.0,3,2.25,1630,9145,1.0,3,7,1630,0.0,1960,1630,9206,22712 days 16:47:18.665876,205,1.3333333333333333,0.0,0,-61,1630.0
535000.0,4,2.5,2880,23994,2.0,3,9,2880,0.0,2002,2470,17009,7371 days 16:47:18.665876,021,1.6,0.0,410,6985,2880.0
525000.0,3,3.25,2200,7440,2.0,4,7,1710,490.0,1947,1260,6765,27460 days 16:47:18.665876,082,0.9230769230769231,3.489795918367347,940,675,1220.0
347500.0,3,1.75,1620,7500,1.0,3,7,1220,400.0,1981,1470,7938,15041 days 16:47:18.665876,068,1.7142857142857142,3.05,150,-438,820.0
620000.0,3,1.75,1480,2185,2.5,3,9,1480,0.0,2005,1480,2441,6275 days 16:47:18.665876,125,1.7142857142857142,0.0,0,-256,1480.0
645000.0,4,2.5,2250,10696,2.0,3,8,2250,0.0,1996,2340,13286,9563 days 16:47:18.665876,112,1.6,0.0,-90,-2590,2250.0
280000.0,3,2.0,1790,42399,1.0,4,7,1790,0.0,1990,1330,40015,11754 days 16:47:18.665876,170,1.5,0.0,460,2384,1790.0
432000.0,3,2.0,1400,6380,1.0,4,7,700,700.0,1924,1690,5800,35861 days 16:47:18.665876,121,1.5,1.0,-290,580,0.0
790000.0,3,1.5,2390,4452,2.0,3,9,1790,600.0,1929,2610,5000,34034 days 16:47:18.665876,356,2.0,2.9833333333333334,-220,-548,1190.0
635000.0,4,1.75,2400,10050,1.0,5,8,2400,0.0,1957,1680,10050,23807 days 16:47:18.665876,013,2.2857142857142856,0.0,720,0,2400.0
442000.0,3,1.5,2050,6384,1.0,3,7,1350,700.0,1958,1590,7214,23442 days 16:47:18.665876,231,2.0,1.9285714285714286,460,-830,650.0
490000.0,4,3.0,2640,5267,2.0,3,7,2640,0.0,2001,2640,5670,7736 days 16:47:18.665876,112,1.3333333333333333,0.0,0,-403,2640.0
250000.0,5,1.75,2320,7700,1.0,5,7,1290,1030.0,1962,1740,7210,21981 days 16:47:18.665876,268,2.857142857142857,1.2524271844660195,580,490,260.0
1330000.0,4,2.5,2440,3600,2.5,4,8,2440,0.0,1902,2440,5440,43896 days 16:47:18.665876,170,1.6,0.0,0,-1840,2440.0
120000.0,3,1.0,1260,7500,1.0,3,6,1260,0.0,1954,1260,7500,24903 days 16:47:18.665876,300,3.0,0.0,0,0,1260.0
2950000.0,5,4.75,6240,47480,1.0,3,1,4610,1630.0,2003,4170,17668,7006 days 16:47:18.665876,261,1.0526315789473684,2.8282208588957056,2070,29812,2980.0
325000.0,4,2.5,1930,8458,2.0,3,7,1930,0.0,1993,1670,9485,10658 days 16:47:18.665876,266,1.6,0.0,260,-1027,1930.0
210000.0,4,1.75,1200,7680,1.0,3,7,1200,0.0,1968,1490,7800,19790 days 16:47:18.665876,163,2.2857142857142856,0.0,-290,-120,1200.0
215000.0,1,1.0,970,7639,1.0,4,5,570,400.0,1920,1360,7380,37322 days 16:47:18.665876,124,1.0,1.425,-390,259,170.0
387000.0,3,1.75,1810,10800,1.0,5,8,1210,600.0,1968,1800,10800,19790 days 16:47:18.665876,302,1.7142857142857142,2.0166666666666666,10,0,610.0
408000.0,3,1.0,1380,7015,1.5,4,7,1380,0.0,1925,1160,6700,35495 days 16:47:18.665876,261,3.0,0.0,220,315,1380.0
410000.0,3,1.0,1470,6500,1.0,4,7,1470,0.0,1953,1470,9300,25268 days 16:47:18.665876,191,3.0,0.0,0,-2800,1470.0
216000.0,3,1.0,1010,7920,1.0,3,6,1010,0.0,1925,1520,7560,35495 days 16:47:18.665876,350,3.0,0.0,-510,360,1010.0
390000.0,3,1.0,1010,7920,1.0,3,6,1010,0.0,1925,1520,7560,35495 days 16:47:18.665876,089,3.0,0.0,-510,360,1010.0
357000.0,3,1.5,1340,11744,1.0,2,7,1340,0.0,1950,2020,13673,26364 days 16:47:18.665876,345,2.0,0.0,-680,-1929,1340.0
215000.0,3,1.0,970,7275,1.0,4,7,970,0.0,1970,1750,7200,19059 days 16:47:18.665876,139,3.0,0.0,-780,75,970.0
265000.0,3,1.0,1122,6554,1.5,3,5,1122,0.0,1900,1610,5650,44626 days 16:47:18.665876,044,3.0,0.0,-488,904,1122.0
589950.0,3,2.75,1670,1350,3.0,3,9,1350,320.0,2014,1520,4800,2988 days 16:47:18.665876,343,1.0909090909090908,4.21875,150,-3450,1030.0
440000.0,3,1.75,2840,16851,1.0,3,8,1600,1240.0,1950,2650,11063,26364 days 16:47:18.665876,037,1.7142857142857142,1.2903225806451613,190,5788,360.0
248000.0,2,1.0,770,8600,1.0,4,4,770,0.0,1914,1420,6960,39513 days 16:47:18.665876,119,2.0,0.0,-650,1640,770.0
730000.0,3,2.25,2040,130680,2.0,3,9,2040,0.0,1977,3080,39630,16502 days 16:47:18.665876,254,1.3333333333333333,0.0,-1040,91050,2040.0
425000.0,4,2.5,3052,12145,2.0,3,8,3052,0.0,2004,2767,8604,6641 days 16:47:18.665876,019,1.6,0.0,285,3541,3052.0
680000.0,3,2.5,2620,14248,2.0,4,8,1830,790.0,1977,2620,12343,16502 days 16:47:18.665876,255,1.2,2.3164556962025316,0,1905,1040.0
341500.0,5,2.25,3120,10400,2.0,3,8,3120,0.0,1980,2160,8267,15407 days 16:47:18.665876,049,2.2222222222222223,0.0,960,2133,3120.0
395000.0,2,1.0,1100,3975,1.0,3,7,900,200.0,1950,1110,4280,26364 days 16:47:18.665876,128,2.0,4.5,-10,-305,700.0
1230000.0,4,2.75,3410,95396,1.5,4,1,3410,0.0,1962,3721,35352,21981 days 16:47:18.665876,212,1.4545454545454546,0.0,-311,60044,3410.0
695500.0,5,2.75,2510,9180,1.0,4,8,1600,910.0,1975,2650,9780,17233 days 16:47:18.665876,189,1.8181818181818181,1.7582417582417582,-140,-600,690.0
308000.0,3,1.75,1680,8629,1.0,3,8,1200,480.0,1977,1990,8400,16502 days 16:47:18.665876,275,1.7142857142857142,2.5,-310,229,720.0
422500.0,3,2.0,1960,6450,1.0,4,7,1000,960.0,1977,1660,20720,16502 days 16:47:18.665876,049,1.5,1.0416666666666667,300,-14270,40.0
418000.0,2,1.0,1040,6900,1.0,4,7,1040,0.0,1915,1620,6280,39148 days 16:47:18.665876,111,2.0,0.0,-580,620,1040.0
385000.0,5,1.5,1750,9780,1.5,4,7,1750,0.0,1961,1750,10295,22346 days 16:47:18.665876,280,3.3333333333333335,0.0,0,-515,1750.0
876650.0,3,3.25,2170,12508,1.5,5,9,1650,520.0,1928,2720,21070,34400 days 16:47:18.665876,132,0.9230769230769231,3.173076923076923,-550,-8562,1130.0
450000.0,3,2.5,1639,2710,2.0,3,8,1479,160.0,2003,1580,1733,7006 days 16:47:18.665876,233,1.2,9.24375,59,977,1319.0
418800.0,4,2.25,2100,9984,1.0,4,7,1290,810.0,1973,1930,10511,17963 days 16:47:18.665876,176,1.7777777777777777,1.5925925925925926,170,-527,480.0
330000.0,2,1.0,880,1753,2.0,4,7,880,0.0,1945,1010,1748,28190 days 16:47:18.665876,281,2.0,0.0,-130,5,880.0
550000.0,3,1.75,1940,8376,1.0,4,8,1290,650.0,1963,2400,8674,21616 days 16:47:18.665876,106,1.7142857142857142,1.9846153846153847,-460,-298,640.0
270000.0,4,2.5,2490,11650,1.0,3,7,1390,1100.0,1990,2010,10495,11754 days 16:47:18.665876,303,1.6,1.2636363636363637,480,1155,290.0
978500.0,3,2.25,2060,7080,2.0,3,9,1800,260.0,1940,3070,7500,30017 days 16:47:18.665876,119,1.3333333333333333,6.923076923076923,-1010,-420,1540.0
975000.0,4,2.5,2720,10455,2.0,3,1,2500,220.0,1981,3240,12348,15041 days 16:47:18.665876,273,1.6,11.363636363636363,-520,-1893,2280.0
455000.0,3,2.25,2180,6850,1.0,3,7,1750,430.0,1973,1740,7016,17963 days 16:47:18.665876,206,1.3333333333333333,4.069767441860465,440,-166,1320.0
1420000.0,4,3.25,3600,38016,2.0,3,1,3310,290.0,1991,2440,22693,11389 days 16:47:18.665876,282,1.2307692307692308,11.413793103448276,1160,15323,3020.0
220000.0,2,1.0,840,9000,1.0,5,6,840,0.0,1951,1350,10400,25999 days 16:47:18.665876,096,2.0,0.0,-510,-1400,840.0
490000.0,3,2.0,2370,12196,2.0,4,7,2370,0.0,1970,1380,12196,19059 days 16:47:18.665876,225,1.5,0.0,990,0,2370.0
420000.0,4,2.25,2270,9100,2.0,3,7,2270,0.0,1978,1710,7910,16137 days 16:47:18.665876,111,1.7777777777777777,0.0,560,1190,2270.0
408500.0,4,2.5,2720,7043,2.0,3,9,2720,0.0,2003,2640,6958,7006 days 16:47:18.665876,342,1.6,0.0,80,85,2720.0
716000.0,3,1.5,1140,4800,1.5,3,7,1140,0.0,1915,1260,4800,39148 days 16:47:18.665876,086,2.0,0.0,-120,0,1140.0
965000.0,4,2.5,2460,5000,2.0,5,8,1620,840.0,1938,2320,5000,30747 days 16:47:18.665876,153,1.6,1.9285714285714286,140,0,780.0
357823.0,3,1.5,1240,9196,1.0,3,8,1240,0.0,1968,1690,10800,19790 days 16:47:18.665876,013,2.0,0.0,-450,-1604,1240.0
7060000.0,5,4.5,10040,37325,2.0,3,1,7680,2360.0,1940,3930,25449,30017 days 16:47:18.665876,162,1.1111111111111112,3.2542372881355934,6110,11876,5320.0
425000.0,3,2.25,1670,9500,1.0,3,7,1170,500.0,1977,1470,9500,16502 days 16:47:18.665876,217,1.3333333333333333,2.34,200,0,670.0
711777.0,4,1.75,2220,6731,1.0,4,7,1110,1110.0,1953,1600,6350,25268 days 16:47:18.665876,106,2.2857142857142856,1.0,620,381,0.0
825000.0,4,1.5,1890,6938,1.5,3,8,1890,0.0,1919,1700,6250,37687 days 16:47:18.665876,167,2.6666666666666665,0.0,190,688,1890.0
210000.0,2,1.0,1100,6000,1.5,4,6,1100,0.0,1900,1280,6000,44626 days 16:47:18.665876,121,2.0,0.0,-180,0,1100.0
575000.0,2,1.75,2770,19700,2.0,3,8,1780,990.0,1983,2360,9700,14311 days 16:47:18.665876,223,1.1428571428571428,1.797979797979798,410,10000,790.0
1210000.0,4,2.75,4250,10925,2.0,3,1,4250,0.0,2003,4650,11544,7006 days 16:47:18.665876,094,1.4545454545454546,0.0,-400,-619,4250.0
431500.0,2,2.0,1370,4866,1.0,3,8,1370,0.0,2005,1365,4784,6275 days 16:47:18.665876,213,1.0,0.0,5,82,1370.0
475000.0,3,1.5,1480,13457,1.0,3,7,1480,0.0,1959,2100,10517,23077 days 16:47:18.665876,246,2.0,0.0,-620,2940,1480.0
1500000.0,4,3.75,3770,4000,2.5,5,9,2890,880.0,1916,2800,5000,38783 days 16:47:18.665876,330,1.0666666666666667,3.284090909090909,970,-1000,2010.0
540000.0,6,3.0,2870,206474,2.0,3,7,2330,540.0,1960,2380,59677,22712 days 16:47:18.665876,357,2.0,4.314814814814815,490,146797,1790.0
775000.0,3,2.5,3820,35016,2.0,4,9,3820,0.0,1987,3010,35190,12850 days 16:47:18.665876,344,1.2,0.0,810,-174,3820.0
635000.0,3,2.5,1530,2978,1.0,3,7,1210,320.0,1997,1640,5100,9197 days 16:47:18.665876,197,1.2,3.78125,-110,-2122,890.0
1300000.0,3,2.75,4120,16365,1.0,3,1,4120,0.0,1999,4020,14110,8467 days 16:47:18.665876,097,1.0909090909090908,0.0,100,2255,4120.0
405000.0,3,2.25,1590,7267,1.0,4,7,1100,490.0,1976,2060,8336,16868 days 16:47:18.665876,213,1.3333333333333333,2.2448979591836733,-470,-1069,610.0
210000.0,3,1.0,1520,8600,1.0,3,6,1040,480.0,1951,1320,8600,25999 days 16:47:18.665876,202,3.0,2.1666666666666665,200,0,560.0
880000.0,4,2.5,2350,4675,2.0,3,9,2150,200.0,1923,2240,3848,36226 days 16:47:18.665876,124,1.6,10.75,110,827,1950.0
239000.0,4,2.0,1370,8837,1.5,3,7,1370,0.0,1955,1360,9000,24538 days 16:47:18.665876,297,2.0,0.0,10,-163,1370.0
515000.0,3,2.5,1540,6100,1.0,3,6,770,770.0,1944,1710,5950,28556 days 16:47:18.665876,195,1.2,1.0,-170,150,0.0
1380000.0,3,3.25,3786,38038,1.0,3,9,1934,1852.0,1978,2850,33361,16137 days 16:47:18.665876,204,0.9230769230769231,1.0442764578833694,936,4677,82.0
215000.0,4,2.25,1500,5393,2.0,3,7,1500,0.0,1999,1500,5952,8467 days 16:47:18.665876,203,1.7777777777777777,0.0,0,-559,1500.0
315000.0,6,2.0,1750,17685,1.0,4,5,1750,0.0,1943,1750,9209,28921 days 16:47:18.665876,099,3.0,0.0,0,8476,1750.0
442500.0,3,1.5,1800,8303,1.0,3,7,1200,600.0,1957,1800,8171,23807 days 16:47:18.665876,211,2.0,2.0,0,132,600.0
311000.0,2,1.75,1180,55321,1.0,3,8,1180,0.0,1941,1480,56192,29651 days 16:47:18.665876,230,1.1428571428571428,0.0,-300,-871,1180.0
425000.0,2,1.0,830,6030,1.0,4,6,830,0.0,1925,1280,6030,35495 days 16:47:18.665876,351,2.0,0.0,-450,0,830.0
433500.0,3,1.75,1540,9450,1.0,4,6,1040,500.0,1919,1200,5400,37687 days 16:47:18.665876,247,1.7142857142857142,2.08,340,4050,540.0
450000.0,3,2.25,1610,8296,2.0,3,8,1610,0.0,1978,1610,8288,16137 days 16:47:18.665876,216,1.3333333333333333,0.0,0,8,1610.0
675000.0,3,2.25,1990,10260,2.0,4,8,1990,0.0,1987,1990,10260,12850 days 16:47:18.665876,140,1.3333333333333333,0.0,0,0,1990.0
535000.0,3,2.5,2070,4132,2.0,3,8,2070,0.0,1999,1530,5606,8467 days 16:47:18.665876,175,1.2,0.0,540,-1474,2070.0
577000.0,3,1.75,1760,12874,1.0,4,7,1230,530.0,1967,1950,10240,20155 days 16:47:18.665876,164,1.7142857142857142,2.3207547169811322,-190,2634,700.0
480000.0,3,1.75,1740,8528,1.0,4,7,1290,450.0,1939,1610,8528,30382 days 16:47:18.665876,351,1.7142857142857142,2.8666666666666667,130,0,840.0
400000.0,3,1.5,1950,4473,1.0,4,6,1530,420.0,1914,2670,14256,39513 days 16:47:18.665876,012,2.0,3.642857142857143,-720,-9783,1110.0
304000.0,3,1.0,1280,8184,1.5,4,6,1280,0.0,1947,1120,8184,27460 days 16:47:18.665876,164,3.0,0.0,160,0,1280.0
355000.0,3,1.75,1460,7203,1.0,3,7,1460,0.0,1990,1570,7203,11754 days 16:47:18.665876,084,1.7142857142857142,0.0,-110,0,1460.0
998000.0,4,3.25,3770,982998,2.0,3,1,3770,0.0,1992,2290,37141,11024 days 16:47:18.665876,248,1.2307692307692308,0.0,1480,945857,3770.0
550000.0,4,1.75,2410,8447,2.0,4,8,2060,350.0,1936,2520,14789,31478 days 16:47:18.665876,226,2.2857142857142856,5.885714285714286,-110,-6342,1710.0
550000.0,4,1.75,2410,8447,2.0,4,8,2060,350.0,1936,2520,14789,31478 days 16:47:18.665876,289,2.2857142857142856,5.885714285714286,-110,-6342,1710.0
210000.0,3,1.75,1400,7300,2.0,3,6,1400,0.0,1948,1440,10825,27095 days 16:47:18.665876,233,1.7142857142857142,0.0,-40,-3525,1400.0
317000.0,3,2.5,2100,7587,2.0,3,9,2100,0.0,1990,2330,8119,11754 days 16:47:18.665876,057,1.2,0.0,-230,-532,2100.0
700000.0,4,3.5,5360,25800,1.0,3,9,3270,2090.0,1971,2650,21781,18694 days 16:47:18.665876,124,1.1428571428571428,1.5645933014354068,2710,4019,1180.0
265000.0,3,1.0,1000,9150,1.0,3,7,1000,0.0,1969,1490,10647,19424 days 16:47:18.665876,167,3.0,0.0,-490,-1497,1000.0
700000.0,4,3.5,3150,6175,2.0,3,9,3150,0.0,2001,3150,6986,7736 days 16:47:18.665876,245,1.1428571428571428,0.0,0,-811,3150.0
1020000.0,5,3.5,4180,17841,2.0,3,1,3160,1020.0,1990,3260,12608,11754 days 16:47:18.665876,251,1.4285714285714286,3.0980392156862746,920,5233,2140.0
1150000.0,4,2.25,2840,20242,1.0,3,8,2240,600.0,1972,2840,20372,18329 days 16:47:18.665876,343,1.7777777777777777,3.7333333333333334,0,-130,1640.0
460000.0,4,2.5,2110,35091,1.0,4,8,1290,820.0,1985,2740,36427,13580 days 16:47:18.665876,178,1.6,1.5731707317073171,-630,-1336,470.0
410000.0,2,1.5,1660,4000,1.0,3,7,1000,660.0,1950,1570,5500,26364 days 16:47:18.665876,267,1.3333333333333333,1.5151515151515151,90,-1500,340.0
665000.0,4,3.0,2160,4400,1.0,5,7,1320,840.0,1921,1430,4400,36956 days 16:47:18.665876,248,1.3333333333333333,1.5714285714285714,730,0,480.0
600000.0,4,2.5,2420,7744,2.0,3,9,2420,0.0,1994,2820,11129,10293 days 16:47:18.665876,104,1.6,0.0,-400,-3385,2420.0
502000.0,4,1.75,1920,3844,1.0,3,7,1170,750.0,1967,1480,3844,20155 days 16:47:18.665876,124,2.2857142857142856,1.56,440,0,420.0
364950.0,4,2.5,2310,8030,2.0,3,7,2310,0.0,1978,1780,8041,16137 days 16:47:18.665876,155,1.6,0.0,530,-11,2310.0
680000.0,3,2.25,2330,4000,1.5,5,7,1520,810.0,1927,1870,4000,34765 days 16:47:18.665876,149,1.3333333333333333,1.876543209876543,460,0,710.0
235500.0,5,2.5,2340,13713,1.0,2,8,1670,670.0,1967,2080,11000,20155 days 16:47:18.665876,189,2.0,2.4925373134328357,260,2713,1000.0
576000.0,4,2.5,2590,5756,2.0,3,8,2590,0.0,2001,2620,6109,7736 days 16:47:18.665876,202,1.6,0.0,-30,-353,2590.0
405000.0,2,3.0,1410,1240,2.0,3,8,1140,270.0,2006,1410,1273,5910 days 16:47:18.665876,125,0.6666666666666666,4.222222222222222,0,-33,870.0
335000.0,3,2.75,2850,8039,1.0,4,8,1540,1310.0,1989,2240,7727,12119 days 16:47:18.665876,197,1.0909090909090908,1.1755725190839694,610,312,230.0
122000.0,2,1.0,730,6728,1.0,3,6,730,0.0,1953,1170,7034,25268 days 16:47:18.665876,110,2.0,0.0,-440,-306,730.0
432000.0,3,1.75,1470,6250,1.0,4,7,1070,400.0,1939,2630,7050,30382 days 16:47:18.665876,157,1.7142857142857142,2.675,-1160,-800,670.0
375000.0,4,2.25,2330,11400,1.0,4,8,2330,0.0,1974,2640,10200,17598 days 16:47:18.665876,239,1.7777777777777777,0.0,-310,1200,2330.0
276000.0,4,2.25,2460,11250,1.0,4,8,2460,0.0,1959,1630,10216,23077 days 16:47:18.665876,176,1.7777777777777777,0.0,830,1034,2460.0
450000.0,3,2.25,2080,111513,1.5,3,8,1680,400.0,1977,2440,107157,16502 days 16:47:18.665876,202,1.3333333333333333,4.2,-360,4356,1280.0
210000.0,2,1.0,990,8140,1.0,1,6,990,0.0,1910,2150,5000,40974 days 16:47:18.665876,131,2.0,0.0,-1160,3140,990.0
279000.0,3,2.5,1450,4106,2.0,3,7,1450,0.0,2011,2000,4000,4084 days 16:47:18.665876,325,1.2,0.0,-550,106,1450.0
635000.0,3,1.75,1340,3900,2.0,5,7,1340,0.0,1900,1470,1611,44626 days 16:47:18.665876,054,1.7142857142857142,0.0,-130,2289,1340.0
350000.0,3,2.5,2730,7372,2.0,3,9,2730,0.0,1998,2710,8343,8832 days 16:47:18.665876,051,1.2,0.0,20,-971,2730.0
218000.0,3,1.0,1140,7560,1.0,4,6,1140,0.0,1958,1300,7560,23442 days 16:47:18.665876,267,3.0,0.0,-160,0,1140.0
750000.0,4,1.5,1950,6300,1.5,3,7,1650,300.0,1944,1760,6300,28556 days 16:47:18.665876,083,2.6666666666666665,5.5,190,0,1350.0
310597.0,4,1.75,2000,25700,1.0,4,7,1150,850.0,1958,2420,27500,23442 days 16:47:18.665876,044,2.2857142857142856,1.3529411764705883,-420,-1800,300.0
355000.0,3,1.0,900,37800,1.0,4,5,700,200.0,1923,1750,11998,36226 days 16:47:18.665876,091,3.0,3.5,-850,25802,500.0
735000.0,5,2.75,3390,5211,2.0,3,9,3390,0.0,2004,3210,5211,6641 days 16:47:18.665876,147,1.8181818181818181,0.0,180,0,3390.0
155000.0,1,1.0,720,6000,1.0,3,6,720,0.0,1940,1040,6000,30017 days 16:47:18.665876,153,1.0,0.0,-320,0,720.0
354000.0,3,1.0,940,10368,1.0,3,7,940,0.0,1965,2090,9620,20885 days 16:47:18.665876,162,3.0,0.0,-1150,748,940.0
415000.0,3,1.75,1770,10513,1.0,4,7,1400,370.0,1982,2070,9968,14676 days 16:47:18.665876,127,1.7142857142857142,3.7837837837837838,-300,545,1030.0
202000.0,1,1.0,590,833,1.0,4,7,590,0.0,1926,780,1617,35130 days 16:47:18.665876,182,1.0,0.0,-190,-784,590.0
580000.0,3,2.5,1980,1873,2.0,3,7,1470,510.0,1996,1500,1873,9563 days 16:47:18.665876,126,1.2,2.8823529411764706,480,0,960.0
1500000.0,4,3.25,3070,10375,2.0,3,1,2180,890.0,1962,2500,11194,21981 days 16:47:18.665876,295,1.2307692307692308,2.449438202247191,570,-819,1290.0
790000.0,4,2.5,3500,7519,2.0,3,9,3500,0.0,2004,3920,7982,6641 days 16:47:18.665876,281,1.6,0.0,-420,-463,3500.0
499900.0,3,2.5,2100,5112,2.0,3,8,2100,0.0,1999,2100,4370,8467 days 16:47:18.665876,064,1.2,0.0,0,742,2100.0
525000.0,4,2.25,2620,98881,1.0,3,7,1820,800.0,1952,1728,95832,25634 days 16:47:18.665876,113,1.7777777777777777,2.275,892,3049,1020.0
810000.0,4,2.5,2810,10613,2.0,3,9,2810,0.0,1989,2800,9933,12119 days 16:47:18.665876,173,1.6,0.0,10,680,2810.0
425000.0,4,1.5,2290,8773,1.0,4,7,1330,960.0,1947,1740,7058,27460 days 16:47:18.665876,051,2.6666666666666665,1.3854166666666667,550,1715,370.0
241250.0,3,1.75,1350,7588,1.0,3,7,1350,0.0,1993,1470,7341,10658 days 16:47:18.665876,360,1.7142857142857142,0.0,-120,247,1350.0
318700.0,4,2.5,2770,19116,1.0,4,8,1600,1170.0,1961,2730,18429,22346 days 16:47:18.665876,316,1.6,1.3675213675213675,40,687,430.0
720000.0,4,1.75,2530,5000,1.5,5,8,2070,460.0,1917,1950,3600,38417 days 16:47:18.665876,239,2.2857142857142856,4.5,580,1400,1610.0
291000.0,3,1.0,1280,10500,1.5,4,5,1280,0.0,1941,1410,10500,29651 days 16:47:18.665876,196,3.0,0.0,-130,0,1280.0
420000.0,3,1.75,1060,38644,1.0,3,7,1060,0.0,1983,1310,11416,14311 days 16:47:18.665876,199,1.7142857142857142,0.0,-250,27228,1060.0
210000.0,2,1.75,1000,3554,1.0,4,8,1000,0.0,1975,1150,4000,17233 days 16:47:18.665876,207,1.1428571428571428,0.0,-150,-446,1000.0
645000.0,3,3.25,3870,11000,2.0,3,9,2970,900.0,1991,2970,11000,11389 days 16:47:18.665876,117,0.9230769230769231,3.3,900,0,2070.0
762000.0,5,2.0,3370,5000,1.5,4,7,2140,1230.0,1907,1920,3200,42070 days 16:47:18.665876,139,2.5,1.7398373983739837,1450,1800,910.0
247500.0,4,1.75,2290,7765,1.0,3,6,2290,0.0,1936,1240,8215,31478 days 16:47:18.665876,205,2.2857142857142856,0.0,1050,-450,2290.0
282500.0,3,2.25,1670,7150,2.0,4,7,1670,0.0,1990,1570,7040,11754 days 16:47:18.665876,204,1.3333333333333333,0.0,100,110,1670.0
395000.0,3,1.75,1460,22651,1.0,4,7,1460,0.0,1961,2030,49222,22346 days 16:47:18.665876,156,1.7142857142857142,0.0,-570,-26571,1460.0
295000.0,3,1.75,1770,8235,1.0,3,7,1030,740.0,1960,1560,8918,22712 days 16:47:18.665876,167,1.7142857142857142,1.3918918918918919,210,-683,290.0
235000.0,2,1.0,820,5100,1.0,4,6,820,0.0,1954,2270,5100,24903 days 16:47:18.665876,238,2.0,0.0,-1450,0,820.0
770000.0,3,1.75,1900,6334,1.0,3,8,1450,450.0,1948,1530,6334,27095 days 16:47:18.665876,274,1.7142857142857142,3.2222222222222223,370,0,1000.0
559950.0,2,2.0,1870,4950,1.0,3,8,1870,0.0,2006,1670,4800,5910 days 16:47:18.665876,128,1.0,0.0,200,150,1870.0
639000.0,4,2.0,1840,5419,1.0,4,7,920,920.0,1942,1800,5419,29286 days 16:47:18.665876,191,2.0,1.0,40,0,0.0
314950.0,3,1.0,1590,8470,1.0,4,7,1140,450.0,1967,1570,9375,20155 days 16:47:18.665876,118,3.0,2.533333333333333,20,-905,690.0
2400000.0,3,2.25,3000,11665,1.5,3,1,3000,0.0,2001,3000,15959,7736 days 16:47:18.665876,129,1.3333333333333333,0.0,0,-4294,3000.0
820000.0,3,1.75,2160,6272,1.0,4,8,1390,770.0,1960,1290,5376,22712 days 16:47:18.665876,153,1.7142857142857142,1.8051948051948052,870,896,620.0
1390000.0,3,3.0,2490,3600,2.0,4,8,1790,700.0,1911,2490,3600,40609 days 16:47:18.665876,254,1.0,2.557142857142857,0,0,1090.0
521450.0,3,2.0,1290,5700,1.0,5,7,1290,0.0,1950,1160,5700,26364 days 16:47:18.665876,290,1.5,0.0,130,0,1290.0
760750.0,3,2.5,3190,49137,2.0,3,9,3190,0.0,1988,3240,53143,12485 days 16:47:18.665876,279,1.2,0.0,-50,-4006,3190.0
759600.0,4,1.0,1540,115434,1.5,4,7,1540,0.0,1923,2027,23522,36226 days 16:47:18.665876,155,4.0,0.0,-487,91912,1540.0
346150.0,3,2.0,2140,7200,1.0,4,8,1480,660.0,1966,2070,7220,20520 days 16:47:18.665876,170,1.5,2.242424242424242,70,-20,820.0
390000.0,2,1.0,980,3800,1.0,3,7,980,0.0,1926,1520,5010,35130 days 16:47:18.665876,112,2.0,0.0,-540,-1210,980.0
359950.0,5,2.25,2450,9432,2.0,3,8,2450,0.0,1973,2310,9100,17963 days 16:47:18.665876,267,2.2222222222222223,0.0,140,332,2450.0
430000.0,3,2.0,1360,5120,1.5,4,6,910,450.0,1924,1440,5120,35861 days 16:47:18.665876,154,1.5,2.022222222222222,-80,0,460.0
960000.0,4,3.5,4610,11676,2.0,3,1,4610,0.0,2000,3900,11164,8102 days 16:47:18.665876,114,1.1428571428571428,0.0,710,512,4610.0
800000.0,7,6.75,7480,41664,2.0,3,1,5080,2400.0,1953,2810,33190,25268 days 16:47:18.665876,280,1.037037037037037,2.1166666666666667,4670,8474,2680.0
1010000.0,3,2.5,2860,5805,2.0,3,9,2860,0.0,1999,2360,5832,8467 days 16:47:18.665876,008,1.2,0.0,500,-27,2860.0
290000.0,3,2.0,1810,11456,1.0,3,7,1810,0.0,1970,1360,12931,19059 days 16:47:18.665876,020,1.5,0.0,450,-1475,1810.0
1350000.0,4,2.0,2240,10296,1.0,5,8,2240,0.0,1948,2500,10918,27095 days 16:47:18.665876,076,2.0,0.0,-260,-622,2240.0
777000.0,3,3.25,3610,59677,2.0,3,1,2440,1170.0,2003,3130,65775,7006 days 16:47:18.665876,133,0.9230769230769231,2.0854700854700856,480,-6098,1270.0
526000.0,2,1.0,1450,4500,1.5,4,7,1450,0.0,1921,1470,5000,36956 days 16:47:18.665876,280,2.0,0.0,-20,-500,1450.0
550000.0,3,3.5,1450,1091,2.0,3,8,1200,250.0,2007,1490,3017,5545 days 16:47:18.665876,108,0.8571428571428571,4.8,-40,-1926,950.0
276000.0,3,1.5,1820,8750,1.0,4,7,1200,620.0,1958,1500,8000,23442 days 16:47:18.665876,357,2.0,1.935483870967742,320,750,580.0
2500000.0,5,3.25,5620,12672,2.0,4,1,4140,1480.0,1916,4470,8050,38783 days 16:47:18.665876,363,1.5384615384615385,2.7972972972972974,1150,4622,2660.0
325000.0,3,1.75,2080,6554,1.0,3,7,1040,1040.0,1950,1230,5650,26364 days 16:47:18.665876,022,1.7142857142857142,1.0,850,904,0.0
365000.0,3,2.5,1780,1754,3.0,3,8,1780,0.0,2007,1780,1607,5545 days 16:47:18.665876,269,1.2,0.0,0,147,1780.0
2150000.0,8,6.0,4340,9415,2.0,3,8,4340,0.0,1967,2050,9100,20155 days 16:47:18.665876,280,1.3333333333333333,0.0,2290,315,4340.0
825050.0,4,3.25,2860,3680,2.0,3,9,1980,880.0,1925,2010,3680,35495 days 16:47:18.665876,064,1.2307692307692308,2.25,850,0,1100.0
690000.0,3,1.5,2540,9520,1.0,3,8,1500,1040.0,1959,1870,6800,23077 days 16:47:18.665876,202,2.0,1.4423076923076923,670,2720,460.0
390000.0,4,1.0,1140,6250,1.5,3,6,1140,0.0,1958,1140,1370,23442 days 16:47:18.665876,105,4.0,0.0,0,4880,1140.0
385000.0,3,2.0,1320,1297,3.0,3,7,1320,0.0,1995,1380,1503,9928 days 16:47:18.665876,063,1.5,0.0,-60,-206,1320.0
619000.0,3,2.5,2040,7503,2.0,3,8,2040,0.0,1987,2170,7503,12850 days 16:47:18.665876,090,1.2,0.0,-130,0,2040.0
494000.0,4,2.25,1790,42000,1.0,3,7,1170,620.0,1983,2060,50094,14311 days 16:47:18.665876,084,1.7777777777777777,1.8870967741935485,-270,-8094,550.0
412450.0,3,2.0,1910,13505,1.0,3,8,1910,0.0,1955,2010,8000,24538 days 16:47:18.665876,117,1.5,0.0,-100,5505,1910.0
580000.0,3,1.75,1460,2800,2.0,3,7,1460,0.0,1928,1220,4062,34400 days 16:47:18.665876,023,1.7142857142857142,0.0,240,-1262,1460.0
269900.0,3,1.5,1420,22100,1.0,5,7,1420,0.0,1957,1540,21780,23807 days 16:47:18.665876,309,2.0,0.0,-120,320,1420.0
704300.0,4,1.5,1790,4080,1.5,5,7,1790,0.0,1928,1710,4080,34400 days 16:47:18.665876,096,2.6666666666666665,0.0,80,0,1790.0
267000.0,3,2.0,1390,6005,2.0,3,8,1390,0.0,2005,1264,5550,6275 days 16:47:18.665876,311,1.5,0.0,126,455,1390.0
310000.0,4,1.75,1880,12150,1.0,3,7,1280,600.0,1976,1980,9680,16868 days 16:47:18.665876,225,2.2857142857142856,2.1333333333333333,-100,2470,680.0
227064.0,3,1.5,1570,10824,2.0,3,7,1570,0.0,1908,1530,8125,41705 days 16:47:18.665876,023,2.0,0.0,40,2699,1570.0
925000.0,3,2.5,2690,7000,2.0,5,7,1840,850.0,1943,1800,6435,28921 days 16:47:18.665876,148,1.2,2.164705882352941,890,565,990.0
245000.0,3,1.75,1670,11452,1.0,3,8,1670,0.0,1992,1820,11152,11024 days 16:47:18.665876,128,1.7142857142857142,0.0,-150,300,1670.0
339888.0,3,1.0,1040,7490,1.0,3,7,1040,0.0,1969,1520,7410,19424 days 16:47:18.665876,348,3.0,0.0,-480,80,1040.0
439000.0,4,2.0,1560,7500,1.0,4,7,1560,0.0,1968,1730,7500,19790 days 16:47:18.665876,191,2.0,0.0,-170,0,1560.0
400000.0,2,1.0,1470,6120,1.0,2,7,1470,0.0,1940,1840,6120,30017 days 16:47:18.665876,147,2.0,0.0,-370,0,1470.0
560000.0,3,2.25,2070,15002,1.5,3,8,2070,0.0,1955,2070,15002,24538 days 16:47:18.665876,181,1.3333333333333333,0.0,0,0,2070.0
703011.0,2,1.0,1370,5922,1.0,3,8,1130,240.0,1941,2460,6759,29651 days 16:47:18.665876,274,2.0,4.708333333333333,-1090,-837,890.0
650000.0,4,2.75,2640,6240,2.0,3,9,2640,0.0,2001,2640,5898,7736 days 16:47:18.665876,262,1.4545454545454546,0.0,0,342,2640.0
299950.0,3,1.0,1030,9916,1.0,4,7,1030,0.0,1972,1470,9044,18329 days 16:47:18.665876,006,3.0,0.0,-440,872,1030.0
228950.0,3,1.0,1120,6625,1.0,3,6,1120,0.0,1942,1120,6794,29286 days 16:47:18.665876,112,3.0,0.0,0,-169,1120.0
465000.0,4,1.75,1730,11700,1.0,3,7,880,850.0,1956,1570,7820,24173 days 16:47:18.665876,274,2.2857142857142856,1.035294117647059,160,3880,30.0
725000.0,3,2.5,2090,9847,2.0,3,9,2090,0.0,1983,2860,11483,14311 days 16:47:18.665876,044,1.2,0.0,-770,-1636,2090.0
212500.0,3,1.0,920,14400,1.0,4,7,920,0.0,1977,1170,9600,16502 days 16:47:18.665876,155,3.0,0.0,-250,4800,920.0
526000.0,4,2.25,2970,54450,2.0,3,8,2970,0.0,1983,2260,6465,14311 days 16:47:18.665876,253,1.7777777777777777,0.0,710,47985,2970.0
383000.0,3,2.5,1720,10031,2.0,3,8,1720,0.0,1993,2280,5845,10658 days 16:47:18.665876,357,1.2,0.0,-560,4186,1720.0
244000.0,3,1.75,1460,4692,1.0,3,7,1460,0.0,1988,1600,4557,12485 days 16:47:18.665876,111,1.7142857142857142,0.0,-140,135,1460.0
565000.0,3,1.5,1540,3570,1.5,5,7,1490,50.0,1930,1620,4080,33669 days 16:47:18.665876,217,2.0,29.8,-80,-510,1440.0
373000.0,8,3.0,2850,12714,1.0,3,7,2850,0.0,1959,1480,4942,23077 days 16:47:18.665876,050,2.6666666666666665,0.0,1370,7772,2850.0
300000.0,3,2.0,1310,9855,1.0,3,7,1310,0.0,1962,1310,8370,21981 days 16:47:18.665876,245,1.5,0.0,0,1485,1310.0
405000.0,5,2.5,2430,4781,2.0,3,9,2430,0.0,2001,2420,4770,7736 days 16:47:18.665876,140,2.0,0.0,10,11,2430.0
979000.0,3,1.5,1700,14133,1.0,4,8,1700,0.0,1954,2630,17376,24903 days 16:47:18.665876,171,2.0,0.0,-930,-3243,1700.0
324888.0,4,1.75,2160,28750,2.0,4,8,2160,0.0,1978,1790,53578,16137 days 16:47:18.665876,320,2.2857142857142856,0.0,370,-24828,2160.0
445000.0,3,1.5,860,3200,1.0,3,6,860,0.0,1929,1220,4300,34034 days 16:47:18.665876,119,2.0,0.0,-360,-1100,860.0
761000.0,3,3.5,2050,2020,2.0,3,8,1520,530.0,2006,1230,3640,5910 days 16:47:18.665876,052,0.8571428571428571,2.8679245283018866,820,-1620,990.0
435000.0,4,2.0,1650,4745,1.0,3,7,1130,520.0,1972,1650,5184,18329 days 16:47:18.665876,117,2.0,2.173076923076923,0,-439,610.0
252000.0,3,2.25,1570,8410,1.0,3,7,1180,390.0,1991,1540,8410,11389 days 16:47:18.665876,234,1.3333333333333333,3.0256410256410255,30,0,790.0
350000.0,3,1.75,1660,10150,1.5,3,7,1660,0.0,1957,1640,8906,23807 days 16:47:18.665876,174,1.7142857142857142,0.0,20,1244,1660.0
875000.0,3,1.0,1220,8119,1.0,4,7,1220,0.0,1955,1910,8119,24538 days 16:47:18.665876,311,3.0,0.0,-690,0,1220.0
940000.0,3,1.0,1220,8119,1.0,4,7,1220,0.0,1955,1910,8119,24538 days 16:47:18.665876,041,3.0,0.0,-690,0,1220.0
280000.0,3,2.0,1780,11342,1.0,3,7,1780,0.0,1964,2140,8449,21251 days 16:47:18.665876,231,1.5,0.0,-360,2893,1780.0
450000.0,3,2.5,2180,4226,2.0,3,8,2180,0.0,2004,2540,4607,6641 days 16:47:18.665876,262,1.2,0.0,-360,-381,2180.0
905000.0,3,2.5,3520,237402,2.5,3,9,3520,0.0,2004,2310,165963,6641 days 16:47:18.665876,365,1.2,0.0,1210,71439,3520.0
382450.0,3,2.5,2220,20531,2.0,3,8,2220,0.0,1998,2420,19249,8832 days 16:47:18.665876,197,1.2,0.0,-200,1282,2220.0
246700.0,3,2.0,1610,13309,1.0,4,7,1610,0.0,1967,1610,15725,20155 days 16:47:18.665876,358,1.5,0.0,0,-2416,1610.0
220000.0,3,1.5,1070,9331,1.0,3,6,1070,0.0,1956,1480,8400,24173 days 16:47:18.665876,226,2.0,0.0,-410,931,1070.0
555750.0,3,1.0,1060,4880,1.0,2,6,910,150.0,1913,1200,4880,39878 days 16:47:18.665876,047,3.0,6.066666666666666,-140,0,760.0
262500.0,3,1.5,1160,8906,1.0,3,7,1160,0.0,1962,1160,8906,21981 days 16:47:18.665876,162,2.0,0.0,0,0,1160.0
515000.0,2,1.0,910,4725,1.0,3,7,910,0.0,1949,1600,5200,26729 days 16:47:18.665876,335,2.0,0.0,-690,-475,910.0
499500.0,3,2.5,2970,21907,2.0,3,9,2970,0.0,1998,2040,27917,8832 days 16:47:18.665876,168,1.2,0.0,930,-6010,2970.0
135000.0,1,1.0,790,13062,1.0,3,6,790,0.0,1942,1240,7137,29286 days 16:47:18.665876,155,1.0,0.0,-450,5925,790.0
462500.0,2,2.0,1540,7290,2.0,3,7,1540,0.0,1948,1540,7072,27095 days 16:47:18.665876,322,1.0,0.0,0,218,1540.0
937500.0,4,2.5,3130,21100,1.0,3,9,2530,600.0,1956,3680,23000,24173 days 16:47:18.665876,105,1.6,4.216666666666667,-550,-1900,1930.0
458000.0,3,1.5,1470,9570,1.0,3,7,1280,190.0,1941,1390,9570,29651 days 16:47:18.665876,112,2.0,6.7368421052631575,80,0,1090.0
845000.0,4,2.75,3160,7143,1.5,3,8,2100,1060.0,1933,2200,6122,32573 days 16:47:18.665876,295,1.4545454545454546,1.9811320754716981,960,1021,1040.0
660000.0,3,2.25,2675,40910,2.0,3,8,2675,0.0,1984,2300,39438,13946 days 16:47:18.665876,151,1.3333333333333333,0.0,375,1472,2675.0
265000.0,3,2.0,1340,6783,1.0,4,7,1340,0.0,1987,1630,6458,12850 days 16:47:18.665876,107,1.5,0.0,-290,325,1340.0
599999.0,9,4.5,3830,6988,2.5,3,7,2450,1380.0,1938,1460,6291,30747 days 16:47:18.665876,127,2.0,1.7753623188405796,2370,697,1070.0
280000.0,3,2.5,1800,8697,2.0,3,8,1800,0.0,1987,1770,8390,12850 days 16:47:18.665876,336,1.2,0.0,30,307,1800.0
875000.0,4,3.0,3720,14125,1.0,4,9,1930,1790.0,1960,3160,15300,22712 days 16:47:18.665876,311,1.3333333333333333,1.0782122905027933,560,-1175,140.0
125000.0,3,1.0,920,7276,1.0,4,6,920,0.0,1961,1120,7276,22346 days 16:47:18.665876,287,3.0,0.0,-200,0,920.0
634800.0,4,3.0,3280,4904,2.0,3,7,3280,0.0,2005,2600,5004,6275 days 16:47:18.665876,343,1.3333333333333333,0.0,680,-100,3280.0
269950.0,4,1.0,1440,9600,1.0,2,7,1440,0.0,1964,1740,43560,21251 days 16:47:18.665876,034,4.0,0.0,-300,-33960,1440.0
359950.0,3,2.25,1940,11612,1.0,4,8,1100,840.0,1981,2180,8954,15041 days 16:47:18.665876,171,1.3333333333333333,1.3095238095238095,-240,2658,260.0
417000.0,3,1.75,1590,11454,1.0,4,8,1590,0.0,1979,1970,9960,15772 days 16:47:18.665876,349,1.7142857142857142,0.0,-380,1494,1590.0
389000.0,2,2.0,1340,4122,1.0,3,8,1340,0.0,2007,1350,4273,5545 days 16:47:18.665876,203,1.0,0.0,-10,-151,1340.0
1040000.0,4,2.5,3770,10893,2.0,3,1,3770,0.0,1997,3710,9685,9197 days 16:47:18.665876,227,1.6,0.0,60,1208,3770.0
698000.0,6,2.5,2680,11250,1.0,5,7,1340,1340.0,1967,2200,9875,20155 days 16:47:18.665876,272,2.4,1.0,480,1375,0.0
685000.0,4,2.5,2820,10125,2.0,3,8,2820,0.0,2008,1560,10125,5180 days 16:47:18.665876,077,1.6,0.0,1260,0,2820.0
198500.0,3,1.75,1520,7137,1.0,3,5,1520,0.0,1932,1240,8602,32939 days 16:47:18.665876,309,1.7142857142857142,0.0,280,-1465,1520.0
350000.0,4,2.5,2560,5428,2.0,3,8,2560,0.0,2012,2620,5428,3719 days 16:47:18.665876,085,1.6,0.0,-60,0,2560.0
649950.0,3,2.5,3310,387684,1.0,3,8,2160,1150.0,1919,2340,189050,37687 days 16:47:18.665876,098,1.2,1.8782608695652174,970,198634,1010.0
441000.0,3,1.5,1540,7200,1.0,3,7,1540,0.0,1968,1560,7500,19790 days 16:47:18.665876,119,2.0,0.0,-20,-300,1540.0
462600.0,3,1.75,1430,11761,1.0,4,8,1430,0.0,1964,2040,10035,21251 days 16:47:18.665876,315,1.7142857142857142,0.0,-610,1726,1430.0
365070.0,4,2.5,2506,6232,2.0,3,7,2506,0.0,2006,2070,8260,5910 days 16:47:18.665876,065,1.6,0.0,436,-2028,2506.0
550000.0,4,2.0,2250,7500,1.0,5,7,1200,1050.0,1956,1440,7500,24173 days 16:47:18.665876,133,2.0,1.1428571428571428,810,0,150.0
470000.0,5,1.75,2740,9600,1.0,4,7,1370,1370.0,1945,1990,4800,28190 days 16:47:18.665876,118,2.857142857142857,1.0,750,4800,0.0
340000.0,3,1.75,1540,10400,1.0,3,6,1540,0.0,1977,1090,7500,16502 days 16:47:18.665876,239,1.7142857142857142,0.0,450,2900,1540.0
910000.0,4,2.75,4190,38912,1.0,4,9,2040,2150.0,1965,3050,36884,20885 days 16:47:18.665876,217,1.4545454545454546,0.9488372093023256,1140,2028,-110.0
405000.0,4,1.75,1690,8392,1.0,3,7,1190,500.0,1979,1880,9861,15772 days 16:47:18.665876,097,2.2857142857142856,2.38,-190,-1469,690.0
661000.0,4,2.25,1990,4600,1.5,4,8,1420,570.0,1932,1810,5750,32939 days 16:47:18.665876,153,1.7777777777777777,2.491228070175439,180,-1150,850.0
635000.0,4,2.5,2410,7069,2.0,3,9,2410,0.0,1993,2240,7184,10658 days 16:47:18.665876,310,1.6,0.0,170,-115,2410.0
282000.0,2,1.0,1150,6098,1.0,3,7,950,200.0,1948,1790,8455,27095 days 16:47:18.665876,125,2.0,4.75,-640,-2357,750.0
235000.0,4,1.75,1720,10137,2.0,3,7,1720,0.0,1956,1350,10205,24173 days 16:47:18.665876,042,2.2857142857142856,0.0,370,-68,1720.0
277500.0,3,2.0,1260,22100,2.0,4,7,1260,0.0,1981,1430,13000,15041 days 16:47:18.665876,231,1.5,0.0,-170,9100,1260.0
346500.0,5,2.5,2020,8250,1.0,4,8,1430,590.0,1978,1680,8959,16137 days 16:47:18.665876,110,2.0,2.4237288135593222,340,-709,840.0
480000.0,5,2.25,2240,5500,1.0,3,7,1490,750.0,1959,2010,6050,23077 days 16:47:18.665876,100,2.2222222222222223,1.9866666666666666,230,-550,740.0
360000.0,4,2.25,1930,6508,2.0,3,8,1930,0.0,1996,2170,6548,9563 days 16:47:18.665876,259,1.7777777777777777,0.0,-240,-40,1930.0
245000.0,3,2.5,1820,6785,1.0,3,7,1420,400.0,1994,1710,6055,10293 days 16:47:18.665876,310,1.2,3.55,110,730,1020.0
625000.0,3,3.5,1560,1490,2.0,3,8,1240,320.0,1995,1560,1662,9928 days 16:47:18.665876,262,0.8571428571428571,3.875,0,-172,920.0
750500.0,5,3.0,2170,2440,1.5,4,8,1450,720.0,1911,2070,4000,40609 days 16:47:18.665876,149,1.6666666666666667,2.013888888888889,100,-1560,730.0
525000.0,3,1.75,1600,9579,1.0,3,8,1180,420.0,1977,1750,9829,16502 days 16:47:18.665876,108,1.7142857142857142,2.8095238095238093,-150,-250,760.0
740000.0,4,3.5,3760,57063,2.0,3,9,2950,810.0,1998,2870,28945,8832 days 16:47:18.665876,210,1.1428571428571428,3.6419753086419755,890,28118,2140.0
523000.0,3,1.5,1240,7735,1.0,4,7,1240,0.0,1957,1260,7500,23807 days 16:47:18.665876,133,2.0,0.0,-20,235,1240.0
292000.0,3,1.75,1090,4500,1.5,5,8,1090,0.0,1929,1640,5225,34034 days 16:47:18.665876,063,1.7142857142857142,0.0,-550,-725,1090.0
625000.0,4,2.5,2740,9599,1.0,3,8,1820,920.0,1961,2660,8280,22346 days 16:47:18.665876,021,1.6,1.9782608695652173,80,1319,900.0
700000.0,3,2.5,3110,11727,2.0,3,9,3110,0.0,2002,4240,13353,7371 days 16:47:18.665876,016,1.2,0.0,-1130,-1626,3110.0
399950.0,3,2.5,1610,1320,2.0,3,7,1280,330.0,2007,1480,1602,5545 days 16:47:18.665876,071,1.2,3.878787878787879,130,-282,950.0
545000.0,4,3.5,1880,1341,3.0,3,8,1650,230.0,2007,1740,1883,5545 days 16:47:18.665876,056,1.1428571428571428,7.173913043478261,140,-542,1420.0
339999.0,4,2.0,1740,6369,1.0,5,6,870,870.0,1954,1560,7200,24903 days 16:47:18.665876,219,2.0,1.0,180,-831,0.0
1210000.0,4,2.25,3270,6000,2.0,5,8,2180,1090.0,1909,2880,6000,41339 days 16:47:18.665876,335,1.7777777777777777,2.0,390,0,1090.0
545000.0,3,2.5,1990,5149,2.0,3,8,1990,0.0,2003,2280,4506,7006 days 16:47:18.665876,317,1.2,0.0,-290,643,1990.0
260000.0,4,1.75,1960,8400,1.0,4,8,1960,0.0,1967,2080,8400,20155 days 16:47:18.665876,068,2.2857142857142856,0.0,-120,0,1960.0
526000.0,3,1.75,1680,3420,1.0,3,7,960,720.0,1992,1680,4080,11024 days 16:47:18.665876,143,1.7142857142857142,1.3333333333333333,0,-660,240.0
701000.0,4,3.0,2910,8540,2.0,3,9,2910,0.0,2003,3040,6091,7006 days 16:47:18.665876,316,1.3333333333333333,0.0,-130,2449,2910.0
290000.0,3,2.25,1500,7482,1.0,4,7,1210,290.0,1968,1480,7308,19790 days 16:47:18.665876,276,1.3333333333333333,4.172413793103448,20,174,920.0
330600.0,1,1.0,580,1799,1.0,3,7,580,0.0,1908,1260,4000,41705 days 16:47:18.665876,277,1.0,0.0,-680,-2201,580.0
550500.0,3,1.75,2540,8280,1.0,3,7,1270,1270.0,1949,1950,8280,26729 days 16:47:18.665876,117,1.7142857142857142,1.0,590,0,0.0
430000.0,2,1.0,950,6426,1.0,3,7,950,0.0,1949,1360,2550,26729 days 16:47:18.665876,072,2.0,0.0,-410,3876,950.0
4000000.0,4,5.5,7080,16573,2.0,3,1,5760,1320.0,2008,3140,15996,5180 days 16:47:18.665876,287,0.7272727272727273,4.363636363636363,3940,577,4440.0
260600.0,2,1.0,810,4560,1.0,3,7,810,0.0,1928,1490,4560,34400 days 16:47:18.665876,216,2.0,0.0,-680,0,810.0
825000.0,5,3.0,4080,7500,2.0,4,8,2720,1360.0,1961,2000,4545,22346 days 16:47:18.665876,352,1.6666666666666667,2.0,2080,2955,1360.0
378950.0,4,2.0,1820,8400,1.0,5,7,1300,520.0,1956,1700,9450,24173 days 16:47:18.665876,296,2.0,2.5,120,-1050,780.0
435000.0,4,2.5,2650,9065,2.0,3,7,2650,0.0,2000,2590,13218,8102 days 16:47:18.665876,016,1.6,0.0,60,-4153,2650.0
631000.0,3,2.25,1670,1396,2.0,3,9,1250,420.0,2015,1610,5191,2623 days 16:47:18.665876,112,1.3333333333333333,2.9761904761904763,60,-3795,830.0
415000.0,3,2.5,2480,8342,2.0,3,8,2480,0.0,1986,2300,8303,13215 days 16:47:18.665876,138,1.2,0.0,180,39,2480.0
222000.0,3,1.75,1240,7560,1.0,3,8,1070,170.0,1967,1650,7560,20155 days 16:47:18.665876,294,1.7142857142857142,6.294117647058823,-410,0,900.0
245000.0,3,2.0,1390,8250,1.0,3,7,1390,0.0,1987,1390,7875,12850 days 16:47:18.665876,232,1.5,0.0,0,375,1390.0
720000.0,3,2.5,2880,10126,2.0,4,1,2880,0.0,1985,2960,10514,13580 days 16:47:18.665876,084,1.2,0.0,-80,-388,2880.0
215000.0,3,1.0,1060,9954,1.0,4,7,1060,0.0,1960,1620,8760,22712 days 16:47:18.665876,357,3.0,0.0,-560,1194,1060.0
579100.0,2,1.0,1070,2754,1.0,3,7,830,240.0,1924,1760,4080,35861 days 16:47:18.665876,303,2.0,3.4583333333333335,-690,-1326,590.0
522500.0,4,1.75,1640,9299,1.5,4,7,870,770.0,1943,2460,14326,28921 days 16:47:18.665876,209,2.2857142857142856,1.12987012987013,-820,-5027,100.0
489000.0,3,2.0,1510,3000,1.0,4,7,910,600.0,1972,1620,4000,18329 days 16:47:18.665876,262,1.5,1.5166666666666666,-110,-1000,310.0
240000.0,3,1.0,1230,2353,1.5,4,6,1230,0.0,1925,1280,1572,35495 days 16:47:18.665876,126,3.0,0.0,-50,781,1230.0
420250.0,3,2.0,1510,3657,1.0,3,8,1510,0.0,2007,1510,3657,5545 days 16:47:18.665876,111,1.5,0.0,0,0,1510.0
523000.0,4,2.5,3180,20870,2.0,3,8,2120,1060.0,1967,2700,14190,20155 days 16:47:18.665876,318,1.6,2.0,480,6680,1060.0
628000.0,4,2.0,2260,6000,1.0,3,8,1430,830.0,1958,2030,5874,23442 days 16:47:18.665876,133,2.0,1.7228915662650603,230,126,600.0
320000.0,4,2.5,1920,7277,2.0,4,8,1920,0.0,1990,2300,7645,11754 days 16:47:18.665876,126,1.6,0.0,-380,-368,1920.0
359950.0,3,2.5,1980,7800,2.0,3,8,1980,0.0,1999,1700,20580,8467 days 16:47:18.665876,322,1.2,0.0,280,-12780,1980.0
232000.0,2,1.0,1200,8063,1.0,4,6,1200,0.0,1958,1200,7500,23442 days 16:47:18.665876,125,2.0,0.0,0,563,1200.0
810000.0,4,2.25,2020,5600,1.0,4,8,1210,810.0,1961,2660,6050,22346 days 16:47:18.665876,318,1.7777777777777777,1.4938271604938271,-640,-450,400.0
245000.0,4,1.5,2010,7561,1.5,4,7,1890,120.0,1921,1420,6564,36956 days 16:47:18.665876,345,2.6666666666666665,15.75,590,997,1770.0
273000.0,3,2.25,1930,8192,1.0,3,7,1470,460.0,1984,1510,8192,13946 days 16:47:18.665876,127,1.3333333333333333,3.1956521739130435,420,0,1010.0
1190000.0,5,2.5,2710,14989,1.0,3,8,1720,990.0,1959,3180,16624,23077 days 16:47:18.665876,042,2.0,1.7373737373737375,-470,-1635,730.0
340000.0,3,1.0,1250,4800,1.0,4,7,1250,0.0,1951,1404,4800,25999 days 16:47:18.665876,136,3.0,0.0,-154,0,1250.0
552000.0,2,2.5,1380,951,3.0,3,9,1380,0.0,2006,1430,3400,5910 days 16:47:18.665876,160,0.8,0.0,-50,-2449,1380.0
790000.0,3,1.75,2050,4080,2.0,3,8,2050,0.0,1991,1890,4080,11389 days 16:47:18.665876,329,1.7142857142857142,0.0,160,0,2050.0
360000.0,3,1.5,1800,22000,2.0,3,8,1800,0.0,1931,1440,16640,33304 days 16:47:18.665876,188,2.0,0.0,360,5360,1800.0
235000.0,3,1.0,1310,15022,1.0,3,7,1310,0.0,1934,1530,13154,32208 days 16:47:18.665876,061,3.0,0.0,-220,1868,1310.0
775000.0,2,1.0,1010,3600,1.0,3,7,1010,0.0,1913,1540,3600,39878 days 16:47:18.665876,283,2.0,0.0,-530,0,1010.0
489200.0,3,2.75,1850,9600,1.5,5,7,1850,0.0,1965,1250,10500,20885 days 16:47:18.665876,134,1.0909090909090908,0.0,600,-900,1850.0
335000.0,4,2.5,2154,6050,2.0,3,8,2154,0.0,2012,2305,5769,3719 days 16:47:18.665876,274,1.6,0.0,-151,281,2154.0
393500.0,3,1.75,1230,1441,2.0,3,8,1010,220.0,2004,1170,1942,6641 days 16:47:18.665876,021,1.7142857142857142,4.590909090909091,60,-501,790.0
360000.0,3,2.0,1960,8846,1.0,4,6,980,980.0,1940,2190,6363,30017 days 16:47:18.665876,261,1.5,1.0,-230,2483,0.0
400800.0,4,1.0,1070,5750,1.0,3,6,870,200.0,1923,1270,5750,36226 days 16:47:18.665876,063,4.0,4.35,-200,0,670.0
585000.0,3,1.0,1450,5378,1.0,3,7,1190,260.0,1939,1810,5559,30382 days 16:47:18.665876,307,3.0,4.576923076923077,-360,-181,930.0
1600000.0,4,2.75,3680,5000,2.0,3,9,2480,1200.0,1936,3200,5000,31478 days 16:47:18.665876,274,1.4545454545454546,2.066666666666667,480,0,1280.0
2880000.0,4,2.5,5760,32033,2.0,4,1,4390,1370.0,1994,3420,28475,10293 days 16:47:18.665876,210,1.6,3.204379562043796,2340,3558,3020.0
300000.0,3,1.0,1220,13000,1.0,4,7,1220,0.0,1955,1510,12600,24538 days 16:47:18.665876,135,3.0,0.0,-290,400,1220.0
1050000.0,4,2.75,2950,4560,2.0,5,7,1810,1140.0,1912,2000,4560,40244 days 16:47:18.665876,318,1.4545454545454546,1.587719298245614,950,0,670.0
360000.0,3,1.5,1340,1110,2.0,3,7,1040,300.0,1999,1220,1110,8467 days 16:47:18.665876,265,2.0,3.466666666666667,120,0,740.0
665900.0,4,2.25,2870,5453,2.0,4,8,2220,650.0,1926,1660,4800,35130 days 16:47:18.665876,171,1.7777777777777777,3.4153846153846152,1210,653,1570.0
470000.0,4,1.0,2590,18224,1.5,4,7,2000,590.0,1911,1800,7080,40609 days 16:47:18.665876,234,4.0,3.389830508474576,790,11144,1410.0
581000.0,4,1.75,2090,8164,1.0,4,8,1070,1020.0,1963,1310,7975,21616 days 16:47:18.665876,133,2.2857142857142856,1.0490196078431373,780,189,50.0
527000.0,6,3.5,3000,8401,1.0,3,8,1500,1500.0,1979,1400,8403,15772 days 16:47:18.665876,188,1.7142857142857142,1.0,1600,-2,0.0
875000.0,4,3.5,2850,4416,1.5,3,7,2040,810.0,1926,1860,4416,35130 days 16:47:18.665876,270,1.1428571428571428,2.5185185185185186,990,0,1230.0
410000.0,3,1.0,1020,6903,1.0,3,7,1020,0.0,1951,1440,6678,25999 days 16:47:18.665876,210,3.0,0.0,-420,225,1020.0
606000.0,3,2.5,2200,6005,2.0,3,9,2200,0.0,1997,2320,6098,9197 days 16:47:18.665876,075,1.2,0.0,-120,-93,2200.0
654000.0,3,2.5,3240,60840,2.0,3,7,3240,0.0,1997,2570,204732,9197 days 16:47:18.665876,121,1.2,0.0,670,-143892,3240.0
150000.0,3,0.75,490,38500,1.5,4,5,490,0.0,1959,800,18297,23077 days 16:47:18.665876,190,4.0,0.0,-310,20203,490.0
373000.0,3,2.5,2990,6771,1.0,3,7,1550,1440.0,2003,1800,6771,7006 days 16:47:18.665876,313,1.2,1.0763888888888888,1190,0,110.0
550000.0,5,2.0,2450,9488,1.0,4,7,1240,1210.0,1900,1310,5693,44626 days 16:47:18.665876,149,2.5,1.024793388429752,1140,3795,30.0
512500.0,3,2.5,1900,7604,2.0,3,8,1900,0.0,1990,1980,9583,11754 days 16:47:18.665876,141,1.2,0.0,-80,-1979,1900.0
360000.0,4,2.5,2640,7388,2.0,3,7,2640,0.0,2003,2640,6383,7006 days 16:47:18.665876,118,1.6,0.0,0,1005,2640.0
369000.0,3,2.0,1340,1480,3.0,3,8,1340,0.0,1997,1340,1321,9197 days 16:47:18.665876,269,1.5,0.0,0,159,1340.0
825000.0,4,2.5,3220,5262,2.0,3,9,3220,0.0,2003,3220,4921,7006 days 16:47:18.665876,364,1.6,0.0,0,341,3220.0
255000.0,3,2.0,930,11475,1.0,3,7,930,0.0,1978,1280,11250,16137 days 16:47:18.665876,335,1.5,0.0,-350,225,930.0
1290000.0,4,2.5,3240,10800,1.0,3,1,2260,980.0,1946,3490,10800,27825 days 16:47:18.665876,148,1.6,2.306122448979592,-250,0,1280.0
270000.0,5,2.5,2630,8470,1.5,4,8,2630,0.0,1968,1780,8575,19790 days 16:47:18.665876,220,2.0,0.0,850,-105,2630.0
480680.0,3,2.5,1730,4924,2.0,3,8,1730,0.0,1996,1610,4313,9563 days 16:47:18.665876,267,1.2,0.0,120,611,1730.0
525000.0,4,1.75,2120,7725,1.0,3,8,1220,900.0,1965,2160,7725,20885 days 16:47:18.665876,062,2.2857142857142856,1.3555555555555556,-40,0,320.0
291500.0,3,1.0,880,9238,1.5,5,6,880,0.0,1946,1170,9238,27825 days 16:47:18.665876,174,3.0,0.0,-290,0,880.0
305000.0,4,2.0,1800,13551,1.0,4,7,1800,0.0,1974,1730,13551,17598 days 16:47:18.665876,364,2.0,0.0,70,0,1800.0
285000.0,3,1.75,1600,7500,1.0,3,7,1600,0.0,1998,1620,7461,8832 days 16:47:18.665876,127,1.7142857142857142,0.0,-20,39,1600.0
1880000.0,3,2.5,3280,29111,2.0,3,1,3280,0.0,1925,3530,21074,35495 days 16:47:18.665876,259,1.2,0.0,-250,8037,3280.0
329500.0,5,1.75,3290,8000,1.0,3,7,1790,1500.0,1968,2380,7000,19790 days 16:47:18.665876,008,2.857142857142857,1.1933333333333334,910,1000,290.0
1570000.0,4,2.25,2890,18226,3.0,3,1,2890,0.0,1984,2870,11151,13946 days 16:47:18.665876,189,1.7777777777777777,0.0,20,7075,2890.0
379260.0,3,2.5,1730,7202,1.0,3,7,1330,400.0,1991,2100,8125,11389 days 16:47:18.665876,223,1.2,3.325,-370,-923,930.0
356000.0,3,2.5,1590,3411,2.0,3,7,1590,0.0,2000,1590,3411,8102 days 16:47:18.665876,190,1.2,0.0,0,0,1590.0
571900.0,4,1.75,1710,8947,1.0,4,7,1710,0.0,1956,1360,10133,24173 days 16:47:18.665876,335,2.2857142857142856,0.0,350,-1186,1710.0
271500.0,3,1.75,1995,18360,2.0,3,7,1995,0.0,1957,1980,13640,23807 days 16:47:18.665876,233,1.7142857142857142,0.0,15,4720,1995.0
390000.0,3,1.75,1300,10030,1.0,4,7,1300,0.0,1967,1520,7713,20155 days 16:47:18.665876,075,1.7142857142857142,0.0,-220,2317,1300.0
550000.0,3,2.5,2720,62310,1.0,3,8,2040,680.0,1985,2770,204296,13580 days 16:47:18.665876,132,1.2,3.0,-50,-141986,1360.0
755000.0,2,2.5,1360,2070,2.0,3,8,1360,0.0,1999,1920,2092,8467 days 16:47:18.665876,005,0.8,0.0,-560,-22,1360.0
509500.0,2,2.5,1590,1485,2.0,3,8,1300,290.0,1994,1880,3675,10293 days 16:47:18.665876,322,0.8,4.482758620689655,-290,-2190,1010.0
486700.0,2,1.0,1200,6278,1.0,3,7,1080,120.0,1942,1200,6211,29286 days 16:47:18.665876,084,2.0,9.0,0,67,960.0
527500.0,2,1.0,1170,3000,1.5,3,7,1170,0.0,1910,1530,4000,40974 days 16:47:18.665876,209,2.0,0.0,-360,-1000,1170.0
475000.0,5,2.5,2010,3600,1.5,3,6,1510,500.0,1912,1780,3600,40244 days 16:47:18.665876,227,2.0,3.02,230,0,1010.0
268000.0,3,2.75,1880,1793,2.0,3,7,1810,70.0,2001,1800,2537,7736 days 16:47:18.665876,239,1.0909090909090908,25.857142857142858,80,-744,1740.0
562000.0,3,2.0,3250,50529,2.0,4,8,3250,0.0,1978,2370,47480,16137 days 16:47:18.665876,106,1.5,0.0,880,3049,3250.0
780000.0,4,2.5,2270,13449,1.0,4,9,1310,960.0,1975,2810,13475,17233 days 16:47:18.665876,203,1.6,1.3645833333333333,-540,-26,350.0
700000.0,9,3.0,3680,4400,2.0,3,7,2830,850.0,1908,1960,2450,41705 days 16:47:18.665876,006,3.0,3.3294117647058825,1720,1950,1980.0
710000.0,3,2.0,1880,3000,1.0,4,8,1040,840.0,1931,1790,3000,33304 days 16:47:18.665876,245,1.5,1.2380952380952381,90,0,200.0
445000.0,3,1.0,1050,5664,1.0,4,7,910,140.0,1947,1500,5664,27460 days 16:47:18.665876,163,3.0,6.5,-450,0,770.0
729000.0,3,3.25,2250,60548,1.0,3,9,2250,0.0,2005,2760,84070,6275 days 16:47:18.665876,258,0.9230769230769231,0.0,-510,-23522,2250.0
384400.0,3,3.25,1689,1388,3.0,3,8,1689,0.0,2008,1459,1384,5180 days 16:47:18.665876,169,0.9230769230769231,0.0,230,4,1689.0
815000.0,6,3.0,2860,17853,1.0,3,8,1430,1430.0,1962,1920,13452,21981 days 16:47:18.665876,086,2.0,1.0,940,4401,0.0
865000.0,4,2.5,2710,4069,3.0,4,1,2710,0.0,1990,1810,3586,11754 days 16:47:18.665876,302,1.6,0.0,900,483,2710.0
514000.0,3,2.0,1770,7200,1.0,4,7,1770,0.0,1967,2250,11250,20155 days 16:47:18.666873,240,1.5,0.0,-480,-4050,1770.0
615000.0,4,2.75,2820,13193,1.0,3,8,1860,960.0,1965,2580,13193,20885 days 16:47:18.666873,140,1.4545454545454546,1.9375,240,0,900.0
865000.0,4,3.25,3400,99170,1.0,4,8,2000,1400.0,1980,3460,47920,15407 days 16:47:18.666873,289,1.2307692307692308,1.4285714285714286,-60,51250,600.0
755000.0,4,2.5,3110,6930,2.0,3,9,3110,0.0,2004,3090,7000,6641 days 16:47:18.666873,286,1.6,0.0,20,-70,3110.0
425000.0,4,1.0,1480,8321,1.0,3,7,1080,400.0,1953,1580,8502,25268 days 16:47:18.666873,117,4.0,2.7,-100,-181,680.0
375000.0,2,1.0,940,9839,1.0,3,6,940,0.0,1910,1330,8740,40974 days 16:47:18.666873,169,2.0,0.0,-390,1099,940.0
750000.0,4,2.5,2680,4548,2.0,3,8,2680,0.0,2009,2750,4548,4814 days 16:47:18.666873,114,1.6,0.0,-70,0,2680.0
722000.0,4,2.75,3190,5408,2.0,3,9,3190,0.0,2005,3160,5773,6275 days 16:47:18.666873,269,1.4545454545454546,0.0,30,-365,3190.0
1010000.0,3,2.5,1920,4480,2.0,3,9,1920,0.0,1949,1790,4500,26729 days 16:47:18.666873,090,1.2,0.0,130,-20,1920.0
725000.0,3,2.5,2610,7510,2.0,3,9,2610,0.0,1996,2610,8458,9563 days 16:47:18.666873,176,1.2,0.0,0,-948,2610.0
170000.0,3,0.75,1040,42180,1.0,2,6,1040,0.0,1947,1270,24090,27460 days 16:47:18.666873,273,4.0,0.0,-230,18090,1040.0
845000.0,4,3.25,2880,35315,1.0,3,1,2270,610.0,1982,1910,167378,14676 days 16:47:18.666873,121,1.2307692307692308,3.721311475409836,970,-132063,1660.0
271900.0,3,2.0,1450,8771,2.0,4,7,1450,0.0,1991,1450,8653,11389 days 16:47:18.666873,015,1.5,0.0,0,118,1450.0
1300000.0,6,4.5,3902,3880,3.0,4,9,2782,1120.0,1977,1100,3870,16502 days 16:47:18.666873,156,1.3333333333333333,2.4839285714285713,2802,10,1662.0
261500.0,4,2.5,2460,7800,1.0,3,8,1500,960.0,1977,2210,7800,16502 days 16:47:18.666873,356,1.6,1.5625,250,0,540.0
619500.0,3,2.5,2170,5000,2.0,3,9,2170,0.0,2003,2170,5000,7006 days 16:47:18.666873,136,1.2,0.0,0,0,2170.0
435000.0,5,2.25,1970,15247,1.0,3,7,1450,520.0,1986,1300,10800,13215 days 16:47:18.666873,161,2.2222222222222223,2.7884615384615383,670,4447,930.0
210000.0,3,1.0,1000,5454,1.0,3,7,1000,0.0,1954,1320,5250,24903 days 16:47:18.666873,276,3.0,0.0,-320,204,1000.0
489950.0,3,2.0,1580,4010,1.0,4,7,790,790.0,1909,1350,5350,41339 days 16:47:18.666873,330,1.5,1.0,230,-1340,0.0
260000.0,4,1.5,2130,8800,1.0,3,7,1100,1030.0,1962,1480,8120,21981 days 16:47:18.666873,128,2.6666666666666665,1.0679611650485437,650,680,70.0
300000.0,4,1.0,1370,8499,1.0,3,7,1370,0.0,1949,1370,8187,26729 days 16:47:18.666873,179,4.0,0.0,0,312,1370.0
530000.0,4,2.0,2150,14161,1.0,3,8,1330,820.0,1966,2310,14034,20520 days 16:47:18.666873,112,2.0,1.6219512195121952,-160,127,510.0
235000.0,3,1.75,1370,14030,1.0,4,8,1370,0.0,1977,2100,15260,16502 days 16:47:18.666873,350,1.7142857142857142,0.0,-730,-1230,1370.0
593500.0,3,1.0,1370,4000,2.0,4,8,1370,0.0,1918,1370,4000,38052 days 16:47:18.666873,005,3.0,0.0,0,0,1370.0
562000.0,3,3.0,3290,80471,2.0,4,8,2330,960.0,1975,1830,30494,17233 days 16:47:18.666873,204,1.0,2.4270833333333335,1460,49977,1370.0
585000.0,3,2.0,3190,207346,2.0,3,9,3190,0.0,1994,2930,206474,10293 days 16:47:18.666873,117,1.5,0.0,260,872,3190.0
2400000.0,4,3.25,4140,20734,1.0,3,1,3300,840.0,1977,4020,20008,16502 days 16:47:18.666873,150,1.2307692307692308,3.9285714285714284,120,726,2460.0
199500.0,3,1.75,1690,8901,1.0,3,7,1690,0.0,1986,1690,7532,13215 days 16:47:18.666873,055,1.7142857142857142,0.0,0,1369,1690.0
544500.0,5,1.0,1690,3240,1.5,3,7,1690,0.0,1914,1230,4500,39513 days 16:47:18.666873,245,5.0,0.0,460,-1260,1690.0
394900.0,3,1.0,1430,13370,1.0,3,7,1430,0.0,1962,1670,10075,21981 days 16:47:18.666873,049,3.0,0.0,-240,3295,1430.0
912000.0,4,3.75,1980,4095,2.0,3,9,1980,0.0,2009,1480,3840,4814 days 16:47:18.666873,212,1.0666666666666667,0.0,500,255,1980.0
260000.0,3,2.5,1490,8102,2.0,4,7,1490,0.0,1990,1640,7943,11754 days 16:47:18.666873,191,1.2,0.0,-150,159,1490.0
858000.0,5,3.0,3620,12778,1.0,5,8,1900,1720.0,1964,2930,10669,21251 days 16:47:18.666873,050,1.6666666666666667,1.1046511627906976,690,2109,180.0
1280000.0,4,2.5,2720,16454,1.0,5,9,1870,850.0,1963,3560,15993,21616 days 16:47:18.666873,343,1.6,2.2,-840,461,1020.0
242150.0,4,1.75,1490,8544,1.0,4,7,1490,0.0,1970,1180,8372,19059 days 16:47:18.666873,133,2.2857142857142856,0.0,310,172,1490.0
220000.0,3,1.75,1230,7200,1.0,3,7,1230,0.0,1986,1540,7210,13215 days 16:47:18.666873,303,1.7142857142857142,0.0,-310,-10,1230.0
235000.0,3,2.0,1900,7980,1.0,4,7,1340,560.0,1977,1690,7840,16502 days 16:47:18.666873,120,1.5,2.392857142857143,210,140,780.0
370000.0,3,1.75,1530,10300,1.0,4,7,1530,0.0,1978,1940,9883,16137 days 16:47:18.666873,294,1.7142857142857142,0.0,-410,417,1530.0
450000.0,3,1.75,2290,44866,1.0,3,8,1390,900.0,1981,2410,44866,15041 days 16:47:18.666873,276,1.7142857142857142,1.5444444444444445,-120,0,490.0
534950.0,5,1.5,2240,6337,1.0,3,8,1280,960.0,1956,1870,6380,24173 days 16:47:18.666873,192,3.3333333333333335,1.3333333333333333,370,-43,320.0
730000.0,4,2.5,3470,14271,2.0,3,9,3470,0.0,2005,3450,9380,6275 days 16:47:18.666873,074,1.6,0.0,20,4891,3470.0
465000.0,4,2.5,3050,32450,1.0,4,8,1550,1500.0,1983,2350,15390,14311 days 16:47:18.666873,268,1.6,1.0333333333333334,700,17060,50.0
178000.0,3,1.0,1100,5734,1.0,4,7,1100,0.0,1955,1770,6050,24538 days 16:47:18.666873,213,3.0,0.0,-670,-316,1100.0
215000.0,3,1.0,1610,7140,1.0,3,7,1080,530.0,1976,1800,7600,16868 days 16:47:18.666873,040,3.0,2.0377358490566038,-190,-460,550.0
300000.0,3,2.75,1910,15508,1.0,3,8,1210,700.0,1984,2450,7989,13946 days 16:47:18.666873,071,1.0909090909090908,1.7285714285714286,-540,7519,510.0
430000.0,3,2.0,1510,7066,1.0,3,7,1230,280.0,1973,1950,8089,17963 days 16:47:18.666873,135,1.5,4.392857142857143,-440,-1023,950.0
183000.0,3,1.5,1280,4366,2.0,4,6,1280,0.0,1985,1280,4366,13580 days 16:47:18.666873,212,2.0,0.0,0,0,1280.0
585000.0,3,2.5,1910,1501,2.5,3,8,1530,380.0,2007,1760,1750,5545 days 16:47:18.666873,163,1.2,4.026315789473684,150,-249,1150.0
192950.0,3,1.0,1170,3330,2.0,4,6,1170,0.0,1969,1090,3330,19424 days 16:47:18.666873,197,3.0,0.0,80,0,1170.0
599000.0,2,1.0,1550,7713,1.0,3,7,1550,0.0,1930,1340,6350,33669 days 16:47:18.666873,269,2.0,0.0,210,1363,1550.0
326500.0,3,1.0,1060,7920,1.0,4,7,1060,0.0,1968,1060,7457,19790 days 16:47:18.666873,189,3.0,0.0,0,463,1060.0
358803.0,2,1.0,1040,5765,1.0,3,7,1040,0.0,1944,1040,3844,28556 days 16:47:18.666873,199,2.0,0.0,0,1921,1040.0
537000.0,3,2.5,1550,12920,2.0,5,7,1550,0.0,1999,2610,10800,8467 days 16:47:18.666873,148,1.2,0.0,-1060,2120,1550.0
1160000.0,3,2.5,2490,24691,1.0,4,9,1580,910.0,1961,2800,24121,22346 days 16:47:18.666873,296,1.2,1.7362637362637363,-310,570,670.0
156000.0,2,1.0,920,5889,1.0,4,6,920,0.0,1950,1210,6180,26364 days 16:47:18.666873,029,2.0,0.0,-290,-291,920.0
219000.0,3,1.0,1250,8276,1.5,5,6,1250,0.0,1939,1250,8792,30382 days 16:47:18.666873,084,3.0,0.0,0,-516,1250.0
1190000.0,3,1.5,2540,2700,2.0,4,8,1630,910.0,1922,2520,5400,36591 days 16:47:18.666873,121,2.0,1.7912087912087913,20,-2700,720.0
248000.0,5,1.75,2190,16788,1.0,3,8,1380,810.0,1978,1920,8366,16137 days 16:47:18.666873,117,2.857142857142857,1.7037037037037037,270,8422,570.0
340000.0,3,1.75,1340,196020,1.0,4,7,1340,0.0,1987,2250,232230,12850 days 16:47:18.666873,040,1.7142857142857142,0.0,-910,-36210,1340.0
899100.0,5,2.5,2410,15300,1.0,4,8,1400,1010.0,1975,2440,15300,17233 days 16:47:18.666873,112,2.0,1.386138613861386,-30,0,390.0
346950.0,3,1.75,1830,10954,1.0,3,7,1830,0.0,1963,1850,8624,21616 days 16:47:18.666873,209,1.7142857142857142,0.0,-20,2330,1830.0
330000.0,3,1.0,1850,5775,2.0,3,6,1740,110.0,1928,1520,3578,34400 days 16:47:18.666873,260,3.0,15.818181818181818,330,2197,1630.0
325000.0,3,1.0,1410,8250,1.0,3,7,1410,0.0,1954,1580,8250,24903 days 16:47:18.666873,212,3.0,0.0,-170,0,1410.0
315000.0,3,1.75,1460,7884,1.0,3,8,1460,0.0,1975,2050,7210,17233 days 16:47:18.666873,300,1.7142857142857142,0.0,-590,674,1460.0
649950.0,3,2.5,1500,1375,2.0,3,9,1200,300.0,2014,1680,1627,2988 days 16:47:18.666873,174,1.2,4.0,-180,-252,900.0
316000.0,3,1.0,1130,7200,1.5,4,6,1130,0.0,1942,1350,1358,29286 days 16:47:18.666873,237,3.0,0.0,-220,5842,1130.0
386000.0,2,2.5,1620,3196,2.0,3,8,1620,0.0,2008,1750,2828,5180 days 16:47:18.666873,168,0.8,0.0,-130,368,1620.0
535000.0,2,1.75,2330,7280,1.0,3,7,1450,880.0,1982,1830,12178,14676 days 16:47:18.666873,098,1.1428571428571428,1.6477272727272727,500,-4898,570.0
600000.0,3,3.0,1520,1800,3.0,3,7,1520,0.0,2003,1520,1500,7006 days 16:47:18.666873,084,1.0,0.0,0,300,1520.0
339000.0,4,2.5,2840,8746,2.0,3,8,2840,0.0,2001,2630,9900,7736 days 16:47:18.666873,322,1.6,0.0,210,-1154,2840.0
167000.0,3,2.0,1520,7456,1.0,3,7,1520,0.0,1949,1740,8464,26729 days 16:47:18.666873,269,1.5,0.0,-220,-1008,1520.0
430000.0,3,1.0,1740,4800,1.0,3,8,1740,0.0,1952,1600,4800,25634 days 16:47:18.666873,349,3.0,0.0,140,0,1740.0
688000.0,4,4.0,4000,9309,2.0,3,9,4000,0.0,2007,3920,8048,5545 days 16:47:18.666873,233,1.0,0.0,80,1261,4000.0
834500.0,3,2.25,2780,6000,1.0,4,9,1670,1110.0,1948,2780,6000,27095 days 16:47:18.666873,251,1.3333333333333333,1.5045045045045045,0,0,560.0
1080000.0,4,4.25,3500,8750,1.0,5,9,2140,1360.0,1951,3110,8750,25999 days 16:47:18.666873,179,0.9411764705882353,1.5735294117647058,390,0,780.0
250000.0,3,1.0,1060,52272,1.0,3,7,1060,0.0,1960,1900,5971,22712 days 16:47:18.666873,335,3.0,0.0,-840,46301,1060.0
402500.0,3,1.0,1290,4000,1.5,3,7,1290,0.0,1926,1160,5040,35130 days 16:47:18.666873,100,3.0,0.0,130,-1040,1290.0
432500.0,3,2.5,2390,6435,1.0,3,8,1600,790.0,1978,2020,7300,16137 days 16:47:18.666873,350,1.2,2.0253164556962027,370,-865,810.0
485000.0,5,1.75,2460,14100,1.0,3,7,1380,1080.0,1972,2028,11078,18329 days 16:47:18.666873,226,2.857142857142857,1.2777777777777777,432,3022,300.0
410000.0,4,2.25,2200,8292,2.0,3,7,2200,0.0,1990,1090,8290,11754 days 16:47:18.666873,294,1.7777777777777777,0.0,1110,2,2200.0
455000.0,3,2.5,1870,7344,1.0,3,8,1470,400.0,1980,1930,7344,15407 days 16:47:18.666873,135,1.2,3.675,-60,0,1070.0
459500.0,4,2.5,2060,8968,1.0,4,7,1190,870.0,1975,1350,8972,17233 days 16:47:18.666873,363,1.6,1.367816091954023,710,-4,320.0
371000.0,4,1.75,1610,11305,1.0,3,7,1610,0.0,1968,1870,11850,19790 days 16:47:18.666873,346,2.2857142857142856,0.0,-260,-545,1610.0
289500.0,3,2.25,2120,3400,2.0,3,7,2120,0.0,2002,2420,3400,7371 days 16:47:18.666873,051,1.3333333333333333,0.0,-300,0,2120.0
395000.0,3,3.5,1450,1263,2.0,3,8,1160,290.0,2007,1390,1282,5545 days 16:47:18.666873,294,0.8571428571428571,4.0,60,-19,870.0
496752.0,2,1.0,1980,5000,1.0,4,7,1090,890.0,1923,1720,5000,36226 days 16:47:18.666873,165,2.0,1.2247191011235956,260,0,200.0
227000.0,2,1.0,860,6800,1.0,3,6,860,0.0,1943,1220,6800,28921 days 16:47:18.666873,274,2.0,0.0,-360,0,860.0
330000.0,3,1.75,1460,9261,1.0,3,7,1460,0.0,1985,1550,8800,13580 days 16:47:18.666873,216,1.7142857142857142,0.0,-90,461,1460.0
480000.0,5,2.0,2590,8610,1.0,4,7,1340,1250.0,1958,1750,8610,23442 days 16:47:18.666873,023,2.5,1.072,840,0,90.0
290000.0,2,1.0,1120,217800,1.0,3,6,1120,0.0,1976,1480,217800,16868 days 16:47:18.666873,218,2.0,0.0,-360,0,1120.0
281000.0,3,1.0,1340,21336,1.5,4,5,1340,0.0,1945,1340,37703,28190 days 16:47:18.666873,316,3.0,0.0,0,-16367,1340.0
705000.0,4,1.5,1780,3120,1.5,3,8,1780,0.0,1926,1710,3600,35130 days 16:47:18.666873,097,2.6666666666666665,0.0,70,-480,1780.0
1400000.0,4,2.5,2920,4000,1.5,5,8,1910,1010.0,1909,2470,4000,41339 days 16:47:18.666873,122,1.6,1.891089108910891,450,0,900.0
485000.0,4,3.25,2820,6611,1.0,3,7,1410,1410.0,1958,2320,6611,23442 days 16:47:18.666873,346,1.2307692307692308,1.0,500,0,0.0
622000.0,3,2.25,1550,1919,3.0,3,8,1550,0.0,2003,1550,2918,7006 days 16:47:18.666873,068,1.3333333333333333,0.0,0,-999,1550.0
380000.0,3,2.25,1600,39848,1.0,4,8,1600,0.0,1958,1600,39848,23442 days 16:47:18.666873,245,1.3333333333333333,0.0,0,0,1600.0
2130000.0,4,2.75,3190,19513,2.0,4,1,3190,0.0,1982,2750,13496,14676 days 16:47:18.666873,330,1.4545454545454546,0.0,440,6017,3190.0
561500.0,3,1.75,1960,6380,1.0,4,7,980,980.0,1939,1480,6380,30382 days 16:47:18.666873,178,1.7142857142857142,1.0,480,0,0.0
242000.0,3,1.0,970,9600,1.0,3,7,970,0.0,1972,1110,9600,18329 days 16:47:18.666873,259,3.0,0.0,-140,0,970.0
348500.0,3,1.5,1360,10726,1.0,4,7,1360,0.0,1966,1650,10726,20520 days 16:47:18.666873,175,2.0,0.0,-290,0,1360.0
370000.0,3,1.5,1360,10726,1.0,4,7,1360,0.0,1966,1650,10726,20520 days 16:47:18.666873,085,2.0,0.0,-290,0,1360.0
752000.0,6,3.75,3810,6663,2.0,4,8,3810,0.0,1977,1610,4561,16502 days 16:47:18.666873,104,1.6,0.0,2200,2102,3810.0
230000.0,3,1.75,1340,8250,1.0,3,7,1100,240.0,1985,1540,7860,13580 days 16:47:18.666873,304,1.7142857142857142,4.583333333333333,-200,390,860.0
715000.0,3,2.25,1990,4977,3.0,3,9,1990,0.0,2012,1280,5000,3719 days 16:47:18.666873,077,1.3333333333333333,0.0,710,-23,1990.0
240415.0,3,1.75,1120,10187,1.0,3,7,1120,0.0,1968,1900,8736,19790 days 16:47:18.666873,107,1.7142857142857142,0.0,-780,1451,1120.0
562000.0,4,1.75,2060,4080,1.5,3,7,1460,600.0,1922,1620,4080,36591 days 16:47:18.666873,329,2.2857142857142856,2.433333333333333,440,0,860.0
360000.0,3,1.5,1170,4080,1.0,5,6,1170,0.0,1917,920,4242,38417 days 16:47:18.666873,217,2.0,0.0,250,-162,1170.0
659950.0,3,2.5,1610,1246,2.0,3,9,1080,530.0,2014,1610,1249,2988 days 16:47:18.666873,302,1.2,2.0377358490566038,0,-3,550.0
458500.0,3,2.0,1890,1599,2.0,3,9,1430,460.0,2012,1780,1562,3719 days 16:47:18.666873,174,1.5,3.108695652173913,110,37,970.0
259950.0,2,2.0,1070,649,2.0,3,9,720,350.0,2008,1070,928,5180 days 16:47:18.666873,064,1.0,2.057142857142857,0,-279,370.0
366000.0,3,1.75,1680,6108,1.0,3,8,1680,0.0,1989,2220,5664,12119 days 16:47:18.666873,261,1.7142857142857142,0.0,-540,444,1680.0
978000.0,4,2.75,2890,7821,2.0,3,9,2890,0.0,2014,2890,10108,2988 days 16:47:18.666873,118,1.4545454545454546,0.0,0,-2287,2890.0
525000.0,2,1.0,1360,6120,1.0,3,7,1060,300.0,1947,1800,5100,27460 days 16:47:18.666873,111,2.0,3.533333333333333,-440,1020,760.0
926300.0,3,1.5,1660,4800,2.0,3,8,1660,0.0,1907,1690,4000,42070 days 16:47:18.666873,142,2.0,0.0,-30,800,1660.0
750000.0,2,1.0,1620,6120,1.0,3,7,1620,0.0,1951,1650,4590,25999 days 16:47:18.666873,113,2.0,0.0,-30,1530,1620.0
660000.0,2,1.0,960,6263,1.0,4,6,960,0.0,1942,1460,6054,29286 days 16:47:18.666873,338,2.0,0.0,-500,209,960.0
305000.0,4,1.75,1000,7200,1.5,4,6,1000,0.0,1947,1280,7200,27460 days 16:47:18.666873,225,2.2857142857142856,0.0,-280,0,1000.0
800000.0,2,2.5,2395,6143,1.0,3,8,2395,0.0,2003,2170,6162,7006 days 16:47:18.666873,116,0.8,0.0,225,-19,2395.0
600000.0,4,1.75,3050,9440,1.0,3,8,1800,1250.0,1966,2020,8660,20520 days 16:47:18.666873,117,2.2857142857142856,1.44,1030,780,550.0
435000.0,2,1.0,1120,88327,1.5,4,6,1120,0.0,1972,1640,136662,18329 days 16:47:18.666873,239,2.0,0.0,-520,-48335,1120.0
1140000.0,4,3.25,2960,4296,2.0,3,9,2190,770.0,2007,2150,6000,5545 days 16:47:18.666873,069,1.2307692307692308,2.844155844155844,810,-1704,1420.0
318000.0,3,2.25,1250,1017,3.0,3,8,1250,0.0,2008,1250,1017,5180 days 16:47:18.666873,283,1.3333333333333333,0.0,0,0,1250.0
639000.0,4,2.0,1940,5000,1.0,4,7,980,960.0,1910,1940,5000,40974 days 16:47:18.666873,279,2.0,1.0208333333333333,0,0,20.0
453000.0,3,2.5,1750,3900,2.0,3,8,1750,0.0,1977,1750,5700,16502 days 16:47:18.666873,075,1.2,0.0,0,-1800,1750.0
800000.0,4,1.75,2150,9148,1.0,4,7,2150,0.0,1955,2370,9148,24538 days 16:47:18.666873,321,2.2857142857142856,0.0,-220,0,2150.0
437000.0,2,1.75,1500,6800,1.0,4,7,910,590.0,1942,1450,6800,29286 days 16:47:18.666873,155,1.1428571428571428,1.5423728813559323,50,0,320.0
490000.0,4,2.5,3000,8645,2.0,3,8,3000,0.0,1985,1930,8866,13580 days 16:47:18.666873,269,1.6,0.0,1070,-221,3000.0
499950.0,4,1.75,1520,7700,1.0,4,7,1520,0.0,1967,1520,7500,20155 days 16:47:18.666873,191,2.2857142857142856,0.0,0,200,1520.0
160134.0,3,1.5,1190,10116,1.0,3,7,1190,0.0,1968,1190,9905,19790 days 16:47:18.666873,360,2.0,0.0,0,211,1190.0
191000.0,3,1.0,990,8255,1.0,3,7,990,0.0,1953,1180,9750,25268 days 16:47:18.666873,349,3.0,0.0,-190,-1495,990.0
221000.0,3,1.0,1250,7280,1.0,3,7,1250,0.0,1965,1450,7350,20885 days 16:47:18.666873,015,3.0,0.0,-200,-70,1250.0
352800.0,4,2.0,2080,6360,1.0,3,7,1330,750.0,1960,2080,6741,22712 days 16:47:18.666873,301,2.0,1.7733333333333334,0,-381,580.0
458000.0,4,1.5,1550,3000,1.5,3,7,1350,200.0,1918,1710,5535,38052 days 16:47:18.666873,168,2.6666666666666665,6.75,-160,-2535,1150.0
359950.0,3,1.0,1290,189486,1.0,4,7,1290,0.0,1960,2370,98881,22712 days 16:47:18.666873,139,3.0,0.0,-1080,90605,1290.0
1050000.0,3,3.0,3250,5093,2.0,3,1,3250,0.0,2004,2820,7752,6641 days 16:47:18.666873,097,1.0,0.0,430,-2659,3250.0
353000.0,3,1.75,1260,11775,1.0,5,6,1260,0.0,1942,1270,5480,29286 days 16:47:18.666873,205,1.7142857142857142,0.0,-10,6295,1260.0
717550.0,3,3.5,2840,4468,3.0,3,1,2840,0.0,2006,3040,5400,5910 days 16:47:18.666873,213,0.8571428571428571,0.0,-200,-932,2840.0
450000.0,3,2.25,1960,6500,2.0,4,8,1960,0.0,1977,1860,6160,16502 days 16:47:18.666873,219,1.3333333333333333,0.0,100,340,1960.0
167500.0,3,1.0,760,3090,1.0,2,5,760,0.0,1903,1020,5356,43531 days 16:47:18.666873,267,3.0,0.0,-260,-2266,760.0
550000.0,3,1.75,2240,78225,2.0,5,8,2240,0.0,1976,2030,202554,16868 days 16:47:18.666873,168,1.7142857142857142,0.0,210,-124329,2240.0
939000.0,4,2.25,2240,9684,2.0,4,9,2240,0.0,1970,2440,9618,19059 days 16:47:18.666873,111,1.7777777777777777,0.0,-200,66,2240.0
700000.0,3,1.75,1820,15570,1.0,3,8,1820,0.0,1948,2490,9480,27095 days 16:47:18.666873,119,1.7142857142857142,0.0,-670,6090,1820.0
480000.0,4,3.5,3370,435600,2.0,3,9,3370,0.0,2005,2790,114868,6275 days 16:47:18.666873,139,1.1428571428571428,0.0,580,320732,3370.0
501000.0,3,1.0,1160,4360,1.0,4,8,1160,0.0,1929,1810,4360,34034 days 16:47:18.666873,241,3.0,0.0,-650,0,1160.0
580000.0,3,2.25,1640,8625,1.0,3,8,1320,320.0,1987,1770,9476,12850 days 16:47:18.666873,035,1.3333333333333333,4.125,-130,-851,1000.0
527550.0,1,0.75,820,59677,1.0,3,5,820,0.0,1999,1590,14163,8467 days 16:47:18.666873,143,1.3333333333333333,0.0,-770,45514,820.0
399000.0,4,2.5,2800,4687,2.0,3,9,2800,0.0,2005,2750,4750,6275 days 16:47:18.666873,328,1.6,0.0,50,-63,2800.0
240000.0,3,1.75,1780,5000,1.5,3,6,1080,700.0,1957,1500,5000,23807 days 16:47:18.666873,105,1.7142857142857142,1.542857142857143,280,0,380.0
353000.0,4,2.75,2200,268329,1.0,3,7,1410,790.0,1989,2240,58806,12119 days 16:47:18.666873,070,1.4545454545454546,1.7848101265822784,-40,209523,620.0
335000.0,4,2.0,1480,3132,1.0,5,6,740,740.0,1910,1480,6420,40974 days 16:47:18.666873,148,2.0,1.0,0,-3288,0.0
475000.0,3,3.0,2010,2554,2.0,3,7,1860,150.0,2001,1370,5100,7736 days 16:47:18.666873,076,1.0,12.4,640,-2546,1710.0
660000.0,3,2.0,2880,5100,1.5,4,7,2080,800.0,1926,1820,5100,35130 days 16:47:18.666873,238,1.5,2.6,1060,0,1280.0
551000.0,3,1.0,940,1948,1.0,5,6,940,0.0,1900,1700,5000,44626 days 16:47:18.666873,205,3.0,0.0,-760,-3052,940.0
249950.0,4,1.75,1620,10530,1.0,3,7,1620,0.0,1968,1890,9975,19790 days 16:47:18.666873,079,2.2857142857142856,0.0,-270,555,1620.0
1150000.0,4,3.25,4400,262666,2.0,3,1,4400,0.0,1988,3240,9791,12485 days 16:47:18.666873,324,1.2307692307692308,0.0,1160,252875,4400.0
575000.0,3,1.75,1530,6743,1.0,3,7,1410,120.0,1955,2040,6000,24538 days 16:47:18.666873,184,1.7142857142857142,11.75,-510,743,1290.0
1090000.0,4,2.75,3460,11350,1.0,4,9,1780,1680.0,1974,3200,13874,17598 days 16:47:18.666873,199,1.4545454545454546,1.0595238095238095,260,-2524,100.0
515000.0,4,2.5,2890,7306,2.0,3,7,2890,0.0,2006,2850,6687,5910 days 16:47:18.666873,322,1.6,0.0,40,619,2890.0
235000.0,3,1.5,1980,11214,1.0,3,7,1980,0.0,1959,1510,9072,23077 days 16:47:18.666873,344,2.0,0.0,470,2142,1980.0
796000.0,3,1.0,1980,3243,1.5,3,8,1980,0.0,1912,1380,1249,40244 days 16:47:18.666873,258,3.0,0.0,600,1994,1980.0
450000.0,2,1.5,1450,2550,1.0,3,7,820,630.0,1984,1450,5100,13946 days 16:47:18.666873,113,1.3333333333333333,1.3015873015873016,0,-2550,190.0
2050000.0,4,3.0,4280,18834,1.0,5,1,2180,2100.0,1971,2490,8858,18694 days 16:47:18.666873,310,1.3333333333333333,1.0380952380952382,1790,9976,80.0
270000.0,4,2.5,1810,6509,2.0,3,7,1810,0.0,1994,1760,7417,10293 days 16:47:18.666873,128,1.6,0.0,50,-908,1810.0
1710000.0,3,3.0,2490,27702,2.0,3,1,2490,0.0,2000,2580,12119,8102 days 16:47:18.666873,104,1.0,0.0,-90,15583,2490.0
565000.0,3,1.0,1610,4108,1.5,5,7,1610,0.0,1928,1680,4467,34400 days 16:47:18.666873,068,3.0,0.0,-70,-359,1610.0
680000.0,1,2.5,1820,3008,2.0,3,7,1090,730.0,1910,1860,3420,40974 days 16:47:18.666873,216,0.4,1.4931506849315068,-40,-412,360.0
5570000.0,5,5.75,9200,35069,2.0,3,1,6200,3000.0,2001,3560,24345,7736 days 16:47:18.666873,216,0.8695652173913043,2.066666666666667,5640,10724,3200.0
864500.0,4,2.5,3520,35991,2.0,4,1,3520,0.0,1992,3210,35991,11024 days 16:47:18.666873,318,1.6,0.0,310,0,3520.0
1150000.0,4,2.25,3740,18000,1.0,4,9,1870,1870.0,1951,2610,10902,25999 days 16:47:18.666873,258,1.7777777777777777,1.0,1130,7098,0.0
335000.0,3,2.25,2150,30476,2.0,3,7,2150,0.0,1991,2010,10800,11389 days 16:47:18.666873,135,1.3333333333333333,0.0,140,19676,2150.0
911000.0,4,3.25,3526,15958,2.0,3,1,3526,0.0,1997,3639,15090,9197 days 16:47:18.666873,124,1.2307692307692308,0.0,-113,868,3526.0
425000.0,2,1.0,1070,6625,1.0,3,7,830,240.0,1950,1310,6625,26364 days 16:47:18.666873,316,2.0,3.4583333333333335,-240,0,590.0
299950.0,3,1.0,1410,81021,1.0,3,7,1410,0.0,1949,2000,81021,26729 days 16:47:18.666873,302,3.0,0.0,-590,0,1410.0
864000.0,4,2.5,3190,49658,2.0,3,1,3190,0.0,1999,3040,49658,8467 days 16:47:18.666873,342,1.6,0.0,150,0,3190.0
425000.0,2,1.0,1270,6000,1.0,3,7,1270,0.0,1939,1770,6000,30382 days 16:47:18.666873,064,2.0,0.0,-500,0,1270.0
374950.0,4,1.5,1970,14490,1.5,4,7,1970,0.0,1963,1880,14880,21616 days 16:47:18.666873,226,2.6666666666666665,0.0,90,-390,1970.0
247000.0,3,2.25,1640,7630,1.0,4,8,1180,460.0,1968,1930,7630,19790 days 16:47:18.666873,337,1.3333333333333333,2.5652173913043477,-290,0,720.0
475000.0,3,1.0,1600,7161,1.0,3,8,1600,0.0,1953,1760,8280,25268 days 16:47:18.666873,346,3.0,0.0,-160,-1119,1600.0
275000.0,3,2.5,3020,5868,2.0,3,7,3020,0.0,2003,2710,5470,7006 days 16:47:18.666873,213,1.2,0.0,310,398,3020.0
355000.0,2,1.0,1350,368517,1.0,3,6,1350,0.0,1947,2330,104108,27460 days 16:47:18.666873,302,2.0,0.0,-980,264409,1350.0
285000.0,4,1.75,1870,22072,1.0,3,7,1070,800.0,1959,2100,10185,23077 days 16:47:18.666873,077,2.2857142857142856,1.3375,-230,11887,270.0
1340000.0,3,2.75,2730,38869,1.5,3,9,1940,790.0,1963,2630,28188,21616 days 16:47:18.666873,248,1.0909090909090908,2.4556962025316458,100,10681,1150.0
325000.0,2,1.0,1100,17817,1.0,3,7,620,480.0,1980,1790,20009,15407 days 16:47:18.666873,223,2.0,1.2916666666666667,-690,-2192,140.0
1670000.0,5,3.5,4320,40816,2.0,4,1,4320,0.0,1997,4320,44584,9197 days 16:47:18.666873,110,1.4285714285714286,0.0,0,-3768,4320.0
402000.0,3,2.5,2700,9994,1.0,4,7,1350,1350.0,1959,2470,10664,23077 days 16:47:18.666873,157,1.2,1.0,230,-670,0.0
1100000.0,3,3.0,3700,16857,1.0,3,1,2170,1530.0,2000,2320,12000,8102 days 16:47:18.666873,226,1.0,1.4183006535947713,1380,4857,640.0
375000.0,4,1.75,2190,9225,1.0,4,7,1250,940.0,1959,2190,9225,23077 days 16:47:18.666873,211,2.2857142857142856,1.3297872340425532,0,0,310.0
396000.0,5,2.75,2840,12253,1.0,3,7,1420,1420.0,1960,2210,11620,22712 days 16:47:18.666873,254,1.8181818181818181,1.0,630,633,0.0
320000.0,4,2.75,2610,9077,1.0,4,8,1310,1300.0,1987,1900,10500,12850 days 16:47:18.666873,197,1.4545454545454546,1.0076923076923077,710,-1423,10.0
610000.0,3,2.5,2630,5827,2.0,3,8,2630,0.0,2001,2330,4715,7736 days 16:47:18.666873,190,1.2,0.0,300,1112,2630.0
249950.0,3,1.5,1090,7698,1.0,5,7,1090,0.0,1966,1540,7624,20520 days 16:47:18.666873,321,2.0,0.0,-450,74,1090.0
675000.0,4,3.5,3090,100835,2.0,3,9,3090,0.0,1999,2400,50543,8467 days 16:47:18.666873,113,1.1428571428571428,0.0,690,50292,3090.0
448000.0,2,2.0,1670,7772,1.0,4,6,860,810.0,1919,1300,7770,37687 days 16:47:18.666873,085,1.0,1.0617283950617284,370,2,50.0
819000.0,3,1.0,1300,3600,2.0,3,7,1300,0.0,1900,2510,4800,44626 days 16:47:18.666873,118,3.0,0.0,-1210,-1200,1300.0
1250000.0,3,2.5,3670,18505,1.0,3,1,2530,1140.0,1983,2920,20000,14311 days 16:47:18.666873,314,1.2,2.219298245614035,750,-1495,1390.0
225000.0,4,2.5,1700,6031,2.0,3,8,1700,0.0,1994,1930,6035,10293 days 16:47:18.666873,335,1.6,0.0,-230,-4,1700.0
790000.0,2,3.0,2560,982278,1.0,3,8,2560,0.0,2004,1620,40946,6641 days 16:47:18.666873,211,0.6666666666666666,0.0,940,941332,2560.0
685000.0,4,2.5,2770,6000,2.0,3,8,2400,370.0,1993,2120,6000,10658 days 16:47:18.666873,104,1.6,6.486486486486487,650,0,2030.0
812000.0,3,3.25,3240,8338,2.0,3,9,3240,0.0,2001,3420,8405,7736 days 16:47:18.666873,171,0.9230769230769231,0.0,-180,-67,3240.0
705000.0,2,2.5,2300,6400,1.0,3,8,2300,0.0,2007,2300,6400,5545 days 16:47:18.666873,336,0.8,0.0,0,0,2300.0
360000.0,4,3.0,2483,6870,2.0,3,8,2483,0.0,2005,1943,6434,6275 days 16:47:18.666873,119,1.3333333333333333,0.0,540,436,2483.0
344000.0,1,1.5,760,779,3.0,3,8,760,0.0,2006,1290,1189,5910 days 16:47:18.666873,012,0.6666666666666666,0.0,-530,-410,760.0
825000.0,4,1.5,2040,6900,2.0,3,9,2040,0.0,1903,3150,8220,43531 days 16:47:18.666873,295,2.6666666666666665,0.0,-1110,-1320,2040.0
476500.0,3,1.0,1200,6120,1.0,4,7,950,250.0,1945,1550,6120,28190 days 16:47:18.666873,117,3.0,3.8,-350,0,700.0
379500.0,2,1.0,960,5096,1.0,5,7,960,0.0,1949,1760,4488,26729 days 16:47:18.666873,328,2.0,0.0,-800,608,960.0
620000.0,3,1.75,2410,35236,1.0,3,8,2410,0.0,1980,2110,16980,15407 days 16:47:18.666873,276,1.7142857142857142,0.0,300,18256,2410.0
477590.0,3,3.25,2260,7701,2.0,3,8,1760,500.0,2000,1880,7529,8102 days 16:47:18.666873,212,0.9230769230769231,3.52,380,172,1260.0
490000.0,3,1.0,1910,8190,1.0,4,7,1010,900.0,1946,1600,5042,27825 days 16:47:18.666873,140,3.0,1.1222222222222222,310,3148,110.0
470000.0,3,1.5,1500,5000,1.5,4,7,1140,360.0,1927,1500,5000,34765 days 16:47:18.666873,179,2.0,3.1666666666666665,0,0,780.0
500000.0,3,2.25,1360,1236,2.0,3,8,1140,220.0,2006,1620,1231,5910 days 16:47:18.666873,205,1.3333333333333333,5.181818181818182,-260,5,920.0
370000.0,3,1.0,1320,7341,1.0,3,7,1320,0.0,1982,1160,7573,14676 days 16:47:18.666873,181,3.0,0.0,160,-232,1320.0
790000.0,2,1.5,1940,4400,1.0,3,7,970,970.0,1923,1480,3080,36226 days 16:47:18.666873,070,1.3333333333333333,1.0,460,1320,0.0
725000.0,4,2.5,2650,18295,2.0,3,8,2650,0.0,1986,2230,19856,13215 days 16:47:18.666873,175,1.6,0.0,420,-1561,2650.0
840000.0,4,2.75,3040,2800,2.0,3,9,2100,940.0,1906,1260,2178,42435 days 16:47:18.666873,148,1.4545454545454546,2.234042553191489,1780,622,1160.0
390000.0,3,1.0,1240,11108,1.0,4,7,1240,0.0,1952,2220,16533,25634 days 16:47:18.666873,155,3.0,0.0,-980,-5425,1240.0
507000.0,3,2.25,2210,11585,1.0,4,7,1510,700.0,1958,1870,14092,23442 days 16:47:18.666873,240,1.3333333333333333,2.157142857142857,340,-2507,810.0
263500.0,3,1.75,1540,6273,1.0,4,6,770,770.0,1951,1140,5512,25999 days 16:47:18.666873,326,1.7142857142857142,1.0,400,761,0.0
369000.0,3,2.5,1320,1683,2.0,3,8,1270,50.0,2004,1320,2206,6641 days 16:47:18.666873,193,1.2,25.4,0,-523,1220.0
500000.0,3,2.5,3040,5326,2.0,3,9,3040,0.0,2008,3040,5442,5180 days 16:47:18.666873,226,1.2,0.0,0,-116,3040.0
570000.0,2,1.0,910,4301,1.0,4,7,910,0.0,1923,1810,4301,36226 days 16:47:18.666873,096,2.0,0.0,-900,0,910.0
284000.0,4,3.0,2040,7145,1.0,3,8,1490,550.0,1994,1940,7145,10293 days 16:47:18.666873,065,1.3333333333333333,2.709090909090909,100,0,940.0
415000.0,2,1.0,980,4108,1.0,3,7,980,0.0,1947,1500,4046,27460 days 16:47:18.666873,314,2.0,0.0,-520,62,980.0
197500.0,3,1.0,980,3090,1.5,3,6,980,0.0,1903,980,3090,43531 days 16:47:18.666873,135,3.0,0.0,0,0,980.0
925000.0,4,3.75,4420,9492,2.0,3,9,3420,1000.0,1962,2880,9900,21981 days 16:47:18.666873,300,1.0666666666666667,3.42,1540,-408,2420.0
468000.0,3,2.0,1570,6300,1.0,3,7,820,750.0,1953,1510,4281,25268 days 16:47:18.666873,316,1.5,1.0933333333333333,60,2019,70.0
355000.0,3,1.0,1600,5001,1.5,5,6,1080,520.0,1930,1340,5001,33669 days 16:47:18.666873,196,3.0,2.076923076923077,260,0,560.0
639000.0,4,1.75,1830,6000,1.0,4,7,930,900.0,1939,1540,6000,30382 days 16:47:18.666873,224,2.2857142857142856,1.0333333333333334,290,0,30.0
720000.0,3,2.5,2820,14250,2.0,3,1,2820,0.0,1991,2820,12600,11389 days 16:47:18.666873,102,1.2,0.0,0,1650,2820.0
381000.0,3,1.75,1800,6000,1.0,5,6,900,900.0,1950,1060,6628,26364 days 16:47:18.666873,163,1.7142857142857142,1.0,740,-628,0.0
1050000.0,3,4.0,4380,42769,2.0,5,1,4380,0.0,1983,3630,35425,14311 days 16:47:18.666873,143,0.75,0.0,750,7344,4380.0
670000.0,3,3.0,2980,3730,2.0,3,9,2980,0.0,2005,2710,3640,6275 days 16:47:18.666873,315,1.0,0.0,270,90,2980.0
400000.0,3,1.0,1690,6658,1.0,3,7,1690,0.0,1942,1080,5925,29286 days 16:47:18.666873,301,3.0,0.0,610,733,1690.0
910000.0,4,3.5,4040,50479,2.0,3,1,4040,0.0,1987,3770,40899,12850 days 16:47:18.666873,177,1.1428571428571428,0.0,270,9580,4040.0
294000.0,3,1.0,1250,9427,1.0,3,6,1250,0.0,1931,1590,8250,33304 days 16:47:18.666873,092,3.0,0.0,-340,1177,1250.0
315001.0,3,1.75,1500,10230,1.0,2,7,1500,0.0,1968,1770,8374,19790 days 16:47:18.666873,069,1.7142857142857142,0.0,-270,1856,1500.0
360000.0,3,2.0,1630,10723,1.0,5,7,1630,0.0,1959,1450,10723,23077 days 16:47:18.666873,212,1.5,0.0,180,0,1630.0
520000.0,3,2.0,1410,2700,2.0,4,7,1410,0.0,1902,1750,4000,43896 days 16:47:18.666873,217,1.5,0.0,-340,-1300,1410.0
474000.0,3,1.0,1140,4560,1.0,4,6,770,370.0,1944,1340,3980,28556 days 16:47:18.666873,283,3.0,2.081081081081081,-200,580,400.0
702000.0,4,2.5,3280,5876,2.0,3,7,3280,0.0,2004,2600,5000,6641 days 16:47:18.666873,072,1.6,0.0,680,876,3280.0
728000.0,4,3.5,3490,87497,2.0,3,9,3490,0.0,2001,2400,55657,7736 days 16:47:18.666873,238,1.1428571428571428,0.0,1090,31840,3490.0
308000.0,4,2.5,2020,7277,2.0,3,8,2020,0.0,1993,2820,7284,10658 days 16:47:18.666873,064,1.6,0.0,-800,-7,2020.0
2000000.0,5,4.0,4580,4443,3.0,3,1,4580,0.0,2004,2710,4443,6641 days 16:47:18.666873,144,1.25,0.0,1870,0,4580.0
340000.0,3,2.5,2270,7917,2.0,3,8,2270,0.0,1986,2160,7917,13215 days 16:47:18.666873,206,1.2,0.0,110,0,2270.0
306500.0,2,1.75,1310,10200,1.0,4,6,1310,0.0,1947,1500,7200,27460 days 16:47:18.666873,091,1.1428571428571428,0.0,-190,3000,1310.0
716000.0,3,2.0,1420,3600,1.5,4,7,1420,0.0,1904,1250,3600,43166 days 16:47:18.666873,026,1.5,0.0,170,0,1420.0
950000.0,4,3.0,2980,44431,2.0,2,1,2640,340.0,1981,2010,7332,15041 days 16:47:18.666873,252,1.3333333333333333,7.764705882352941,970,37099,2300.0
673200.0,5,3.0,4180,8561,2.0,3,7,4180,0.0,2003,3425,6591,7006 days 16:47:18.666873,241,1.6666666666666667,0.0,755,1970,4180.0
564500.0,4,2.25,1950,6000,1.0,3,7,1350,600.0,1961,1980,6000,22346 days 16:47:18.666873,082,1.7777777777777777,2.25,-30,0,750.0
393000.0,4,1.75,1790,11801,1.0,4,8,1790,0.0,1974,2000,12988,17598 days 16:47:18.666873,037,2.2857142857142856,0.0,-210,-1187,1790.0
425000.0,5,1.75,1400,5071,1.0,3,5,1400,0.0,1916,1200,7500,38783 days 16:47:18.666873,071,2.857142857142857,0.0,200,-2429,1400.0
150000.0,3,1.0,1320,24684,1.0,3,7,1320,0.0,1979,1120,21214,15772 days 16:47:18.666873,211,3.0,0.0,200,3470,1320.0
327000.0,4,2.25,1620,106722,1.0,3,8,1200,420.0,1980,1620,38400,15407 days 16:47:18.666873,051,1.7777777777777777,2.857142857142857,0,68322,780.0
444900.0,4,2.5,3120,7448,2.0,3,9,3120,0.0,1998,2980,8102,8832 days 16:47:18.666873,077,1.6,0.0,140,-654,3120.0
305000.0,4,2.5,2100,14773,2.0,3,8,2100,0.0,1998,2370,15440,8832 days 16:47:18.666873,203,1.6,0.0,-270,-667,2100.0
469000.0,3,3.25,1370,1194,3.0,3,8,1370,0.0,2004,1800,2678,6641 days 16:47:18.666873,230,0.9230769230769231,0.0,-430,-1484,1370.0
525000.0,3,1.75,1520,7875,1.0,5,8,1520,0.0,1969,2150,9428,19424 days 16:47:18.666873,269,1.7142857142857142,0.0,-630,-1553,1520.0
330000.0,3,2.5,2410,17424,1.0,3,7,1630,780.0,1978,1530,11761,16137 days 16:47:18.666873,094,1.2,2.08974358974359,880,5663,850.0
618000.0,4,1.0,1260,4080,1.0,4,7,1260,0.0,1911,1340,4080,40609 days 16:47:18.666873,275,4.0,0.0,-80,0,1260.0
295500.0,4,2.5,2830,7350,1.0,3,8,1690,1140.0,1982,2350,7768,14676 days 16:47:18.666873,321,1.6,1.4824561403508771,480,-418,550.0
567035.0,3,2.0,2064,46173,2.0,5,7,2064,0.0,1903,1640,21780,43531 days 16:47:18.666873,199,1.5,0.0,424,24393,2064.0
518000.0,4,2.25,2640,34870,1.0,3,8,1770,870.0,1977,2500,35580,16502 days 16:47:18.666873,206,1.7777777777777777,2.0344827586206895,140,-710,900.0
303000.0,2,1.0,1020,9200,1.0,3,7,1020,0.0,1978,1520,9600,16137 days 16:47:18.666873,124,2.0,0.0,-500,-400,1020.0
413107.0,3,1.5,1420,7520,1.0,4,7,1420,0.0,1956,2000,7520,24173 days 16:47:18.666873,288,2.0,0.0,-580,0,1420.0
400000.0,3,1.0,1350,3090,1.5,5,6,1350,0.0,1914,1350,3090,39513 days 16:47:18.666873,232,3.0,0.0,0,0,1350.0
535000.0,3,1.0,1290,6859,1.0,4,7,1290,0.0,1941,1560,6369,29651 days 16:47:18.666873,098,3.0,0.0,-270,490,1290.0
555000.0,4,2.0,1680,2600,1.0,5,7,840,840.0,1915,1680,3340,39148 days 16:47:18.666873,262,2.0,1.0,0,-740,0.0
312000.0,3,2.5,2280,6386,2.0,3,8,2280,0.0,2008,2550,4835,5180 days 16:47:18.666873,323,1.2,0.0,-270,1551,2280.0
785200.0,3,2.25,1840,3500,1.5,5,8,1540,300.0,1910,1800,3300,40974 days 16:47:18.666873,154,1.3333333333333333,5.133333333333334,40,200,1240.0
749000.0,4,2.0,2040,11850,1.0,3,7,1020,1020.0,1959,2040,8504,23077 days 16:47:18.666873,289,2.0,1.0,0,3346,0.0
285000.0,3,1.5,1490,10367,1.0,3,7,1010,480.0,1957,1000,8254,23807 days 16:47:18.666873,095,2.0,2.1041666666666665,490,2113,530.0
425000.0,4,2.5,2440,5088,2.0,3,7,2440,0.0,2007,2440,5762,5545 days 16:47:18.666873,253,1.6,0.0,0,-674,2440.0
360000.0,3,2.0,1930,15540,1.0,3,8,1260,670.0,1958,1900,12123,23442 days 16:47:18.666873,198,1.5,1.8805970149253732,30,3417,590.0
260000.0,3,1.0,1200,6615,1.0,4,7,1200,0.0,1954,1230,6615,24903 days 16:47:18.666873,125,3.0,0.0,-30,0,1200.0
369000.0,3,2.0,1550,8509,1.0,3,7,1150,400.0,1959,1840,7620,23077 days 16:47:18.666873,150,1.5,2.875,-290,889,750.0
275000.0,4,2.5,2180,11132,1.0,4,8,1620,560.0,1978,1950,13801,16137 days 16:47:18.666873,227,1.6,2.892857142857143,230,-2669,1060.0
407000.0,3,2.25,1430,1448,3.0,3,8,1430,0.0,2005,1430,1383,6275 days 16:47:18.666873,246,1.3333333333333333,0.0,0,65,1430.0
575000.0,2,1.75,1230,5418,1.0,3,8,990,240.0,1949,1330,5074,26729 days 16:47:18.666873,102,1.1428571428571428,4.125,-100,344,750.0
1240000.0,3,1.5,1670,3852,2.0,4,8,1670,0.0,1928,2320,4572,34400 days 16:47:18.666873,117,2.0,0.0,-650,-720,1670.0
875000.0,2,2.5,2720,4913,1.0,4,8,1700,1020.0,1936,2520,5303,31478 days 16:47:18.666873,008,0.8,1.6666666666666667,200,-390,680.0
320000.0,4,1.5,2220,6811,1.0,4,7,1270,950.0,1961,1800,7350,22346 days 16:47:18.666873,193,2.6666666666666665,1.3368421052631578,420,-539,320.0
810000.0,3,1.5,1520,9041,1.0,4,7,1520,0.0,1954,3260,10020,24903 days 16:47:18.666873,184,2.0,0.0,-1740,-979,1520.0
274000.0,3,1.75,1590,7620,1.0,4,7,1090,500.0,1984,1590,7620,13946 days 16:47:18.666873,104,1.7142857142857142,2.18,0,0,590.0
239900.0,4,1.75,1480,9523,1.0,3,7,1120,360.0,1959,1590,8300,23077 days 16:47:18.666873,353,2.2857142857142856,3.111111111111111,-110,1223,760.0
450000.0,4,1.5,1860,7808,1.0,3,7,1080,780.0,1953,1530,7884,25268 days 16:47:18.666873,348,2.6666666666666665,1.3846153846153846,330,-76,300.0
263400.0,4,2.0,1360,60548,1.0,3,6,960,400.0,1960,1930,28800,22712 days 16:47:18.666873,181,2.0,2.4,-570,31748,560.0
265000.0,3,1.0,1360,5967,1.0,3,6,1360,0.0,1954,1360,6052,24903 days 16:47:18.666873,105,3.0,0.0,0,-85,1360.0
418000.0,4,3.0,2360,6250,1.0,3,7,1460,900.0,1960,2500,6250,22712 days 16:47:18.666873,167,1.3333333333333333,1.6222222222222222,-140,0,560.0
430000.0,3,2.0,1860,7500,1.0,3,7,930,930.0,1909,1000,5000,41339 days 16:47:18.666873,112,1.5,1.0,860,2500,0.0
1440000.0,3,2.25,2630,9705,2.5,4,8,2630,0.0,1987,2640,14284,12850 days 16:47:18.666873,113,1.3333333333333333,0.0,-10,-4579,2630.0
297000.0,2,1.75,1280,37373,1.0,4,7,1280,0.0,1996,2180,48351,9563 days 16:47:18.666873,324,1.1428571428571428,0.0,-900,-10978,1280.0
650000.0,4,2.25,2330,7220,2.0,3,8,1600,730.0,1988,2220,9100,12485 days 16:47:18.666873,091,1.7777777777777777,2.191780821917808,110,-1880,870.0
195000.0,2,1.0,720,18000,1.0,3,6,720,0.0,1950,1250,7925,26364 days 16:47:18.666873,129,2.0,0.0,-530,10075,720.0
554000.0,3,3.5,3380,108900,2.0,3,9,2700,680.0,1999,2250,130680,8467 days 16:47:18.666873,167,0.8571428571428571,3.9705882352941178,1130,-21780,2020.0
550000.0,3,2.0,3650,843309,2.0,4,7,3650,0.0,1991,1870,273992,11389 days 16:47:18.666873,272,1.5,0.0,1780,569317,3650.0
700000.0,3,1.75,1640,4590,1.5,5,7,1640,0.0,1951,1760,5100,25999 days 16:47:18.666873,050,1.7142857142857142,0.0,-120,-510,1640.0
300000.0,4,1.0,1730,177657,1.5,3,5,1730,0.0,1948,1400,45175,27095 days 16:47:18.666873,275,4.0,0.0,330,132482,1730.0
315000.0,2,1.0,1030,8576,1.5,5,6,1030,0.0,1952,1310,8504,25634 days 16:47:18.666873,280,2.0,0.0,-280,72,1030.0
603000.0,3,1.0,1790,5250,1.0,3,7,1400,390.0,1943,1790,5250,28921 days 16:47:18.666873,281,3.0,3.58974358974359,0,0,1010.0
530000.0,2,1.0,840,3400,1.0,4,7,840,0.0,1924,2000,4000,35861 days 16:47:18.666873,180,2.0,0.0,-1160,-600,840.0
397500.0,3,1.75,1300,8480,1.0,3,7,1300,0.0,1969,1740,7280,19424 days 16:47:18.666873,252,1.7142857142857142,0.0,-440,1200,1300.0
221000.0,3,1.0,1240,5250,1.5,4,6,1240,0.0,1904,1240,5250,43166 days 16:47:18.666873,084,3.0,0.0,0,0,1240.0
466000.0,4,2.25,2170,8050,1.0,3,7,1220,950.0,1976,1820,7700,16868 days 16:47:18.666873,336,1.7777777777777777,1.2842105263157895,350,350,270.0
197500.0,3,1.0,1330,5412,2.0,5,7,1330,0.0,1905,1710,10825,42800 days 16:47:18.666873,170,3.0,0.0,-380,-5413,1330.0
280000.0,3,3.0,1390,1080,2.0,3,7,1140,250.0,2006,1450,1461,5910 days 16:47:18.666873,127,1.0,4.56,-60,-381,890.0
412000.0,2,1.5,1240,3873,1.0,4,6,860,380.0,1909,1240,4336,41339 days 16:47:18.666873,276,1.3333333333333333,2.263157894736842,0,-463,480.0
454000.0,2,1.0,880,6731,1.0,4,7,880,0.0,1950,1240,6731,26364 days 16:47:18.666873,230,2.0,0.0,-360,0,880.0
540000.0,4,2.25,2540,228254,1.0,3,8,1450,1090.0,1990,1780,59241,11754 days 16:47:18.666873,132,1.7777777777777777,1.3302752293577982,760,169013,360.0
250000.0,5,1.5,2520,5753,1.5,4,7,1510,1010.0,1928,1620,6875,34400 days 16:47:18.666873,160,3.3333333333333335,1.495049504950495,900,-1122,500.0
900000.0,5,2.25,2510,35691,1.0,3,9,2510,0.0,1967,3160,35037,20155 days 16:47:18.666873,131,2.2222222222222223,0.0,-650,654,2510.0
245000.0,5,1.75,2020,7902,1.0,3,7,1220,800.0,1962,2220,8819,21981 days 16:47:18.666873,133,2.857142857142857,1.525,-200,-917,420.0
290000.0,3,1.75,2060,7251,1.0,3,7,1350,710.0,1987,1520,7582,12850 days 16:47:18.666873,280,1.7142857142857142,1.9014084507042253,540,-331,640.0
160000.0,2,1.0,930,7742,1.0,3,6,930,0.0,1933,2240,8723,32573 days 16:47:18.666873,036,2.0,0.0,-1310,-981,930.0
1260000.0,2,1.5,2700,7225,1.5,3,8,1660,1040.0,1910,2970,5150,40974 days 16:47:18.666873,089,1.3333333333333333,1.5961538461538463,-270,2075,620.0
325000.0,2,1.0,1060,6050,1.0,3,7,940,120.0,1939,1540,5279,30382 days 16:47:18.666873,086,2.0,7.833333333333333,-480,771,820.0
185000.0,2,1.0,670,6750,1.0,4,5,670,0.0,1947,1700,11520,27460 days 16:47:18.666873,008,2.0,0.0,-1030,-4770,670.0
477000.0,3,2.0,1750,4990,1.0,3,7,950,800.0,1916,1700,5000,38783 days 16:47:18.666873,268,1.5,1.1875,50,-10,150.0
100000.0,2,1.0,930,7623,1.0,2,6,930,0.0,1942,1300,7641,29286 days 16:47:18.666873,181,2.0,0.0,-370,-18,930.0
345000.0,4,2.5,2420,11481,1.0,3,8,1370,1050.0,1985,2290,8985,13580 days 16:47:18.666873,124,1.6,1.3047619047619048,130,2496,320.0
530000.0,4,2.25,2410,14985,1.0,4,7,1950,460.0,1965,2510,15256,20885 days 16:47:18.666873,090,1.7777777777777777,4.239130434782608,-100,-271,1490.0
203000.0,3,1.0,1150,7156,1.0,4,6,1150,0.0,1953,1210,7156,25268 days 16:47:18.666873,171,3.0,0.0,-60,0,1150.0
599000.0,4,2.5,2480,5000,2.0,3,7,2480,0.0,2004,2410,5000,6641 days 16:47:18.666873,301,1.6,0.0,70,0,2480.0
370000.0,4,1.0,1310,6000,1.5,3,7,1310,0.0,1940,1630,6000,30017 days 16:47:18.666873,201,4.0,0.0,-320,0,1310.0
140000.0,3,1.0,1240,8000,1.0,4,6,1040,200.0,1954,1240,8000,24903 days 16:47:18.666873,058,3.0,5.2,0,0,840.0
500000.0,3,1.0,1150,5100,2.0,3,8,1150,0.0,1911,1440,5100,40609 days 16:47:18.666873,174,3.0,0.0,-290,0,1150.0
527200.0,3,1.75,1460,4000,1.0,4,7,730,730.0,1929,1360,4000,34034 days 16:47:18.666873,034,1.7142857142857142,1.0,100,0,0.0
549900.0,5,2.75,3060,7015,1.0,5,8,1600,1460.0,1979,2190,7600,15772 days 16:47:18.666873,130,1.8181818181818181,1.095890410958904,870,-585,140.0
760000.0,4,2.5,3520,8095,2.0,3,9,3520,0.0,2006,2460,4676,5910 days 16:47:18.666873,122,1.6,0.0,1060,3419,3520.0
319000.0,2,1.0,960,4400,1.0,4,7,960,0.0,1951,1520,5000,25999 days 16:47:18.666873,209,2.0,0.0,-560,-600,960.0
362300.0,3,2.5,2430,15264,2.0,3,8,2430,0.0,1997,2260,10416,9197 days 16:47:18.666873,174,1.2,0.0,170,4848,2430.0
421000.0,3,2.5,1930,4505,1.0,4,7,1440,490.0,1973,1550,4505,17963 days 16:47:18.666873,117,1.2,2.938775510204082,380,0,950.0
690000.0,3,1.0,1090,4000,1.5,4,7,1090,0.0,1945,1520,4000,28190 days 16:47:18.666873,063,3.0,0.0,-430,0,1090.0
640000.0,3,2.5,2790,31798,1.0,5,8,1650,1140.0,1953,1400,14849,25268 days 16:47:18.666873,240,1.2,1.4473684210526316,1390,16949,510.0
238000.0,4,1.75,1650,6900,1.0,3,7,910,740.0,1978,1540,7645,16137 days 16:47:18.666873,342,2.2857142857142856,1.2297297297297298,110,-745,170.0
789000.0,3,3.0,3740,39640,2.0,3,1,3740,0.0,1991,2930,26136,11389 days 16:47:18.666873,153,1.0,0.0,810,13504,3740.0
1050000.0,6,4.0,5310,12741,2.0,3,1,3600,1710.0,1967,4190,12632,20155 days 16:47:18.666873,113,1.5,2.1052631578947367,1120,109,1890.0
302500.0,3,2.5,1690,4476,2.0,3,7,1690,0.0,2008,2250,4488,5180 days 16:47:18.666873,098,1.2,0.0,-560,-12,1690.0
259950.0,4,1.75,1400,7920,1.0,3,7,1400,0.0,1963,1910,7700,21616 days 16:47:18.666873,070,2.2857142857142856,0.0,-510,220,1400.0
456000.0,3,1.5,1440,28516,1.0,4,7,1440,0.0,1975,2080,27049,17233 days 16:47:18.666873,171,2.0,0.0,-640,1467,1440.0
369950.0,3,2.5,1360,3718,2.0,3,7,1360,0.0,1987,1090,3718,12850 days 16:47:18.666873,268,1.2,0.0,270,0,1360.0
363750.0,3,1.75,1726,197326,2.0,4,7,1726,0.0,1982,2114,99316,14676 days 16:47:18.666873,136,1.7142857142857142,0.0,-388,98010,1726.0
585000.0,3,1.75,2220,216493,1.0,3,8,2220,0.0,1989,2900,169884,12119 days 16:47:18.666873,223,1.7142857142857142,0.0,-680,46609,2220.0
268000.0,3,2.5,1850,6676,2.0,3,7,1850,0.0,1986,1700,6663,13215 days 16:47:18.666873,281,1.2,0.0,150,13,1850.0
1200000.0,5,2.5,2860,4000,2.0,4,8,2160,700.0,1910,1340,1224,40974 days 16:47:18.666873,266,2.0,3.085714285714286,1520,2776,1460.0
345000.0,3,1.0,1120,10176,1.0,3,6,920,200.0,1905,1350,7500,42800 days 16:47:18.666873,197,3.0,4.6,-230,2676,720.0
539000.0,4,2.5,2340,19850,2.0,3,9,2340,0.0,1993,1930,15439,10658 days 16:47:18.666873,056,1.6,0.0,410,4411,2340.0
851000.0,5,3.25,3760,9792,2.0,3,9,2550,1210.0,1984,2960,16500,13946 days 16:47:18.666873,183,1.5384615384615385,2.1074380165289255,800,-6708,1340.0
900000.0,3,2.5,1920,7200,2.0,3,1,1780,140.0,1997,2080,5000,9197 days 16:47:18.666873,098,1.2,12.714285714285714,-160,2200,1640.0
850000.0,3,2.5,3230,5000,2.0,5,8,2430,800.0,1945,1820,5000,28190 days 16:47:18.666873,184,1.2,3.0375,1410,0,1630.0
345000.0,3,1.75,1540,6909,1.0,4,7,920,620.0,1955,1130,6908,24538 days 16:47:18.666873,161,1.7142857142857142,1.4838709677419355,410,1,300.0
534500.0,3,2.5,1700,3150,2.0,3,8,1700,0.0,2005,1700,3600,6275 days 16:47:18.666873,167,1.2,0.0,0,-450,1700.0
643500.0,6,5.25,3600,3960,2.0,3,7,2400,1200.0,1971,1450,4600,18694 days 16:47:18.666873,322,1.1428571428571428,2.0,2150,-640,1200.0
1210000.0,3,2.75,3150,5520,1.5,4,8,2130,1020.0,1925,3160,6200,35495 days 16:47:18.666873,092,1.0909090909090908,2.088235294117647,-10,-680,1110.0
495000.0,2,1.75,1280,4000,1.0,4,7,730,550.0,1929,2250,5382,34034 days 16:47:18.666873,015,1.1428571428571428,1.3272727272727274,-970,-1382,180.0
535000.0,2,1.0,980,4120,1.0,3,7,830,150.0,1950,1760,4120,26364 days 16:47:18.666873,211,2.0,5.533333333333333,-780,0,680.0
435000.0,4,2.5,2190,6578,2.0,3,7,2190,0.0,2004,2190,5416,6641 days 16:47:18.666873,302,1.6,0.0,0,1162,2190.0
305000.0,4,2.0,2470,1831,2.0,3,7,1970,500.0,2009,1310,7500,4814 days 16:47:18.666873,317,2.0,3.94,1160,-5669,1470.0
799000.0,4,2.5,2590,7910,2.0,3,9,2590,0.0,2001,1700,7488,7736 days 16:47:18.666873,170,1.6,0.0,890,422,2590.0
700000.0,4,2.5,2580,15031,2.0,3,9,2580,0.0,1999,3030,10361,8467 days 16:47:18.666873,317,1.6,0.0,-450,4670,2580.0
467000.0,3,2.25,1270,1213,2.0,3,8,1040,230.0,2005,1410,1265,6275 days 16:47:18.666873,140,1.3333333333333333,4.521739130434782,-140,-52,810.0
263000.0,3,1.0,1250,7560,1.0,3,6,1250,0.0,1959,1270,7615,23077 days 16:47:18.666873,097,3.0,0.0,-20,-55,1250.0
760000.0,4,2.5,4660,7157,2.0,3,9,3020,1640.0,2003,3300,7047,7006 days 16:47:18.666873,232,1.6,1.8414634146341464,1360,110,1380.0
293000.0,4,2.5,2019,4435,2.0,3,8,2019,0.0,2008,1950,4800,5180 days 16:47:18.666873,038,1.6,0.0,69,-365,2019.0
245000.0,3,2.0,1490,7929,1.0,3,7,1490,0.0,1989,1650,7929,12119 days 16:47:18.666873,233,1.5,0.0,-160,0,1490.0
181000.0,2,1.5,1560,10807,1.0,2,7,1560,0.0,1949,1660,196591,26729 days 16:47:18.666873,212,1.3333333333333333,0.0,-100,-185784,1560.0
240000.0,3,1.0,1030,15264,1.0,4,7,1030,0.0,1962,1430,14840,21981 days 16:47:18.666873,113,3.0,0.0,-400,424,1030.0
880000.0,4,2.75,2560,7961,1.0,4,8,1450,1110.0,1975,2500,9009,17233 days 16:47:18.666873,321,1.4545454545454546,1.3063063063063063,60,-1048,340.0
285000.0,3,2.0,1460,6377,1.0,3,7,1460,0.0,1995,1600,6250,9928 days 16:47:18.666873,176,1.5,0.0,-140,127,1460.0
407500.0,2,1.0,770,6017,1.0,3,7,770,0.0,1950,1670,7500,26364 days 16:47:18.666873,106,2.0,0.0,-900,-1483,770.0
325000.0,4,2.5,1960,3543,2.0,3,7,1960,0.0,2004,2420,3646,6641 days 16:47:18.666873,224,1.6,0.0,-460,-103,1960.0
405000.0,3,1.75,1900,10454,1.0,3,7,1390,510.0,1978,2000,12000,16137 days 16:47:18.666873,290,1.7142857142857142,2.7254901960784315,-100,-1546,880.0
291700.0,3,2.5,1970,4120,1.5,3,6,1230,740.0,1927,1470,4080,34765 days 16:47:18.666873,097,1.2,1.662162162162162,500,40,490.0
370000.0,3,2.5,2490,18525,2.0,3,8,2490,0.0,1995,1850,9516,9928 days 16:47:18.666873,289,1.2,0.0,640,9009,2490.0
270000.0,3,1.5,1430,8960,1.0,4,6,1430,0.0,1953,1560,10125,25268 days 16:47:18.666873,148,2.0,0.0,-130,-1165,1430.0
800000.0,4,2.5,2680,7200,1.0,3,8,1380,1300.0,1952,1950,8520,25634 days 16:47:18.666873,147,1.6,1.0615384615384615,730,-1320,80.0
1130000.0,4,3.5,4300,8406,2.0,3,1,3580,720.0,1987,2770,10006,12850 days 16:47:18.666873,294,1.1428571428571428,4.972222222222222,1530,-1600,2860.0
399950.0,4,2.5,3200,7545,2.0,3,7,3200,0.0,2003,2840,7137,7006 days 16:47:18.666873,234,1.6,0.0,360,408,3200.0
419000.0,3,1.75,2140,15030,1.0,4,7,1570,570.0,1958,2170,15030,23442 days 16:47:18.666873,205,1.7142857142857142,2.754385964912281,-30,0,1000.0
1160000.0,4,2.5,4240,43995,2.0,3,1,4240,0.0,1989,3720,59522,12119 days 16:47:18.666873,196,1.6,0.0,520,-15527,4240.0
1410000.0,4,3.5,3410,10769,2.0,3,1,3410,0.0,2008,2650,10058,5180 days 16:47:18.666873,139,1.1428571428571428,0.0,760,711,3410.0
710000.0,4,2.75,2090,8064,2.0,5,7,2090,0.0,1967,1460,8400,20155 days 16:47:18.666873,212,1.4545454545454546,0.0,630,-336,2090.0
650000.0,3,1.0,1410,4840,1.0,4,6,1230,180.0,1942,1410,5400,29286 days 16:47:18.666873,089,3.0,6.833333333333333,0,-560,1050.0
369900.0,4,2.5,2820,33750,2.0,4,9,2820,0.0,1984,2510,36180,13946 days 16:47:18.666873,051,1.6,0.0,310,-2430,2820.0
641000.0,4,2.5,2770,63118,2.0,3,9,2770,0.0,1997,2770,44224,9197 days 16:47:18.666873,178,1.6,0.0,0,18894,2770.0
403000.0,3,1.0,1400,6879,1.0,3,7,1400,0.0,1951,1950,7400,25999 days 16:47:18.666873,077,3.0,0.0,-550,-521,1400.0
1020000.0,3,3.25,3620,4000,2.0,3,1,2730,890.0,2005,1910,5000,6275 days 16:47:18.666873,184,0.9230769230769231,3.067415730337079,1710,-1000,1840.0
865000.0,4,2.5,2260,13600,1.0,4,8,1770,490.0,1974,2630,13995,17598 days 16:47:18.666873,265,1.6,3.6122448979591835,-370,-395,1280.0
2490000.0,4,2.5,3440,23954,1.5,5,1,2260,1180.0,1931,4230,18723,33304 days 16:47:18.666873,315,1.6,1.9152542372881356,-790,5231,1080.0
810000.0,4,1.0,2150,3588,2.0,4,8,1850,300.0,1926,1950,3588,35130 days 16:47:18.666873,289,4.0,6.166666666666667,200,0,1550.0
316750.0,3,2.5,1256,1154,3.0,3,7,1256,0.0,2005,1309,1232,6275 days 16:47:18.666873,196,1.2,0.0,-53,-78,1256.0
652500.0,4,2.25,2220,130244,2.0,3,8,2220,0.0,1989,2680,130680,12119 days 16:47:18.666873,232,1.7777777777777777,0.0,-460,-436,2220.0
360000.0,6,2.75,2850,15240,1.0,3,7,1850,1000.0,1962,2090,7620,21981 days 16:47:18.666873,035,2.1818181818181817,1.85,760,7620,850.0
208000.0,2,1.0,700,5100,1.0,4,5,700,0.0,1953,970,5811,25268 days 16:47:18.666873,106,2.0,0.0,-270,-711,700.0
898000.0,4,2.5,3700,63991,2.0,3,1,3700,0.0,1992,3210,47215,11024 days 16:47:18.666873,041,1.6,0.0,490,16776,3700.0
295000.0,4,1.75,1400,11934,1.0,3,7,1050,350.0,1961,2080,10400,22346 days 16:47:18.666873,058,2.2857142857142856,3.0,-680,1534,700.0
652500.0,4,1.75,3130,18253,2.0,3,7,3130,0.0,1978,1850,12220,16137 days 16:47:18.666873,126,2.2857142857142856,0.0,1280,6033,3130.0
560000.0,4,3.0,2170,5764,2.0,3,8,2170,0.0,1992,2010,5681,11024 days 16:47:18.666873,206,1.3333333333333333,0.0,160,83,2170.0
280000.0,3,1.0,1020,8400,1.0,4,7,1020,0.0,1957,1690,8030,23807 days 16:47:18.666873,124,3.0,0.0,-670,370,1020.0
289950.0,3,2.5,1760,8584,1.5,5,7,1760,0.0,1937,2160,8584,31112 days 16:47:18.666873,181,1.2,0.0,-400,0,1760.0
397500.0,3,2.5,1860,44093,1.0,3,7,1860,0.0,1978,1900,6130,16137 days 16:47:18.666873,100,1.2,0.0,-40,37963,1860.0
380000.0,2,1.0,1140,75132,1.0,3,7,1140,0.0,1956,2570,35200,24173 days 16:47:18.666873,083,2.0,0.0,-1430,39932,1140.0
415900.0,3,2.5,1670,22703,1.0,3,7,1310,360.0,1988,1510,16817,12485 days 16:47:18.666873,304,1.2,3.638888888888889,160,5886,950.0
475000.0,2,1.75,1710,8645,1.0,4,7,1510,200.0,1923,1280,5366,36226 days 16:47:18.666873,197,1.1428571428571428,7.55,430,3279,1310.0
125000.0,1,1.0,500,7440,1.0,1,5,500,0.0,1928,1350,7440,34400 days 16:47:18.666873,275,1.0,0.0,-850,0,500.0
238000.0,3,1.0,1470,32670,1.0,3,7,1020,450.0,1958,2640,24100,23442 days 16:47:18.666873,233,3.0,2.2666666666666666,-1170,8570,570.0
296000.0,4,1.5,1370,9750,1.0,3,7,1070,300.0,1953,1540,9789,25268 days 16:47:18.666873,232,2.6666666666666665,3.566666666666667,-170,-39,770.0
475000.0,6,3.0,3470,117612,1.5,3,7,3470,0.0,1924,2120,17100,35861 days 16:47:18.666873,126,2.0,0.0,1350,100512,3470.0
390000.0,3,2.25,1650,6250,1.5,3,7,1650,0.0,1910,2060,6250,40974 days 16:47:18.666873,054,1.3333333333333333,0.0,-410,0,1650.0
425000.0,3,1.0,1180,3750,1.0,3,6,1030,150.0,1940,1280,3750,30017 days 16:47:18.667871,323,3.0,6.866666666666666,-100,0,880.0
725000.0,6,3.0,3110,5000,1.5,5,7,1810,1300.0,1921,1600,4000,36956 days 16:47:18.667871,177,2.0,1.3923076923076922,1510,1000,510.0
605000.0,3,2.25,2080,12134,1.0,4,8,1530,550.0,1973,2320,12400,17963 days 16:47:18.667871,183,1.3333333333333333,2.7818181818181817,-240,-266,980.0
302000.0,3,1.0,1600,1950,2.0,2,7,1600,0.0,1906,1310,1138,42435 days 16:47:18.667871,309,3.0,0.0,290,812,1600.0
886000.0,3,2.25,2380,6000,2.0,5,9,1650,730.0,1931,2000,6000,33304 days 16:47:18.667871,077,1.3333333333333333,2.26027397260274,380,0,920.0
540000.0,4,1.75,1630,6120,1.0,5,7,980,650.0,1918,1630,4080,38052 days 16:47:18.667871,226,2.2857142857142856,1.5076923076923077,0,2040,330.0
435000.0,4,2.25,1910,8400,2.0,3,7,1910,0.0,1975,1910,8400,17233 days 16:47:18.667871,104,1.7777777777777777,0.0,0,0,1910.0
409000.0,4,3.25,3140,10752,2.0,3,7,2300,840.0,1992,1300,9920,11024 days 16:47:18.667871,283,1.2307692307692308,2.738095238095238,1840,832,1460.0
405000.0,3,1.0,1250,7280,1.0,3,7,1250,0.0,1975,1690,7280,17233 days 16:47:18.667871,006,3.0,0.0,-440,0,1250.0
560200.0,3,2.5,1990,3984,2.0,3,8,1990,0.0,2004,2320,3984,6641 days 16:47:18.667871,162,1.2,0.0,-330,0,1990.0
324000.0,4,1.75,2110,7208,1.0,3,8,1170,940.0,1975,1820,7208,17233 days 16:47:18.667871,174,2.2857142857142856,1.2446808510638299,290,0,230.0
390000.0,4,2.5,2490,8290,2.0,3,9,2490,0.0,1999,2690,7008,8467 days 16:47:18.667871,139,1.6,0.0,-200,1282,2490.0
414000.0,2,1.0,800,5000,1.0,3,6,800,0.0,1938,1220,5000,30747 days 16:47:18.667871,097,2.0,0.0,-420,0,800.0
441500.0,3,2.5,2360,4670,2.0,3,7,2360,0.0,1998,2420,5620,8832 days 16:47:18.667871,246,1.2,0.0,-60,-950,2360.0
375000.0,3,2.5,1770,5146,2.0,3,7,1770,0.0,1992,1230,5160,11024 days 16:47:18.667871,068,1.2,0.0,540,-14,1770.0
668500.0,4,2.5,2710,5500,2.0,3,9,2710,0.0,1999,2710,6242,8467 days 16:47:18.667871,153,1.6,0.0,0,-742,2710.0
540000.0,5,1.5,1940,10202,1.5,4,7,1940,0.0,1940,1900,8000,30017 days 16:47:18.667871,280,3.3333333333333335,0.0,40,2202,1940.0
1040000.0,4,3.25,3450,11240,2.0,4,1,2430,1020.0,1960,2412,19499,22712 days 16:47:18.667871,157,1.2307692307692308,2.3823529411764706,1038,-8259,1410.0
1350000.0,4,3.25,3440,4920,2.0,3,1,2520,920.0,2014,2350,5166,2988 days 16:47:18.667871,084,1.2307692307692308,2.739130434782609,1090,-246,1600.0
758000.0,4,2.75,2410,9549,1.0,4,7,1780,630.0,1956,2090,9549,24173 days 16:47:18.667871,127,1.4545454545454546,2.8253968253968256,320,0,1150.0
949880.0,4,2.25,2290,10687,2.0,3,9,2290,0.0,1978,2290,10300,16137 days 16:47:18.667871,147,1.7777777777777777,0.0,0,387,2290.0
570000.0,3,1.0,1030,4089,1.5,3,7,1030,0.0,1927,1440,4917,34765 days 16:47:18.667871,127,3.0,0.0,-410,-828,1030.0
736000.0,4,2.5,2290,12047,2.0,4,9,2290,0.0,1988,3130,15666,12485 days 16:47:18.667871,126,1.6,0.0,-840,-3619,2290.0
670000.0,3,1.5,1490,4400,1.5,4,7,1490,0.0,1906,1560,4400,42435 days 16:47:18.667871,177,2.0,0.0,-70,0,1490.0
1130000.0,4,1.75,2370,8400,1.0,5,9,1270,1100.0,1949,2370,8400,26729 days 16:47:18.667871,096,2.2857142857142856,1.1545454545454545,0,0,170.0
690000.0,2,1.75,1600,4000,1.0,5,7,850,750.0,1918,1860,4000,38052 days 16:47:18.667871,167,1.1428571428571428,1.1333333333333333,-260,0,100.0
610000.0,4,2.25,2240,45738,2.0,3,7,2240,0.0,1988,3180,45738,12485 days 16:47:18.667871,072,1.7777777777777777,0.0,-940,0,2240.0
413500.0,2,1.0,770,4000,1.0,5,5,770,0.0,1924,1420,5040,35861 days 16:47:18.667871,139,2.0,0.0,-650,-1040,770.0
765000.0,3,2.5,2300,9752,2.0,3,8,2300,0.0,1968,2640,10764,19790 days 16:47:18.667871,104,1.2,0.0,-340,-1012,2300.0
828200.0,4,2.75,3400,7081,2.0,3,9,3400,0.0,2001,3060,7081,7736 days 16:47:18.667871,344,1.4545454545454546,0.0,340,0,3400.0
205000.0,2,1.0,900,4397,1.0,3,6,900,0.0,1918,1430,4500,38052 days 16:47:18.667871,207,2.0,0.0,-530,-103,900.0
465000.0,3,2.5,1450,5175,1.0,3,8,1030,420.0,1995,1740,9250,9928 days 16:47:18.667871,336,1.2,2.4523809523809526,-290,-4075,610.0
556000.0,4,2.5,2240,5402,2.0,3,8,2240,0.0,2005,2240,7560,6275 days 16:47:18.667871,070,1.6,0.0,0,-2158,2240.0
540000.0,4,2.5,1780,4169,2.0,3,8,1780,0.0,1994,1830,4164,10293 days 16:47:18.667871,159,1.6,0.0,-50,5,1780.0
423000.0,4,2.5,2320,4254,2.0,3,8,2320,0.0,2004,2330,4602,6641 days 16:47:18.667871,210,1.6,0.0,-10,-348,2320.0
375000.0,3,1.75,1590,14766,1.0,3,8,1590,0.0,1963,2040,10190,21616 days 16:47:18.667871,100,1.7142857142857142,0.0,-450,4576,1590.0
173250.0,3,1.0,990,12696,1.5,3,7,990,0.0,1936,1260,8937,31478 days 16:47:18.667871,343,3.0,0.0,-270,3759,990.0
599900.0,3,1.5,2605,12030,1.0,3,8,1355,1250.0,2003,1590,15242,7006 days 16:47:18.667871,036,2.0,1.084,1015,-3212,105.0
646000.0,5,2.75,2870,4461,1.0,3,7,1650,1220.0,1976,1890,4196,16868 days 16:47:18.667871,169,1.8181818181818181,1.3524590163934427,980,265,430.0
1080000.0,5,4.75,5180,17811,2.0,3,1,4070,1110.0,2001,3960,15103,7736 days 16:47:18.667871,156,1.0526315789473684,3.6666666666666665,1220,2708,2960.0
558000.0,4,2.0,2180,3870,1.0,3,7,1020,1160.0,1900,1520,2580,44626 days 16:47:18.667871,161,2.0,0.8793103448275862,660,1290,-140.0
354000.0,2,1.0,850,5225,1.0,3,7,850,0.0,1949,1230,5225,26729 days 16:47:18.667871,314,2.0,0.0,-380,0,850.0
1200000.0,4,4.0,4050,9517,2.0,3,1,3360,690.0,1990,3330,9436,11754 days 16:47:18.667871,008,1.0,4.869565217391305,720,81,2670.0
670000.0,4,2.0,2250,4200,1.5,3,7,1650,600.0,1909,1200,3360,41339 days 16:47:18.667871,090,2.0,2.75,1050,840,1050.0
1130000.0,6,4.25,3100,9378,3.0,3,1,3100,0.0,1978,3270,6334,16137 days 16:47:18.667871,279,1.411764705882353,0.0,-170,3044,3100.0
267500.0,2,1.0,1747,12250,2.5,4,6,1747,0.0,1948,1620,10300,27095 days 16:47:18.667871,219,2.0,0.0,127,1950,1747.0
299800.0,4,2.5,2410,4708,2.0,3,8,2410,0.0,2002,2517,5290,7371 days 16:47:18.667871,056,1.6,0.0,-107,-582,2410.0
430000.0,4,1.75,2070,9120,1.0,4,7,1250,820.0,1958,1650,8400,23442 days 16:47:18.667871,104,2.2857142857142856,1.524390243902439,420,720,430.0
775000.0,5,1.0,1860,3040,1.5,3,7,1530,330.0,1921,1910,3600,36956 days 16:47:18.667871,072,5.0,4.636363636363637,-50,-560,1200.0
333000.0,3,1.0,950,5214,1.0,3,7,830,120.0,1944,1490,7636,28556 days 16:47:18.667871,022,3.0,6.916666666666667,-540,-2422,710.0
336000.0,3,2.0,1060,11765,1.0,4,6,1060,0.0,1951,1500,9151,25999 days 16:47:18.667871,097,1.5,0.0,-440,2614,1060.0
323000.0,2,1.0,880,1712,2.0,4,7,880,0.0,1945,1360,1748,28190 days 16:47:18.667871,009,2.0,0.0,-480,-36,880.0
575000.0,4,2.5,2550,56628,2.0,3,9,2550,0.0,2001,1870,56628,7736 days 16:47:18.667871,196,1.6,0.0,680,0,2550.0
328000.0,2,2.25,1550,2079,2.0,3,8,1550,0.0,2008,1420,1977,5180 days 16:47:18.667871,339,0.8888888888888888,0.0,130,102,1550.0
572500.0,3,1.0,1590,4600,1.5,4,7,1290,300.0,1926,1770,4350,35130 days 16:47:18.667871,344,3.0,4.3,-180,250,990.0
600000.0,3,1.75,1650,5100,1.0,5,7,1040,610.0,1908,1540,5100,41705 days 16:47:18.667871,142,1.7142857142857142,1.7049180327868851,110,0,430.0
412000.0,4,3.0,2430,7242,2.0,3,8,2430,0.0,2003,2430,7242,7006 days 16:47:18.667871,110,1.3333333333333333,0.0,0,0,2430.0
827500.0,3,2.5,1810,7200,1.0,5,7,1310,500.0,1960,2050,7200,22712 days 16:47:18.667871,337,1.2,2.62,-240,0,810.0
300000.0,4,2.5,2890,17349,2.0,3,8,2890,0.0,1994,2330,22356,10293 days 16:47:18.667871,084,1.6,0.0,560,-5007,2890.0
415000.0,3,2.5,1280,5040,2.0,4,7,1280,0.0,1985,1500,5040,13580 days 16:47:18.667871,317,1.2,0.0,-220,0,1280.0
800000.0,3,2.75,2220,4000,2.0,3,8,1700,520.0,1914,1800,4000,39513 days 16:47:18.667871,191,1.0909090909090908,3.269230769230769,420,0,1180.0
420000.0,3,1.0,1060,6000,1.0,3,8,1060,0.0,1954,1240,7874,24903 days 16:47:18.667871,076,3.0,0.0,-180,-1874,1060.0
266000.0,3,1.5,1120,8250,1.0,4,7,1120,0.0,1957,1320,8400,23807 days 16:47:18.667871,288,2.0,0.0,-200,-150,1120.0
499000.0,4,2.5,2680,10590,2.0,3,8,2680,0.0,2004,2330,5566,6641 days 16:47:18.667871,294,1.6,0.0,350,5024,2680.0
440000.0,4,1.5,1770,5750,2.0,3,7,1770,0.0,1947,970,5750,27460 days 16:47:18.667871,177,2.6666666666666665,0.0,800,0,1770.0
495000.0,3,2.0,2950,12196,2.0,4,7,2310,640.0,1918,2320,19844,38052 days 16:47:18.667871,174,1.5,3.609375,630,-7648,1670.0
630000.0,2,1.75,1260,5300,1.0,4,7,840,420.0,1951,1280,3000,25999 days 16:47:18.667871,089,1.1428571428571428,2.0,-20,2300,420.0
424000.0,3,1.75,1430,6818,1.0,5,7,1430,0.0,1972,1480,7210,18329 days 16:47:18.667871,216,1.7142857142857142,0.0,-50,-392,1430.0
760000.0,4,2.5,2730,36183,2.0,3,9,2730,0.0,1986,2710,5964,13215 days 16:47:18.667871,155,1.6,0.0,20,30219,2730.0
650000.0,4,3.5,3270,15704,2.0,3,9,2110,1160.0,1990,3020,8582,11754 days 16:47:18.667871,231,1.1428571428571428,1.8189655172413792,250,7122,950.0
248500.0,4,1.75,1720,10018,1.0,5,7,1720,0.0,1960,1220,10018,22712 days 16:47:18.667871,127,2.2857142857142856,0.0,500,0,1720.0
379600.0,3,1.75,1270,12420,1.0,4,7,1270,0.0,1962,1560,9910,21981 days 16:47:18.667871,111,1.7142857142857142,0.0,-290,2510,1270.0
538000.0,4,2.5,3260,10032,1.0,3,8,1960,1300.0,1978,1802,7249,16137 days 16:47:18.667871,202,1.6,1.5076923076923077,1458,2783,660.0
530000.0,4,2.5,2050,6360,2.0,3,8,2050,0.0,1988,2070,7541,12485 days 16:47:18.667871,167,1.6,0.0,-20,-1181,2050.0
545000.0,4,2.25,2050,9720,2.0,3,8,2050,0.0,1967,2310,9680,20155 days 16:47:18.667871,020,1.7777777777777777,0.0,-260,40,2050.0
925000.0,4,3.0,3580,35261,1.5,3,1,3580,0.0,1985,3540,36750,13580 days 16:47:18.667871,175,1.3333333333333333,0.0,40,-1489,3580.0
565000.0,4,2.75,1960,48787,1.5,4,9,1960,0.0,1983,1970,36425,14311 days 16:47:18.667871,343,1.4545454545454546,0.0,-10,12362,1960.0
405100.0,2,1.0,840,3522,1.0,3,6,840,0.0,1947,1390,4800,27460 days 16:47:18.667871,134,2.0,0.0,-550,-1278,840.0
502000.0,3,1.75,1300,8800,1.0,4,8,1300,0.0,1963,1350,8800,21616 days 16:47:18.667871,160,1.7142857142857142,0.0,-50,0,1300.0
425000.0,3,2.25,1260,3000,2.0,3,7,1260,0.0,2003,1630,3042,7006 days 16:47:18.667871,307,1.3333333333333333,0.0,-370,-42,1260.0
233500.0,3,2.25,1650,2958,2.0,3,7,1650,0.0,1985,1510,3788,13580 days 16:47:18.667871,174,1.3333333333333333,0.0,140,-830,1650.0
287000.0,3,2.5,1710,10341,2.0,3,7,1710,0.0,1986,1830,9358,13215 days 16:47:18.667871,082,1.2,0.0,-120,983,1710.0
190000.0,3,1.0,1180,8775,1.0,3,7,1180,0.0,1966,1300,8100,20520 days 16:47:18.667871,044,3.0,0.0,-120,675,1180.0
666000.0,3,2.25,2780,31510,2.0,3,8,2780,0.0,1979,2890,36400,15772 days 16:47:18.667871,307,1.3333333333333333,0.0,-110,-4890,2780.0
330000.0,2,1.0,950,3090,1.0,4,6,950,0.0,1909,1230,4120,41339 days 16:47:18.667871,335,2.0,0.0,-280,-1030,950.0
1490000.0,5,3.5,3620,7821,2.0,3,1,2790,830.0,1958,2690,9757,23442 days 16:47:18.667871,254,1.4285714285714286,3.36144578313253,930,-1936,1960.0
393000.0,3,2.25,2140,10256,2.0,3,8,2140,0.0,1987,2040,11717,12850 days 16:47:18.667871,252,1.3333333333333333,0.0,100,-1461,2140.0
353000.0,4,2.75,1920,4627,1.0,3,8,1010,910.0,1998,1910,7210,8832 days 16:47:18.667871,267,1.4545454545454546,1.10989010989011,10,-2583,100.0
260000.0,2,1.0,750,6720,1.0,3,6,750,0.0,1916,920,6720,38783 days 16:47:18.667871,293,2.0,0.0,-170,0,750.0
680000.0,3,2.5,2060,2551,2.0,3,8,1900,160.0,2001,2060,2936,7736 days 16:47:18.667871,349,1.2,11.875,0,-385,1740.0
921000.0,3,2.25,2380,11200,1.0,4,8,2380,0.0,1963,2010,11200,21616 days 16:47:18.667871,196,1.3333333333333333,0.0,370,0,2380.0
319000.0,2,1.0,750,6380,1.0,3,7,750,0.0,1949,1690,6495,26729 days 16:47:18.667871,352,2.0,0.0,-940,-115,750.0
280000.0,3,1.0,1160,10881,1.0,2,7,920,240.0,1983,1280,10843,14311 days 16:47:18.667871,112,3.0,3.8333333333333335,-120,38,680.0
220000.0,3,1.0,1050,6300,1.0,3,6,1050,0.0,1942,740,6300,29286 days 16:47:18.667871,162,3.0,0.0,310,0,1050.0
219000.0,3,1.5,1740,5200,1.0,4,7,1060,680.0,1977,1540,5200,16502 days 16:47:18.667871,021,2.0,1.5588235294117647,200,0,380.0
528000.0,4,2.75,2050,7171,1.0,3,8,1540,510.0,1988,1960,7110,12485 days 16:47:18.667871,220,1.4545454545454546,3.019607843137255,90,61,1030.0
405000.0,3,1.75,1980,8100,1.0,4,7,1310,670.0,1949,1450,8212,26729 days 16:47:18.667871,147,1.7142857142857142,1.955223880597015,530,-112,640.0
372977.0,3,2.5,1690,1618,2.0,3,8,1150,540.0,2014,1690,1618,2988 days 16:47:18.667871,134,1.2,2.1296296296296298,0,0,610.0
934550.0,4,3.25,2320,5900,1.5,4,9,2320,0.0,1910,2320,6240,40974 days 16:47:18.667871,127,1.2307692307692308,0.0,0,-340,2320.0
1470000.0,3,1.5,2480,9900,2.0,3,1,2130,350.0,1940,2860,9288,30017 days 16:47:18.667871,037,2.0,6.085714285714285,-380,612,1780.0
975000.0,4,2.25,2290,5350,2.0,4,9,2120,170.0,1958,2910,5350,23442 days 16:47:18.667871,154,1.7777777777777777,12.470588235294118,-620,0,1950.0
800866.0,5,2.5,3180,13806,2.0,4,1,3180,0.0,1990,3180,13798,11754 days 16:47:18.667871,125,2.0,0.0,0,8,3180.0
950000.0,7,3.5,3470,16264,2.0,4,9,3470,0.0,1980,3040,13500,15407 days 16:47:18.667871,103,2.0,0.0,430,2764,3470.0
624000.0,4,3.0,1540,4140,1.5,5,7,1540,0.0,1902,1460,5000,43896 days 16:47:18.667871,247,1.3333333333333333,0.0,80,-860,1540.0
1850000.0,5,2.25,2800,8442,2.0,3,9,2800,0.0,1963,3220,9156,21616 days 16:47:18.667871,226,2.2222222222222223,0.0,-420,-714,2800.0
310000.0,3,1.0,1050,9876,1.0,3,7,1050,0.0,1953,1760,9403,25268 days 16:47:18.667871,134,3.0,0.0,-710,473,1050.0
315000.0,3,1.75,1480,6800,1.0,4,7,1480,0.0,1968,1500,7900,19790 days 16:47:18.667871,338,1.7142857142857142,0.0,-20,-1100,1480.0
675000.0,3,2.0,1010,5973,1.0,5,6,1010,0.0,1942,1920,6015,29286 days 16:47:18.667871,232,1.5,0.0,-910,-42,1010.0
490000.0,3,1.75,1660,8208,1.0,4,8,1660,0.0,1965,2210,11000,20885 days 16:47:18.667871,317,1.7142857142857142,0.0,-550,-2792,1660.0
154000.0,2,1.0,1040,20524,1.0,3,6,1040,0.0,1949,1880,38996,26729 days 16:47:18.667871,252,2.0,0.0,-840,-18472,1040.0
480000.0,4,1.75,2220,6500,2.0,4,8,2220,0.0,1964,2430,11600,21251 days 16:47:18.667871,160,2.2857142857142856,0.0,-210,-5100,2220.0
196900.0,3,1.0,1270,7500,1.0,3,6,1270,0.0,1954,1250,8000,24903 days 16:47:18.667871,044,3.0,0.0,20,-500,1270.0
735000.0,3,3.25,2960,39370,2.0,3,1,2960,0.0,1989,2960,56628,12119 days 16:47:18.667871,238,0.9230769230769231,0.0,0,-17258,2960.0
205500.0,3,2.0,1330,8748,1.0,3,7,1330,0.0,1986,1510,8584,13215 days 16:47:18.667871,058,1.5,0.0,-180,164,1330.0
357186.0,2,1.75,1210,1040,2.0,3,8,1210,0.0,2014,1210,1090,2988 days 16:47:18.667871,167,1.1428571428571428,0.0,0,-50,1210.0
275000.0,4,2.5,2120,6754,2.0,3,7,2120,0.0,1998,2120,6937,8832 days 16:47:18.667871,028,1.6,0.0,0,-183,2120.0
248500.0,3,1.75,2090,12026,1.0,4,7,2090,0.0,1948,1700,9496,27095 days 16:47:18.667871,249,1.7142857142857142,0.0,390,2530,2090.0
350000.0,3,2.5,2680,7836,2.0,3,8,2680,0.0,1990,2340,8040,11754 days 16:47:18.667871,153,1.2,0.0,340,-204,2680.0
390000.0,4,2.75,1790,47250,1.0,3,7,1220,570.0,1987,1250,43791,12850 days 16:47:18.667871,224,1.4545454545454546,2.1403508771929824,540,3459,650.0
390000.0,3,2.75,1950,12240,1.0,3,7,1250,700.0,1956,1880,12000,24173 days 16:47:18.667871,196,1.0909090909090908,1.7857142857142858,70,240,550.0
660000.0,5,2.25,3740,14913,1.5,4,9,3740,0.0,1979,2180,7600,15772 days 16:47:18.667871,103,2.2222222222222223,0.0,1560,7313,3740.0
717000.0,3,2.5,2480,5137,2.0,3,9,2480,0.0,2000,2480,6023,8102 days 16:47:18.667871,163,1.2,0.0,0,-886,2480.0
260000.0,5,2.5,2580,11250,1.0,3,7,1410,1170.0,1964,2240,11780,21251 days 16:47:18.667871,364,2.0,1.205128205128205,340,-530,240.0
745000.0,3,2.0,2290,5001,1.0,4,7,1490,800.0,1960,1230,5001,22712 days 16:47:18.667871,120,1.5,1.8625,1060,0,690.0
470000.0,4,2.5,2320,12042,1.0,4,7,1320,1000.0,1975,2160,7054,17233 days 16:47:18.667871,049,1.6,1.32,160,4988,320.0
429000.0,3,2.5,2530,8820,2.0,3,8,2530,0.0,1997,2340,9472,9197 days 16:47:18.667871,125,1.2,0.0,190,-652,2530.0
220000.0,4,2.0,1400,7140,1.0,3,7,1400,0.0,1969,1610,10500,19424 days 16:47:18.667871,098,2.0,0.0,-210,-3360,1400.0
716100.0,3,1.0,1640,4000,1.5,5,7,1640,0.0,1909,2140,4000,41339 days 16:47:18.667871,195,3.0,0.0,-500,0,1640.0
371000.0,4,1.0,1960,94525,1.5,3,6,1960,0.0,1979,2430,188564,15772 days 16:47:18.667871,254,4.0,0.0,-470,-94039,1960.0
379000.0,5,2.75,3000,25175,1.0,4,7,1500,1500.0,1961,2170,40523,22346 days 16:47:18.667871,205,1.8181818181818181,1.0,830,-15348,0.0
937500.0,3,1.0,1320,8500,1.0,4,7,1320,0.0,1954,2790,10800,24903 days 16:47:18.667871,083,3.0,0.0,-1470,-2300,1320.0
720000.0,4,2.0,1760,4500,1.5,5,7,1760,0.0,1906,1740,4220,42435 days 16:47:18.667871,300,2.0,0.0,20,280,1760.0
616000.0,3,3.25,2130,2306,2.0,5,7,1420,710.0,1924,1560,4500,35861 days 16:47:18.667871,117,0.9230769230769231,2.0,570,-2194,710.0
259000.0,3,2.0,1390,7120,1.0,3,7,1390,0.0,1988,1530,7688,12485 days 16:47:18.667871,104,1.5,0.0,-140,-568,1390.0
538000.0,3,1.75,1400,3825,1.5,4,6,1100,300.0,1904,1720,5100,43166 days 16:47:18.667871,134,1.7142857142857142,3.6666666666666665,-320,-1275,800.0
605000.0,3,2.75,3230,9576,1.5,4,8,3230,0.0,1966,2820,9576,20520 days 16:47:18.667871,127,1.0909090909090908,0.0,410,0,3230.0
369950.0,3,1.0,1110,7603,1.0,3,7,1110,0.0,1967,1260,8094,20155 days 16:47:18.667871,307,3.0,0.0,-150,-491,1110.0
310000.0,3,2.5,1670,4220,2.0,3,7,1670,0.0,2002,1670,4238,7371 days 16:47:18.667871,104,1.2,0.0,0,-18,1670.0
227500.0,3,1.0,1540,9450,1.0,4,7,1540,0.0,1960,1210,9450,22712 days 16:47:18.667871,118,3.0,0.0,330,0,1540.0
274000.0,4,2.25,2090,7400,1.0,3,9,1670,420.0,1973,2260,8000,17963 days 16:47:18.667871,325,1.7777777777777777,3.9761904761904763,-170,-600,1250.0
410000.0,3,2.0,1410,8088,1.0,3,7,1410,0.0,1987,1770,7401,12850 days 16:47:18.667871,324,1.5,0.0,-360,687,1410.0
354800.0,3,2.0,1370,78408,1.0,5,7,1370,0.0,1964,1620,9690,21251 days 16:47:18.667871,143,1.5,0.0,-250,68718,1370.0
650000.0,4,2.25,1910,5120,1.0,3,8,1300,610.0,1954,1810,5153,24903 days 16:47:18.667871,254,1.7777777777777777,2.1311475409836067,100,-33,690.0
353000.0,3,2.0,1678,13862,1.0,3,7,1678,0.0,1994,1550,11753,10293 days 16:47:18.667871,125,1.5,0.0,128,2109,1678.0
224975.0,3,1.0,960,12745,1.0,4,6,960,0.0,1977,1160,10488,16502 days 16:47:18.667871,063,3.0,0.0,-200,2257,960.0
600000.0,2,1.75,2080,13054,1.0,3,7,2080,0.0,1951,2440,13054,25999 days 16:47:18.667871,132,1.1428571428571428,0.0,-360,0,2080.0
437500.0,3,2.25,1790,7700,1.0,4,7,1340,450.0,1976,1610,7350,16868 days 16:47:18.667871,049,1.3333333333333333,2.977777777777778,180,350,890.0
567000.0,3,2.5,2540,6093,2.0,3,9,2540,0.0,1999,2540,5924,8467 days 16:47:18.667871,141,1.2,0.0,0,169,2540.0
225000.0,5,1.5,1790,11656,2.0,3,7,1790,0.0,1963,2040,9790,21616 days 16:47:18.667871,126,3.3333333333333335,0.0,-250,1866,1790.0
255000.0,2,1.0,940,9330,1.0,3,6,940,0.0,1941,1900,6145,29651 days 16:47:18.667871,249,2.0,0.0,-960,3185,940.0
2480000.0,5,3.75,6810,7500,2.5,3,1,6110,700.0,1922,2660,7500,36591 days 16:47:18.667871,063,1.3333333333333333,8.728571428571428,4150,0,5410.0
370000.0,2,1.0,900,4600,1.0,3,6,900,0.0,1951,1060,4600,25999 days 16:47:18.667871,164,2.0,0.0,-160,0,900.0
675000.0,4,1.75,1900,8800,1.0,3,8,1140,760.0,1975,2280,8800,17233 days 16:47:18.667871,111,2.2857142857142856,1.5,-380,0,380.0
285000.0,3,1.0,1440,4268,1.0,3,7,1040,400.0,1953,1370,4268,25268 days 16:47:18.667871,247,3.0,2.6,70,0,640.0
310000.0,3,1.75,2070,37904,1.0,4,7,1420,650.0,1973,2011,19110,17963 days 16:47:18.667871,127,1.7142857142857142,2.1846153846153844,59,18794,770.0
475000.0,4,2.5,2240,7245,1.0,4,7,1140,1100.0,1972,1740,7350,18329 days 16:47:18.667871,336,1.6,1.0363636363636364,500,-105,40.0
410000.0,4,2.5,3320,5034,2.0,4,7,3320,0.0,2006,2580,4950,5910 days 16:47:18.667871,128,1.6,0.0,740,84,3320.0
895000.0,4,2.25,1950,5950,1.0,3,8,1330,620.0,1947,2600,5593,27460 days 16:47:18.667871,183,1.7777777777777777,2.1451612903225805,-650,357,710.0
375000.0,3,1.5,1240,7733,1.0,3,6,790,450.0,1941,1130,7733,29651 days 16:47:18.667871,234,2.0,1.7555555555555555,110,0,340.0
349000.0,4,2.5,1830,4694,2.0,3,7,1830,0.0,2003,1830,5175,7006 days 16:47:18.667871,117,1.6,0.0,0,-481,1830.0
650500.0,3,1.75,1740,4400,1.5,3,8,1740,0.0,1903,1740,4400,43531 days 16:47:18.667871,096,1.7142857142857142,0.0,0,0,1740.0
760000.0,3,1.75,1410,15120,1.0,4,7,1410,0.0,1950,1880,15120,26364 days 16:47:18.667871,118,1.7142857142857142,0.0,-470,0,1410.0
480000.0,4,2.75,2050,3960,1.0,4,7,1180,870.0,1986,1440,5040,13215 days 16:47:18.667871,140,1.4545454545454546,1.3563218390804597,610,-1080,310.0
689000.0,4,2.75,3220,16145,2.0,3,1,3220,0.0,1993,3200,12921,10658 days 16:47:18.667871,269,1.4545454545454546,0.0,20,3224,3220.0
415000.0,3,1.75,1960,5000,1.0,5,6,980,980.0,1911,1790,5000,40609 days 16:47:18.667871,133,1.7142857142857142,1.0,170,0,0.0
195000.0,3,1.75,1070,6110,1.0,4,7,1070,0.0,1968,1350,6148,19790 days 16:47:18.667871,117,1.7142857142857142,0.0,-280,-38,1070.0
318000.0,5,2.5,2820,9956,1.0,4,7,1410,1410.0,1967,2700,9956,20155 days 16:47:18.667871,212,2.0,1.0,120,0,0.0
404000.0,4,3.0,4060,35621,1.0,3,9,2030,2030.0,1989,2950,35259,12119 days 16:47:18.667871,143,1.3333333333333333,1.0,1110,362,0.0
339950.0,2,1.0,800,3090,1.0,4,6,800,0.0,1925,1400,3090,35495 days 16:47:18.667871,303,2.0,0.0,-600,0,800.0
215000.0,3,1.0,1260,7897,1.0,3,7,1260,0.0,1979,1560,8285,15772 days 16:47:18.667871,328,3.0,0.0,-300,-388,1260.0
339900.0,3,2.5,2420,7423,2.0,3,8,2420,0.0,1990,2260,7629,11754 days 16:47:18.667871,230,1.2,0.0,160,-206,2420.0
285000.0,1,1.5,810,3211,2.0,4,7,810,0.0,1982,1320,3298,14676 days 16:47:18.667871,139,0.6666666666666666,0.0,-510,-87,810.0
550000.0,3,1.0,1600,5000,1.5,3,7,1110,490.0,1947,1380,5000,27460 days 16:47:18.667871,197,3.0,2.2653061224489797,220,0,620.0
219000.0,3,1.0,970,7790,1.0,3,6,970,0.0,1967,1150,8160,20155 days 16:47:18.667871,336,3.0,0.0,-180,-370,970.0
555000.0,2,1.5,1780,4750,1.0,4,7,1080,700.0,1947,1690,5962,27460 days 16:47:18.667871,227,1.3333333333333333,1.542857142857143,90,-1212,380.0
233000.0,3,2.0,1350,7686,1.0,3,7,1350,0.0,1989,1470,7686,12119 days 16:47:18.667871,202,1.5,0.0,-120,0,1350.0
248000.0,3,1.75,1840,19501,1.0,4,8,1270,570.0,1972,1910,12000,18329 days 16:47:18.667871,092,1.7142857142857142,2.2280701754385963,-70,7501,700.0
454000.0,5,2.25,2550,9200,1.0,4,8,1580,970.0,1975,2090,9200,17233 days 16:47:18.667871,112,2.2222222222222223,1.6288659793814433,460,0,610.0
950000.0,4,2.5,1700,4418,2.0,3,8,1700,0.0,1931,2090,4174,33304 days 16:47:18.667871,090,1.6,0.0,-390,244,1700.0
359000.0,3,2.5,2430,7857,2.0,5,8,1730,700.0,1980,2160,8740,15407 days 16:47:18.667871,258,1.2,2.4714285714285715,270,-883,1030.0
407500.0,5,2.0,2740,8230,1.5,3,7,2210,530.0,1962,2130,8232,21981 days 16:47:18.667871,246,2.5,4.169811320754717,610,-2,1680.0
224000.0,3,1.5,1560,7300,1.0,4,7,1040,520.0,1964,1460,7910,21251 days 16:47:18.667871,148,2.0,2.0,100,-610,520.0
210000.0,2,1.0,1040,4590,1.0,3,7,1040,0.0,1954,1040,6120,24903 days 16:47:18.667871,199,2.0,0.0,0,-1530,1040.0
261000.0,4,1.75,1820,9824,1.0,5,7,1820,0.0,1968,1410,11013,19790 days 16:47:18.667871,023,2.2857142857142856,0.0,410,-1189,1820.0
719000.0,3,3.0,1833,1706,3.0,3,9,1833,0.0,1998,1466,1455,8832 days 16:47:18.667871,218,1.0,0.0,367,251,1833.0
440000.0,3,2.5,2160,3738,2.0,3,8,2160,0.0,1994,1500,4000,10293 days 16:47:18.667871,034,1.2,0.0,660,-262,2160.0
525000.0,3,2.75,2100,10362,2.0,3,9,1510,590.0,1998,2240,11842,8832 days 16:47:18.667871,141,1.0909090909090908,2.559322033898305,-140,-1480,920.0
375000.0,3,1.5,1370,9720,2.0,3,7,1370,0.0,1968,1510,8775,19790 days 16:47:18.667871,202,2.0,0.0,-140,945,1370.0
428000.0,2,2.5,1414,1960,2.0,3,8,1414,0.0,1986,1414,2511,13215 days 16:47:18.667871,090,0.8,0.0,0,-551,1414.0
988830.0,5,3.25,4115,7910,2.0,3,9,4115,0.0,2014,3950,6765,2988 days 16:47:18.667871,322,1.5384615384615385,0.0,165,1145,4115.0
199950.0,3,1.75,1550,6225,1.0,4,7,1550,0.0,1949,1760,9496,26729 days 16:47:18.667871,277,1.7142857142857142,0.0,-210,-3271,1550.0
840000.0,4,2.25,2100,3671,1.5,3,8,1750,350.0,1929,1800,4560,34034 days 16:47:18.667871,301,1.7777777777777777,5.0,300,-889,1400.0
285000.0,3,1.75,1160,7006,1.0,4,7,1160,0.0,1992,1670,7750,11024 days 16:47:18.667871,251,1.7142857142857142,0.0,-510,-744,1160.0
330000.0,5,2.5,3597,4972,2.0,3,7,3597,0.0,2006,3193,6000,5910 days 16:47:18.667871,258,2.0,0.0,404,-1028,3597.0
147500.0,3,1.5,1230,10125,1.0,3,7,1230,0.0,1960,1970,10125,22712 days 16:47:18.667871,002,2.0,0.0,-740,0,1230.0
320000.0,4,2.5,2190,7125,2.0,5,8,2190,0.0,1978,2190,8075,16137 days 16:47:18.667871,311,1.6,0.0,0,-950,2190.0
382500.0,3,1.75,1040,9000,1.0,4,7,1040,0.0,1967,1750,10878,20155 days 16:47:18.667871,182,1.7142857142857142,0.0,-710,-1878,1040.0
2050000.0,5,4.0,4690,8208,2.0,3,9,3040,1650.0,1926,3300,8001,35130 days 16:47:18.667871,083,1.25,1.8424242424242425,1390,207,1390.0
596000.0,4,2.25,2270,10000,1.0,5,8,1720,550.0,1974,2270,10148,17598 days 16:47:18.667871,226,1.7777777777777777,3.1272727272727274,0,-148,1170.0
220000.0,4,2.25,1950,7280,2.0,4,8,1950,0.0,1979,1910,7280,15772 days 16:47:18.667871,315,1.7777777777777777,0.0,40,0,1950.0
325000.0,3,2.5,1880,6818,2.0,3,8,1880,0.0,1993,1970,7000,10658 days 16:47:18.667871,268,1.2,0.0,-90,-182,1880.0
679950.0,4,2.5,2850,5664,2.0,3,9,2850,0.0,2001,2850,5475,7736 days 16:47:18.667871,085,1.6,0.0,0,189,2850.0
175000.0,2,1.0,1160,6911,1.0,3,7,1160,0.0,1947,1120,6948,27460 days 16:47:18.667871,049,2.0,0.0,40,-37,1160.0
268000.0,3,1.75,1370,10050,1.0,4,7,1370,0.0,1966,1720,10050,20520 days 16:47:18.667871,335,1.7142857142857142,0.0,-350,0,1370.0
715000.0,4,3.5,3260,110579,2.0,3,1,3260,0.0,1997,3470,97895,9197 days 16:47:18.667871,262,1.1428571428571428,0.0,-210,12684,3260.0
600000.0,7,2.25,3170,36384,2.0,3,8,3170,0.0,1969,2460,38370,19424 days 16:47:18.667871,098,3.111111111111111,0.0,710,-1986,3170.0
950000.0,5,2.5,3450,35880,2.0,3,1,3450,0.0,1992,3450,26820,11024 days 16:47:18.667871,063,2.0,0.0,0,9060,3450.0
475000.0,2,1.75,1490,224334,1.0,3,8,1490,0.0,1983,2350,213879,14311 days 16:47:18.667871,161,1.1428571428571428,0.0,-860,10455,1490.0
700000.0,3,1.5,1460,78408,1.0,4,7,1460,0.0,1963,3320,7787,21616 days 16:47:18.667871,092,2.0,0.0,-1860,70621,1460.0
275000.0,3,1.75,1300,20700,1.0,3,7,1300,0.0,1962,1930,37638,21981 days 16:47:18.667871,239,1.7142857142857142,0.0,-630,-16938,1300.0
369500.0,3,1.75,1300,20700,1.0,3,7,1300,0.0,1962,1930,37638,21981 days 16:47:18.667871,077,1.7142857142857142,0.0,-630,-16938,1300.0
215000.0,4,2.0,1540,7575,1.0,4,7,1040,500.0,1978,1720,7575,16137 days 16:47:18.667871,202,2.0,2.08,-180,0,540.0
593450.0,4,2.25,2130,7172,2.0,4,8,2130,0.0,1964,1910,7653,21251 days 16:47:18.667871,112,1.7777777777777777,0.0,220,-481,2130.0
498800.0,2,1.75,1350,4614,1.0,3,8,1350,0.0,2008,1680,4775,5180 days 16:47:18.667871,190,1.1428571428571428,0.0,-330,-161,1350.0
849000.0,5,3.25,2450,6534,2.0,3,8,1770,680.0,1951,1620,6534,25999 days 16:47:18.667871,342,1.5384615384615385,2.6029411764705883,830,0,1090.0
1150000.0,4,2.5,1940,4875,2.0,4,9,1940,0.0,1925,1790,4875,35495 days 16:47:18.667871,363,1.6,0.0,150,0,1940.0
825000.0,5,2.5,2890,5110,2.0,3,9,2890,0.0,2003,3010,5110,7006 days 16:47:18.667871,196,2.0,0.0,-120,0,2890.0
265000.0,3,1.75,1680,9769,1.0,3,8,1340,340.0,1989,1730,9686,12119 days 16:47:18.667871,055,1.7142857142857142,3.9411764705882355,-50,83,1000.0
285000.0,4,2.25,1960,10400,1.0,4,8,1220,740.0,1985,1650,8660,13580 days 16:47:18.667871,357,1.7777777777777777,1.6486486486486487,310,1740,480.0
240000.0,3,1.75,1590,7931,1.0,3,7,1190,400.0,1979,1680,7931,15772 days 16:47:18.667871,365,1.7142857142857142,2.975,-90,0,790.0
261000.0,4,1.0,1390,17739,1.0,3,7,1390,0.0,1958,1230,7840,23442 days 16:47:18.667871,202,4.0,0.0,160,9899,1390.0
330000.0,4,1.75,2440,7350,1.0,3,8,1610,830.0,1978,2180,7680,16137 days 16:47:18.667871,178,2.2857142857142856,1.9397590361445782,260,-330,780.0
250000.0,4,2.0,1850,7560,1.0,4,7,1540,310.0,1978,1620,7658,16137 days 16:47:18.667871,153,2.0,4.967741935483871,230,-98,1230.0
350000.0,4,2.5,2800,9538,2.0,3,8,2800,0.0,1993,1970,7750,10658 days 16:47:18.667871,191,1.6,0.0,830,1788,2800.0
930000.0,3,2.5,3780,35273,1.5,3,1,3780,0.0,1986,3450,35273,13215 days 16:47:18.667871,268,1.2,0.0,330,0,3780.0
275000.0,3,2.0,1910,8050,1.0,4,7,1000,910.0,1980,1780,7344,15407 days 16:47:18.667871,303,1.5,1.098901098901099,130,706,90.0
325000.0,4,2.25,2460,7620,1.0,3,7,1230,1230.0,1969,2090,7620,19424 days 16:47:18.667871,054,1.7777777777777777,1.0,370,0,0.0
255000.0,1,1.0,810,5000,1.0,3,7,590,220.0,1936,1920,5000,31478 days 16:47:18.667871,114,1.0,2.6818181818181817,-1110,0,370.0
562200.0,3,1.5,1900,5250,1.0,4,7,1500,400.0,1943,1810,5250,28921 days 16:47:18.667871,079,2.0,3.75,90,0,1100.0
952000.0,2,1.75,3490,88909,1.0,3,1,2320,1170.0,1980,3490,40185,15407 days 16:47:18.667871,232,1.1428571428571428,1.982905982905983,0,48724,1150.0
365000.0,3,2.5,2200,7350,1.0,5,8,1570,630.0,1988,2350,7557,12485 days 16:47:18.667871,124,1.2,2.492063492063492,-150,-207,940.0
332900.0,3,1.5,1190,11996,1.0,4,7,1190,0.0,1969,1190,9756,19424 days 16:47:18.667871,075,2.0,0.0,0,2240,1190.0
721000.0,3,2.25,2040,18360,2.0,4,8,2040,0.0,1983,2590,21315,14311 days 16:47:18.667871,113,1.3333333333333333,0.0,-550,-2955,2040.0
487275.0,4,2.5,2400,3986,2.0,3,8,2400,0.0,1999,2070,3986,8467 days 16:47:18.667871,111,1.6,0.0,330,0,2400.0
310000.0,3,2.5,1670,5791,2.0,3,7,1670,0.0,1995,1610,6034,9928 days 16:47:18.667871,119,1.2,0.0,60,-243,1670.0
245000.0,2,1.0,990,4800,1.0,3,6,990,0.0,1908,1700,5400,41705 days 16:47:18.667871,015,2.0,0.0,-710,-600,990.0
325000.0,3,1.75,2920,10573,1.0,4,7,2920,0.0,1964,1560,10572,21251 days 16:47:18.667871,105,1.7142857142857142,0.0,1360,1,2920.0
550000.0,3,1.75,1840,9401,1.0,3,8,1840,0.0,1971,2850,14323,18694 days 16:47:18.667871,316,1.7142857142857142,0.0,-1010,-4922,1840.0
350000.0,2,1.0,910,4500,1.5,4,7,910,0.0,1906,1270,3500,42435 days 16:47:18.667871,132,2.0,0.0,-360,1000,910.0
599000.0,5,2.5,2950,72309,2.0,3,8,2950,0.0,2006,1480,56192,5910 days 16:47:18.667871,195,2.0,0.0,1470,16117,2950.0
259950.0,3,1.5,1240,9500,1.0,4,7,1240,0.0,1955,1845,10125,24538 days 16:47:18.667871,316,2.0,0.0,-605,-625,1240.0
240000.0,4,2.5,1980,7264,2.0,3,7,1980,0.0,1996,1600,6380,9563 days 16:47:18.667871,335,1.6,0.0,380,884,1980.0
186000.0,3,1.0,1200,10080,1.0,4,7,1200,0.0,1969,1230,9800,19424 days 16:47:18.667871,042,3.0,0.0,-30,280,1200.0
395000.0,3,1.5,1280,15028,1.0,3,7,1280,0.0,1982,1470,13698,14676 days 16:47:18.667871,035,2.0,0.0,-190,1330,1280.0
475000.0,4,2.5,3150,5757,2.0,3,9,3150,0.0,2004,3100,5757,6641 days 16:47:18.667871,258,1.6,0.0,50,0,3150.0
815000.0,5,3.5,3500,10794,2.0,3,1,3500,0.0,1996,3110,10837,9563 days 16:47:18.667871,216,1.4285714285714286,0.0,390,-43,3500.0
572000.0,3,1.5,1680,13751,1.0,4,7,1680,0.0,1951,1760,13500,25999 days 16:47:18.667871,245,2.0,0.0,-80,251,1680.0
419500.0,3,2.5,1360,3188,2.0,3,7,1360,0.0,1986,1090,3188,13215 days 16:47:18.667871,290,1.2,0.0,270,0,1360.0
298700.0,3,2.25,2110,7350,1.0,3,8,1530,580.0,1980,2640,7777,15407 days 16:47:18.667871,246,1.3333333333333333,2.6379310344827585,-530,-427,950.0
549000.0,2,1.0,2034,13392,1.0,5,7,1159,875.0,1947,1156,15961,27460 days 16:47:18.667871,175,2.0,1.3245714285714285,878,-2569,284.0
278000.0,3,1.5,1900,9994,1.0,3,7,1120,780.0,1960,1900,9994,22712 days 16:47:18.667871,112,2.0,1.435897435897436,0,0,340.0
455000.0,4,2.0,2380,4500,1.5,3,6,1470,910.0,1926,1300,4500,35130 days 16:47:18.667871,364,2.0,1.6153846153846154,1080,0,560.0
465000.0,2,1.5,1120,1201,3.0,3,8,1120,0.0,1999,1370,1298,8467 days 16:47:18.667871,105,1.3333333333333333,0.0,-250,-97,1120.0
620000.0,4,4.0,2850,2970,2.0,3,8,2120,730.0,1999,2380,3559,8467 days 16:47:18.667871,274,1.0,2.904109589041096,470,-589,1390.0
620000.0,5,3.0,2540,11422,1.0,3,8,1270,1270.0,1962,2090,10741,21981 days 16:47:18.667871,037,1.6666666666666667,1.0,450,681,0.0
450000.0,3,1.75,1160,6120,1.0,3,7,1040,120.0,1941,1530,6120,29651 days 16:47:18.667871,312,1.7142857142857142,8.666666666666666,-370,0,920.0
690000.0,4,3.5,2710,2147,2.0,3,1,2220,490.0,2007,2650,2252,5545 days 16:47:18.667871,051,1.1428571428571428,4.530612244897959,60,-105,1730.0
1900000.0,5,2.25,3120,16672,2.0,4,9,3120,0.0,1969,3740,17853,19424 days 16:47:18.667871,133,2.2222222222222223,0.0,-620,-1181,3120.0
1940000.0,5,2.25,3120,16672,2.0,4,9,3120,0.0,1969,3740,17853,19424 days 16:47:18.667871,072,2.2222222222222223,0.0,-620,-1181,3120.0
832500.0,3,2.0,1870,9527,1.0,4,7,1870,0.0,1951,1970,11904,25999 days 16:47:18.667871,230,1.5,0.0,-100,-2377,1870.0
245000.0,3,1.0,1010,9678,1.0,5,7,1010,0.0,1955,1010,9375,24538 days 16:47:18.667871,311,3.0,0.0,0,303,1010.0
820000.0,3,2.5,2980,18935,1.5,3,1,2980,0.0,1990,3670,18225,11754 days 16:47:18.667871,290,1.2,0.0,-690,710,2980.0
369000.0,4,2.75,2420,6495,2.0,3,8,2420,0.0,2005,2420,6200,6275 days 16:47:18.667871,219,1.4545454545454546,0.0,0,295,2420.0
1050000.0,4,3.25,3830,8331,2.0,3,9,3830,0.0,2014,4080,8425,2988 days 16:47:18.667871,288,1.2307692307692308,0.0,-250,-94,3830.0
653000.0,3,3.0,3040,5067,3.0,3,1,3040,0.0,1993,1820,5998,10658 days 16:47:18.667871,260,1.0,0.0,1220,-931,3040.0
220650.0,2,1.75,1460,10500,1.0,3,7,1460,0.0,1980,1340,9600,15407 days 16:47:18.667871,112,1.1428571428571428,0.0,120,900,1460.0
300000.0,5,3.0,1940,6355,1.0,3,8,1200,740.0,2007,1940,5033,5545 days 16:47:18.667871,167,1.6666666666666667,1.6216216216216217,0,1322,460.0
970000.0,4,3.5,3780,20023,2.0,3,1,3780,0.0,2001,2150,3675,7736 days 16:47:18.667871,255,1.1428571428571428,0.0,1630,16348,3780.0
360000.0,4,2.5,1950,5451,2.0,3,7,1950,0.0,2004,2240,6221,6641 days 16:47:18.667871,328,1.6,0.0,-290,-770,1950.0
672500.0,3,2.5,2450,5760,2.0,3,9,2450,0.0,2000,2450,5762,8102 days 16:47:18.667871,089,1.2,0.0,0,-2,2450.0
268000.0,4,1.5,1730,7020,1.5,4,5,1730,0.0,1953,1110,7020,25268 days 16:47:18.667871,113,2.6666666666666665,0.0,620,0,1730.0
440000.0,4,1.5,1690,3245,1.5,3,8,1690,0.0,1929,1380,1590,34034 days 16:47:18.667871,336,2.6666666666666665,0.0,310,1655,1690.0
1400000.0,3,2.5,2550,7200,2.0,3,1,2550,0.0,1981,2030,3500,15041 days 16:47:18.667871,134,1.2,0.0,520,3700,2550.0
359000.0,4,2.25,2710,22860,1.0,4,7,1850,860.0,1962,1700,22860,21981 days 16:47:18.667871,027,1.7777777777777777,2.1511627906976742,1010,0,990.0
266500.0,4,1.75,1880,7632,1.0,4,7,1180,700.0,1978,1840,8528,16137 days 16:47:18.667871,149,2.2857142857142856,1.6857142857142857,40,-896,480.0
635000.0,4,2.5,2930,8679,2.0,3,8,2930,0.0,2014,2030,7264,2988 days 16:47:18.667871,350,1.6,0.0,900,1415,2930.0
559000.0,3,2.5,3110,217800,2.0,3,9,3110,0.0,2001,2220,217800,7736 days 16:47:18.667871,286,1.2,0.0,890,0,3110.0
895000.0,4,2.5,3480,38985,2.0,3,1,3480,0.0,1989,3630,36290,12119 days 16:47:18.667871,352,1.6,0.0,-150,2695,3480.0
625000.0,2,1.5,1110,118047,1.0,3,7,1110,0.0,1961,2970,43500,22346 days 16:47:18.667871,027,1.3333333333333333,0.0,-1860,74547,1110.0
650000.0,4,2.25,2440,9320,1.0,4,7,1880,560.0,1957,1530,9335,23807 days 16:47:18.667871,071,1.7777777777777777,3.357142857142857,910,-15,1320.0
312500.0,4,1.75,2280,7840,1.0,3,7,1280,1000.0,1957,2120,7260,23807 days 16:47:18.667871,055,2.2857142857142856,1.28,160,580,280.0
225000.0,3,1.0,900,6099,1.0,3,6,790,110.0,1944,1240,6099,28556 days 16:47:18.667871,268,3.0,7.181818181818182,-340,0,680.0
425000.0,4,1.75,1980,8400,1.0,3,7,1330,650.0,1968,1920,8400,19790 days 16:47:18.667871,323,2.2857142857142856,2.046153846153846,60,0,680.0
329999.0,3,2.75,3360,41250,1.0,4,7,1820,1540.0,1988,2580,98881,12485 days 16:47:18.667871,050,1.0909090909090908,1.1818181818181819,780,-57631,280.0
572000.0,5,2.25,2340,9225,2.0,3,8,2340,0.0,1973,2140,9348,17963 days 16:47:18.667871,197,2.2222222222222223,0.0,200,-123,2340.0
386500.0,4,2.5,3110,5048,2.0,3,8,3110,0.0,2002,3110,5190,7371 days 16:47:18.667871,097,1.6,0.0,0,-142,3110.0
452000.0,2,1.0,980,5000,1.0,3,6,980,0.0,1904,1270,4500,43166 days 16:47:18.667871,021,2.0,0.0,-290,500,980.0
278000.0,4,2.0,1480,6324,1.0,3,7,1480,0.0,1943,1480,3600,28921 days 16:47:18.667871,346,2.0,0.0,0,2724,1480.0
474900.0,3,2.25,1800,43647,1.0,4,8,1800,0.0,1976,2480,25608,16868 days 16:47:18.667871,154,1.3333333333333333,0.0,-680,18039,1800.0
450000.0,2,1.75,2130,6574,1.0,3,8,1500,630.0,1946,2130,6275,27825 days 16:47:18.667871,104,1.1428571428571428,2.380952380952381,0,299,870.0
611000.0,2,1.0,1270,5100,1.0,3,7,1100,170.0,1900,1670,3900,44626 days 16:47:18.667871,308,2.0,6.470588235294118,-400,1200,930.0
214100.0,2,2.5,1150,2064,2.0,3,7,1150,0.0,2004,1880,2855,6641 days 16:47:18.667871,156,0.8,0.0,-730,-791,1150.0
317000.0,3,2.5,1840,5011,2.0,3,8,1840,0.0,2012,2000,4793,3719 days 16:47:18.667871,134,1.2,0.0,-160,218,1840.0
1000000.0,4,3.5,3180,12528,2.0,4,9,2060,1120.0,1979,2850,11410,15772 days 16:47:18.667871,064,1.1428571428571428,1.8392857142857142,330,1118,940.0
1000000.0,5,2.75,1510,5700,2.0,4,7,1510,0.0,1946,2190,5700,27825 days 16:47:18.667871,114,1.8181818181818181,0.0,-680,0,1510.0
525000.0,4,2.5,3070,7200,2.0,3,8,3070,0.0,2005,2590,7200,6275 days 16:47:18.667871,125,1.6,0.0,480,0,3070.0
436000.0,3,2.25,1800,6680,2.0,3,8,1800,0.0,1983,1630,8621,14311 days 16:47:18.667871,274,1.3333333333333333,0.0,170,-1941,1800.0
450000.0,3,1.75,1540,9154,1.0,3,8,1540,0.0,1983,1990,10273,14311 days 16:47:18.667871,199,1.7142857142857142,0.0,-450,-1119,1540.0
588500.0,3,1.75,2330,14892,1.0,3,8,1970,360.0,1980,2570,14217,15407 days 16:47:18.667871,122,1.7142857142857142,5.472222222222222,-240,675,1610.0
340000.0,4,1.75,1400,8374,1.0,3,7,1400,0.0,1953,1420,8360,25268 days 16:47:18.667871,131,2.2857142857142856,0.0,-20,14,1400.0
482000.0,4,2.5,2846,85377,1.5,3,8,1976,870.0,2000,1696,57934,8102 days 16:47:18.667871,195,1.6,2.2712643678160918,1150,27443,1106.0
1580000.0,4,3.5,5830,131116,2.0,3,1,5830,0.0,2005,5340,207206,6275 days 16:47:18.667871,347,1.1428571428571428,0.0,490,-76090,5830.0
749000.0,3,2.5,3380,7126,2.0,3,8,3380,0.0,1965,1810,7308,20885 days 16:47:18.667871,223,1.2,0.0,1570,-182,3380.0
330000.0,3,1.5,1440,7875,1.0,4,8,1440,0.0,1968,1800,8964,19790 days 16:47:18.667871,131,2.0,0.0,-360,-1089,1440.0
568000.0,3,2.5,1740,1279,3.0,3,8,1740,0.0,2008,1740,1280,5180 days 16:47:18.667871,233,1.2,0.0,0,-1,1740.0
239000.0,3,1.75,1470,8925,1.0,4,7,1470,0.0,1957,1430,9282,23807 days 16:47:18.667871,267,1.7142857142857142,0.0,40,-357,1470.0
528000.0,3,2.5,2810,4932,2.0,3,8,2810,0.0,2003,2470,4919,7006 days 16:47:18.667871,007,1.2,0.0,340,13,2810.0
385000.0,4,3.0,2090,5102,1.0,3,7,1350,740.0,1994,2090,5102,10293 days 16:47:18.667871,211,1.3333333333333333,1.8243243243243243,0,0,610.0
825000.0,4,3.25,4110,14219,2.0,4,1,2570,1540.0,1979,2760,12283,15772 days 16:47:18.667871,245,1.2307692307692308,1.6688311688311688,1350,1936,1030.0
815000.0,5,3.25,3230,5000,2.0,3,9,2350,880.0,2002,1520,5000,7371 days 16:47:18.667871,330,1.5384615384615385,2.6704545454545454,1710,0,1470.0
690000.0,3,1.75,2070,6000,1.0,3,8,1340,730.0,1955,2200,6000,24538 days 16:47:18.667871,280,1.7142857142857142,1.8356164383561644,-130,0,610.0
210000.0,3,1.0,1660,7440,1.0,3,7,1270,390.0,1957,1540,7440,23807 days 16:47:18.667871,084,3.0,3.2564102564102564,120,0,880.0
599000.0,4,1.0,1590,4280,1.5,3,7,1590,0.0,1924,2230,4280,35861 days 16:47:18.667871,106,4.0,0.0,-640,0,1590.0
860000.0,3,1.75,1860,5584,1.0,3,8,1310,550.0,1951,1630,6022,25999 days 16:47:18.667871,043,1.7142857142857142,2.381818181818182,230,-438,760.0
147200.0,3,1.0,1420,9600,1.0,4,6,1420,0.0,1954,1400,8415,24903 days 16:47:18.667871,043,3.0,0.0,20,1185,1420.0
476900.0,3,1.0,1240,5758,1.5,4,6,960,280.0,1910,1460,5750,40974 days 16:47:18.667871,126,3.0,3.4285714285714284,-220,8,680.0
450000.0,4,2.5,2500,36254,1.0,4,8,1590,910.0,1978,2360,36254,16137 days 16:47:18.667871,219,1.6,1.7472527472527473,140,0,680.0
570000.0,4,2.5,2640,11816,2.0,3,8,2640,0.0,1999,2400,11816,8467 days 16:47:18.667871,126,1.6,0.0,240,0,2640.0
567500.0,3,1.0,1440,3060,1.5,4,7,1440,0.0,1910,1440,3570,40974 days 16:47:18.667871,289,3.0,0.0,0,-510,1440.0
790000.0,5,3.25,3030,20446,2.0,3,9,2130,900.0,1976,2890,20908,16868 days 16:47:18.667871,296,1.5384615384615385,2.3666666666666667,140,-462,1230.0
875000.0,3,1.5,1820,12686,1.0,4,7,1820,0.0,1952,3020,11550,25634 days 16:47:18.667871,188,2.0,0.0,-1200,1136,1820.0
490000.0,3,2.0,2220,10275,2.0,3,9,1640,580.0,1980,2300,9975,15407 days 16:47:18.667871,161,1.5,2.8275862068965516,-80,300,1060.0
335000.0,3,1.75,2430,9133,1.0,4,7,1410,1020.0,1978,1980,9592,16137 days 16:47:18.667871,161,1.7142857142857142,1.3823529411764706,450,-459,390.0
550000.0,3,1.75,1670,10798,1.0,4,8,1670,0.0,1962,2290,10798,21981 days 16:47:18.667871,105,1.7142857142857142,0.0,-620,0,1670.0
385000.0,3,1.75,1180,10541,1.0,4,7,940,240.0,1981,1230,10879,15041 days 16:47:18.667871,136,1.7142857142857142,3.9166666666666665,-50,-338,700.0
395000.0,3,1.75,1620,8085,1.0,3,7,1210,410.0,1976,1700,8085,16868 days 16:47:18.667871,199,1.7142857142857142,2.951219512195122,-80,0,800.0
650000.0,2,1.0,1030,5750,1.0,5,8,1030,0.0,1928,1570,5750,34400 days 16:47:18.667871,162,2.0,0.0,-540,0,1030.0
637000.0,4,2.75,2900,5803,2.0,3,9,2900,0.0,2007,2900,6212,5545 days 16:47:18.667871,063,1.4545454545454546,0.0,0,-409,2900.0
692500.0,3,2.25,3420,9900,1.0,3,9,1710,1710.0,1963,2290,10700,21616 days 16:47:18.667871,287,1.3333333333333333,1.0,1130,-800,0.0
322400.0,3,1.75,1710,15844,1.0,4,8,1710,0.0,1964,1990,20359,21251 days 16:47:18.667871,273,1.7142857142857142,0.0,-280,-4515,1710.0
233500.0,3,1.5,1580,10517,1.0,4,6,1580,0.0,1957,1400,10658,23807 days 16:47:18.667871,248,2.0,0.0,180,-141,1580.0
400000.0,3,2.0,1230,11413,1.0,3,7,990,240.0,1984,1570,11517,13946 days 16:47:18.667871,175,1.5,4.125,-340,-104,750.0
547000.0,5,2.5,2200,4080,1.5,5,7,1420,780.0,1916,1300,4080,38783 days 16:47:18.667871,171,2.0,1.8205128205128205,900,0,640.0
519000.0,5,2.25,2570,13054,1.0,3,8,1470,1100.0,1950,2570,19807,26364 days 16:47:18.667871,183,2.2222222222222223,1.3363636363636364,0,-6753,370.0
699000.0,5,2.75,2970,36817,2.0,4,8,2970,0.0,1978,2730,29150,16137 days 16:47:18.667871,078,1.8181818181818181,0.0,240,7667,2970.0
525000.0,3,1.75,1970,8000,1.0,4,8,1970,0.0,1968,1910,8000,19790 days 16:47:18.667871,282,1.7142857142857142,0.0,60,0,1970.0
430000.0,4,3.0,3220,8936,2.0,3,9,2450,770.0,1990,2810,10500,11754 days 16:47:18.667871,142,1.3333333333333333,3.1818181818181817,410,-1564,1680.0
325000.0,3,1.0,1600,7500,1.0,3,7,1600,0.0,1966,2050,7200,20520 days 16:47:18.667871,349,3.0,0.0,-450,300,1600.0
279000.0,2,1.0,670,6300,1.0,5,6,670,0.0,1942,760,6300,29286 days 16:47:18.667871,191,2.0,0.0,-90,0,670.0
805000.0,4,1.75,2360,4750,2.0,5,7,1660,700.0,1911,1810,4750,40609 days 16:47:18.667871,070,2.2857142857142856,2.3714285714285714,550,0,960.0
419950.0,3,3.0,2150,3962,1.5,3,7,1540,610.0,1949,1730,4609,26729 days 16:47:18.667871,035,1.0,2.5245901639344264,420,-647,930.0
425000.0,2,1.0,620,4455,1.0,3,6,620,0.0,1927,1180,5000,34765 days 16:47:18.667871,106,2.0,0.0,-560,-545,620.0
446000.0,4,1.75,1730,5922,2.0,5,7,1730,0.0,1949,1700,6127,26729 days 16:47:18.667871,205,2.2857142857142856,0.0,30,-205,1730.0
455000.0,5,2.0,2500,7860,1.0,3,7,1040,1460.0,1963,2060,9684,21616 days 16:47:18.667871,061,2.5,0.7123287671232876,440,-1824,-420.0
226550.0,3,1.0,990,4440,1.0,3,6,990,0.0,1943,990,6771,28921 days 16:47:18.667871,190,3.0,0.0,0,-2331,990.0
764000.0,3,2.0,1420,4080,1.5,5,8,1420,0.0,1904,1220,3060,43166 days 16:47:18.667871,273,1.5,0.0,200,1020,1420.0
439950.0,3,2.25,2170,15000,2.0,4,8,2170,0.0,1978,2430,14256,16137 days 16:47:18.667871,125,1.3333333333333333,0.0,-260,744,2170.0
453000.0,4,2.0,1880,5100,1.0,3,8,1880,0.0,1952,1610,4590,25634 days 16:47:18.667871,350,2.0,0.0,270,510,1880.0
219950.0,3,1.0,1300,9620,1.0,3,7,1300,0.0,1971,1420,9620,18694 days 16:47:18.667871,037,3.0,0.0,-120,0,1300.0
702500.0,3,1.5,2360,6750,2.0,5,7,1930,430.0,1926,1320,4500,35130 days 16:47:18.667871,134,2.0,4.488372093023256,1040,2250,1500.0
285000.0,3,1.5,1780,12231,1.0,4,8,1780,0.0,1956,2460,12663,24173 days 16:47:18.667871,289,2.0,0.0,-680,-432,1780.0
320000.0,2,1.0,950,5316,1.0,3,7,950,0.0,1948,1620,6085,27095 days 16:47:18.667871,177,2.0,0.0,-670,-769,950.0
425000.0,3,1.75,1680,14630,1.5,3,8,1680,0.0,1985,1920,14630,13580 days 16:47:18.667871,350,1.7142857142857142,0.0,-240,0,1680.0
540000.0,4,2.5,2290,4450,2.0,3,9,2290,0.0,2004,2570,5096,6641 days 16:47:18.667871,197,1.6,0.0,-280,-646,2290.0
1060000.0,4,5.25,4140,14757,2.0,3,1,4140,0.0,2005,4440,15523,6275 days 16:47:18.667871,344,0.7619047619047619,0.0,-300,-766,4140.0
1170000.0,4,3.75,3920,4500,3.0,3,8,3920,0.0,2013,2040,3000,3353 days 16:47:18.667871,084,1.0666666666666667,0.0,1880,1500,3920.0
576000.0,3,1.75,1500,13891,1.0,4,7,1500,0.0,1951,2020,13891,25999 days 16:47:18.667871,111,1.7142857142857142,0.0,-520,0,1500.0
525000.0,3,1.75,1720,7200,1.0,3,7,1140,580.0,1977,1700,8400,16502 days 16:47:18.667871,107,1.7142857142857142,1.9655172413793103,20,-1200,560.0
324950.0,4,2.5,2641,8615,2.0,3,7,2641,0.0,1998,2641,8091,8832 days 16:47:18.667871,234,1.6,0.0,0,524,2641.0
600000.0,3,2.5,4930,77536,2.0,3,9,3930,1000.0,1981,2760,7351,15041 days 16:47:18.667871,234,1.2,3.93,2170,70185,2930.0
464000.0,3,2.5,2460,5400,1.0,4,8,1520,940.0,2001,1745,5400,7736 days 16:47:18.667871,223,1.2,1.6170212765957446,715,0,580.0
266000.0,4,2.25,1995,7102,2.0,4,8,1995,0.0,1981,1880,7950,15041 days 16:47:18.667871,188,1.7777777777777777,0.0,115,-848,1995.0
775000.0,3,2.5,3010,74390,2.0,3,1,3010,0.0,1998,3240,109771,8832 days 16:47:18.667871,216,1.2,0.0,-230,-35381,3010.0
415000.0,3,1.75,1270,4800,1.0,3,7,1270,0.0,1952,1220,4800,25634 days 16:47:18.667871,169,1.7142857142857142,0.0,50,0,1270.0
550000.0,4,2.75,3080,6731,2.0,3,9,3080,0.0,2003,3080,6731,7006 days 16:47:18.667871,262,1.4545454545454546,0.0,0,0,3080.0
235000.0,3,2.25,1670,7606,2.0,3,7,1670,0.0,1990,1670,7433,11754 days 16:47:18.667871,014,1.3333333333333333,0.0,0,173,1670.0
280000.0,3,2.0,1470,8089,1.0,3,7,1470,0.0,1987,1530,7721,12850 days 16:47:18.667871,171,1.5,0.0,-60,368,1470.0
459000.0,3,1.75,1730,7807,1.0,3,7,1260,470.0,1976,1800,7650,16868 days 16:47:18.667871,303,1.7142857142857142,2.6808510638297873,-70,157,790.0
195000.0,3,1.0,1070,7615,1.0,4,7,1070,0.0,1969,1240,6906,19424 days 16:47:18.667871,287,3.0,0.0,-170,709,1070.0
235000.0,3,1.5,1660,8738,1.0,4,7,1080,580.0,1959,1500,8466,23077 days 16:47:18.667871,316,2.0,1.8620689655172413,160,272,500.0
711800.0,4,2.25,2410,16650,1.0,4,8,2410,0.0,1965,2720,11141,20885 days 16:47:18.667871,330,1.7777777777777777,0.0,-310,5509,2410.0
440000.0,3,2.5,1040,1032,3.0,3,7,1040,0.0,2007,1290,1275,5545 days 16:47:18.667871,016,1.2,0.0,-250,-243,1040.0
515000.0,2,1.0,970,3300,1.0,4,7,970,0.0,1916,1060,3600,38783 days 16:47:18.667871,048,2.0,0.0,-90,-300,970.0
1200000.0,5,2.75,2910,9480,1.5,3,8,2910,0.0,1939,2940,6600,30382 days 16:47:18.667871,122,1.8181818181818181,0.0,-30,2880,2910.0
560000.0,3,1.75,2340,12443,1.5,4,8,2340,0.0,1965,1970,9600,20885 days 16:47:18.668869,096,1.7142857142857142,0.0,370,2843,2340.0
340000.0,3,1.75,1880,11249,1.0,3,7,1330,550.0,1985,1870,14547,13580 days 16:47:18.668869,171,1.7142857142857142,2.418181818181818,10,-3298,780.0
600000.0,2,1.0,1110,3500,1.5,3,6,970,140.0,1912,1884,1778,40244 days 16:47:18.668869,314,2.0,6.928571428571429,-774,1722,830.0
764000.0,4,2.5,2790,7938,2.0,3,9,2790,0.0,1997,2780,7779,9197 days 16:47:18.668869,169,1.6,0.0,10,159,2790.0
337000.0,4,2.0,1590,8779,1.0,3,8,1590,0.0,2001,2090,9600,7736 days 16:47:18.668869,210,2.0,0.0,-500,-821,1590.0
1390000.0,6,2.75,5700,20000,1.0,4,1,2850,2850.0,1977,3690,15700,16502 days 16:47:18.668869,150,2.1818181818181817,1.0,2010,4300,0.0
249000.0,4,1.0,1200,7552,1.0,3,6,1060,140.0,1919,1580,7680,37687 days 16:47:18.668869,323,4.0,7.571428571428571,-380,-128,920.0
350000.0,3,3.0,3200,35782,1.0,3,8,2360,840.0,1978,3090,37887,16137 days 16:47:18.668869,196,1.0,2.8095238095238093,110,-2105,1520.0
269950.0,3,2.25,1510,6000,1.0,4,7,1150,360.0,1993,1510,6000,10658 days 16:47:18.668869,029,1.3333333333333333,3.1944444444444446,0,0,790.0
735000.0,3,1.75,1880,108900,1.0,3,7,1880,0.0,1978,2730,37731,16137 days 16:47:18.668869,056,1.7142857142857142,0.0,-850,71169,1880.0
1300000.0,4,2.5,3070,4000,2.0,4,8,2070,1000.0,1940,2560,4000,30017 days 16:47:18.668869,090,1.6,2.07,510,0,1070.0
475000.0,4,2.25,2110,7560,2.0,4,8,2110,0.0,1974,2110,7560,17598 days 16:47:18.668869,254,1.7777777777777777,0.0,0,0,2110.0
339000.0,3,2.0,2350,8459,1.5,3,9,2350,0.0,1989,2430,8459,12119 days 16:47:18.668869,069,1.5,0.0,-80,0,2350.0
600000.0,4,3.5,3270,15160,1.0,3,8,1660,1610.0,1997,2790,15160,9197 days 16:47:18.668869,070,1.1428571428571428,1.031055900621118,480,0,50.0
397500.0,4,1.75,2220,4760,1.0,3,7,1320,900.0,1918,940,4760,38052 days 16:47:18.668869,219,2.2857142857142856,1.4666666666666666,1280,0,420.0
1530000.0,4,3.5,5990,111078,2.0,3,1,5990,0.0,2004,4690,118918,6641 days 16:47:18.668869,234,1.1428571428571428,0.0,1300,-7840,5990.0
460000.0,3,2.0,1760,9055,2.0,4,7,1760,0.0,1985,2010,9383,13580 days 16:47:18.668869,127,1.5,0.0,-250,-328,1760.0
370000.0,4,2.75,2200,5207,1.0,5,7,1120,1080.0,1951,1210,6008,25999 days 16:47:18.668869,350,1.4545454545454546,1.037037037037037,990,-801,40.0
250000.0,4,1.0,1550,7296,1.5,3,6,1550,0.0,1957,1370,7680,23807 days 16:47:18.668869,084,4.0,0.0,180,-384,1550.0
1100000.0,4,3.75,5070,60123,2.0,3,1,5070,0.0,2000,4920,101930,8102 days 16:47:18.668869,184,1.0666666666666667,0.0,150,-41807,5070.0
430000.0,2,2.25,1040,1516,2.0,3,8,1040,0.0,2008,1560,1920,5180 days 16:47:18.668869,273,0.8888888888888888,0.0,-520,-404,1040.0
1090000.0,3,1.5,2560,4000,1.5,5,8,1660,900.0,1927,2560,4000,34765 days 16:47:18.668869,219,2.0,1.8444444444444446,0,0,760.0
670000.0,3,1.75,1850,8160,1.0,3,8,1850,0.0,1952,1600,8160,25634 days 16:47:18.668869,109,1.7142857142857142,0.0,250,0,1850.0
461550.0,3,1.5,2090,11895,1.0,3,7,1790,300.0,1954,2180,11072,24903 days 16:47:18.668869,113,2.0,5.966666666666667,-90,823,1490.0
479990.0,3,2.5,2010,2386,2.0,3,8,1390,620.0,2014,1690,1870,2988 days 16:47:18.668869,217,1.2,2.2419354838709675,320,516,770.0
643000.0,4,2.5,2518,4663,2.0,3,8,2518,0.0,2005,2280,4525,6275 days 16:47:18.668869,104,1.6,0.0,238,138,2518.0
607000.0,3,2.75,2810,12813,2.0,3,8,2040,770.0,1988,1890,10336,12485 days 16:47:18.668869,273,1.0909090909090908,2.6493506493506493,920,2477,1270.0
625000.0,3,2.5,2600,10092,1.0,3,9,2600,0.0,1984,2440,9298,13946 days 16:47:18.668869,143,1.2,0.0,160,794,2600.0
731100.0,3,2.5,2060,8778,1.0,3,8,1160,900.0,1953,1990,7560,25268 days 16:47:18.668869,210,1.2,1.288888888888889,70,1218,260.0
859000.0,3,2.5,2920,434728,2.0,4,8,2920,0.0,1999,3150,55216,8467 days 16:47:18.668869,068,1.2,0.0,-230,379512,2920.0
435000.0,4,2.5,2130,10375,2.0,4,8,2130,0.0,1986,2220,8508,13215 days 16:47:18.668869,307,1.6,0.0,-90,1867,2130.0
465000.0,3,3.0,2290,15600,1.0,3,8,1420,870.0,1948,1890,14143,27095 days 16:47:18.668869,302,1.0,1.632183908045977,400,1457,550.0
740000.0,3,1.0,1230,6380,1.5,3,7,1230,0.0,1927,1250,6380,34765 days 16:47:18.668869,105,3.0,0.0,-20,0,1230.0
740000.0,3,1.75,2020,9478,1.0,4,9,2020,0.0,1961,3050,15594,22346 days 16:47:18.668869,344,1.7142857142857142,0.0,-1030,-6116,2020.0
250000.0,3,2.0,1430,7280,1.0,3,7,990,440.0,1980,1430,7280,15407 days 16:47:18.668869,323,1.5,2.25,0,0,550.0
656000.0,2,2.5,2270,1763,3.0,3,7,1820,450.0,2009,2180,1763,4814 days 16:47:18.668869,070,0.8,4.044444444444444,90,0,1370.0
300000.0,4,2.5,1910,8058,2.0,3,8,1910,0.0,1992,1910,6500,11024 days 16:47:18.668869,282,1.6,0.0,0,1558,1910.0
643000.0,3,1.5,1780,214315,1.0,3,7,1780,0.0,1954,2740,133419,24903 days 16:47:18.668869,051,2.0,0.0,-960,80896,1780.0
311000.0,4,2.5,2690,6124,2.0,3,7,2690,0.0,2007,2300,6002,5545 days 16:47:18.668869,219,1.6,0.0,390,122,2690.0
360000.0,3,1.75,1330,7482,1.0,4,7,1330,0.0,1975,1480,8096,17233 days 16:47:18.668869,202,1.7142857142857142,0.0,-150,-614,1330.0
475000.0,4,2.5,3060,10043,1.0,4,8,1700,1360.0,1968,1630,8296,19790 days 16:47:18.668869,139,1.6,1.25,1430,1747,340.0
469950.0,3,3.25,1760,1778,3.0,3,8,1760,0.0,2008,1520,1615,5180 days 16:47:18.668869,221,0.9230769230769231,0.0,240,163,1760.0
240000.0,3,1.75,1570,8750,1.0,3,7,1570,0.0,1960,1890,8825,22712 days 16:47:18.668869,184,1.7142857142857142,0.0,-320,-75,1570.0
232000.0,2,1.0,960,8100,1.0,3,6,810,150.0,1936,960,12150,31478 days 16:47:18.668869,272,2.0,5.4,0,-4050,660.0
350000.0,3,2.0,1680,81893,1.0,3,7,1680,0.0,1991,2480,38637,11389 days 16:47:18.668869,225,1.5,0.0,-800,43256,1680.0
803000.0,2,1.0,1440,33747,1.5,3,7,1440,0.0,1928,1980,8400,34400 days 16:47:18.668869,009,2.0,0.0,-540,25347,1440.0
355000.0,3,2.25,1960,7000,1.0,3,8,1600,360.0,1980,1980,7140,15407 days 16:47:18.668869,344,1.3333333333333333,4.444444444444445,-20,-140,1240.0
475000.0,4,2.0,1790,2250,1.0,4,7,840,950.0,1909,1440,1545,41339 days 16:47:18.668869,141,2.0,0.8842105263157894,350,705,-110.0
823000.0,3,2.5,2560,9825,2.0,4,9,2560,0.0,1988,2710,12034,12485 days 16:47:18.668869,083,1.2,0.0,-150,-2209,2560.0
395000.0,2,1.5,1010,3060,1.0,4,7,1010,0.0,1918,1160,4080,38052 days 16:47:18.668869,316,1.3333333333333333,0.0,-150,-1020,1010.0
499000.0,4,3.75,2560,5250,2.0,3,7,1900,660.0,1963,1400,5250,21616 days 16:47:18.668869,117,1.0666666666666667,2.878787878787879,1160,0,1240.0
420000.0,2,1.75,1200,3136,1.0,3,7,800,400.0,1904,1330,3164,43166 days 16:47:18.668869,092,1.1428571428571428,2.0,-130,-28,400.0
961500.0,3,2.5,3910,14000,2.0,3,1,3910,0.0,1999,2280,14000,8467 days 16:47:18.668869,224,1.2,0.0,1630,0,3910.0
833000.0,4,1.75,2260,12238,1.0,3,9,2260,0.0,1967,2430,10204,20155 days 16:47:18.668869,090,2.2857142857142856,0.0,-170,2034,2260.0
479000.0,3,2.25,2110,11319,2.0,4,8,2110,0.0,1978,1860,11319,16137 days 16:47:18.668869,174,1.3333333333333333,0.0,250,0,2110.0
1150000.0,4,2.5,3340,10422,2.0,3,1,3340,0.0,1996,1770,9490,9563 days 16:47:18.668869,182,1.6,0.0,1570,932,3340.0
267000.0,3,1.0,1400,8100,1.5,3,6,1400,0.0,1944,1420,8100,28556 days 16:47:18.668869,189,3.0,0.0,-20,0,1400.0
555000.0,4,1.75,1760,94525,1.5,3,7,1760,0.0,1988,3030,34848,12485 days 16:47:18.668869,254,2.2857142857142856,0.0,-1270,59677,1760.0
490000.0,3,2.5,2010,9725,2.0,4,8,2010,0.0,1987,1850,6858,12850 days 16:47:18.668869,212,1.2,0.0,160,2867,2010.0
619000.0,4,2.0,2300,3400,1.5,5,8,1550,750.0,1915,1670,4200,39148 days 16:47:18.668869,149,2.0,2.066666666666667,630,-800,800.0
569950.0,5,2.75,2510,28185,1.0,4,7,1600,910.0,1963,2910,14880,21616 days 16:47:18.668869,304,1.8181818181818181,1.7582417582417582,-400,13305,690.0
549000.0,3,2.0,1340,3000,2.0,5,7,1340,0.0,1905,1120,3000,42800 days 16:47:18.668869,329,1.5,0.0,220,0,1340.0
422500.0,3,1.75,1560,7245,1.5,3,7,1560,0.0,1962,2220,8502,21981 days 16:47:18.668869,296,1.7142857142857142,0.0,-660,-1257,1560.0
400000.0,4,3.5,3350,9681,1.0,3,7,2140,1210.0,1980,2580,9681,15407 days 16:47:18.668869,213,1.1428571428571428,1.7685950413223142,770,0,930.0
692500.0,4,2.75,3710,7984,2.0,3,9,3710,0.0,1999,2950,7984,8467 days 16:47:18.668869,190,1.4545454545454546,0.0,760,0,3710.0
310000.0,4,2.5,2430,5499,2.0,3,8,2430,0.0,2002,2890,5190,7371 days 16:47:18.668869,177,1.6,0.0,-460,309,2430.0
499900.0,3,1.75,2430,8820,1.0,3,8,1630,800.0,1977,2390,10050,16502 days 16:47:18.668869,350,1.7142857142857142,2.0375,40,-1230,830.0
492000.0,3,2.25,2100,7335,2.0,3,8,2100,0.0,1983,2050,8930,14311 days 16:47:18.668869,239,1.3333333333333333,0.0,50,-1595,2100.0
460000.0,2,2.5,1880,40575,1.0,3,9,1880,0.0,1987,1930,32935,12850 days 16:47:18.668869,126,0.8,0.0,-50,7640,1880.0
800000.0,3,2.5,1630,2640,2.0,5,8,1630,0.0,1919,1630,3000,37687 days 16:47:18.668869,197,1.2,0.0,0,-360,1630.0
832600.0,4,1.0,1640,4200,1.5,3,7,1640,0.0,1925,1730,3990,35495 days 16:47:18.668869,097,4.0,0.0,-90,210,1640.0
470000.0,4,2.75,2310,7350,1.0,3,8,1670,640.0,1989,2600,6077,12119 days 16:47:18.668869,077,1.4545454545454546,2.609375,-290,1273,1030.0
542000.0,2,2.0,1930,4500,1.0,3,8,1930,0.0,2003,1670,5200,7006 days 16:47:18.668869,294,1.0,0.0,260,-700,1930.0
1310000.0,4,4.5,4750,13912,2.0,3,1,3600,1150.0,2005,3600,22124,6275 days 16:47:18.668869,170,0.8888888888888888,3.130434782608696,1150,-8212,2450.0
308130.0,4,2.5,2300,7500,1.0,2,7,1650,650.0,1959,2300,7500,23077 days 16:47:18.668869,283,1.6,2.5384615384615383,0,0,1000.0
310000.0,2,1.0,1050,2699,1.0,3,7,1050,0.0,2005,1240,2671,6275 days 16:47:18.668869,070,2.0,0.0,-190,28,1050.0
235000.0,2,1.0,1500,8015,1.0,3,6,1500,0.0,1947,1130,8015,27460 days 16:47:18.668869,295,2.0,0.0,370,0,1500.0
215000.0,3,1.0,1150,7560,1.0,4,6,1150,0.0,1958,1230,7560,23442 days 16:47:18.668869,262,3.0,0.0,-80,0,1150.0
210000.0,4,1.5,1920,10403,1.0,3,7,1370,550.0,1959,1550,9619,23077 days 16:47:18.668869,156,2.6666666666666665,2.4909090909090907,370,784,820.0
730000.0,4,2.75,3660,150282,2.0,3,1,3660,0.0,1990,3090,53578,11754 days 16:47:18.668869,330,1.4545454545454546,0.0,570,96704,3660.0
245000.0,3,1.75,1720,9342,1.0,4,7,1140,580.0,1981,1330,7540,15041 days 16:47:18.668869,344,1.7142857142857142,1.9655172413793103,390,1802,560.0
540000.0,3,2.25,2100,20018,1.0,3,8,1470,630.0,1948,2410,17196,27095 days 16:47:18.668869,258,1.3333333333333333,2.3333333333333335,-310,2822,840.0
299000.0,4,2.5,2400,6078,2.0,3,8,2400,0.0,2001,2406,7642,7736 days 16:47:18.668869,034,1.6,0.0,-6,-1564,2400.0
510000.0,3,2.5,2540,40106,2.0,3,1,2540,0.0,1991,3190,71797,11389 days 16:47:18.668869,322,1.2,0.0,-650,-31691,2540.0
198000.0,4,1.75,2080,7200,1.0,4,7,1050,1030.0,1966,1500,7350,20520 days 16:47:18.668869,184,2.2857142857142856,1.0194174757281553,580,-150,20.0
950000.0,5,3.25,3400,7452,2.0,3,1,3400,0.0,1999,2650,8749,8467 days 16:47:18.668869,143,1.5384615384615385,0.0,750,-1297,3400.0
300000.0,4,1.75,2200,7600,2.0,3,8,2200,0.0,1978,1910,7600,16137 days 16:47:18.668869,051,2.2857142857142856,0.0,290,0,2200.0
528000.0,5,1.75,2140,8580,1.0,3,7,1200,940.0,1962,1600,9206,21981 days 16:47:18.668869,247,2.857142857142857,1.2765957446808511,540,-626,260.0
507000.0,5,3.25,3850,16249,2.0,3,9,3030,820.0,2002,2640,7393,7371 days 16:47:18.668869,169,1.5384615384615385,3.6951219512195124,1210,8856,2210.0
770000.0,4,3.25,4270,6384,2.0,3,9,3060,1210.0,2001,2850,6285,7736 days 16:47:18.668869,050,1.2307692307692308,2.5289256198347108,1420,99,1850.0
255000.0,3,1.75,1340,7210,1.0,4,7,1340,0.0,1975,1370,7210,17233 days 16:47:18.668869,051,1.7142857142857142,0.0,-30,0,1340.0
220000.0,1,1.5,1100,3451,1.5,4,8,1100,0.0,1978,1400,4560,16137 days 16:47:18.668869,125,0.6666666666666666,0.0,-300,-1109,1100.0
690700.0,5,2.75,2870,5349,2.0,3,9,2870,0.0,2005,2800,5000,6275 days 16:47:18.668869,054,1.8181818181818181,0.0,70,349,2870.0
447000.0,2,1.0,1320,8380,1.0,3,7,1320,0.0,1953,1290,8025,25268 days 16:47:18.668869,178,2.0,0.0,30,355,1320.0
755000.0,6,2.0,2150,4505,1.0,3,7,1270,880.0,1952,1740,4505,25634 days 16:47:18.668869,140,3.0,1.4431818181818181,410,0,390.0
700000.0,4,1.5,2470,6000,1.5,3,7,1480,990.0,1940,2140,4000,30017 days 16:47:18.668869,072,2.6666666666666665,1.494949494949495,330,2000,490.0
250000.0,4,2.75,1910,7700,1.0,4,7,1000,910.0,1980,1880,7875,15407 days 16:47:18.668869,196,1.4545454545454546,1.098901098901099,30,-175,90.0
320000.0,3,2.5,2130,6969,2.0,3,7,2130,0.0,2003,1670,9545,7006 days 16:47:18.668869,130,1.2,0.0,460,-2576,2130.0
565000.0,4,2.5,2240,14667,2.0,4,9,2240,0.0,1989,2410,11243,12119 days 16:47:18.668869,134,1.6,0.0,-170,3424,2240.0
754300.0,5,2.75,1800,4500,2.0,4,7,1680,120.0,1939,1730,4500,30382 days 16:47:18.668869,114,1.8181818181818181,14.0,70,0,1560.0
529888.0,4,2.5,3140,8455,2.0,3,8,3140,0.0,2003,3140,7391,7006 days 16:47:18.668869,049,1.6,0.0,0,1064,3140.0
432000.0,3,2.5,1920,9812,2.0,3,8,1920,0.0,2000,1830,10534,8102 days 16:47:18.668869,310,1.2,0.0,90,-722,1920.0
235000.0,3,1.0,1050,7670,1.5,5,7,1050,0.0,1955,1220,7670,24538 days 16:47:18.668869,077,3.0,0.0,-170,0,1050.0
994900.0,4,3.5,3695,6556,2.0,3,9,3695,0.0,2014,4160,6786,2988 days 16:47:18.668869,027,1.1428571428571428,0.0,-465,-230,3695.0
489000.0,4,2.5,3910,8442,2.0,3,9,2710,1200.0,2000,2650,7576,8102 days 16:47:18.668869,093,1.6,2.2583333333333333,1260,866,1510.0
800000.0,4,2.75,3010,7427,2.0,3,8,3010,0.0,2010,3000,4929,4449 days 16:47:18.668869,110,1.4545454545454546,0.0,10,2498,3010.0
370000.0,4,1.5,1370,9957,1.0,3,7,900,470.0,1972,1510,8088,18329 days 16:47:18.668869,136,2.6666666666666665,1.9148936170212767,-140,1869,430.0
436000.0,4,2.75,2080,9600,1.0,3,8,1240,840.0,1979,1880,9525,15772 days 16:47:18.668869,346,1.4545454545454546,1.4761904761904763,200,75,400.0
395000.0,3,2.5,2250,3757,2.0,3,7,2250,0.0,2006,2250,4556,5910 days 16:47:18.668869,148,1.2,0.0,0,-799,2250.0
377691.0,5,1.75,2120,8399,1.0,4,7,1320,800.0,1942,2120,8398,29286 days 16:47:18.668869,143,2.857142857142857,1.65,0,1,520.0
370000.0,5,3.0,2220,5185,2.0,3,7,2220,0.0,2003,2340,6316,7006 days 16:47:18.668869,107,1.6666666666666667,0.0,-120,-1131,2220.0
515000.0,3,2.5,1440,4394,1.0,5,8,1440,0.0,1987,1900,5893,12850 days 16:47:18.668869,296,1.2,0.0,-460,-1499,1440.0
169000.0,3,1.0,910,7686,1.0,3,7,910,0.0,1969,1020,7686,19424 days 16:47:18.668869,269,3.0,0.0,-110,0,910.0
475000.0,3,1.0,1270,4268,1.0,3,7,1270,0.0,1921,1310,4080,36956 days 16:47:18.668869,080,3.0,0.0,-40,188,1270.0
420000.0,3,2.5,2480,6180,2.0,3,9,2480,0.0,1999,2870,6180,8467 days 16:47:18.668869,115,1.2,0.0,-390,0,2480.0
1300000.0,6,2.75,2630,9420,2.0,5,9,2510,120.0,1900,1540,4969,44626 days 16:47:18.668869,182,2.1818181818181817,20.916666666666668,1090,4451,2390.0
822000.0,3,2.0,2410,13300,2.0,3,9,1840,570.0,1985,2930,10900,13580 days 16:47:18.668869,056,1.5,3.2280701754385963,-520,2400,1270.0
1500000.0,4,2.75,2930,25697,1.0,4,9,2310,620.0,1964,3810,20681,21251 days 16:47:18.668869,350,1.4545454545454546,3.725806451612903,-880,5016,1690.0
485000.0,3,2.25,1570,6810,1.0,3,8,1180,390.0,1988,1620,6584,12485 days 16:47:18.668869,089,1.3333333333333333,3.0256410256410255,-50,226,790.0
270000.0,4,1.0,1900,8505,1.0,3,7,1200,700.0,1956,1440,8505,24173 days 16:47:18.668869,219,4.0,1.7142857142857142,460,0,500.0
300000.0,6,2.5,2590,11250,1.0,4,8,1390,1200.0,1978,2270,8360,16137 days 16:47:18.668869,091,2.4,1.1583333333333334,320,2890,190.0
878000.0,4,2.5,3810,7728,2.0,3,9,3810,0.0,2007,3290,7728,5545 days 16:47:18.668869,106,1.6,0.0,520,0,3810.0
590000.0,3,2.5,2290,4203,2.0,3,9,2290,0.0,2001,2290,5089,7736 days 16:47:18.668869,093,1.2,0.0,0,-886,2290.0
611900.0,1,2.25,1220,2100,2.0,4,8,1220,0.0,1946,3150,6000,27825 days 16:47:18.668869,323,0.4444444444444444,0.0,-1930,-3900,1220.0
240000.0,3,1.75,1100,7373,1.0,4,7,1100,0.0,1968,1430,8415,19790 days 16:47:18.668869,078,1.7142857142857142,0.0,-330,-1042,1100.0
395000.0,4,2.5,2810,10951,2.0,3,8,2810,0.0,2003,1680,6625,7006 days 16:47:18.668869,107,1.6,0.0,1130,4326,2810.0
169000.0,3,1.0,890,7110,1.0,3,6,890,0.0,1957,1100,8375,23807 days 16:47:18.668869,197,3.0,0.0,-210,-1265,890.0
200500.0,3,2.0,1280,14972,1.0,3,7,1280,0.0,1963,1800,9698,21616 days 16:47:18.668869,083,1.5,0.0,-520,5274,1280.0
308000.0,3,2.5,2320,7140,2.0,3,8,2320,0.0,1990,2360,7955,11754 days 16:47:18.668869,100,1.2,0.0,-40,-815,2320.0
290256.0,3,2.25,1720,7885,2.0,3,8,1720,0.0,1983,2340,7885,14311 days 16:47:18.668869,191,1.3333333333333333,0.0,-620,0,1720.0
279950.0,3,1.75,1530,8800,1.0,4,7,1040,490.0,1967,1530,8690,20155 days 16:47:18.668869,117,1.7142857142857142,2.122448979591837,0,110,550.0
195000.0,3,1.75,1580,7875,1.0,3,7,1580,0.0,1979,1560,8314,15772 days 16:47:18.668869,219,1.7142857142857142,0.0,20,-439,1580.0
630000.0,3,1.0,1360,13000,1.0,5,6,1360,0.0,1945,1890,19650,28190 days 16:47:18.668869,238,3.0,0.0,-530,-6650,1360.0
1160000.0,4,3.0,2680,15438,2.0,3,8,2680,0.0,1902,4480,14406,43896 days 16:47:18.668869,096,1.3333333333333333,0.0,-1800,1032,2680.0
478000.0,3,2.25,1640,3896,2.0,3,8,1640,0.0,1994,1780,3999,10293 days 16:47:18.668869,182,1.3333333333333333,0.0,-140,-103,1640.0
835000.0,3,2.25,2520,6690,2.0,5,8,1700,820.0,1944,1990,5792,28556 days 16:47:18.668869,226,1.3333333333333333,2.073170731707317,530,898,880.0
639000.0,3,2.25,1400,2421,2.0,3,9,1400,0.0,2005,1500,2743,6275 days 16:47:18.668869,107,1.3333333333333333,0.0,-100,-322,1400.0
623000.0,4,2.75,2300,12633,2.0,3,9,2300,0.0,1984,2240,9246,13946 days 16:47:18.668869,286,1.4545454545454546,0.0,60,3387,2300.0
220000.0,3,1.75,1900,7680,1.0,3,7,1260,640.0,1959,2000,7740,23077 days 16:47:18.668869,351,1.7142857142857142,1.96875,-100,-60,620.0
526000.0,3,2.25,2000,18099,1.0,4,8,1250,750.0,1978,2060,12000,16137 days 16:47:18.668869,084,1.3333333333333333,1.6666666666666667,-60,6099,500.0
243500.0,2,1.0,900,5016,1.0,3,6,900,0.0,1948,1420,5184,27095 days 16:47:18.668869,023,2.0,0.0,-520,-168,900.0
750000.0,4,2.5,2980,4930,2.0,3,9,2890,90.0,2000,2980,6099,8102 days 16:47:18.668869,132,1.6,32.111111111111114,0,-1169,2800.0
329000.0,4,2.0,1850,9126,1.0,5,7,1850,0.0,1963,1730,9110,21616 days 16:47:18.668869,077,2.0,0.0,120,16,1850.0
525000.0,4,1.0,1570,4000,1.5,3,7,1570,0.0,1920,1610,4000,37322 days 16:47:18.668869,269,4.0,0.0,-40,0,1570.0
190000.0,2,1.0,670,3101,1.0,4,6,670,0.0,1948,1660,4100,27095 days 16:47:18.668869,076,2.0,0.0,-990,-999,670.0
772650.0,4,2.5,2660,10800,1.0,3,7,2660,0.0,1955,2640,10800,24538 days 16:47:18.668869,177,1.6,0.0,20,0,2660.0
355000.0,3,2.5,2110,4038,2.0,4,8,2110,0.0,1989,2110,3727,12119 days 16:47:18.668869,191,1.2,0.0,0,311,2110.0
650000.0,3,1.75,1970,54450,1.0,3,8,1570,400.0,1980,2460,36677,15407 days 16:47:18.668869,091,1.7142857142857142,3.925,-490,17773,1170.0
678500.0,3,2.75,1210,3600,1.5,5,7,1210,0.0,1910,1630,3910,40974 days 16:47:18.668869,070,1.0909090909090908,0.0,-420,-310,1210.0
669950.0,4,2.5,2670,11877,2.0,3,9,2670,0.0,1996,2430,11333,9563 days 16:47:18.668869,177,1.6,0.0,240,544,2670.0
850000.0,3,2.25,3000,18450,1.0,3,1,3000,0.0,1983,2980,12304,14311 days 16:47:18.668869,070,1.3333333333333333,0.0,20,6146,3000.0
813000.0,3,1.75,2080,11866,1.0,3,8,2080,0.0,1960,2240,10696,22712 days 16:47:18.668869,303,1.7142857142857142,0.0,-160,1170,2080.0
710000.0,3,2.0,1780,9732,1.0,3,8,1780,0.0,1967,1900,10200,20155 days 16:47:18.668869,240,1.5,0.0,-120,-468,1780.0
792500.0,3,1.5,1960,2400,2.0,3,8,1330,630.0,1911,2090,4000,40609 days 16:47:18.668869,336,2.0,2.111111111111111,-130,-1600,700.0
285900.0,5,1.5,1690,7725,1.5,4,7,1690,0.0,1961,1690,7739,22346 days 16:47:18.668869,072,3.3333333333333335,0.0,0,-14,1690.0
389000.0,3,2.0,2080,12972,1.0,4,7,1250,830.0,1981,1530,10089,15041 days 16:47:18.668869,131,1.5,1.5060240963855422,550,2883,420.0
675000.0,3,2.25,2070,2833,2.0,3,8,1490,580.0,1966,1940,3794,20520 days 16:47:18.668869,339,1.3333333333333333,2.5689655172413794,130,-961,910.0
352000.0,2,0.75,760,33801,1.0,4,4,760,0.0,1931,1100,39504,33304 days 16:47:18.668869,295,2.6666666666666665,0.0,-340,-5703,760.0
1050000.0,4,3.25,4020,11588,2.0,3,1,4020,0.0,2000,3190,8066,8102 days 16:47:18.668869,127,1.2307692307692308,0.0,830,3522,4020.0
768500.0,4,1.75,3620,10400,1.0,4,8,1820,1800.0,1965,2410,10400,20885 days 16:47:18.668869,008,2.2857142857142856,1.011111111111111,1210,0,20.0
500000.0,4,2.0,2330,7778,1.0,3,7,1230,1100.0,1961,1250,8160,22346 days 16:47:18.668869,360,2.0,1.1181818181818182,1080,-382,130.0
685000.0,3,2.5,1460,8800,1.0,4,7,1460,0.0,1956,2200,8800,24173 days 16:47:18.668869,364,1.2,0.0,-740,0,1460.0
648475.0,4,2.75,2250,5700,1.0,3,8,1200,1050.0,1951,1720,3850,25999 days 16:47:18.668869,143,1.4545454545454546,1.1428571428571428,530,1850,150.0
655000.0,6,5.0,2850,6600,2.0,3,7,2850,0.0,1994,1870,9900,10293 days 16:47:18.668869,112,1.2,0.0,980,-3300,2850.0
895000.0,4,2.75,2640,4000,2.0,5,8,1730,910.0,1925,1530,3740,35495 days 16:47:18.668869,255,1.4545454545454546,1.901098901098901,1110,260,820.0
195000.0,3,1.0,1310,9554,1.0,3,7,960,350.0,1962,1310,9845,21981 days 16:47:18.668869,098,3.0,2.742857142857143,0,-291,610.0
368000.0,4,2.5,2720,7350,2.0,3,9,2720,0.0,1989,2570,8336,12119 days 16:47:18.668869,342,1.6,0.0,150,-986,2720.0
997000.0,4,3.5,3430,13609,2.0,3,1,3430,0.0,2001,3880,11614,7736 days 16:47:18.668869,059,1.1428571428571428,0.0,-450,1995,3430.0
335000.0,3,2.75,1990,19991,1.0,3,7,1340,650.0,1977,1750,9775,16502 days 16:47:18.668869,356,1.0909090909090908,2.0615384615384613,240,10216,690.0
250000.0,3,2.0,1170,7258,1.0,3,7,1170,0.0,1984,1410,7750,13946 days 16:47:18.668869,141,1.5,0.0,-240,-492,1170.0
278500.0,3,1.75,1390,8980,1.0,4,8,1390,0.0,1985,1770,9085,13580 days 16:47:18.668869,071,1.7142857142857142,0.0,-380,-105,1390.0
260000.0,4,1.5,1540,7300,2.0,3,7,1540,0.0,1973,1580,7650,17963 days 16:47:18.668869,028,2.6666666666666665,0.0,-40,-350,1540.0
162500.0,2,1.0,760,6141,1.0,2,6,760,0.0,1920,900,4120,37322 days 16:47:18.668869,274,2.0,0.0,-140,2021,760.0
239000.0,4,1.0,1280,8316,1.0,3,6,1280,0.0,1950,1310,7830,26364 days 16:47:18.668869,195,4.0,0.0,-30,486,1280.0
600000.0,4,2.5,2990,5122,2.0,3,8,2990,0.0,2004,3140,7875,6641 days 16:47:18.668869,325,1.6,0.0,-150,-2753,2990.0
350000.0,4,2.25,1770,7778,2.0,3,7,1770,0.0,1998,1770,7591,8832 days 16:47:18.668869,118,1.7777777777777777,0.0,0,187,1770.0
852500.0,5,3.75,3830,8131,2.0,3,1,3830,0.0,2005,3570,7290,6275 days 16:47:18.668869,349,1.3333333333333333,0.0,260,841,3830.0
485000.0,3,2.5,2870,5490,2.0,3,9,2870,0.0,2008,3040,5442,5180 days 16:47:18.668869,202,1.2,0.0,-170,48,2870.0
299000.0,3,1.0,1520,8320,1.0,3,6,1520,0.0,1953,1500,8320,25268 days 16:47:18.668869,280,3.0,0.0,20,0,1520.0
227450.0,2,1.0,660,6509,1.0,4,5,660,0.0,1952,970,5713,25634 days 16:47:18.668869,112,2.0,0.0,-310,796,660.0
383000.0,3,1.0,1800,5612,1.0,4,7,1200,600.0,1942,1450,5250,29286 days 16:47:18.668869,143,3.0,2.0,350,362,600.0
835000.0,2,3.25,3570,392475,1.0,3,9,2370,1200.0,1998,3190,217800,8832 days 16:47:18.668869,012,0.6153846153846154,1.975,380,174675,1170.0
760000.0,5,1.5,3050,2992,1.5,4,8,1920,1130.0,1931,1200,1209,33304 days 16:47:18.668869,042,3.3333333333333335,1.6991150442477876,1850,1783,790.0
532500.0,2,1.0,820,3000,1.0,4,7,820,0.0,1924,1490,3000,35861 days 16:47:18.668869,048,2.0,0.0,-670,0,820.0
635000.0,3,2.5,3610,26359,1.0,3,8,1950,1660.0,1998,2620,26427,8832 days 16:47:18.668869,329,1.2,1.1746987951807228,990,-68,290.0
438500.0,3,2.0,1490,3072,1.0,5,7,770,720.0,1912,1320,3072,40244 days 16:47:18.668869,237,1.5,1.0694444444444444,170,0,50.0
545500.0,3,2.5,1560,9361,1.5,4,7,1360,200.0,1936,1670,6244,31478 days 16:47:18.668869,169,1.2,6.8,-110,3117,1160.0
675000.0,3,1.75,1660,9549,1.0,3,7,1660,0.0,1956,2090,9549,24173 days 16:47:18.668869,104,1.7142857142857142,0.0,-430,0,1660.0
450000.0,3,1.75,1180,4080,1.0,4,6,760,420.0,1928,1490,4080,34400 days 16:47:18.668869,169,1.7142857142857142,1.8095238095238095,-310,0,340.0
199999.0,3,1.0,960,10815,1.0,5,5,960,0.0,1900,1330,10815,44626 days 16:47:18.668869,357,3.0,0.0,-370,0,960.0
375000.0,3,1.5,1630,16170,1.0,3,7,1630,0.0,1988,1630,9931,12485 days 16:47:18.668869,253,2.0,0.0,0,6239,1630.0
600000.0,4,2.25,2260,43847,2.0,3,8,2260,0.0,1982,2470,37304,14676 days 16:47:18.668869,120,1.7777777777777777,0.0,-210,6543,2260.0
292600.0,3,1.5,1520,7123,1.0,4,7,1520,0.0,1959,1450,8023,23077 days 16:47:18.668869,189,2.0,0.0,70,-900,1520.0
1040000.0,5,2.75,3050,8904,1.0,4,8,1650,1400.0,1956,2920,8904,24173 days 16:47:18.668869,078,1.8181818181818181,1.1785714285714286,130,0,250.0
610000.0,3,1.0,1000,4959,1.0,3,8,1000,0.0,1945,2240,4959,28190 days 16:47:18.668869,283,3.0,0.0,-1240,0,1000.0
397450.0,4,2.5,2650,9451,2.0,4,8,2650,0.0,1993,2510,8850,10658 days 16:47:18.668869,237,1.6,0.0,140,601,2650.0
382000.0,3,2.25,1750,15528,1.0,3,8,1270,480.0,1963,2170,12000,21616 days 16:47:18.668869,104,1.3333333333333333,2.6458333333333335,-420,3528,790.0
370000.0,3,2.25,1770,7667,1.0,3,8,1270,500.0,1966,2180,8103,20520 days 16:47:18.668869,016,1.3333333333333333,2.54,-410,-436,770.0
520000.0,3,2.25,1770,7667,1.0,3,8,1270,500.0,1966,2180,8103,20520 days 16:47:18.668869,118,1.3333333333333333,2.54,-410,-436,770.0
260000.0,2,1.0,770,7906,1.0,4,6,770,0.0,1948,990,7906,27095 days 16:47:18.668869,182,2.0,0.0,-220,0,770.0
890000.0,4,2.5,3370,7200,2.0,3,8,3370,0.0,2014,1880,7200,2988 days 16:47:18.668869,324,1.6,0.0,1490,0,3370.0
344000.0,5,2.0,2130,8412,1.0,3,7,1440,690.0,1946,2310,7474,27825 days 16:47:18.668869,238,2.5,2.0869565217391304,-180,938,750.0
205000.0,3,1.0,1050,8498,1.0,3,7,1050,0.0,1958,1340,8498,23442 days 16:47:18.668869,176,3.0,0.0,-290,0,1050.0
379000.0,5,2.5,2803,8550,1.0,3,8,2803,0.0,1963,1810,8550,21616 days 16:47:18.668869,127,2.0,0.0,993,0,2803.0
424240.0,3,2.0,2080,12094,2.0,4,8,2080,0.0,1982,2230,12204,14676 days 16:47:18.668869,234,1.5,0.0,-150,-110,2080.0
589950.0,3,2.0,2080,12094,2.0,4,8,2080,0.0,1982,2230,12204,14676 days 16:47:18.668869,328,1.5,0.0,-150,-110,2080.0
582000.0,4,1.75,2120,4650,1.0,3,7,1190,930.0,1951,2070,6487,25999 days 16:47:18.668869,132,2.2857142857142856,1.2795698924731183,50,-1837,260.0
349000.0,3,2.5,2550,7709,2.0,3,9,2550,0.0,1989,2410,9250,12119 days 16:47:18.668869,071,1.2,0.0,140,-1541,2550.0
658000.0,3,1.0,1290,12005,1.0,4,7,1290,0.0,1966,1930,8000,20520 days 16:47:18.668869,098,3.0,0.0,-640,4005,1290.0
294000.0,5,2.75,1790,5000,1.5,4,7,1060,730.0,1915,1400,5000,39148 days 16:47:18.668869,302,1.8181818181818181,1.452054794520548,390,0,330.0
690000.0,5,3.5,2720,7598,2.0,3,8,1860,860.0,1993,2430,7728,10658 days 16:47:18.668869,177,1.4285714285714286,2.1627906976744184,290,-130,1000.0
600000.0,3,1.0,1040,5000,1.5,3,7,1040,0.0,1912,1440,4400,40244 days 16:47:18.668869,113,3.0,0.0,-400,600,1040.0
199990.0,3,1.0,840,5200,1.0,3,6,840,0.0,1969,870,5200,19424 days 16:47:18.668869,016,3.0,0.0,-30,0,840.0
220000.0,3,1.75,1650,8850,1.0,3,7,1650,0.0,1959,1400,8800,23077 days 16:47:18.668869,343,1.7142857142857142,0.0,250,50,1650.0
440000.0,4,2.25,2080,15750,1.0,3,8,1460,620.0,1976,1960,10500,16868 days 16:47:18.668869,026,1.7777777777777777,2.3548387096774195,120,5250,840.0
439990.0,4,2.5,1540,1994,2.0,3,8,1540,0.0,2014,1540,1689,2988 days 16:47:18.668869,247,1.6,0.0,0,305,1540.0
815000.0,4,2.5,3880,7208,2.0,3,1,3880,0.0,2006,3280,7221,5910 days 16:47:18.668869,070,1.6,0.0,600,-13,3880.0
535000.0,4,2.25,1860,3766,2.0,3,8,1860,0.0,1995,1860,4169,9928 days 16:47:18.668869,111,1.7777777777777777,0.0,0,-403,1860.0
215000.0,3,1.75,1280,10016,1.0,4,7,1280,0.0,1975,1670,9764,17233 days 16:47:18.668869,330,1.7142857142857142,0.0,-390,252,1280.0
605000.0,3,2.5,3200,35012,1.5,3,8,2100,1100.0,1965,2690,35100,20885 days 16:47:18.668869,054,1.2,1.9090909090909092,510,-88,1000.0
349900.0,3,2.5,2200,7278,2.0,3,8,2200,0.0,1990,2190,8580,11754 days 16:47:18.668869,150,1.2,0.0,10,-1302,2200.0
495000.0,3,1.0,1570,5510,1.0,4,7,1070,500.0,1940,1770,6380,30017 days 16:47:18.668869,049,3.0,2.14,-200,-870,570.0
515100.0,3,2.5,2074,4900,2.0,3,8,2074,0.0,1997,1840,7382,9197 days 16:47:18.668869,287,1.2,0.0,234,-2482,2074.0
620000.0,4,2.5,2450,55387,2.0,3,9,2450,0.0,1994,2730,38827,10293 days 16:47:18.668869,175,1.6,0.0,-280,16560,2450.0
657500.0,4,2.25,2520,10370,2.0,3,9,2520,0.0,1980,2848,12682,15407 days 16:47:18.668869,022,1.7777777777777777,0.0,-328,-2312,2520.0
250000.0,5,1.75,2190,8250,1.0,3,7,1190,1000.0,1963,2570,8250,21616 days 16:47:18.668869,019,2.857142857142857,1.19,-380,0,190.0
385000.0,5,1.75,2190,8250,1.0,3,7,1190,1000.0,1963,2570,8250,21616 days 16:47:18.668869,111,2.857142857142857,1.19,-380,0,190.0
307000.0,3,1.5,2320,7500,1.0,3,7,2320,0.0,1976,1480,10000,16868 days 16:47:18.668869,142,2.0,0.0,840,-2500,2320.0
288000.0,3,2.5,1370,9253,1.0,3,7,1090,280.0,1994,1470,9253,10293 days 16:47:18.668869,133,1.2,3.892857142857143,-100,0,810.0
226450.0,3,1.75,1730,7200,1.5,4,6,1730,0.0,1944,860,7200,28556 days 16:47:18.668869,301,1.7142857142857142,0.0,870,0,1730.0
390000.0,3,2.5,1640,6991,1.0,3,7,1110,530.0,1967,1860,7342,20155 days 16:47:18.668869,069,1.2,2.0943396226415096,-220,-351,580.0
350000.0,3,1.0,1300,10236,1.0,4,6,1300,0.0,1971,1380,11325,18694 days 16:47:18.668869,273,3.0,0.0,-80,-1089,1300.0
368000.0,3,1.5,1560,7884,1.0,3,7,1060,500.0,1969,1820,9000,19424 days 16:47:18.668869,335,2.0,2.12,-260,-1116,560.0
469000.0,2,1.0,1120,4284,1.0,3,6,730,390.0,1921,2050,4160,36956 days 16:47:18.668869,230,2.0,1.8717948717948718,-930,124,340.0
865000.0,3,2.25,2670,150270,2.0,3,9,2670,0.0,1985,3080,81054,13580 days 16:47:18.668869,082,1.3333333333333333,0.0,-410,69216,2670.0
515000.0,5,2.5,3810,15916,1.5,5,8,3810,0.0,1967,2470,11662,20155 days 16:47:18.668869,013,2.0,0.0,1340,4254,3810.0
410000.0,3,1.75,1440,8560,1.0,4,7,1440,0.0,1979,1460,7560,15772 days 16:47:18.668869,023,1.7142857142857142,0.0,-20,1000,1440.0
210000.0,4,1.0,1200,43560,1.0,3,5,1200,0.0,1968,1400,54450,19790 days 16:47:18.668869,220,4.0,0.0,-200,-10890,1200.0
460000.0,3,1.75,1520,7700,1.0,3,7,820,700.0,1969,1420,7674,19424 days 16:47:18.668869,084,1.7142857142857142,1.1714285714285715,100,26,120.0
241500.0,4,2.5,2500,9654,1.0,3,8,1830,670.0,1979,2500,8839,15772 days 16:47:18.668869,262,1.6,2.7313432835820897,0,815,1160.0
322200.0,4,2.25,2010,19000,2.0,4,8,2010,0.0,1975,1950,19626,17233 days 16:47:18.668869,174,1.7777777777777777,0.0,60,-626,2010.0
279000.0,4,1.0,1210,6000,1.5,3,7,1210,0.0,1943,1470,6000,28921 days 16:47:18.668869,230,4.0,0.0,-260,0,1210.0
303000.0,2,1.0,1100,27007,1.0,4,6,1100,0.0,1943,1746,91476,28921 days 16:47:18.668869,251,2.0,0.0,-646,-64469,1100.0
420000.0,3,1.5,1050,6615,1.0,4,6,800,250.0,1950,1530,5250,26364 days 16:47:18.668869,293,2.0,3.2,-480,1365,550.0
249000.0,3,1.75,2120,18335,1.0,3,7,1380,740.0,1961,2050,18333,22346 days 16:47:18.668869,225,1.7142857142857142,1.864864864864865,70,2,640.0
294950.0,3,1.0,1240,8840,1.0,3,6,1240,0.0,1952,1250,8840,25634 days 16:47:18.668869,195,3.0,0.0,-10,0,1240.0
1320000.0,4,3.5,3460,3997,2.0,3,1,2560,900.0,2004,1860,4000,6641 days 16:47:18.668869,132,1.1428571428571428,2.8444444444444446,1600,-3,1660.0
335000.0,3,1.75,1270,4800,1.0,3,7,1270,0.0,1953,1490,4800,25268 days 16:47:18.668869,258,1.7142857142857142,0.0,-220,0,1270.0
1160000.0,4,2.25,2980,8051,1.5,4,1,2020,960.0,1935,2760,5499,31843 days 16:47:18.668869,156,1.7777777777777777,2.1041666666666665,220,2552,1060.0
520000.0,2,1.0,1250,3708,1.5,3,7,1250,0.0,1926,1430,3708,35130 days 16:47:18.668869,070,2.0,0.0,-180,0,1250.0
560000.0,4,1.75,1740,8800,1.0,4,8,1740,0.0,1965,2180,8436,20885 days 16:47:18.668869,259,2.2857142857142856,0.0,-440,364,1740.0
243400.0,4,1.5,1730,7464,2.0,4,7,1730,0.0,1959,1370,7860,23077 days 16:47:18.668869,285,2.6666666666666665,0.0,360,-396,1730.0
405000.0,3,2.0,1240,14404,1.0,3,7,1240,0.0,1988,1350,9990,12485 days 16:47:18.668869,149,1.5,0.0,-110,4414,1240.0
495000.0,2,1.0,1670,14695,1.5,5,7,1670,0.0,1930,1800,11355,33669 days 16:47:18.668869,275,2.0,0.0,-130,3340,1670.0
350000.0,4,2.5,2140,7095,2.0,3,8,2140,0.0,1992,1600,7182,11024 days 16:47:18.668869,092,1.6,0.0,540,-87,2140.0
368500.0,5,2.75,2530,7601,1.0,3,7,1520,1010.0,1992,2400,7776,11024 days 16:47:18.668869,345,1.8181818181818181,1.504950495049505,130,-175,510.0
99000.0,2,1.0,960,8236,1.0,2,6,960,0.0,1948,1260,8236,27095 days 16:47:18.668869,005,2.0,0.0,-300,0,960.0
1070000.0,4,3.75,4130,12320,2.0,3,1,4130,0.0,2001,3690,11227,7736 days 16:47:18.668869,154,1.0666666666666667,0.0,440,1093,4130.0
430000.0,4,1.75,1710,7724,1.0,3,8,1710,0.0,1983,1940,7724,14311 days 16:47:18.668869,238,2.2857142857142856,0.0,-230,0,1710.0
412500.0,3,1.5,1490,8475,1.0,4,7,1490,0.0,1963,1490,8540,21616 days 16:47:18.668869,135,2.0,0.0,0,-65,1490.0
1120000.0,4,3.25,4750,62365,2.0,3,1,4750,0.0,1988,3300,31866,12485 days 16:47:18.668869,347,1.2307692307692308,0.0,1450,30499,4750.0
915000.0,4,2.5,3400,35062,2.0,4,1,3400,0.0,1988,2880,9705,12485 days 16:47:18.668869,240,1.6,0.0,520,25357,3400.0
535000.0,3,2.5,2210,7620,2.0,3,8,2210,0.0,1994,1920,7440,10293 days 16:47:18.668869,143,1.2,0.0,290,180,2210.0
390000.0,3,1.5,1650,8676,1.0,4,8,1130,520.0,1979,1400,8499,15772 days 16:47:18.668869,308,2.0,2.173076923076923,250,177,610.0
499000.0,3,1.5,1260,3135,1.0,4,7,780,480.0,1944,1540,3025,28556 days 16:47:18.668869,251,2.0,1.625,-280,110,300.0
375000.0,3,1.0,1960,7955,1.0,4,7,1260,700.0,1963,1850,8219,21616 days 16:47:18.668869,211,3.0,1.8,110,-264,560.0
349000.0,4,2.5,1800,7620,2.0,3,8,1800,0.0,1995,1800,6879,9928 days 16:47:18.668869,301,1.6,0.0,0,741,1800.0
635000.0,3,2.25,1940,7482,1.0,4,7,1240,700.0,1964,2340,9310,21251 days 16:47:18.668869,304,1.3333333333333333,1.7714285714285714,-400,-1828,540.0
682000.0,4,2.75,2820,8009,2.0,3,9,2820,0.0,2001,2820,7398,7736 days 16:47:18.668869,349,1.4545454545454546,0.0,0,611,2820.0
321027.0,4,2.25,2820,16770,1.0,4,8,1920,900.0,1966,2320,13850,20520 days 16:47:18.668869,034,1.7777777777777777,2.1333333333333333,500,2920,1020.0
150000.0,2,1.0,720,4120,1.0,5,5,720,0.0,1915,940,6180,39148 days 16:47:18.668869,329,2.0,0.0,-220,-2060,720.0
410000.0,3,1.75,1640,17583,1.0,3,7,1110,530.0,1969,1420,11680,19424 days 16:47:18.668869,347,1.7142857142857142,2.0943396226415096,220,5903,580.0
449950.0,3,2.0,1560,4080,2.0,3,7,1560,0.0,1923,1900,4080,36226 days 16:47:18.668869,143,1.5,0.0,-340,0,1560.0
194990.0,6,2.5,1560,7144,1.0,3,6,1060,500.0,1913,1300,6232,39878 days 16:47:18.668869,286,2.4,2.12,260,912,560.0
475000.0,4,1.75,1910,8775,1.0,3,7,1210,700.0,1956,2210,8778,24173 days 16:47:18.668869,002,2.2857142857142856,1.7285714285714286,-300,-3,510.0
530000.0,5,1.75,1570,3000,2.0,4,7,1570,0.0,1908,1610,3000,41705 days 16:47:18.668869,028,2.857142857142857,0.0,-40,0,1570.0
319950.0,4,2.5,2038,7643,2.0,3,8,2038,0.0,2011,2634,6824,4084 days 16:47:18.668869,203,1.6,0.0,-596,819,2038.0
210000.0,3,2.25,1720,9435,1.0,4,7,1220,500.0,1978,1690,7215,16137 days 16:47:18.668869,086,1.3333333333333333,2.44,30,2220,720.0
485000.0,3,2.75,1670,3330,1.5,4,7,1670,0.0,1925,1370,5000,35495 days 16:47:18.668869,360,1.0909090909090908,0.0,300,-1670,1670.0
774000.0,4,2.75,2830,10240,2.0,4,9,2830,0.0,1998,3490,10240,8832 days 16:47:18.668869,028,1.4545454545454546,0.0,-660,0,2830.0
478000.0,4,2.0,1690,8208,1.0,4,7,1210,480.0,1958,1620,8496,23442 days 16:47:18.668869,288,2.0,2.5208333333333335,70,-288,730.0
385000.0,4,2.5,1620,5280,2.0,4,7,1620,0.0,1924,1590,5280,35861 days 16:47:18.668869,296,1.6,0.0,30,0,1620.0
595000.0,4,2.5,2360,43017,2.0,3,9,2360,0.0,1989,2750,40334,12119 days 16:47:18.668869,107,1.6,0.0,-390,2683,2360.0
285000.0,3,1.5,1480,7117,1.0,3,7,1170,310.0,1960,2230,14775,22712 days 16:47:18.668869,077,2.0,3.774193548387097,-750,-7658,860.0
723000.0,4,2.5,2700,4004,2.0,3,9,2700,0.0,2004,2260,4459,6641 days 16:47:18.668869,134,1.6,0.0,440,-455,2700.0
279000.0,3,1.5,1780,16000,1.0,2,7,1240,540.0,1960,1860,9775,22712 days 16:47:18.668869,224,2.0,2.2962962962962963,-80,6225,700.0
195000.0,3,1.5,1430,7560,1.0,5,6,1430,0.0,1958,1150,7560,23442 days 16:47:18.668869,065,2.0,0.0,280,0,1430.0
625000.0,2,1.0,2160,2192,1.0,5,8,1170,990.0,1925,1150,2152,35495 days 16:47:18.668869,288,2.0,1.1818181818181819,1010,40,180.0
270000.0,3,1.75,1800,9314,2.0,3,8,1800,0.0,1979,2100,9658,15772 days 16:47:18.668869,118,1.7142857142857142,0.0,-300,-344,1800.0
559000.0,2,2.0,1930,5520,1.0,3,8,1930,0.0,2006,1640,4533,5910 days 16:47:18.668869,280,1.0,0.0,290,987,1930.0
474000.0,4,2.25,1960,14834,1.0,4,8,1330,630.0,1976,1540,15000,16868 days 16:47:18.668869,033,1.7777777777777777,2.111111111111111,420,-166,700.0
303500.0,4,2.5,1920,7345,2.0,3,8,1920,0.0,1992,1860,7364,11024 days 16:47:18.668869,318,1.6,0.0,60,-19,1920.0
350000.0,3,1.75,1470,8645,1.0,3,6,1470,0.0,1949,1470,7680,26729 days 16:47:18.668869,360,1.7142857142857142,0.0,0,965,1470.0
367500.0,5,3.0,2980,10064,1.0,3,7,1680,1300.0,1940,1590,7800,30017 days 16:47:18.668869,218,1.6666666666666667,1.2923076923076924,1390,2264,380.0
595000.0,5,3.0,2980,10064,1.0,3,7,1680,1300.0,1940,1590,7800,30017 days 16:47:18.668869,056,1.6666666666666667,1.2923076923076924,1390,2264,380.0
589000.0,3,2.0,2360,118483,1.0,3,8,2360,0.0,1981,2660,91476,15041 days 16:47:18.668869,279,1.5,0.0,-300,27007,2360.0
585000.0,3,1.75,1790,87213,1.0,4,7,1790,0.0,1974,3270,39586,17598 days 16:47:18.668869,065,1.7142857142857142,0.0,-1480,47627,1790.0
482975.0,3,2.25,2130,8801,1.0,3,8,1370,760.0,1976,2820,8801,16868 days 16:47:18.668869,275,1.3333333333333333,1.8026315789473684,-690,0,610.0
365500.0,4,2.5,2030,4499,2.0,3,8,2030,0.0,2003,2030,4539,7006 days 16:47:18.668869,323,1.6,0.0,0,-40,2030.0
570000.0,4,2.0,1790,7800,1.0,5,8,1790,0.0,1972,2150,7838,18329 days 16:47:18.668869,192,2.0,0.0,-360,-38,1790.0
335000.0,3,2.5,2260,8040,2.0,3,8,2260,0.0,1990,2390,8040,11754 days 16:47:18.668869,033,1.2,0.0,-130,0,2260.0
767500.0,4,2.0,2350,4815,1.5,4,7,1450,900.0,1914,1640,4013,39513 days 16:47:18.668869,098,2.0,1.6111111111111112,710,802,550.0
386591.0,3,2.5,1690,1613,2.0,3,8,1150,540.0,2014,1690,1662,2988 days 16:47:18.668869,139,1.2,2.1296296296296298,0,-49,610.0
279000.0,3,1.0,1320,5750,1.5,3,7,1320,0.0,1913,1010,5700,39878 days 16:47:18.668869,203,3.0,0.0,310,50,1320.0
620000.0,4,2.5,2690,32780,2.0,3,9,2690,0.0,1998,2840,36555,8832 days 16:47:18.668869,099,1.6,0.0,-150,-3775,2690.0
407000.0,4,2.25,2810,23400,1.0,3,7,1710,1100.0,1958,1860,14900,23442 days 16:47:18.668869,126,1.7777777777777777,1.5545454545454545,950,8500,610.0
364250.0,3,2.5,2280,213879,2.0,3,8,2280,0.0,1994,2380,178160,10293 days 16:47:18.668869,239,1.2,0.0,-100,35719,2280.0
399000.0,4,2.5,2870,9292,2.0,3,8,2540,330.0,1979,2590,7533,15772 days 16:47:18.668869,147,1.6,7.696969696969697,280,1759,2210.0
766950.0,3,2.5,3030,30007,1.5,4,1,3030,0.0,1992,3360,34983,11024 days 16:47:18.668869,134,1.2,0.0,-330,-4976,3030.0
710000.0,4,2.75,2940,4232,2.0,3,9,2940,0.0,2004,2410,4000,6641 days 16:47:18.668869,261,1.4545454545454546,0.0,530,232,2940.0
320000.0,3,1.0,1190,4120,1.0,3,6,1190,0.0,1929,1360,4635,34034 days 16:47:18.668869,055,3.0,0.0,-170,-515,1190.0
300000.0,3,2.5,1800,3253,2.0,3,7,1800,0.0,2001,1800,3081,7736 days 16:47:18.668869,296,1.2,0.0,0,172,1800.0
263000.0,3,1.75,1580,9187,1.0,3,8,1180,400.0,1993,1620,6397,10658 days 16:47:18.668869,191,1.7142857142857142,2.95,-40,2790,780.0
445000.0,3,2.5,1730,4408,2.0,3,8,1730,0.0,1996,1730,4408,9563 days 16:47:18.668869,283,1.2,0.0,0,0,1730.0
554000.0,3,2.0,1910,9001,1.0,4,7,1910,0.0,1957,2040,8700,23807 days 16:47:18.668869,096,1.5,0.0,-130,301,1910.0
335000.0,2,1.75,1000,5100,1.0,3,6,940,60.0,1906,1900,5100,42435 days 16:47:18.668869,205,1.1428571428571428,15.666666666666666,-900,0,880.0
307000.0,4,2.75,2520,6964,1.0,4,7,1260,1260.0,1987,1930,6949,12850 days 16:47:18.668869,363,1.4545454545454546,1.0,590,15,0.0
404000.0,3,1.0,1420,8160,1.0,3,7,970,450.0,1947,1340,8160,27460 days 16:47:18.668869,061,3.0,2.1555555555555554,80,0,520.0
775000.0,4,3.5,3080,5250,2.0,3,9,3080,0.0,2003,2980,5509,7006 days 16:47:18.668869,212,1.1428571428571428,0.0,100,-259,3080.0
220000.0,3,1.0,1060,9126,1.0,5,7,1060,0.0,1956,1300,9126,24173 days 16:47:18.668869,141,3.0,0.0,-240,0,1060.0
518000.0,4,2.5,2160,9750,2.0,3,8,2160,0.0,1983,2840,10535,14311 days 16:47:18.668869,246,1.6,0.0,-680,-785,2160.0
1600000.0,4,3.5,4060,9486,2.0,3,1,4060,0.0,2005,2410,9486,6275 days 16:47:18.668869,343,1.1428571428571428,0.0,1650,0,4060.0
315000.0,1,2.25,1940,2550,2.0,4,7,1100,840.0,1979,1580,5100,15772 days 16:47:18.668869,296,0.4444444444444444,1.3095238095238095,360,-2550,260.0
572650.0,4,2.5,2250,11349,2.0,3,8,2250,0.0,1991,2110,9964,11389 days 16:47:18.668869,212,1.6,0.0,140,1385,2250.0
350000.0,2,1.0,1620,9205,1.0,5,6,850,770.0,1921,2460,5469,36956 days 16:47:18.668869,170,2.0,1.103896103896104,-840,3736,80.0
285000.0,2,1.0,920,5850,1.0,4,6,920,0.0,1900,1640,5476,44626 days 16:47:18.668869,262,2.0,0.0,-720,374,920.0
231000.0,3,2.5,1370,7247,2.0,3,7,1370,0.0,1995,1720,8085,9928 days 16:47:18.668869,084,1.2,0.0,-350,-838,1370.0
179000.0,3,1.0,920,5200,1.0,4,6,920,0.0,1969,920,5200,19424 days 16:47:18.668869,225,3.0,0.0,0,0,920.0
244000.0,3,1.5,1360,9625,1.0,3,7,1360,0.0,1963,1890,9625,21616 days 16:47:18.668869,089,2.0,0.0,-530,0,1360.0
610000.0,6,2.5,3610,12033,2.0,3,8,3210,400.0,1970,2210,8577,19059 days 16:47:18.668869,356,2.4,8.025,1400,3456,2810.0
419000.0,4,2.5,3010,9155,2.0,3,9,3010,0.0,2005,3010,5762,6275 days 16:47:18.668869,283,1.6,0.0,0,3393,3010.0
779000.0,3,1.75,2320,6400,1.0,4,8,1420,900.0,1957,2540,7680,23807 days 16:47:18.668869,238,1.7142857142857142,1.5777777777777777,-220,-1280,520.0
695000.0,5,3.0,3290,14134,1.0,3,7,1870,1420.0,2004,1970,11470,6641 days 16:47:18.668869,258,1.6666666666666667,1.3169014084507042,1320,2664,450.0
329000.0,3,2.75,1920,7700,1.0,4,8,1320,600.0,1978,2040,8000,16137 days 16:47:18.668869,012,1.0909090909090908,2.2,-120,-300,720.0
475226.0,3,2.5,2120,4512,2.0,3,8,2120,0.0,1988,2000,4553,12485 days 16:47:18.668869,239,1.2,0.0,120,-41,2120.0
638000.0,3,2.5,2170,5000,2.0,3,9,2170,0.0,2003,2170,5000,7006 days 16:47:18.668869,084,1.2,0.0,0,0,2170.0
440000.0,2,1.5,1330,15873,1.0,3,7,900,430.0,1984,1610,12043,13946 days 16:47:18.668869,084,1.3333333333333333,2.0930232558139537,-280,3830,470.0
214000.0,3,2.0,1580,5080,1.0,4,6,800,780.0,1942,1580,7114,29286 days 16:47:18.668869,040,1.5,1.0256410256410255,0,-2034,20.0
600000.0,3,2.75,3580,14217,2.0,4,1,2210,1370.0,1989,3990,14674,12119 days 16:47:18.668869,119,1.0909090909090908,1.6131386861313868,-410,-457,840.0
935000.0,4,2.0,2580,4500,2.0,4,9,1850,730.0,1905,2590,4100,42800 days 16:47:18.668869,104,2.0,2.5342465753424657,-10,400,1120.0
630000.0,4,1.75,1930,10210,1.5,3,8,1670,260.0,1941,2730,6600,29651 days 16:47:18.668869,300,2.2857142857142856,6.423076923076923,-800,3610,1410.0
575000.0,3,2.5,2120,4780,2.0,3,7,2120,0.0,2004,1690,2650,6641 days 16:47:18.668869,273,1.2,0.0,430,2130,2120.0
323000.0,4,1.75,1310,9690,1.0,4,7,1310,0.0,1967,2280,9618,20155 days 16:47:18.668869,197,2.2857142857142856,0.0,-970,72,1310.0
425000.0,3,2.5,2670,13218,1.0,4,1,2670,0.0,1988,1960,13130,12485 days 16:47:18.668869,136,1.2,0.0,710,88,2670.0
411000.0,2,2.25,1910,108900,1.0,4,7,1010,900.0,1972,2050,108900,18329 days 16:47:18.668869,125,0.8888888888888888,1.1222222222222222,-140,0,110.0
299800.0,4,1.5,1530,9000,1.0,4,6,1530,0.0,1976,1520,8500,16868 days 16:47:18.668869,202,2.6666666666666665,0.0,10,500,1530.0
823000.0,6,1.75,2920,5000,2.5,4,9,2780,140.0,1908,2020,5000,41705 days 16:47:18.668869,125,3.4285714285714284,19.857142857142858,900,0,2640.0
200000.0,3,1.0,1010,8108,1.0,3,7,1010,0.0,1955,1110,8108,24538 days 16:47:18.668869,251,3.0,0.0,-100,0,1010.0
760000.0,4,1.75,2450,13300,1.0,4,9,1630,820.0,1987,3150,15500,12850 days 16:47:18.668869,140,2.2857142857142856,1.9878048780487805,-700,-2200,810.0
359950.0,4,2.5,1820,3899,2.0,3,7,1820,0.0,1999,1820,3899,8467 days 16:47:18.668869,118,1.6,0.0,0,0,1820.0
375000.0,4,2.5,2090,8325,1.0,4,7,1470,620.0,1983,1700,8025,14311 days 16:47:18.668869,034,1.6,2.370967741935484,390,300,850.0
295000.0,2,1.75,2200,89298,1.0,3,7,1100,1100.0,1973,2590,89298,17963 days 16:47:18.668869,128,1.1428571428571428,1.0,-390,0,0.0
250000.0,4,3.0,2250,7882,2.0,3,8,1570,680.0,1986,1550,7508,13215 days 16:47:18.668869,078,1.3333333333333333,2.3088235294117645,700,374,890.0
497000.0,3,2.25,1450,1387,3.0,3,8,1450,0.0,2000,1450,1429,8102 days 16:47:18.668869,296,1.3333333333333333,0.0,0,-42,1450.0
520000.0,4,2.5,2280,8798,2.0,4,8,2280,0.0,1987,2180,8632,12850 days 16:47:18.668869,225,1.6,0.0,100,166,2280.0
365000.0,4,3.5,2720,6781,2.0,3,8,2100,620.0,1999,2280,5942,8467 days 16:47:18.668869,198,1.1428571428571428,3.3870967741935485,440,839,1480.0
459900.0,3,2.25,2250,8000,1.0,3,8,1460,790.0,1976,1930,9000,16868 days 16:47:18.668869,342,1.3333333333333333,1.8481012658227849,320,-1000,670.0
158000.0,3,2.0,1090,6090,1.0,3,7,940,150.0,1940,1840,6090,30017 days 16:47:18.668869,126,1.5,6.266666666666667,-750,0,790.0
439950.0,4,2.25,2780,15075,2.0,3,7,2780,0.0,1985,1650,25542,13580 days 16:47:18.668869,231,1.7777777777777777,0.0,1130,-10467,2780.0
899000.0,4,2.25,2290,40946,1.0,4,8,1550,740.0,1960,2790,20076,22712 days 16:47:18.668869,008,1.7777777777777777,2.0945945945945947,-500,20870,810.0
535000.0,3,1.75,2330,12141,1.0,3,7,1390,940.0,1983,1850,12141,14311 days 16:47:18.668869,183,1.7142857142857142,1.4787234042553192,480,0,450.0
530000.0,4,4.5,4060,10800,2.0,3,1,4060,0.0,2007,1830,9768,5545 days 16:47:18.668869,024,0.8888888888888888,0.0,2230,1032,4060.0
215000.0,4,2.0,1470,7000,1.0,4,8,1470,0.0,1967,1640,7000,20155 days 16:47:18.668869,035,2.0,0.0,-170,0,1470.0
798000.0,5,2.75,3220,5934,2.0,3,9,3220,0.0,2006,3100,5934,5910 days 16:47:18.668869,070,1.8181818181818181,0.0,120,0,3220.0
785000.0,4,2.5,3270,9578,2.0,3,9,3270,0.0,1993,3120,8784,10658 days 16:47:18.668869,311,1.6,0.0,150,794,3270.0
433000.0,3,1.75,2160,8565,1.0,3,8,1730,430.0,1971,2910,9570,18694 days 16:47:18.668869,077,1.7142857142857142,4.023255813953488,-750,-1005,1300.0
425000.0,2,1.0,1150,6835,1.0,3,7,1010,140.0,1922,1150,6561,36591 days 16:47:18.668869,202,2.0,7.214285714285714,0,274,870.0
654000.0,4,2.5,2240,7540,1.0,3,8,1540,700.0,1962,1960,7250,21981 days 16:47:18.668869,205,1.6,2.2,280,290,840.0
215000.0,3,1.5,1280,5065,2.0,4,6,1280,0.0,1983,1070,4491,14311 days 16:47:18.668869,290,2.0,0.0,210,574,1280.0
232000.0,3,1.0,840,6540,1.0,3,6,840,0.0,1970,1010,6600,19059 days 16:47:18.668869,077,3.0,0.0,-170,-60,840.0
675000.0,3,1.75,1680,10500,1.0,4,8,1680,0.0,1959,2250,10400,23077 days 16:47:18.668869,127,1.7142857142857142,0.0,-570,100,1680.0
665000.0,5,2.75,2330,8000,1.0,4,7,1550,780.0,1972,1750,8419,18329 days 16:47:18.668869,308,1.8181818181818181,1.9871794871794872,580,-419,770.0
835000.0,4,2.5,3030,29163,2.0,3,1,3030,0.0,1998,2780,40669,8832 days 16:47:18.668869,174,1.6,0.0,250,-11506,3030.0
525000.0,6,3.0,2880,7560,2.0,3,7,2880,0.0,1980,1470,1815,15407 days 16:47:18.668869,226,2.0,0.0,1410,5745,2880.0
780000.0,3,2.75,2910,3094,2.0,5,7,2010,900.0,1939,2400,7530,30382 days 16:47:18.668869,124,1.0909090909090908,2.2333333333333334,510,-4436,1110.0
844000.0,4,3.25,3090,67518,2.0,3,1,3090,0.0,1988,3200,65775,12485 days 16:47:18.668869,227,1.2307692307692308,0.0,-110,1743,3090.0
680000.0,4,2.75,2720,54048,2.0,3,8,2720,0.0,1985,2580,37721,13580 days 16:47:18.668869,027,1.4545454545454546,0.0,140,16327,2720.0
290000.0,3,1.5,1310,8100,1.0,3,7,1310,0.0,1965,1330,8100,20885 days 16:47:18.668869,237,2.0,0.0,-20,0,1310.0
560000.0,2,1.0,1790,15783,1.0,4,8,1360,430.0,1959,1790,7494,23077 days 16:47:18.668869,084,2.0,3.1627906976744184,0,8289,930.0
605500.0,3,2.5,2830,6536,2.0,3,9,2830,0.0,1989,2710,6954,12119 days 16:47:18.668869,168,1.2,0.0,120,-418,2830.0
762500.0,4,2.5,3150,5979,2.0,3,9,3150,0.0,2005,3150,6595,6275 days 16:47:18.668869,238,1.6,0.0,0,-616,3150.0
1740000.0,5,3.25,3930,5500,2.0,3,9,2910,1020.0,2014,2040,5115,2988 days 16:47:18.668869,064,1.5384615384615385,2.8529411764705883,1890,385,1890.0
665000.0,6,2.75,2840,8346,1.0,5,8,1420,1420.0,1961,2250,8346,22346 days 16:47:18.668869,175,2.1818181818181817,1.0,590,0,0.0
540000.0,5,1.0,2480,4400,1.5,3,7,1640,840.0,1919,1940,4400,37687 days 16:47:18.668869,070,5.0,1.9523809523809523,540,0,800.0
375000.0,3,2.5,1930,6180,1.0,3,7,1330,600.0,1961,1940,6180,22346 days 16:47:18.668869,323,1.2,2.216666666666667,-10,0,730.0
342000.0,3,1.0,1260,6826,1.0,3,6,720,540.0,1944,1300,6826,28556 days 16:47:18.668869,136,3.0,1.3333333333333333,-40,0,180.0
340000.0,3,1.0,670,23522,1.0,4,6,670,0.0,1968,1880,20270,19790 days 16:47:18.668869,069,3.0,0.0,-1210,3252,670.0
1250000.0,5,3.25,3930,12719,2.0,4,1,2540,1390.0,1974,3600,15909,17598 days 16:47:18.668869,089,1.5384615384615385,1.8273381294964028,330,-3190,1150.0
693000.0,4,2.5,3160,13063,2.0,3,1,3160,0.0,1999,3350,14213,8467 days 16:47:18.668869,344,1.6,0.0,-190,-1150,3160.0
638500.0,4,1.75,1770,12462,1.0,4,8,1770,0.0,1962,2310,14810,21981 days 16:47:18.668869,110,2.2857142857142856,0.0,-540,-2348,1770.0
805000.0,5,3.0,2240,18265,2.0,4,8,2240,0.0,1963,1990,18265,21616 days 16:47:18.668869,026,1.6666666666666667,0.0,250,0,2240.0
250000.0,3,1.0,990,8062,1.0,4,7,990,0.0,1960,1420,8790,22712 days 16:47:18.668869,190,3.0,0.0,-430,-728,990.0
325000.0,3,2.5,1580,4698,2.0,3,7,1580,0.0,1998,2070,4698,8832 days 16:47:18.668869,121,1.2,0.0,-490,0,1580.0
270000.0,4,1.75,1560,4290,2.0,3,7,1560,0.0,1994,1250,6000,10293 days 16:47:18.668869,091,2.2857142857142856,0.0,310,-1710,1560.0
880000.0,6,2.5,2640,3680,2.0,5,8,1760,880.0,1922,1960,3680,36591 days 16:47:18.668869,191,2.4,2.0,680,0,880.0
300000.0,2,1.75,2120,6350,1.0,4,6,1440,680.0,1924,1590,6350,35861 days 16:47:18.668869,218,1.1428571428571428,2.1176470588235294,530,0,760.0
290000.0,2,1.0,1200,8750,1.0,3,6,1200,0.0,1948,1100,8408,27095 days 16:47:18.668869,349,2.0,0.0,100,342,1200.0
2850000.0,4,4.0,5040,17208,1.0,5,1,2870,2170.0,1976,4050,18647,16868 days 16:47:18.668869,121,1.0,1.3225806451612903,990,-1439,700.0
259950.0,3,1.0,1460,5825,1.0,5,5,1260,200.0,1942,1150,5926,29286 days 16:47:18.668869,023,3.0,6.3,310,-101,1060.0
1780000.0,4,3.25,4890,13402,2.0,3,1,4890,0.0,2004,5790,13539,6641 days 16:47:18.668869,283,1.2307692307692308,0.0,-900,-137,4890.0
299950.0,3,1.0,1580,5250,1.0,5,7,1580,0.0,1954,1180,5940,24903 days 16:47:18.668869,310,3.0,0.0,400,-690,1580.0
483000.0,3,2.25,2100,43560,1.0,4,8,1330,770.0,1977,2100,43560,16502 days 16:47:18.668869,096,1.3333333333333333,1.7272727272727273,0,0,560.0
890000.0,3,2.25,2060,8640,1.0,4,8,2060,0.0,1966,2030,9000,20520 days 16:47:18.668869,163,1.3333333333333333,0.0,30,-360,2060.0
719000.0,3,2.5,1690,4500,1.5,4,8,1690,0.0,1928,2140,7200,34400 days 16:47:18.669866,128,1.2,0.0,-450,-2700,1690.0
785000.0,4,3.0,3370,100681,1.0,5,8,1920,1450.0,1977,2440,43705,16502 days 16:47:18.669866,281,1.3333333333333333,1.3241379310344827,930,56976,470.0
660000.0,3,2.5,2330,3995,2.0,3,9,2330,0.0,2006,2330,3740,5910 days 16:47:18.669866,085,1.2,0.0,0,255,2330.0
264000.0,4,1.75,1820,8118,1.0,4,7,1080,740.0,1980,1810,8050,15407 days 16:47:18.669866,169,2.2857142857142856,1.4594594594594594,10,68,340.0
575000.0,3,1.75,1890,11141,1.0,4,8,1890,0.0,1968,2720,11144,19790 days 16:47:18.669866,251,1.7142857142857142,0.0,-830,-3,1890.0
1220000.0,4,3.75,3820,53574,1.0,3,1,3820,0.0,1994,3140,54014,10293 days 16:47:18.669866,175,1.0666666666666667,0.0,680,-440,3820.0
475000.0,3,2.5,2770,98881,2.0,3,9,2770,0.0,1991,1830,74923,11389 days 16:47:18.669866,227,1.2,0.0,940,23958,2770.0
845800.0,4,3.5,3020,12750,2.0,3,1,3020,0.0,1990,3120,14351,11754 days 16:47:18.669866,325,1.1428571428571428,0.0,-100,-1601,3020.0
352500.0,3,1.75,1170,8182,1.0,3,7,1170,0.0,1962,1610,8183,21981 days 16:47:18.669866,162,1.7142857142857142,0.0,-440,-1,1170.0
347000.0,3,1.0,1270,8400,1.0,3,7,1270,0.0,1955,1390,8400,24538 days 16:47:18.669866,174,3.0,0.0,-120,0,1270.0
560000.0,4,2.75,1950,6192,2.0,3,8,1950,0.0,1992,2040,5441,11024 days 16:47:18.669866,009,1.4545454545454546,0.0,-90,751,1950.0
323000.0,4,2.75,2230,50094,1.0,4,7,1330,900.0,1977,2230,40770,16502 days 16:47:18.669866,124,1.4545454545454546,1.4777777777777779,0,9324,430.0
595000.0,3,1.75,2220,22081,1.5,4,7,2220,0.0,1922,2010,12360,36591 days 16:47:18.669866,065,1.7142857142857142,0.0,210,9721,2220.0
257500.0,4,2.0,2060,6400,1.0,3,7,1170,890.0,1977,1890,8736,16502 days 16:47:18.669866,051,2.0,1.3146067415730338,170,-2336,280.0
450000.0,3,1.0,1100,4600,1.0,3,7,1100,0.0,1917,1200,5175,38417 days 16:47:18.669866,148,3.0,0.0,-100,-575,1100.0
410000.0,4,1.0,1140,7208,1.0,3,7,900,240.0,1970,1300,7991,19059 days 16:47:18.669866,317,4.0,3.75,-160,-783,660.0
810000.0,3,1.75,1980,13503,1.0,4,9,1320,660.0,1952,2450,10890,25634 days 16:47:18.669866,164,1.7142857142857142,2.0,-470,2613,660.0
372500.0,5,3.0,2480,10090,1.0,3,7,1300,1180.0,2004,2290,9900,6641 days 16:47:18.669866,132,1.6666666666666667,1.1016949152542372,190,190,120.0
325000.0,3,1.0,1050,9083,1.0,3,7,1050,0.0,1951,1440,9071,25999 days 16:47:18.669866,337,3.0,0.0,-390,12,1050.0
280000.0,3,1.0,1260,7660,1.0,3,6,1260,0.0,1947,1990,7861,27460 days 16:47:18.669866,294,3.0,0.0,-730,-201,1260.0
258000.0,3,2.0,1680,19978,1.0,3,6,880,800.0,1948,2150,11588,27095 days 16:47:18.669866,192,1.5,1.1,-470,8390,80.0
329950.0,4,1.0,1360,5900,1.5,4,7,1360,0.0,1949,1050,5900,26729 days 16:47:18.669866,239,4.0,0.0,310,0,1360.0
836000.0,4,2.5,2450,12987,1.0,4,9,2030,420.0,1980,2730,13685,15407 days 16:47:18.669866,346,1.6,4.833333333333333,-280,-698,1610.0
365000.0,5,2.5,2260,7040,2.0,3,8,2260,0.0,1999,2180,6910,8467 days 16:47:18.669866,099,2.0,0.0,80,130,2260.0
111300.0,2,1.0,1060,6000,1.0,4,5,1060,0.0,1908,940,6000,41705 days 16:47:18.669866,042,2.0,0.0,120,0,1060.0
864000.0,4,2.5,3720,105850,2.0,4,1,3720,0.0,1984,2830,88256,13946 days 16:47:18.669866,117,1.6,0.0,890,17594,3720.0
725000.0,3,1.75,1610,8613,1.0,5,7,1610,0.0,1962,2010,8670,21981 days 16:47:18.669866,174,1.7142857142857142,0.0,-400,-57,1610.0
550000.0,4,2.5,3350,6605,2.0,3,8,2670,680.0,1990,2730,5962,11754 days 16:47:18.669866,049,1.6,3.926470588235294,620,643,1990.0
130000.0,2,1.0,790,7500,1.0,3,7,790,0.0,1951,1560,7794,25999 days 16:47:18.669866,106,2.0,0.0,-770,-294,790.0
765000.0,2,1.75,1660,4000,1.0,3,7,990,670.0,1940,2070,4000,30017 days 16:47:18.669866,269,1.1428571428571428,1.4776119402985075,-410,0,320.0
255000.0,3,1.5,1420,7480,1.0,4,7,1420,0.0,1963,1720,7700,21616 days 16:47:18.669866,111,2.0,0.0,-300,-220,1420.0
268000.0,3,1.75,1250,5546,1.0,4,7,1250,0.0,1987,1640,4791,12850 days 16:47:18.669866,251,1.7142857142857142,0.0,-390,755,1250.0
985000.0,3,1.75,1700,8534,1.0,4,7,1700,0.0,1953,2100,10443,25268 days 16:47:18.669866,091,1.7142857142857142,0.0,-400,-1909,1700.0
751305.0,4,2.5,2660,8469,2.0,3,1,2660,0.0,1994,2920,10697,10293 days 16:47:18.669866,322,1.6,0.0,-260,-2228,2660.0
280000.0,3,1.0,1350,7553,1.5,3,6,1350,0.0,1914,1380,7470,39513 days 16:47:18.669866,113,3.0,0.0,-30,83,1350.0
304000.0,4,2.0,1810,8750,1.0,2,7,1110,700.0,1967,1810,8750,20155 days 16:47:18.669866,167,2.0,1.5857142857142856,0,0,410.0
200000.0,4,2.75,2210,13235,2.0,3,8,1730,480.0,1988,1750,7542,12485 days 16:47:18.669866,113,1.4545454545454546,3.6041666666666665,460,5693,1250.0
325000.0,3,1.5,2120,41325,1.0,4,7,1420,700.0,1973,1780,42000,17963 days 16:47:18.669866,051,2.0,2.0285714285714285,340,-675,720.0
736000.0,3,2.25,2470,11603,2.0,3,8,1540,930.0,1988,2850,11250,12485 days 16:47:18.669866,083,1.3333333333333333,1.6559139784946237,-380,353,610.0
426500.0,4,2.5,2700,6515,2.0,3,9,2700,0.0,1998,2900,6710,8832 days 16:47:18.669866,191,1.6,0.0,-200,-195,2700.0
640000.0,2,1.75,1760,4400,1.0,4,7,880,880.0,1930,1330,4180,33669 days 16:47:18.669866,171,1.1428571428571428,1.0,430,220,0.0
230000.0,5,2.0,1930,6120,1.5,3,6,1930,0.0,1941,1130,6120,29651 days 16:47:18.669866,141,2.5,0.0,800,0,1930.0
366350.0,4,1.0,1680,5043,1.5,4,6,1680,0.0,1911,1560,5765,40609 days 16:47:18.669866,083,4.0,0.0,120,-722,1680.0
365000.0,2,1.0,1390,8336,1.0,4,6,910,480.0,1946,1610,7847,27825 days 16:47:18.669866,006,2.0,1.8958333333333333,-220,489,430.0
482000.0,4,2.25,2240,8322,2.0,3,8,2240,0.0,1979,2240,6448,15772 days 16:47:18.669866,056,1.7777777777777777,0.0,0,1874,2240.0
345000.0,4,1.0,1980,7991,1.5,3,7,1980,0.0,1962,1730,7700,21981 days 16:47:18.669866,136,4.0,0.0,250,291,1980.0
682000.0,3,1.75,1830,5120,1.5,5,8,1830,0.0,1903,2120,5120,43531 days 16:47:18.669866,134,1.7142857142857142,0.0,-290,0,1830.0
657500.0,3,1.75,980,6002,1.0,4,6,980,0.0,1942,1150,6054,29286 days 16:47:18.669866,227,1.7142857142857142,0.0,-170,-52,980.0
895000.0,6,2.5,3550,6533,2.0,3,8,3550,0.0,1925,3140,6234,35495 days 16:47:18.669866,109,2.4,0.0,410,299,3550.0
425000.0,3,1.5,1660,5665,1.0,5,7,920,740.0,1918,1530,5665,38052 days 16:47:18.669866,093,2.0,1.2432432432432432,130,0,180.0
532500.0,4,2.5,2490,8750,2.0,3,8,2040,450.0,1976,2120,10240,16868 days 16:47:18.669866,218,1.6,4.533333333333333,370,-1490,1590.0
540000.0,4,2.5,2329,9436,2.0,3,9,2329,0.0,1995,2660,10252,9928 days 16:47:18.669866,281,1.6,0.0,-331,-816,2329.0
578000.0,3,2.25,1790,9580,2.0,3,8,1790,0.0,1984,2060,9995,13946 days 16:47:18.669866,192,1.3333333333333333,0.0,-270,-415,1790.0
1090000.0,3,3.0,2830,6041,2.0,3,8,1840,990.0,1915,3420,6360,39148 days 16:47:18.669866,040,1.0,1.8585858585858586,-590,-319,850.0
322500.0,3,1.0,1160,9750,1.0,3,7,1160,0.0,1968,1160,10565,19790 days 16:47:18.669866,247,3.0,0.0,0,-815,1160.0
140000.0,3,1.0,1000,10560,1.0,3,7,1000,0.0,1955,1190,9375,24538 days 16:47:18.669866,015,3.0,0.0,-190,1185,1000.0
485000.0,3,2.5,2540,51836,1.0,4,8,1820,720.0,1976,1650,51836,16868 days 16:47:18.669866,253,1.2,2.5277777777777777,890,0,1100.0
575000.0,2,1.5,1750,19709,1.5,4,8,1440,310.0,1978,1950,21075,16137 days 16:47:18.669866,231,1.3333333333333333,4.645161290322581,-200,-1366,1130.0
421000.0,3,2.5,2890,21780,2.0,3,8,2890,0.0,2000,2120,8117,8102 days 16:47:18.669866,168,1.2,0.0,770,13663,2890.0
355000.0,4,2.0,1870,3497,1.0,3,7,1200,670.0,1954,1270,3497,24903 days 16:47:18.669866,070,2.0,1.791044776119403,600,0,530.0
515000.0,4,2.25,2200,6967,2.0,3,8,2200,0.0,1986,1970,7439,13215 days 16:47:18.669866,077,1.7777777777777777,0.0,230,-472,2200.0
309000.0,3,1.0,1300,7200,1.0,4,7,1300,0.0,1952,1740,7100,25634 days 16:47:18.669866,118,3.0,0.0,-440,100,1300.0
815000.0,5,2.25,3410,35536,2.0,3,1,2530,880.0,1974,3140,43453,17598 days 16:47:18.669866,055,2.2222222222222223,2.875,270,-7917,1650.0
285000.0,3,1.0,1160,7875,1.0,3,7,1160,0.0,1953,1600,7875,25268 days 16:47:18.669866,310,3.0,0.0,-440,0,1160.0
700000.0,3,1.75,2100,5000,1.5,3,8,2100,0.0,1916,1830,4200,38783 days 16:47:18.669866,314,1.7142857142857142,0.0,270,800,2100.0
289000.0,3,2.5,1490,8628,2.0,3,7,1490,0.0,1994,1640,8514,10293 days 16:47:18.669866,089,1.2,0.0,-150,114,1490.0
458000.0,4,3.0,3280,62726,1.5,3,7,3280,0.0,1979,3210,73616,15772 days 16:47:18.669866,346,1.3333333333333333,0.0,70,-10890,3280.0
230000.0,3,1.75,1450,8378,1.0,4,8,1450,0.0,1978,1860,8496,16137 days 16:47:18.669866,230,1.7142857142857142,0.0,-410,-118,1450.0
432500.0,3,2.5,1930,7120,1.0,4,7,1420,510.0,1961,1600,8352,22346 days 16:47:18.669866,224,1.2,2.784313725490196,330,-1232,910.0
288000.0,3,1.75,1660,10440,1.0,3,7,1040,620.0,1978,1240,10380,16137 days 16:47:18.669866,212,1.7142857142857142,1.6774193548387097,420,60,420.0
354000.0,3,1.75,1260,12330,1.0,3,7,1260,0.0,1968,1320,12800,19790 days 16:47:18.669866,213,1.7142857142857142,0.0,-60,-470,1260.0
119500.0,3,1.0,1170,11000,1.0,2,6,1170,0.0,1980,1590,10894,15407 days 16:47:18.669866,155,3.0,0.0,-420,106,1170.0
805000.0,4,3.0,3350,23781,1.0,4,9,2020,1330.0,1979,2870,12036,15772 days 16:47:18.669866,324,1.3333333333333333,1.518796992481203,480,11745,690.0
435000.0,3,2.5,1420,2581,3.0,3,7,1420,0.0,2004,1420,2509,6641 days 16:47:18.669866,162,1.2,0.0,0,72,1420.0
260000.0,3,1.75,2170,10018,1.0,4,7,1630,540.0,1978,2049,15263,16137 days 16:47:18.669866,265,1.7142857142857142,3.0185185185185186,121,-5245,1090.0
377000.0,4,1.75,1800,8385,1.0,5,6,900,900.0,1950,1770,8385,26364 days 16:47:18.669866,091,2.2857142857142856,1.0,30,0,0.0
602000.0,4,2.5,2000,7376,2.0,3,8,2000,0.0,1990,1950,5218,11754 days 16:47:18.669866,079,1.6,0.0,50,2158,2000.0
530000.0,3,1.75,1660,4800,1.0,3,7,960,700.0,1941,1510,4800,29651 days 16:47:18.669866,300,1.7142857142857142,1.3714285714285714,150,0,260.0
525000.0,4,2.0,1540,3740,1.0,4,7,770,770.0,1946,1090,5080,27825 days 16:47:18.669866,084,2.0,1.0,450,-1340,0.0
250000.0,2,1.5,1160,1086,2.0,3,7,890,270.0,2006,1160,1086,5910 days 16:47:18.669866,314,1.3333333333333333,3.2962962962962963,0,0,620.0
681000.0,3,1.0,1700,6356,1.5,3,7,1700,0.0,1907,2080,6000,42070 days 16:47:18.669866,148,3.0,0.0,-380,356,1700.0
625000.0,3,1.75,1580,20588,1.0,3,8,1580,0.0,1970,2080,7800,19059 days 16:47:18.669866,248,1.7142857142857142,0.0,-500,12788,1580.0
448500.0,3,2.5,2080,3920,2.0,3,8,2080,0.0,2010,2110,3710,4449 days 16:47:18.669866,128,1.2,0.0,-30,210,2080.0
260000.0,3,2.0,1030,7260,1.0,3,6,1030,0.0,1947,1380,8100,27460 days 16:47:18.669866,295,1.5,0.0,-350,-840,1030.0
538000.0,3,1.75,1770,8050,1.0,4,7,1020,750.0,1963,2000,7875,21616 days 16:47:18.669866,303,1.7142857142857142,1.36,-230,175,270.0
385500.0,3,2.0,1540,7947,1.0,3,7,1120,420.0,1961,1910,7950,22346 days 16:47:18.669866,141,1.5,2.6666666666666665,-370,-3,700.0
428400.0,4,2.5,2650,6000,2.0,3,9,2650,0.0,2000,2630,6381,8102 days 16:47:18.669866,248,1.6,0.0,20,-381,2650.0
346290.0,4,2.75,2690,9240,2.0,3,8,2690,0.0,1998,2640,9240,8832 days 16:47:18.669866,210,1.4545454545454546,0.0,50,0,2690.0
355000.0,4,2.5,2390,6775,2.0,3,7,2390,0.0,2003,2560,6346,7006 days 16:47:18.669866,232,1.6,0.0,-170,429,2390.0
650000.0,5,2.75,2580,7865,1.0,4,8,1480,1100.0,1964,2140,8400,21251 days 16:47:18.669866,118,1.8181818181818181,1.3454545454545455,440,-535,380.0
340000.0,4,2.5,2160,5455,2.0,3,7,2160,0.0,2003,2160,5257,7006 days 16:47:18.669866,211,1.6,0.0,0,198,2160.0
630000.0,4,2.0,2000,5000,1.5,5,7,2000,0.0,1925,2200,5000,35495 days 16:47:18.669866,050,2.0,0.0,-200,0,2000.0
227000.0,3,1.0,1280,7198,1.0,5,6,1280,0.0,1916,1260,7198,38783 days 16:47:18.669866,311,3.0,0.0,20,0,1280.0
600000.0,4,2.75,2810,17674,1.0,4,8,1640,1170.0,1978,2400,11240,16137 days 16:47:18.669866,210,1.4545454545454546,1.4017094017094016,410,6434,470.0
540400.0,4,1.75,1680,6758,1.0,3,8,1680,0.0,1974,1910,7000,17598 days 16:47:18.669866,033,2.2857142857142856,0.0,-230,-242,1680.0
569000.0,3,2.5,2150,8060,2.0,3,8,2150,0.0,1995,2150,7172,9928 days 16:47:18.669866,274,1.2,0.0,0,888,2150.0
735000.0,3,2.5,2820,8159,2.0,3,9,2820,0.0,2004,2910,5000,6641 days 16:47:18.669866,191,1.2,0.0,-90,3159,2820.0
434000.0,3,2.25,1750,9353,1.0,3,7,1210,540.0,1987,1930,8545,12850 days 16:47:18.669866,350,1.3333333333333333,2.240740740740741,-180,808,670.0
578888.0,2,2.0,1060,4000,1.0,2,7,1000,60.0,1914,1310,4000,39513 days 16:47:18.669866,078,1.0,16.666666666666668,-250,0,940.0
465425.0,4,2.75,2430,20720,1.0,3,7,2430,0.0,1967,2580,26950,20155 days 16:47:18.669866,143,1.4545454545454546,0.0,-150,-6230,2430.0
280500.0,4,2.75,2660,7754,1.5,3,8,1590,1070.0,1986,2250,7754,13215 days 16:47:18.669866,112,1.4545454545454546,1.485981308411215,410,0,520.0
539950.0,2,2.0,1670,3507,1.0,3,9,1670,0.0,2007,2330,3889,5545 days 16:47:18.669866,036,1.0,0.0,-660,-382,1670.0
406430.0,3,2.0,1380,15426,1.0,4,7,1380,0.0,1968,1380,15426,19790 days 16:47:18.669866,247,1.5,0.0,0,0,1380.0
1150000.0,4,3.75,4160,35000,2.0,3,1,4160,0.0,1991,5330,36446,11389 days 16:47:18.669866,036,1.0666666666666667,0.0,-1170,-1446,4160.0
250000.0,3,2.5,1790,6191,2.0,3,8,1790,0.0,1992,1790,6758,11024 days 16:47:18.669866,315,1.2,0.0,0,-567,1790.0
266000.0,3,2.5,1940,8547,1.0,3,7,1460,480.0,1989,1750,7803,12119 days 16:47:18.669866,128,1.2,3.0416666666666665,190,744,980.0
258000.0,3,2.0,1390,7200,1.0,3,7,1390,0.0,1996,1630,7340,9563 days 16:47:18.669866,203,1.5,0.0,-240,-140,1390.0
472000.0,3,2.0,2200,21890,1.0,3,8,1200,1000.0,1961,2600,15162,22346 days 16:47:18.669866,357,1.5,1.2,-400,6728,200.0
530000.0,3,2.25,1264,1536,2.0,3,8,1264,0.0,2003,1264,2067,7006 days 16:47:18.669866,218,1.3333333333333333,0.0,0,-531,1264.0
302282.0,2,1.0,1095,5120,1.5,3,7,1095,0.0,1901,1310,5120,44261 days 16:47:18.669866,203,2.0,0.0,-215,0,1095.0
370000.0,2,1.0,850,6213,1.0,3,6,750,100.0,1916,1880,5500,38783 days 16:47:18.669866,070,2.0,7.5,-1030,713,650.0
625000.0,4,2.0,1760,5307,1.5,4,7,1170,590.0,1948,1850,6600,27095 days 16:47:18.669866,286,2.0,1.9830508474576272,-90,-1293,580.0
142500.0,1,1.0,690,6825,1.0,4,5,690,0.0,1917,1330,5381,38417 days 16:47:18.669866,099,1.0,0.0,-640,1444,690.0
334000.0,3,1.75,1400,7405,1.0,3,7,1400,0.0,1961,1820,7440,22346 days 16:47:18.669866,021,1.7142857142857142,0.0,-420,-35,1400.0
362000.0,5,3.0,1810,3000,2.0,3,7,1810,0.0,1998,1670,3000,8832 days 16:47:18.669866,189,1.6666666666666667,0.0,140,0,1810.0
181000.0,2,1.0,1310,4000,1.0,3,7,950,360.0,1942,1310,4000,29286 days 16:47:18.669866,107,2.0,2.638888888888889,0,0,590.0
241500.0,3,1.0,1400,10425,1.0,4,7,1400,0.0,1968,1440,10425,19790 days 16:47:18.669866,365,3.0,0.0,-40,0,1400.0
245000.0,3,1.75,2350,12720,1.0,4,7,1180,1170.0,1964,1680,10400,21251 days 16:47:18.669866,035,1.7142857142857142,1.0085470085470085,670,2320,10.0
227500.0,3,1.0,1150,8848,1.0,3,7,1150,0.0,1968,1220,9576,19790 days 16:47:18.669866,126,3.0,0.0,-70,-728,1150.0
158550.0,5,1.5,1710,8100,1.5,4,7,1710,0.0,1961,1480,8025,22346 days 16:47:18.669866,276,3.3333333333333335,0.0,230,75,1710.0
450000.0,3,2.25,1660,10247,1.0,5,7,1130,530.0,1968,1680,7637,19790 days 16:47:18.669866,268,1.3333333333333333,2.1320754716981134,-20,2610,600.0
485000.0,3,1.75,1950,10080,1.0,4,7,1950,0.0,1967,2340,8800,20155 days 16:47:18.669866,035,1.7142857142857142,0.0,-390,1280,1950.0
353000.0,4,1.75,1780,9794,1.0,3,7,1780,0.0,1967,1160,9750,20155 days 16:47:18.669866,310,2.2857142857142856,0.0,620,44,1780.0
500000.0,4,3.0,2450,4668,2.0,3,8,2450,0.0,2004,2460,4895,6641 days 16:47:18.669866,096,1.3333333333333333,0.0,-10,-227,2450.0
360000.0,1,2.25,2060,10600,1.5,3,7,1560,500.0,1927,2060,11880,34765 days 16:47:18.669866,251,0.4444444444444444,3.12,0,-1280,1060.0
357500.0,3,1.5,1540,11858,1.0,4,7,1540,0.0,1966,1550,11473,20520 days 16:47:18.669866,054,2.0,0.0,-10,385,1540.0
272000.0,3,2.5,1650,13816,2.0,3,7,1650,0.0,1998,1650,15144,8832 days 16:47:18.669866,126,1.2,0.0,0,-1328,1650.0
422000.0,3,1.0,1160,7854,1.0,3,7,1160,0.0,1960,1300,8317,22712 days 16:47:18.669866,118,3.0,0.0,-140,-463,1160.0
365000.0,2,2.0,1440,15000,1.0,3,7,1440,0.0,1985,1780,15000,13580 days 16:47:18.669866,260,1.0,0.0,-340,0,1440.0
450000.0,3,1.75,2150,13789,1.0,4,8,1610,540.0,1966,2150,15480,20520 days 16:47:18.669866,233,1.7142857142857142,2.9814814814814814,0,-1691,1070.0
275053.0,2,1.0,1060,6504,1.0,3,6,1060,0.0,1950,1100,7200,26364 days 16:47:18.669866,265,2.0,0.0,-40,-696,1060.0
1880000.0,3,2.75,2620,17919,1.0,4,9,2620,0.0,1949,3400,14400,26729 days 16:47:18.669866,310,1.0909090909090908,0.0,-780,3519,2620.0
725000.0,3,1.75,1630,9000,1.0,3,7,960,670.0,1955,1880,9000,24538 days 16:47:18.669866,070,1.7142857142857142,1.4328358208955223,-250,0,290.0
235000.0,3,1.75,1840,9697,1.0,4,7,1500,340.0,1985,1430,8079,13580 days 16:47:18.669866,163,1.7142857142857142,4.411764705882353,410,1618,1160.0
510000.0,2,1.0,820,4206,1.0,3,5,820,0.0,1949,1810,7200,26729 days 16:47:18.669866,345,2.0,0.0,-990,-2994,820.0
489950.0,2,1.0,820,4206,1.0,3,5,820,0.0,1949,1810,7200,26729 days 16:47:18.669866,098,2.0,0.0,-990,-2994,820.0
463000.0,3,2.5,2010,4195,2.0,3,8,2010,0.0,1998,2010,5779,8832 days 16:47:18.669866,211,1.2,0.0,0,-1584,2010.0
536000.0,4,2.25,1990,5948,2.0,3,8,1990,0.0,1991,2150,6459,11389 days 16:47:18.669866,168,1.7777777777777777,0.0,-160,-511,1990.0
375000.0,4,2.5,2990,6145,2.0,3,8,2990,0.0,2003,2590,6512,7006 days 16:47:18.669866,294,1.6,0.0,400,-367,2990.0
630000.0,4,2.5,2540,4727,2.0,3,9,2540,0.0,1999,3640,5129,8467 days 16:47:18.669866,251,1.6,0.0,-1100,-402,2540.0
362000.0,3,2.25,1640,14374,1.0,4,7,1140,500.0,1963,2020,10500,21616 days 16:47:18.669866,126,1.3333333333333333,2.28,-380,3874,640.0
350000.0,4,2.75,2500,11659,1.0,3,9,1490,1010.0,1979,2830,9915,15772 days 16:47:18.669866,035,1.4545454545454546,1.4752475247524752,-330,1744,480.0
1690000.0,4,3.5,4020,13515,2.0,3,1,4020,0.0,2001,3930,13515,7736 days 16:47:18.669866,276,1.1428571428571428,0.0,90,0,4020.0
255000.0,3,2.0,1500,8775,1.0,3,6,1390,110.0,1943,1310,8775,28921 days 16:47:18.669866,055,1.5,12.636363636363637,190,0,1280.0
269000.0,4,2.5,1594,7665,1.0,5,7,1088,506.0,1975,1536,6000,17233 days 16:47:18.669866,218,1.6,2.150197628458498,58,1665,582.0
370000.0,4,3.0,2130,4838,1.5,4,7,2130,0.0,1930,1070,4838,33669 days 16:47:18.669866,237,1.3333333333333333,0.0,1060,0,2130.0
270000.0,3,1.0,1130,7920,1.0,3,7,1130,0.0,1961,1390,8580,22346 days 16:47:18.669866,121,3.0,0.0,-260,-660,1130.0
265000.0,3,2.0,1690,9516,1.0,3,7,1690,0.0,1997,1850,9516,9197 days 16:47:18.669866,055,1.5,0.0,-160,0,1690.0
487000.0,2,1.0,1440,4046,1.0,3,7,960,480.0,1946,1400,4046,27825 days 16:47:18.669866,119,2.0,2.0,40,0,480.0
835000.0,4,3.25,3270,6027,2.0,3,1,3270,0.0,2001,3270,6546,7736 days 16:47:18.669866,216,1.2307692307692308,0.0,0,-519,3270.0
850000.0,4,3.25,4350,112750,1.0,3,9,2200,2150.0,2006,2180,223027,5910 days 16:47:18.669866,182,1.2307692307692308,1.0232558139534884,2170,-110277,50.0
575000.0,4,2.75,1610,11201,1.0,5,7,1020,590.0,1982,1610,9000,14676 days 16:47:18.669866,335,1.4545454545454546,1.728813559322034,0,2201,430.0
335000.0,3,1.0,950,8000,1.0,3,7,950,0.0,1968,2270,8540,19790 days 16:47:18.669866,193,3.0,0.0,-1320,-540,950.0
318000.0,3,1.0,1010,7200,1.0,5,6,1010,0.0,1948,1590,7663,27095 days 16:47:18.669866,220,3.0,0.0,-580,-463,1010.0
242500.0,3,1.5,1200,9720,1.0,4,7,1200,0.0,1965,1380,10284,20885 days 16:47:18.669866,122,2.0,0.0,-180,-564,1200.0
750000.0,5,2.25,2020,8400,1.0,4,7,1010,1010.0,1963,1890,9233,21616 days 16:47:18.669866,338,2.2222222222222223,1.0,130,-833,0.0
439900.0,5,3.5,3390,7950,2.0,3,7,3390,0.0,2003,2580,6900,7006 days 16:47:18.669866,202,1.4285714285714286,0.0,810,1050,3390.0
710000.0,2,1.0,1700,3040,1.5,3,8,1460,240.0,1914,1620,3230,39513 days 16:47:18.669866,097,2.0,6.083333333333333,80,-190,1220.0
2400000.0,5,3.25,3410,9088,2.0,3,9,2760,650.0,1912,3540,7100,40244 days 16:47:18.669866,155,1.5384615384615385,4.246153846153846,-130,1988,2110.0
435000.0,3,1.75,2030,13700,1.0,3,8,1630,400.0,1976,2120,11200,16868 days 16:47:18.669866,349,1.7142857142857142,4.075,-90,2500,1230.0
874000.0,4,2.75,2860,6867,1.0,5,7,1560,1300.0,1946,2290,5350,27825 days 16:47:18.669866,360,1.4545454545454546,1.2,570,1517,260.0
385000.0,4,1.75,1690,4080,1.0,4,7,870,820.0,1984,1320,4080,13946 days 16:47:18.669866,167,2.2857142857142856,1.0609756097560976,370,0,50.0
110000.0,2,1.0,760,4746,1.0,3,5,760,0.0,1930,1360,7810,33669 days 16:47:18.669866,303,2.0,0.0,-600,-3064,760.0
477000.0,3,1.75,1780,8085,1.0,3,7,1210,570.0,1976,1780,8085,16868 days 16:47:18.669866,171,1.7142857142857142,2.1228070175438596,0,0,640.0
500000.0,3,2.0,1550,6394,1.5,5,8,1550,0.0,1918,1440,6387,38052 days 16:47:18.669866,255,1.5,0.0,110,7,1550.0
885000.0,4,2.5,4090,11225,2.0,3,1,4090,0.0,2005,3510,8762,6275 days 16:47:18.669866,240,1.6,0.0,580,2463,4090.0
235000.0,2,1.0,880,5600,1.0,5,7,880,0.0,1955,1240,7015,24538 days 16:47:18.669866,239,2.0,0.0,-360,-1415,880.0
210000.0,3,2.75,1320,15236,1.0,3,7,880,440.0,1995,1490,8351,9928 days 16:47:18.669866,124,1.0909090909090908,2.0,-170,6885,440.0
320000.0,2,1.0,950,4000,1.0,3,6,950,0.0,1910,1480,4000,40974 days 16:47:18.669866,110,2.0,0.0,-530,0,950.0
406000.0,3,1.75,1390,7904,1.0,3,7,1390,0.0,1985,1910,7904,13580 days 16:47:18.669866,072,1.7142857142857142,0.0,-520,0,1390.0
350000.0,3,1.75,1900,10225,1.0,4,8,1220,680.0,1963,1850,12630,21616 days 16:47:18.669866,301,1.7142857142857142,1.7941176470588236,50,-2405,540.0
350000.0,2,0.75,1392,43710,1.5,4,7,1392,0.0,1978,1640,99316,16137 days 16:47:18.669866,161,2.6666666666666665,0.0,-248,-55606,1392.0
720000.0,4,2.5,3340,8930,2.0,3,1,3340,0.0,1999,3160,7865,8467 days 16:47:18.669866,191,1.6,0.0,180,1065,3340.0
343000.0,3,1.0,1400,5662,1.5,5,5,1400,0.0,1920,1250,14375,37322 days 16:47:18.669866,268,3.0,0.0,150,-8713,1400.0
558000.0,3,2.25,2220,15757,1.0,3,8,1280,940.0,1982,2020,14098,14676 days 16:47:18.669866,343,1.3333333333333333,1.3617021276595744,200,1659,340.0
364000.0,4,1.0,1210,7740,1.5,3,7,1210,0.0,1922,1100,7740,36591 days 16:47:18.669866,107,4.0,0.0,110,0,1210.0
420000.0,3,1.75,2390,11242,1.0,3,7,1290,1100.0,1959,2270,9650,23077 days 16:47:18.669866,301,1.7142857142857142,1.1727272727272726,120,1592,190.0
450000.0,5,2.0,1870,7344,1.5,3,7,1870,0.0,1960,1870,7650,22712 days 16:47:18.669866,135,2.5,0.0,0,-306,1870.0
392000.0,2,1.5,940,5000,1.0,4,7,810,130.0,1925,940,5026,35495 days 16:47:18.669866,225,1.3333333333333333,6.230769230769231,0,-26,680.0
100000.0,4,1.0,1120,2685,1.0,3,5,860,260.0,1939,1120,4838,30382 days 16:47:18.669866,161,4.0,3.3076923076923075,0,-2153,600.0
480000.0,3,2.5,1250,1103,3.0,3,8,1250,0.0,2005,1250,1188,6275 days 16:47:18.669866,163,1.2,0.0,0,-85,1250.0
212000.0,3,1.5,1060,9225,1.0,4,7,1060,0.0,1955,1270,9375,24538 days 16:47:18.669866,239,2.0,0.0,-210,-150,1060.0
560000.0,5,2.5,2410,8960,1.0,5,7,1600,810.0,1978,2410,11514,16137 days 16:47:18.669866,337,2.0,1.9753086419753085,0,-2554,790.0
359950.0,5,2.75,2844,3990,2.0,3,8,2844,0.0,2013,2273,3900,3353 days 16:47:18.669866,118,1.8181818181818181,0.0,571,90,2844.0
535000.0,4,2.5,2200,110642,1.0,5,7,1330,870.0,1979,2290,51400,15772 days 16:47:18.669866,253,1.6,1.528735632183908,-90,59242,460.0
980000.0,5,4.0,3460,5400,2.0,3,1,2830,630.0,2012,1890,5400,3719 days 16:47:18.669866,100,1.25,4.492063492063492,1570,0,2200.0
720000.0,2,1.0,1580,2199,2.0,3,8,1580,0.0,1921,2170,4405,36956 days 16:47:18.669866,317,2.0,0.0,-590,-2206,1580.0
619950.0,2,1.0,1520,5400,1.0,3,7,920,600.0,1951,1600,5400,25999 days 16:47:18.669866,272,2.0,1.5333333333333334,-80,0,320.0
489000.0,3,2.5,2260,19821,2.0,3,9,2260,0.0,1994,2750,22718,10293 days 16:47:18.669866,150,1.2,0.0,-490,-2897,2260.0
415000.0,4,2.0,1800,2970,1.0,4,7,1000,800.0,1923,1690,3801,36226 days 16:47:18.669866,167,2.0,1.25,110,-831,200.0
672500.0,4,2.5,2650,11108,2.0,3,1,2650,0.0,1987,2650,11585,12850 days 16:47:18.669866,105,1.6,0.0,0,-477,2650.0
352500.0,3,1.0,1000,4171,1.0,3,7,1000,0.0,1985,1090,3479,13580 days 16:47:18.669866,290,3.0,0.0,-90,692,1000.0
258750.0,4,2.0,2300,8400,1.0,4,6,1150,1150.0,1962,1230,8400,21981 days 16:47:18.669866,246,2.0,1.0,1070,0,0.0
350000.0,3,1.0,1080,7000,1.0,4,6,1080,0.0,1916,1410,7214,38783 days 16:47:18.669866,054,3.0,0.0,-330,-214,1080.0
152000.0,3,1.0,902,10464,1.0,3,7,902,0.0,1965,1510,7210,20885 days 16:47:18.669866,210,3.0,0.0,-608,3254,902.0
378500.0,2,1.0,730,7528,1.0,3,7,730,0.0,1946,1620,7528,27825 days 16:47:18.669866,160,2.0,0.0,-890,0,730.0
1020000.0,4,1.75,2600,41041,1.5,4,8,2600,0.0,1965,2750,37318,20885 days 16:47:18.669866,211,2.2857142857142856,0.0,-150,3723,2600.0
419000.0,3,1.5,1570,6700,1.0,4,7,1570,0.0,1956,1570,7300,24173 days 16:47:18.669866,122,2.0,0.0,0,-600,1570.0
895000.0,5,3.0,2876,13927,1.0,4,9,1970,906.0,1973,3500,14454,17963 days 16:47:18.669866,141,1.6666666666666667,2.1743929359823397,-624,-527,1064.0
668500.0,4,2.25,2290,9546,1.0,4,8,1780,510.0,1976,2360,8864,16868 days 16:47:18.669866,269,1.7777777777777777,3.4901960784313726,-70,682,1270.0
487000.0,2,2.5,1470,2533,2.0,3,8,1470,0.0,2005,1470,6511,6275 days 16:47:18.669866,233,0.8,0.0,0,-3978,1470.0
538000.0,3,3.5,2620,10137,2.0,3,8,1970,650.0,1992,1960,7680,11024 days 16:47:18.669866,336,0.8571428571428571,3.0307692307692307,660,2457,1320.0
898000.0,5,1.5,2680,28014,1.0,4,8,1450,1230.0,1963,2900,22180,21616 days 16:47:18.669866,148,3.3333333333333335,1.1788617886178863,-220,5834,220.0
315000.0,4,2.0,2020,7767,1.0,3,8,2020,0.0,1995,1940,8239,9928 days 16:47:18.669866,267,2.0,0.0,80,-472,2020.0
800000.0,3,2.5,2100,4440,2.0,3,7,2100,0.0,1945,2100,6000,28190 days 16:47:18.669866,118,1.2,0.0,0,-1560,2100.0
516130.0,3,1.75,1510,8250,1.0,4,8,1510,0.0,1962,1770,8250,21981 days 16:47:18.669866,195,1.7142857142857142,0.0,-260,0,1510.0
1600000.0,3,2.5,2850,19593,1.5,3,1,1790,1060.0,1978,2850,18782,16137 days 16:47:18.669866,028,1.2,1.6886792452830188,0,811,730.0
1200000.0,4,2.5,4280,12796,2.0,3,1,3400,880.0,1999,3520,9593,8467 days 16:47:18.669866,117,1.6,3.8636363636363638,760,3203,2520.0
355425.0,4,2.5,3238,9112,1.0,4,8,1678,1560.0,1979,3056,9668,15772 days 16:47:18.669866,071,1.6,1.0756410256410256,182,-556,118.0
1160000.0,3,2.5,2740,5925,2.0,3,1,2740,0.0,1913,2740,5948,39878 days 16:47:18.669866,175,1.2,0.0,0,-23,2740.0
689000.0,4,2.5,2020,9600,2.0,4,7,2020,0.0,1954,2250,8550,24903 days 16:47:18.669866,269,1.6,0.0,-230,1050,2020.0
500000.0,3,3.25,1520,1500,3.0,3,7,1520,0.0,2000,1520,1323,8102 days 16:47:18.669866,013,0.9230769230769231,0.0,0,177,1520.0
430000.0,5,2.5,3860,42733,1.0,4,8,2300,1560.0,1955,2520,19353,24538 days 16:47:18.669866,199,2.0,1.4743589743589745,1340,23380,740.0
299500.0,4,2.25,1600,15312,1.0,4,7,1080,520.0,1979,1620,12375,15772 days 16:47:18.669866,325,1.7777777777777777,2.076923076923077,-20,2937,560.0
349950.0,4,2.5,2090,5289,2.0,3,8,2090,0.0,1989,2080,7109,12119 days 16:47:18.669866,175,1.6,0.0,10,-1820,2090.0
1420000.0,5,3.25,4020,4500,2.0,3,9,3120,900.0,2010,3550,5775,4449 days 16:47:18.669866,301,1.5384615384615385,3.466666666666667,470,-1275,2220.0
998000.0,4,2.25,2910,10189,2.0,3,9,2910,0.0,1988,2780,10125,12485 days 16:47:18.669866,350,1.7777777777777777,0.0,130,64,2910.0
329000.0,3,1.0,900,9600,1.0,4,7,900,0.0,1970,1220,8240,19059 days 16:47:18.669866,125,3.0,0.0,-320,1360,900.0
575000.0,3,1.75,1720,5956,2.0,3,8,1720,0.0,1981,1620,9324,15041 days 16:47:18.669866,282,1.7142857142857142,0.0,100,-3368,1720.0
529900.0,5,2.25,3030,9430,2.0,4,8,2600,430.0,1961,2230,8425,22346 days 16:47:18.669866,275,2.2222222222222223,6.046511627906977,800,1005,2170.0
1470000.0,4,2.5,3030,10189,1.0,3,9,2380,650.0,2003,1940,10189,7006 days 16:47:18.669866,324,1.6,3.6615384615384614,1090,0,1730.0
725000.0,4,1.75,2190,9400,1.0,4,7,1450,740.0,1962,1980,9000,21981 days 16:47:18.669866,213,2.2857142857142856,1.9594594594594594,210,400,710.0
335000.0,3,2.0,1210,9926,1.0,4,7,1210,0.0,1954,1690,9737,24903 days 16:47:18.669866,064,1.5,0.0,-480,189,1210.0
395300.0,3,1.5,1120,7000,1.0,3,7,1120,0.0,1955,1470,7950,24538 days 16:47:18.669866,135,2.0,0.0,-350,-950,1120.0
510000.0,4,2.75,3180,13348,2.0,3,8,3020,160.0,2004,3020,10029,6641 days 16:47:18.669866,196,1.4545454545454546,18.875,160,3319,2860.0
203000.0,3,1.0,920,7500,1.0,4,7,920,0.0,1970,1660,8000,19059 days 16:47:18.669866,037,3.0,0.0,-740,-500,920.0
248000.0,2,1.0,700,8301,1.0,3,6,700,0.0,1953,1250,8304,25268 days 16:47:18.669866,338,2.0,0.0,-550,-3,700.0
265000.0,3,2.25,2540,7216,2.0,3,8,2540,0.0,1991,2140,7531,11389 days 16:47:18.669866,027,1.3333333333333333,0.0,400,-315,2540.0
1000000.0,4,1.5,2100,4560,1.5,4,8,2100,0.0,1912,1930,4560,40244 days 16:47:18.669866,124,2.6666666666666665,0.0,170,0,2100.0
1000000.0,3,1.0,1540,24500,1.5,3,7,1540,0.0,1949,1540,7250,26729 days 16:47:18.669866,096,3.0,0.0,0,17250,1540.0
241400.0,3,2.0,1420,9828,1.0,4,7,1420,0.0,1990,1550,7227,11754 days 16:47:18.669866,096,1.5,0.0,-130,2601,1420.0
309950.0,4,1.75,1450,10074,1.0,4,7,1450,0.0,1966,1340,8023,20520 days 16:47:18.669866,071,2.2857142857142856,0.0,110,2051,1450.0
294010.0,3,1.75,1550,4057,1.0,3,6,830,720.0,1945,1100,4116,28190 days 16:47:18.669866,238,1.7142857142857142,1.1527777777777777,450,-59,110.0
345000.0,3,2.25,1920,9672,2.0,4,8,1920,0.0,1984,1950,10125,13946 days 16:47:18.669866,350,1.3333333333333333,0.0,-30,-453,1920.0
625000.0,3,2.25,1920,9672,2.0,4,8,1920,0.0,1984,1950,10125,13946 days 16:47:18.669866,124,1.3333333333333333,0.0,-30,-453,1920.0
559000.0,2,2.0,1660,4500,1.0,3,8,1660,0.0,2003,1670,5580,7006 days 16:47:18.669866,076,1.0,0.0,-10,-1080,1660.0
866000.0,4,3.25,3990,9786,2.0,3,9,3990,0.0,2004,3920,8200,6641 days 16:47:18.669866,188,1.2307692307692308,0.0,70,1586,3990.0
770000.0,3,2.0,2350,5700,1.5,4,8,1810,540.0,1939,2170,6000,30382 days 16:47:18.669866,125,1.5,3.3518518518518516,180,-300,1270.0
259950.0,3,1.5,1350,7827,1.0,4,7,1350,0.0,1968,1900,7827,19790 days 16:47:18.669866,227,2.0,0.0,-550,0,1350.0
352000.0,5,2.75,2980,9838,1.0,3,7,1710,1270.0,1968,2240,9838,19790 days 16:47:18.669866,070,1.8181818181818181,1.3464566929133859,740,0,440.0
2470000.0,5,4.75,6390,13180,2.0,3,1,4560,1830.0,1940,4010,8137,30017 days 16:47:18.669866,175,1.0526315789473684,2.4918032786885247,2380,5043,2730.0
395000.0,3,2.0,1590,10229,1.0,3,7,1590,0.0,1966,1320,10222,20520 days 16:47:18.669866,310,1.5,0.0,270,7,1590.0
276500.0,4,1.75,1400,6650,1.5,4,6,1400,0.0,1942,1120,8645,29286 days 16:47:18.669866,075,2.2857142857142856,0.0,280,-1995,1400.0
530000.0,3,2.25,1880,100623,1.5,3,8,1880,0.0,1987,2520,21689,12850 days 16:47:18.669866,293,1.3333333333333333,0.0,-640,78934,1880.0
798000.0,4,3.25,3500,10260,2.0,3,1,3500,0.0,1987,3500,10658,12850 days 16:47:18.669866,205,1.2307692307692308,0.0,0,-398,3500.0
380000.0,2,2.0,1370,5756,1.0,3,8,1370,0.0,1986,1380,5444,13215 days 16:47:18.669866,225,1.0,0.0,-10,312,1370.0
350000.0,4,2.5,2810,10433,2.0,3,8,2810,0.0,2001,2640,9240,7736 days 16:47:18.669866,231,1.6,0.0,170,1193,2810.0
325000.0,3,2.5,2220,6049,2.0,4,8,2220,0.0,1990,1980,7226,11754 days 16:47:18.669866,134,1.2,0.0,240,-1177,2220.0
336000.0,3,2.5,2110,4549,2.0,4,8,2110,0.0,1989,2110,4030,12119 days 16:47:18.669866,092,1.2,0.0,0,519,2110.0
286900.0,3,2.25,1720,17235,1.0,4,7,1440,280.0,1974,1990,35048,17598 days 16:47:18.669866,297,1.3333333333333333,5.142857142857143,-270,-17813,1160.0
472000.0,5,2.25,1780,7245,1.0,4,8,1330,450.0,1976,1780,7653,16868 days 16:47:18.669866,273,2.2222222222222223,2.9555555555555557,0,-408,880.0
263000.0,3,1.75,1410,8100,2.0,3,7,1410,0.0,1985,1560,8100,13580 days 16:47:18.669866,181,1.7142857142857142,0.0,-150,0,1410.0
565000.0,3,3.0,2110,4000,1.0,4,7,1110,1000.0,1965,1730,4000,20885 days 16:47:18.669866,197,1.0,1.11,380,0,110.0
765000.0,3,2.5,2700,8444,2.0,3,1,2700,0.0,1992,2840,9165,11024 days 16:47:18.669866,281,1.2,0.0,-140,-721,2700.0
1520000.0,3,2.25,2610,9409,1.0,4,8,2610,0.0,1963,2970,9156,21616 days 16:47:18.669866,223,1.3333333333333333,0.0,-360,253,2610.0
405000.0,3,2.0,1660,8174,1.0,3,7,830,830.0,1981,1610,9318,15041 days 16:47:18.669866,357,1.5,1.0,50,-1144,0.0
1100000.0,4,3.5,4570,16219,2.0,3,1,4570,0.0,2002,4700,16500,7371 days 16:47:18.669866,117,1.1428571428571428,0.0,-130,-281,4570.0
555000.0,3,3.0,3760,188760,1.0,4,1,2640,1120.0,1979,2820,50543,15772 days 16:47:18.669866,254,1.0,2.357142857142857,940,138217,1520.0
305000.0,3,2.5,1610,3516,2.0,3,8,1610,0.0,2006,1610,3056,5910 days 16:47:18.669866,117,1.2,0.0,0,460,1610.0
289950.0,3,2.25,1740,9370,1.0,3,7,1390,350.0,1992,1740,7555,11024 days 16:47:18.669866,244,1.3333333333333333,3.9714285714285715,0,1815,1040.0
487500.0,5,3.5,3530,218472,2.0,3,7,2380,1150.0,1999,2110,211404,8467 days 16:47:18.669866,225,1.4285714285714286,2.0695652173913044,1420,7068,1230.0
96500.0,3,1.0,840,12091,1.0,3,6,840,0.0,1959,840,9324,23077 days 16:47:18.669866,302,3.0,0.0,0,2767,840.0
185000.0,3,1.0,840,12091,1.0,3,6,840,0.0,1959,840,9324,23077 days 16:47:18.669866,056,3.0,0.0,0,2767,840.0
150550.0,4,1.0,1470,6061,1.5,3,7,1470,0.0,1945,1230,6175,28190 days 16:47:18.669866,239,4.0,0.0,240,-114,1470.0
339000.0,4,2.0,2470,5080,1.5,3,6,1970,500.0,1948,1060,5080,27095 days 16:47:18.669866,175,2.0,3.94,1410,0,1470.0
675000.0,4,1.75,2220,7230,1.0,3,8,1280,940.0,1950,2210,7230,26364 days 16:47:18.669866,033,2.2857142857142856,1.3617021276595744,10,0,340.0
615000.0,3,1.75,1720,4080,1.0,4,7,960,760.0,1924,1660,4080,35861 days 16:47:18.669866,175,1.7142857142857142,1.263157894736842,60,0,200.0
837500.0,4,2.5,2700,9320,2.0,4,8,2700,0.0,1994,2120,8056,10293 days 16:47:18.669866,155,1.6,0.0,580,1264,2700.0
250000.0,2,1.0,950,11835,1.0,3,5,950,0.0,1932,1690,12586,32939 days 16:47:18.669866,231,2.0,0.0,-740,-751,950.0
583000.0,3,2.5,1790,8144,2.0,3,8,1790,0.0,1989,1800,7503,12119 days 16:47:18.669866,176,1.2,0.0,-10,641,1790.0
499000.0,3,2.5,1610,1728,3.0,3,8,1610,0.0,2000,1540,3090,8102 days 16:47:18.669866,247,1.2,0.0,70,-1362,1610.0
550000.0,3,2.5,2290,6328,2.0,3,8,2290,0.0,2001,1600,6180,7736 days 16:47:18.669866,197,1.2,0.0,690,148,2290.0
400000.0,4,2.5,2170,204296,1.0,4,7,2170,0.0,1980,1760,154202,15407 days 16:47:18.669866,267,1.6,0.0,410,50094,2170.0
990400.0,3,2.5,2100,4097,2.0,3,9,2100,0.0,2008,1820,4764,5180 days 16:47:18.669866,050,1.2,0.0,280,-667,2100.0
600000.0,3,2.5,2320,52272,1.5,3,8,2320,0.0,1974,2200,52272,17598 days 16:47:18.669866,233,1.2,0.0,120,0,2320.0
325000.0,2,1.0,1120,6236,1.0,4,6,1120,0.0,1954,1340,7784,24903 days 16:47:18.669866,043,2.0,0.0,-220,-1548,1120.0
265000.0,3,2.5,1530,6000,2.0,4,7,1530,0.0,1991,1360,6000,11389 days 16:47:18.669866,191,1.2,0.0,170,0,1530.0
1620000.0,3,2.5,3490,9362,1.0,5,9,1770,1720.0,1960,3640,7425,22712 days 16:47:18.669866,008,1.2,1.0290697674418605,-150,1937,50.0
347500.0,3,1.5,1180,8353,1.0,3,7,1180,0.0,1960,1710,8748,22712 days 16:47:18.669866,068,2.0,0.0,-530,-395,1180.0
629000.0,5,2.0,2050,3000,1.5,3,7,1470,580.0,1912,1560,4500,40244 days 16:47:18.669866,009,2.5,2.5344827586206895,490,-1500,890.0
1090000.0,2,2.0,2360,11340,1.5,3,9,2360,0.0,1997,3030,11340,9197 days 16:47:18.669866,189,1.0,0.0,-670,0,2360.0
397500.0,4,2.5,2570,7859,2.0,3,8,2570,0.0,1992,2150,7284,11024 days 16:47:18.669866,181,1.6,0.0,420,575,2570.0
404500.0,2,1.0,1270,3700,1.5,3,7,1270,0.0,1909,1980,3200,41339 days 16:47:18.669866,303,2.0,0.0,-710,500,1270.0
225000.0,3,1.5,1250,7500,1.0,3,7,1250,0.0,1967,1260,7563,20155 days 16:47:18.669866,133,2.0,0.0,-10,-63,1250.0
267000.0,3,2.25,2510,9900,1.0,3,8,1610,900.0,1978,1940,8510,16137 days 16:47:18.669866,133,1.3333333333333333,1.788888888888889,570,1390,710.0
800000.0,4,3.75,2690,4000,2.0,4,9,2120,570.0,1909,2830,4000,41339 days 16:47:18.669866,162,1.0666666666666667,3.719298245614035,-140,0,1550.0
339000.0,4,2.5,2900,6918,2.0,3,8,2900,0.0,2001,2720,10376,7736 days 16:47:18.669866,041,1.6,0.0,180,-3458,2900.0
1850000.0,4,2.5,3830,11972,1.0,3,1,2370,1460.0,1981,3080,12297,15041 days 16:47:18.669866,105,1.6,1.6232876712328768,750,-325,910.0
525000.0,5,1.0,1280,3876,1.5,3,7,1280,0.0,1923,1420,3825,36226 days 16:47:18.669866,273,5.0,0.0,-140,51,1280.0
1150000.0,5,3.5,4350,6218,2.0,3,1,3520,830.0,2007,3260,5989,5545 days 16:47:18.669866,279,1.4285714285714286,4.240963855421687,1090,229,2690.0
565000.0,1,1.0,1370,6250,1.5,4,7,1370,0.0,1921,1450,6250,36956 days 16:47:18.669866,357,1.0,0.0,-80,0,1370.0
387000.0,2,2.25,1230,1280,2.0,3,8,960,270.0,2012,1130,1357,3719 days 16:47:18.669866,140,0.8888888888888888,3.5555555555555554,100,-77,690.0
720000.0,4,2.5,2440,34290,2.0,3,9,2440,0.0,1987,2860,38119,12850 days 16:47:18.669866,170,1.6,0.0,-420,-3829,2440.0
1500000.0,4,3.5,4410,12426,2.0,3,1,3420,990.0,1996,4090,12127,9563 days 16:47:18.669866,192,1.1428571428571428,3.4545454545454546,320,299,2430.0
235000.0,2,1.0,910,7617,1.0,3,6,910,0.0,1936,1310,6624,31478 days 16:47:18.669866,238,2.0,0.0,-400,993,910.0
365000.0,2,1.0,910,7617,1.0,3,6,910,0.0,1936,1310,6624,31478 days 16:47:18.669866,016,2.0,0.0,-400,993,910.0
368250.0,3,2.5,2150,7484,2.0,3,8,2150,0.0,1988,2150,6879,12485 days 16:47:18.669866,141,1.2,0.0,0,605,2150.0
580000.0,3,2.5,2150,7484,2.0,3,8,2150,0.0,1988,2150,6879,12485 days 16:47:18.669866,317,1.2,0.0,0,605,2150.0
1100000.0,4,3.25,3190,11774,2.0,3,8,2610,580.0,1956,2240,8725,24173 days 16:47:18.669866,198,1.2307692307692308,4.5,950,3049,2030.0
215000.0,4,2.5,2130,4496,2.0,3,7,2130,0.0,2004,3220,5400,6641 days 16:47:18.669866,027,1.6,0.0,-1090,-904,2130.0
705000.0,4,3.0,3150,9318,2.0,3,9,3150,0.0,2001,3150,9318,7736 days 16:47:18.669866,246,1.3333333333333333,0.0,0,0,3150.0
465000.0,3,2.25,1450,1540,2.0,3,8,1180,270.0,2005,1450,1540,6275 days 16:47:18.669866,009,1.3333333333333333,4.37037037037037,0,0,910.0
650000.0,5,2.0,2400,3500,1.5,3,8,1900,500.0,1911,1520,4000,40609 days 16:47:18.669866,356,2.5,3.8,880,-500,1400.0
335000.0,4,2.25,2280,7500,1.0,4,7,1140,1140.0,1963,1660,8000,21616 days 16:47:18.669866,202,1.7777777777777777,1.0,620,-500,0.0
640000.0,4,2.0,2310,31850,1.5,4,8,2310,0.0,1984,2710,36042,13946 days 16:47:18.669866,118,2.0,0.0,-400,-4192,2310.0
638250.0,4,2.5,2460,8029,2.0,3,9,2460,0.0,1989,2420,7987,12119 days 16:47:18.669866,062,1.6,0.0,40,42,2460.0
1460000.0,4,3.5,4200,14353,2.0,3,1,3640,560.0,1996,3750,16316,9563 days 16:47:18.669866,290,1.1428571428571428,6.5,450,-1963,3080.0
842000.0,4,1.75,2170,9525,1.0,3,8,2170,0.0,1960,1910,9525,22712 days 16:47:18.669866,197,2.2857142857142856,0.0,260,0,2170.0
499950.0,3,2.25,2880,7200,1.0,3,8,1710,1170.0,1970,1880,10200,19059 days 16:47:18.669866,281,1.3333333333333333,1.4615384615384615,1000,-3000,540.0
810000.0,4,2.5,3280,25211,2.0,3,1,3280,0.0,1985,3280,25211,13580 days 16:47:18.669866,048,1.6,0.0,0,0,3280.0
310000.0,5,2.0,2900,11970,2.0,4,7,2900,0.0,1969,1260,12398,19424 days 16:47:18.669866,057,2.5,0.0,1640,-428,2900.0
730000.0,3,2.5,2160,8809,1.0,3,9,1540,620.0,2014,930,5420,2988 days 16:47:18.669866,304,1.2,2.4838709677419355,1230,3389,920.0
637800.0,4,1.75,2250,4750,1.5,4,7,1420,830.0,1924,1930,4750,35861 days 16:47:18.669866,317,2.2857142857142856,1.7108433734939759,320,0,590.0
225000.0,3,1.0,1340,4800,1.5,4,5,1340,0.0,1903,1240,4800,43531 days 16:47:18.669866,037,3.0,0.0,100,0,1340.0
417500.0,4,1.0,1390,10800,1.5,4,7,1390,0.0,1941,1390,9360,29651 days 16:47:18.669866,161,4.0,0.0,0,1440,1390.0
265000.0,4,2.0,1600,10160,1.0,4,7,1600,0.0,1972,1540,9352,18329 days 16:47:18.669866,079,2.0,0.0,60,808,1600.0
550000.0,4,2.5,2050,8683,2.0,3,8,2050,0.0,1987,2010,8744,12850 days 16:47:18.669866,206,1.6,0.0,40,-61,2050.0
625700.0,3,2.0,2570,159865,1.0,5,7,2570,0.0,1968,2010,38322,19790 days 16:47:18.669866,026,1.5,0.0,560,121543,2570.0
595000.0,3,2.5,2660,10637,2.0,3,9,2660,0.0,1991,2590,8637,11389 days 16:47:18.669866,213,1.2,0.0,70,2000,2660.0
270000.0,3,1.5,1540,13475,1.0,4,7,1540,0.0,1972,1550,13475,18329 days 16:47:18.669866,195,2.0,0.0,-10,0,1540.0
739375.0,5,3.0,2640,3200,2.0,4,7,2140,500.0,1906,1540,2242,42435 days 16:47:18.669866,199,1.6666666666666667,4.28,1100,958,1640.0
357562.0,2,1.75,1210,1032,2.0,3,8,1210,0.0,2014,1210,1090,2988 days 16:47:18.669866,189,1.1428571428571428,0.0,0,-58,1210.0
1010000.0,4,2.5,3760,29224,2.0,3,1,3760,0.0,1987,3930,19916,12850 days 16:47:18.669866,162,1.6,0.0,-170,9308,3760.0
455000.0,2,1.75,1350,4286,1.0,3,8,1350,0.0,2004,1440,4839,6641 days 16:47:18.669866,273,1.1428571428571428,0.0,-90,-553,1350.0
310000.0,5,2.25,2600,9600,1.0,4,8,1810,790.0,1969,2070,9660,19424 days 16:47:18.669866,121,2.2222222222222223,2.2911392405063293,530,-60,1020.0
415000.0,3,2.75,3900,111514,2.0,3,6,3460,440.0,1967,2460,217800,20155 days 16:47:18.669866,223,1.0909090909090908,7.863636363636363,1440,-106286,3020.0
452000.0,2,1.0,1340,8100,1.0,3,8,1340,0.0,1950,1680,7752,26364 days 16:47:18.669866,231,2.0,0.0,-340,348,1340.0
810000.0,3,2.0,1760,16928,1.0,3,7,1760,0.0,1953,3430,10059,25268 days 16:47:18.669866,013,1.5,0.0,-1670,6869,1760.0
730001.0,3,2.0,1840,4750,1.0,5,7,1010,830.0,1951,1760,5510,25999 days 16:47:18.669866,147,1.5,1.216867469879518,80,-760,180.0
825000.0,3,2.25,2980,86636,1.0,3,9,2230,750.0,1989,2980,107157,12119 days 16:47:18.669866,120,1.3333333333333333,2.973333333333333,0,-20521,1480.0
665000.0,3,2.5,1730,3000,2.0,3,8,1730,0.0,1996,1730,1774,9563 days 16:47:18.669866,197,1.2,0.0,0,1226,1730.0
327500.0,4,1.75,1650,7800,1.0,3,8,1650,0.0,1968,1750,10400,19790 days 16:47:18.669866,155,2.2857142857142856,0.0,-100,-2600,1650.0
699950.0,3,2.5,3370,36218,2.0,4,9,3370,0.0,1988,2980,31793,12485 days 16:47:18.669866,209,1.2,0.0,390,4425,3370.0
424000.0,3,2.5,2200,34680,2.0,3,9,2200,0.0,1985,2560,35840,13580 days 16:47:18.669866,209,1.2,0.0,-360,-1160,2200.0
657000.0,4,2.5,2180,3375,1.5,4,7,1420,760.0,1926,1560,3375,35130 days 16:47:18.669866,176,1.6,1.868421052631579,620,0,660.0
445000.0,3,1.75,1490,10844,1.0,3,7,1210,280.0,1974,2090,9944,17598 days 16:47:18.669866,198,1.7142857142857142,4.321428571428571,-600,900,930.0
450000.0,3,2.5,1530,762,2.0,3,8,1050,480.0,2007,1610,1482,5545 days 16:47:18.669866,212,1.2,2.1875,-80,-720,570.0
350000.0,3,1.0,1180,7455,1.0,4,7,1180,0.0,1964,1450,8154,21251 days 16:47:18.669866,269,3.0,0.0,-270,-699,1180.0
460000.0,4,2.5,2080,17532,2.0,3,9,2080,0.0,1996,2550,12560,9563 days 16:47:18.669866,316,1.6,0.0,-470,4972,2080.0
272000.0,4,2.25,1880,6160,2.0,3,7,1880,0.0,1993,1580,6405,10658 days 16:47:18.669866,308,1.7777777777777777,0.0,300,-245,1880.0
535000.0,3,2.5,2510,5544,2.0,3,7,2510,0.0,2001,2660,5614,7736 days 16:47:18.669866,020,1.2,0.0,-150,-70,2510.0
216500.0,2,1.0,1060,5200,1.0,3,6,1060,0.0,1969,910,5200,19424 days 16:47:18.669866,120,2.0,0.0,150,0,1060.0
325000.0,3,2.5,2130,12245,2.0,3,8,2130,0.0,1989,1910,12216,12119 days 16:47:18.669866,056,1.2,0.0,220,29,2130.0
420200.0,3,1.75,1320,7280,1.0,3,7,1320,0.0,1968,1370,7800,19790 days 16:47:18.669866,096,1.7142857142857142,0.0,-50,-520,1320.0
258000.0,3,1.75,1040,5650,1.0,5,6,1040,0.0,1951,1290,5650,25999 days 16:47:18.669866,336,1.7142857142857142,0.0,-250,0,1040.0
450000.0,3,2.0,1150,4500,1.5,3,7,1150,0.0,1917,1230,5400,38417 days 16:47:18.669866,336,1.5,0.0,-80,-900,1150.0
720168.0,4,2.25,2120,3794,2.0,4,7,1420,700.0,1926,1420,3840,35130 days 16:47:18.669866,342,1.7777777777777777,2.0285714285714285,700,-46,720.0
652000.0,3,2.0,2130,5000,1.5,5,7,1330,800.0,1925,2010,5000,35495 days 16:47:18.669866,275,1.5,1.6625,120,0,530.0
569500.0,4,2.5,2340,8248,2.0,3,8,2340,0.0,1989,2140,9963,12119 days 16:47:18.669866,211,1.6,0.0,200,-1715,2340.0
411000.0,4,1.75,2250,292288,1.0,4,7,2250,0.0,1963,1550,23798,21616 days 16:47:18.669866,114,2.2857142857142856,0.0,700,268490,2250.0
524950.0,3,1.75,1890,3825,1.0,3,7,1290,600.0,1974,1320,3825,17598 days 16:47:18.669866,139,1.7142857142857142,2.15,570,0,690.0
153000.0,2,1.0,1140,10152,1.0,3,6,760,380.0,1942,1340,10141,29286 days 16:47:18.669866,082,2.0,2.0,-200,11,380.0
338500.0,4,2.5,2390,6111,2.0,3,8,2390,0.0,1997,2520,6500,9197 days 16:47:18.669866,012,1.6,0.0,-130,-389,2390.0
570000.0,3,1.75,2390,9000,1.0,3,8,1500,890.0,1975,2040,9000,17233 days 16:47:18.669866,121,1.7142857142857142,1.6853932584269662,350,0,610.0
653000.0,3,2.0,2680,8429,1.0,4,9,1880,800.0,1950,1570,8640,26364 days 16:47:18.669866,302,1.5,2.35,1110,-211,1080.0
435000.0,2,2.5,1560,1222,2.0,3,8,1080,480.0,2008,1560,2081,5180 days 16:47:18.669866,324,0.8,2.25,0,-859,600.0
207000.0,2,1.0,1130,8160,1.0,4,6,1130,0.0,1952,1060,6120,25634 days 16:47:18.669866,330,2.0,0.0,70,2040,1130.0
540000.0,2,1.0,1120,7500,1.0,4,7,1120,0.0,1971,3040,16940,18694 days 16:47:18.669866,206,2.0,0.0,-1920,-9440,1120.0
386000.0,4,2.25,2050,9583,2.0,3,8,1770,280.0,1965,2230,9730,20885 days 16:47:18.669866,176,1.7777777777777777,6.321428571428571,-180,-147,1490.0
265000.0,5,2.25,2600,8075,1.5,4,8,2600,0.0,1969,2200,8800,19424 days 16:47:18.669866,239,2.2222222222222223,0.0,400,-725,2600.0
250000.0,3,2.25,1050,572,2.0,3,7,740,310.0,2006,1260,1062,5910 days 16:47:18.669866,007,1.3333333333333333,2.3870967741935485,-210,-490,430.0
1700000.0,3,2.0,2600,6600,2.0,3,1,1930,670.0,1970,2670,6270,19059 days 16:47:18.669866,005,1.5,2.8805970149253732,-70,330,1260.0
455000.0,4,2.5,2811,7251,2.0,3,9,2811,0.0,2009,3040,7250,4814 days 16:47:18.669866,337,1.6,0.0,-229,1,2811.0
1800000.0,4,3.25,4060,13000,2.0,3,1,4060,0.0,2000,3220,13800,8102 days 16:47:18.669866,147,1.2307692307692308,0.0,840,-800,4060.0
759000.0,3,2.0,2260,7200,1.0,3,7,1130,1130.0,1941,2260,6000,29651 days 16:47:18.669866,303,1.5,1.0,0,1200,0.0
970000.0,4,2.75,4430,74358,2.0,3,1,4430,0.0,1990,3820,80875,11754 days 16:47:18.669866,085,1.4545454545454546,0.0,610,-6517,4430.0
690000.0,3,2.25,2430,8327,1.0,4,9,1430,1000.0,1978,2550,10427,16137 days 16:47:18.669866,239,1.3333333333333333,1.43,-120,-2100,430.0
789900.0,3,2.5,3420,25150,1.0,4,1,1750,1670.0,1987,2900,19604,12850 days 16:47:18.669866,189,1.2,1.0479041916167664,520,5546,80.0
447500.0,2,1.0,1180,5100,1.5,3,7,1180,0.0,1926,980,5100,35130 days 16:47:18.669866,077,2.0,0.0,200,0,1180.0
440000.0,4,2.25,2010,7575,1.0,3,7,1220,790.0,1974,1820,7831,17598 days 16:47:18.669866,164,1.7777777777777777,1.5443037974683544,190,-256,430.0
278000.0,3,2.0,1230,7789,1.0,3,7,1230,0.0,1994,1470,8670,10293 days 16:47:18.669866,104,1.5,0.0,-240,-881,1230.0
980000.0,5,2.5,2750,6000,1.5,3,8,1750,1000.0,1904,1520,4158,43166 days 16:47:18.669866,195,2.0,1.75,1230,1842,750.0
245000.0,3,2.75,1300,14197,1.0,3,7,860,440.0,1996,1550,7596,9563 days 16:47:18.669866,181,1.0909090909090908,1.9545454545454546,-250,6601,420.0
287000.0,3,1.5,1150,11475,1.0,3,7,1150,0.0,1971,1640,11475,18694 days 16:47:18.669866,294,2.0,0.0,-490,0,1150.0
435000.0,3,1.75,2220,132858,1.0,3,7,1110,1110.0,1988,2130,77536,12485 days 16:47:18.670863,154,1.7142857142857142,1.0,90,55322,0.0
585000.0,3,2.5,2050,11690,2.0,4,9,2050,0.0,1989,2410,10172,12119 days 16:47:18.670863,196,1.2,0.0,-360,1518,2050.0
616000.0,4,1.75,1700,5846,1.0,3,8,1700,0.0,1957,1480,5177,23807 days 16:47:18.670863,182,2.2857142857142856,0.0,220,669,1700.0
203000.0,3,1.75,1610,9000,1.0,4,7,1100,510.0,1978,1610,8000,16137 days 16:47:18.670863,015,1.7142857142857142,2.156862745098039,0,1000,590.0
860000.0,4,2.75,2720,3840,2.0,3,8,1790,930.0,1920,1360,3880,37322 days 16:47:18.670863,126,1.4545454545454546,1.924731182795699,1360,-40,860.0
833000.0,4,2.5,2190,12690,1.0,3,8,1170,1020.0,1973,2630,10843,17963 days 16:47:18.670863,089,1.6,1.1470588235294117,-440,1847,150.0
565000.0,4,2.75,2730,6856,2.0,3,8,2730,0.0,2003,2520,5569,7006 days 16:47:18.670863,345,1.4545454545454546,0.0,210,1287,2730.0
572500.0,3,2.5,2490,7589,2.0,3,9,2490,0.0,1991,2500,10386,11389 days 16:47:18.670863,043,1.2,0.0,-10,-2797,2490.0
254000.0,4,2.0,1510,4235,1.0,3,7,1510,0.0,1955,1510,4268,24538 days 16:47:18.670863,136,2.0,0.0,0,-33,1510.0
1530000.0,4,4.25,4720,21000,3.0,5,1,4720,0.0,1971,3010,20000,18694 days 16:47:18.670863,092,0.9411764705882353,0.0,1710,1000,4720.0
900000.0,4,3.0,3810,217800,2.0,3,9,3810,0.0,2003,2580,217364,7006 days 16:47:18.670863,021,1.3333333333333333,0.0,1230,436,3810.0
899000.0,3,2.5,1950,3730,2.0,3,9,1950,0.0,1996,2080,4000,9563 days 16:47:18.670863,057,1.2,0.0,-130,-270,1950.0
560000.0,3,2.0,1300,6000,1.0,5,7,1300,0.0,1943,1230,6000,28921 days 16:47:18.670863,114,1.5,0.0,70,0,1300.0
512500.0,3,1.75,1610,7200,1.0,3,7,1180,430.0,1976,1520,7973,16868 days 16:47:18.670863,063,1.7142857142857142,2.744186046511628,90,-773,750.0
775000.0,4,2.5,2040,5000,1.5,5,7,1180,860.0,1924,1540,5000,35861 days 16:47:18.670863,054,1.6,1.372093023255814,500,0,320.0
200000.0,2,1.0,700,4700,1.0,5,5,700,0.0,1953,960,5200,25268 days 16:47:18.670863,162,2.0,0.0,-260,-500,700.0
172000.0,3,1.0,970,4700,1.0,4,6,720,250.0,1943,1560,4600,28921 days 16:47:18.670863,212,3.0,2.88,-590,100,470.0
219900.0,3,1.0,910,6000,1.0,2,6,910,0.0,1956,1090,6957,24173 days 16:47:18.670863,142,3.0,0.0,-180,-957,910.0
641200.0,3,1.0,1060,9123,1.0,3,7,1060,0.0,1952,1620,9121,25634 days 16:47:18.670863,192,3.0,0.0,-560,2,1060.0
473000.0,5,3.25,2180,7200,2.0,4,7,2180,0.0,1982,1840,7644,14676 days 16:47:18.670863,196,1.5384615384615385,0.0,340,-444,2180.0
540000.0,3,1.75,2050,9580,1.0,3,8,1400,650.0,1984,1740,11952,13946 days 16:47:18.670863,182,1.7142857142857142,2.1538461538461537,310,-2372,750.0
295000.0,2,1.0,750,4500,1.0,3,6,750,0.0,1945,1540,4000,28190 days 16:47:18.670863,124,2.0,0.0,-790,500,750.0
370000.0,3,1.0,800,2296,1.0,4,6,800,0.0,1908,1480,1472,41705 days 16:47:18.670863,148,3.0,0.0,-680,824,800.0
1730000.0,4,2.25,3470,8000,1.5,3,9,2360,1110.0,1906,3010,8000,42435 days 16:47:18.670863,195,1.7777777777777777,2.126126126126126,460,0,1250.0
275000.0,3,1.5,1390,48257,1.0,3,6,1390,0.0,1922,1440,45302,36591 days 16:47:18.670863,129,2.0,0.0,-50,2955,1390.0
89000.0,3,1.0,900,4750,1.0,4,6,900,0.0,1969,900,3404,19424 days 16:47:18.670863,287,3.0,0.0,0,1346,900.0
175000.0,2,1.75,1050,9800,1.5,4,6,1050,0.0,1975,1230,12726,17233 days 16:47:18.670863,217,1.1428571428571428,0.0,-180,-2926,1050.0
490000.0,3,2.5,2410,11900,1.0,4,9,1600,810.0,1989,3090,11902,12119 days 16:47:18.670863,049,1.2,1.9753086419753085,-680,-2,790.0
342400.0,3,2.25,1180,9630,2.0,3,7,1180,0.0,1986,2660,5979,13215 days 16:47:18.670863,135,1.3333333333333333,0.0,-1480,3651,1180.0
345000.0,3,1.0,1140,4200,2.0,4,7,1140,0.0,1904,1510,4000,43166 days 16:47:18.670863,174,3.0,0.0,-370,200,1140.0
399000.0,2,1.0,700,3400,1.0,3,6,700,0.0,1946,1570,4512,27825 days 16:47:18.670863,329,2.0,0.0,-870,-1112,700.0
550000.0,4,2.5,2060,9719,1.0,4,8,1320,740.0,1960,2050,9643,22712 days 16:47:18.670863,227,1.6,1.7837837837837838,10,76,580.0
652450.0,3,2.25,2230,11835,1.0,5,8,1630,600.0,1974,2190,10384,17598 days 16:47:18.670863,337,1.3333333333333333,2.716666666666667,40,1451,1030.0
438000.0,2,2.25,1950,29347,1.0,3,8,1350,600.0,1953,2125,7751,25268 days 16:47:18.670863,119,0.8888888888888888,2.25,-175,21596,750.0
605000.0,3,1.75,2100,5058,1.0,3,7,1340,760.0,1941,1640,5000,29651 days 16:47:18.670863,093,1.7142857142857142,1.763157894736842,460,58,580.0
395000.0,4,2.5,2130,11733,1.0,5,7,1330,800.0,1969,1800,9131,19424 days 16:47:18.670863,272,1.6,1.6625,330,2602,530.0
449950.0,3,2.0,1880,3048,2.0,4,7,1880,0.0,1902,1680,3600,43896 days 16:47:18.670863,316,1.5,0.0,200,-552,1880.0
651100.0,4,2.5,2310,5526,2.0,3,9,2310,0.0,2003,2500,5769,7006 days 16:47:18.670863,089,1.6,0.0,-190,-243,2310.0
241000.0,3,1.0,880,6050,1.0,3,6,880,0.0,1945,1130,6050,28190 days 16:47:18.670863,035,3.0,0.0,-250,0,880.0
268500.0,2,1.5,1290,1749,1.0,3,8,660,630.0,1969,1860,1749,19424 days 16:47:18.670863,353,1.3333333333333333,1.0476190476190477,-570,0,30.0
200000.0,2,1.0,1010,7200,1.0,3,6,1010,0.0,1956,1290,9000,24173 days 16:47:18.670863,023,2.0,0.0,-280,-1800,1010.0
400375.0,4,1.75,1690,7680,1.0,5,6,890,800.0,1946,1060,7680,27825 days 16:47:18.670863,335,2.2857142857142856,1.1125,630,0,90.0
429000.0,2,1.75,1350,6315,1.0,3,8,1350,0.0,2005,1665,5390,6275 days 16:47:18.670863,148,1.1428571428571428,0.0,-315,925,1350.0
230000.0,3,1.0,680,2400,1.0,4,6,680,0.0,1903,1470,3600,43531 days 16:47:18.670863,297,3.0,0.0,-790,-1200,680.0
1200000.0,4,2.25,2860,10702,2.0,3,1,2860,0.0,1982,2890,10572,14676 days 16:47:18.670863,049,1.7777777777777777,0.0,-30,130,2860.0
314200.0,1,1.0,610,6000,1.0,4,5,610,0.0,1918,970,5000,38052 days 16:47:18.670863,099,1.0,0.0,-360,1000,610.0
513000.0,4,2.5,2660,8887,1.0,4,8,1880,780.0,1967,1910,9620,20155 days 16:47:18.670863,113,1.6,2.41025641025641,750,-733,1100.0
535000.0,2,1.0,1390,5346,1.0,5,7,960,430.0,1908,1450,5040,41705 days 16:47:18.670863,092,2.0,2.2325581395348837,-60,306,530.0
420000.0,6,3.0,2290,6344,2.0,3,7,2290,0.0,1980,1360,3202,15407 days 16:47:18.670863,064,2.0,0.0,930,3142,2290.0
345950.0,3,2.5,2110,4118,2.0,3,8,2110,0.0,1989,2110,4044,12119 days 16:47:18.670863,174,1.2,0.0,0,74,2110.0
483500.0,3,2.0,1200,2016,1.0,4,7,600,600.0,1931,1730,4520,33304 days 16:47:18.670863,232,1.5,1.0,-530,-2504,0.0
695000.0,4,2.25,2360,2500,2.0,3,8,1520,840.0,2001,1810,3900,7736 days 16:47:18.670863,342,1.7777777777777777,1.8095238095238095,550,-1400,680.0
295000.0,4,2.5,2350,8906,2.0,3,7,2350,0.0,1993,2000,8165,10658 days 16:47:18.670863,279,1.6,0.0,350,741,2350.0
434975.0,3,2.25,1590,9960,1.0,3,7,1060,530.0,1976,1860,9760,16868 days 16:47:18.670863,098,1.3333333333333333,2.0,-270,200,530.0
513000.0,3,2.5,1810,4592,2.0,3,8,1810,0.0,1992,1810,4758,11024 days 16:47:18.670863,189,1.2,0.0,0,-166,1810.0
360000.0,3,1.75,1900,11407,1.0,3,8,1900,0.0,1963,1710,11407,21616 days 16:47:18.670863,082,1.7142857142857142,0.0,190,0,1900.0
234900.0,3,1.0,1250,8000,1.0,3,7,1250,0.0,1956,1040,6973,24173 days 16:47:18.670863,076,3.0,0.0,210,1027,1250.0
963000.0,4,3.5,3280,6603,2.0,3,1,3280,0.0,2007,3280,7333,5545 days 16:47:18.670863,167,1.1428571428571428,0.0,0,-730,3280.0
595000.0,2,1.5,870,4800,1.0,3,7,870,0.0,1924,2090,4800,35861 days 16:47:18.670863,231,1.3333333333333333,0.0,-1220,0,870.0
942500.0,4,3.25,3570,14408,2.0,3,1,3570,0.0,2006,4100,14577,5910 days 16:47:18.670863,297,1.2307692307692308,0.0,-530,-169,3570.0
1030000.0,4,3.25,3780,11200,2.0,3,1,3780,0.0,2002,3720,11813,7371 days 16:47:18.670863,248,1.2307692307692308,0.0,60,-613,3780.0
350000.0,3,1.0,1190,3600,1.5,3,6,1190,0.0,1904,1680,3600,43166 days 16:47:18.670863,084,3.0,0.0,-490,0,1190.0
416500.0,4,2.0,2280,39848,2.0,4,8,2280,0.0,1991,1900,38472,11389 days 16:47:18.670863,310,2.0,0.0,380,1376,2280.0
209900.0,3,1.0,1030,60720,1.5,3,5,1030,0.0,1912,1330,10342,40244 days 16:47:18.670863,259,3.0,0.0,-300,50378,1030.0
802000.0,3,1.75,2870,5000,1.5,4,8,1840,1030.0,1907,2200,5000,42070 days 16:47:18.670863,173,1.7142857142857142,1.7864077669902914,670,0,810.0
230000.0,4,1.5,1520,8800,1.0,4,7,1520,0.0,1960,1370,8800,22712 days 16:47:18.670863,212,2.6666666666666665,0.0,150,0,1520.0
489000.0,3,3.0,3700,10375,2.0,3,9,3700,0.0,1982,2130,9132,14676 days 16:47:18.670863,183,1.0,0.0,1570,1243,3700.0
497000.0,3,1.5,2240,28750,1.0,3,8,1620,620.0,1956,3200,23873,24173 days 16:47:18.670863,195,2.0,2.6129032258064515,-960,4877,1000.0
250000.0,3,2.25,1920,7738,1.0,3,8,1520,400.0,1965,2170,8452,20885 days 16:47:18.670863,183,1.3333333333333333,3.8,-250,-714,1120.0
925000.0,3,3.0,2560,3600,2.0,3,1,2110,450.0,1994,2160,3600,10293 days 16:47:18.670863,227,1.0,4.688888888888889,400,0,1660.0
390000.0,4,2.5,1840,15496,2.0,3,8,1840,0.0,1991,1840,15040,11389 days 16:47:18.670863,204,1.6,0.0,0,456,1840.0
415000.0,3,2.75,2080,9600,1.0,3,7,2080,0.0,1988,2220,9600,12485 days 16:47:18.670863,069,1.0909090909090908,0.0,-140,0,2080.0
785000.0,3,2.0,1600,9638,1.0,5,7,1600,0.0,1952,1800,11400,25634 days 16:47:18.670863,094,1.5,0.0,-200,-1762,1600.0
575000.0,3,2.0,2168,4000,1.5,3,8,2168,0.0,1907,1770,4000,42070 days 16:47:18.670863,267,1.5,0.0,398,0,2168.0
170000.0,2,1.0,860,8636,1.0,3,6,860,0.0,1924,1100,8636,35861 days 16:47:18.670863,026,2.0,0.0,-240,0,860.0
750000.0,4,1.75,2100,3400,1.0,5,7,1100,1000.0,1915,1890,3771,39148 days 16:47:18.670863,287,2.2857142857142856,1.1,210,-371,100.0
230000.0,3,1.0,1140,9639,1.0,4,7,1140,0.0,1967,1140,9639,20155 days 16:47:18.670863,080,3.0,0.0,0,0,1140.0
855000.0,4,3.0,3090,35074,2.0,3,9,3090,0.0,1978,3120,35150,16137 days 16:47:18.670863,005,1.3333333333333333,0.0,-30,-76,3090.0
235000.0,3,1.0,1330,45738,2.0,2,6,1330,0.0,1967,1490,24000,20155 days 16:47:18.670863,217,3.0,0.0,-160,21738,1330.0
335000.0,2,1.0,1360,69260,1.0,4,5,1360,0.0,1937,1460,69260,31112 days 16:47:18.670863,251,2.0,0.0,-100,0,1360.0
1200000.0,5,3.0,3420,18129,2.0,3,9,2540,880.0,1952,3750,16316,25634 days 16:47:18.670863,184,1.6666666666666667,2.8863636363636362,-330,1813,1660.0
677000.0,4,2.0,2180,6000,1.5,3,8,2060,120.0,1927,1370,4500,34765 days 16:47:18.670863,089,2.0,17.166666666666668,810,1500,1940.0
575000.0,3,2.0,1800,5000,2.0,5,7,1600,200.0,1925,1640,5000,35495 days 16:47:18.670863,295,1.5,8.0,160,0,1400.0
450000.0,2,1.0,1120,4590,1.0,3,7,1120,0.0,1924,1120,5100,35861 days 16:47:18.670863,049,2.0,0.0,0,-510,1120.0
817250.0,3,2.5,2980,7202,2.0,3,8,2980,0.0,1999,2430,7280,8467 days 16:47:18.670863,086,1.2,0.0,550,-78,2980.0
440000.0,4,2.25,2600,28600,1.0,3,8,1810,790.0,1968,2580,26950,19790 days 16:47:18.670863,336,1.7777777777777777,2.2911392405063293,20,1650,1020.0
526000.0,2,2.0,1550,2400,1.5,4,7,1550,0.0,1900,1180,1224,44626 days 16:47:18.670863,127,1.0,0.0,370,1176,1550.0
762500.0,3,2.25,3330,15258,2.0,3,1,3330,0.0,1986,3360,14850,13215 days 16:47:18.670863,206,1.3333333333333333,0.0,-30,408,3330.0
325000.0,4,2.5,2200,7719,2.0,3,8,2200,0.0,2000,2460,7348,8102 days 16:47:18.670863,104,1.6,0.0,-260,371,2200.0
840000.0,4,3.5,3840,85728,2.0,3,1,3840,0.0,1998,2430,42643,8832 days 16:47:18.670863,191,1.1428571428571428,0.0,1410,43085,3840.0
377500.0,2,1.0,840,4500,1.0,3,6,840,0.0,1939,1300,5000,30382 days 16:47:18.670863,123,2.0,0.0,-460,-500,840.0
212500.0,3,1.5,1270,7128,1.0,4,6,1270,0.0,1954,1270,7986,24903 days 16:47:18.670863,266,2.0,0.0,0,-858,1270.0
749400.0,4,2.5,3240,20301,2.0,3,1,3240,0.0,1985,3010,23650,13580 days 16:47:18.670863,135,1.6,0.0,230,-3349,3240.0
663000.0,3,2.5,2480,37843,1.5,4,8,2480,0.0,1974,2350,42122,17598 days 16:47:18.670863,177,1.2,0.0,130,-4279,2480.0
1480000.0,3,2.25,4470,22518,2.0,3,9,3240,1230.0,1953,2930,21837,25268 days 16:47:18.670863,202,1.3333333333333333,2.6341463414634148,1540,681,2010.0
261000.0,3,1.0,1780,7800,1.0,3,7,1060,720.0,1957,1450,7800,23807 days 16:47:18.670863,288,3.0,1.4722222222222223,330,0,340.0
515000.0,4,2.5,1850,9248,2.0,3,8,1850,0.0,1997,2080,8711,9197 days 16:47:18.670863,100,1.6,0.0,-230,537,1850.0
410000.0,3,2.25,2200,16921,2.0,3,8,2200,0.0,1987,2060,16921,12850 days 16:47:18.670863,132,1.3333333333333333,0.0,140,0,2200.0
336000.0,3,2.25,2760,10160,1.0,3,8,2760,0.0,1969,2760,9600,19424 days 16:47:18.670863,189,1.3333333333333333,0.0,0,560,2760.0
440000.0,2,1.0,1090,4128,1.0,3,7,1090,0.0,1948,1090,5413,27095 days 16:47:18.670863,056,2.0,0.0,0,-1285,1090.0
908950.0,4,2.75,3090,6200,2.0,3,9,3090,0.0,2014,2890,10108,2988 days 16:47:18.670863,009,1.4545454545454546,0.0,200,-3908,3090.0
554000.0,2,1.0,820,3700,1.0,5,7,820,0.0,1968,1750,9000,19790 days 16:47:18.670863,329,2.0,0.0,-930,-5300,820.0
387000.0,3,2.25,1445,1606,2.0,3,7,1300,145.0,2003,1410,1286,7006 days 16:47:18.670863,129,1.3333333333333333,8.96551724137931,35,320,1155.0
268643.0,4,2.25,1810,9240,2.0,3,7,1810,0.0,1961,1660,9240,22346 days 16:47:18.670863,125,1.7777777777777777,0.0,150,0,1810.0
514000.0,3,1.75,1620,5000,1.0,3,7,920,700.0,1954,1610,5000,24903 days 16:47:18.670863,202,1.7142857142857142,1.3142857142857143,10,0,220.0
420000.0,2,1.75,1060,4182,2.0,3,7,1060,0.0,1977,1760,4590,16502 days 16:47:18.670863,204,1.1428571428571428,0.0,-700,-408,1060.0
199000.0,3,1.75,1050,9871,1.0,5,7,1050,0.0,1968,1300,10794,19790 days 16:47:18.670863,253,1.7142857142857142,0.0,-250,-923,1050.0
225000.0,3,1.0,1010,15701,1.0,4,7,1010,0.0,1949,1260,9800,26729 days 16:47:18.670863,076,3.0,0.0,-250,5901,1010.0
320000.0,4,2.5,2050,8424,2.0,4,8,2050,0.0,1993,1970,8448,10658 days 16:47:18.670863,231,1.6,0.0,80,-24,2050.0
204995.0,2,1.0,970,8185,1.0,5,6,970,0.0,1904,1500,12541,43166 days 16:47:18.670863,296,2.0,0.0,-530,-4356,970.0
376000.0,3,2.0,1540,1827,2.0,3,8,1540,0.0,2005,1560,2058,6275 days 16:47:18.670863,363,1.5,0.0,-20,-231,1540.0
705000.0,4,2.75,3000,6222,2.0,3,9,3000,0.0,2004,3340,7222,6641 days 16:47:18.670863,349,1.4545454545454546,0.0,-340,-1000,3000.0
725995.0,4,2.5,3190,7869,2.0,3,9,3190,0.0,2001,2630,6739,7736 days 16:47:18.670863,153,1.6,0.0,560,1130,3190.0
285000.0,4,2.5,1870,8190,1.0,3,7,1100,770.0,1977,1590,9150,16502 days 16:47:18.670863,026,1.6,1.4285714285714286,280,-960,330.0
285000.0,4,2.5,2200,9397,2.0,3,8,2200,0.0,1987,2310,9176,12850 days 16:47:18.670863,122,1.6,0.0,-110,221,2200.0
731000.0,4,2.5,3070,5936,2.0,3,9,3070,0.0,2005,3160,5936,6275 days 16:47:18.670863,232,1.6,0.0,-90,0,3070.0
1560000.0,4,3.75,3730,17000,2.0,4,1,2820,910.0,1986,3880,15550,13215 days 16:47:18.670863,121,1.0666666666666667,3.098901098901099,-150,1450,1910.0
620000.0,2,1.0,990,4332,1.0,3,7,990,0.0,1909,1920,3420,41339 days 16:47:18.670863,296,2.0,0.0,-930,912,990.0
1110000.0,3,4.0,4160,31796,2.0,3,1,4160,0.0,1989,4300,36192,12119 days 16:47:18.670863,112,0.75,0.0,-140,-4396,4160.0
796000.0,4,3.5,3670,4960,2.0,3,9,2870,800.0,2005,1520,6335,6275 days 16:47:18.670863,203,1.1428571428571428,3.5875,2150,-1375,2070.0
255000.0,3,1.5,910,25500,1.0,3,5,910,0.0,1943,1580,10019,28921 days 16:47:18.670863,273,2.0,0.0,-670,15481,910.0
807000.0,3,2.5,1940,4000,2.0,4,9,1940,0.0,2000,1410,4000,8102 days 16:47:18.670863,118,1.2,0.0,530,0,1940.0
315000.0,4,2.5,1780,6000,2.0,3,9,1780,0.0,2000,2650,6000,8102 days 16:47:18.670863,314,1.6,0.0,-870,0,1780.0
637000.0,3,2.25,2200,7355,2.0,4,8,2200,0.0,1986,2290,7868,13215 days 16:47:18.670863,058,1.3333333333333333,0.0,-90,-513,2200.0
2730000.0,4,4.25,6410,43838,2.5,4,1,5610,800.0,1906,2270,6630,42435 days 16:47:18.670863,337,0.9411764705882353,7.0125,4140,37208,4810.0
490000.0,3,2.0,2070,10023,1.0,3,8,1220,850.0,1981,2130,9694,15041 days 16:47:18.670863,345,1.5,1.4352941176470588,-60,329,370.0
253000.0,3,1.75,2040,7281,1.0,3,7,1020,1020.0,1962,1740,7527,21981 days 16:47:18.670863,161,1.7142857142857142,1.0,300,-246,0.0
325900.0,4,2.5,2320,6270,2.0,3,8,2320,0.0,2004,2150,6270,6641 days 16:47:18.670863,128,1.6,0.0,170,0,2320.0
425000.0,2,2.0,1440,6677,1.0,3,7,870,570.0,1952,2020,7642,25634 days 16:47:18.670863,288,1.0,1.5263157894736843,-580,-965,300.0
215000.0,4,2.5,1700,6675,2.0,3,7,1700,0.0,1997,1570,7540,9197 days 16:47:18.670863,248,1.6,0.0,130,-865,1700.0
315000.0,4,2.5,1700,6675,2.0,3,7,1700,0.0,1997,1570,7540,9197 days 16:47:18.670863,098,1.6,0.0,130,-865,1700.0
724800.0,3,2.0,2050,3933,1.0,3,8,1180,870.0,1926,1940,4000,35130 days 16:47:18.670863,136,1.5,1.3563218390804597,110,-67,310.0
295000.0,2,1.0,800,6500,1.0,4,6,800,0.0,1953,1220,7000,25268 days 16:47:18.670863,190,2.0,0.0,-420,-500,800.0
509007.0,3,1.75,1800,7620,1.0,3,8,1350,450.0,1951,1770,7620,25999 days 16:47:18.670863,075,1.7142857142857142,3.0,30,0,900.0
306000.0,5,2.0,1460,169448,1.5,3,6,1460,0.0,1910,2250,6059,40974 days 16:47:18.670863,103,2.5,0.0,-790,163389,1460.0
205000.0,3,1.75,1290,7210,1.0,3,7,1290,0.0,1984,1350,7509,13946 days 16:47:18.670863,198,1.7142857142857142,0.0,-60,-299,1290.0
275000.0,3,1.5,1900,9737,1.0,4,7,1200,700.0,1968,1670,9737,19790 days 16:47:18.670863,212,2.0,1.7142857142857142,230,0,500.0
685000.0,3,1.75,1480,7000,1.0,3,8,1480,0.0,1963,1850,4000,21616 days 16:47:18.670863,310,1.7142857142857142,0.0,-370,3000,1480.0
465000.0,4,2.5,2090,12833,1.0,3,7,1220,870.0,1969,1740,11200,19424 days 16:47:18.670863,110,1.6,1.4022988505747127,350,1633,350.0
560000.0,4,2.25,1950,9800,1.0,3,8,1330,620.0,1968,2170,9800,19790 days 16:47:18.670863,189,1.7777777777777777,2.1451612903225805,-220,0,710.0
458500.0,3,1.75,1250,9605,1.0,3,7,1250,0.0,1964,1570,9605,21251 days 16:47:18.670863,054,1.7142857142857142,0.0,-320,0,1250.0
354000.0,3,1.0,990,7590,1.0,3,6,990,0.0,1959,1100,7590,23077 days 16:47:18.670863,090,3.0,0.0,-110,0,990.0
441000.0,3,2.5,2740,7923,2.0,3,9,2740,0.0,1998,2740,8815,8832 days 16:47:18.670863,013,1.2,0.0,0,-892,2740.0
194000.0,3,1.75,1260,10488,1.0,2,7,1110,150.0,1952,1540,9120,25634 days 16:47:18.670863,241,1.7142857142857142,7.4,-280,1368,960.0
316500.0,4,2.5,2150,6807,2.0,4,8,2150,0.0,1991,1910,7240,11389 days 16:47:18.670863,135,1.6,0.0,240,-433,2150.0
524950.0,3,1.75,1750,3250,1.5,4,7,1230,520.0,1929,1480,3600,34034 days 16:47:18.670863,237,1.7142857142857142,2.3653846153846154,270,-350,710.0
1050000.0,3,2.25,2880,6092,2.0,4,8,1920,960.0,1983,2880,5308,14311 days 16:47:18.670863,117,1.3333333333333333,2.0,0,784,960.0
925000.0,4,2.25,2590,13894,2.0,4,9,2590,0.0,1975,2720,13894,17233 days 16:47:18.670863,102,1.7777777777777777,0.0,-130,0,2590.0
780000.0,3,1.75,2430,4524,1.5,4,7,1830,600.0,1924,1610,4100,35861 days 16:47:18.670863,293,1.7142857142857142,3.05,820,424,1230.0
241000.0,2,2.0,1470,3128,2.0,3,6,1470,0.0,2005,1180,2576,6275 days 16:47:18.670863,139,1.0,0.0,290,552,1470.0
519000.0,3,2.75,2020,10744,1.0,5,7,1270,750.0,1954,2020,11069,24903 days 16:47:18.670863,170,1.0909090909090908,1.6933333333333334,0,-325,520.0
286000.0,2,1.0,610,4000,1.0,4,6,610,0.0,1918,870,5160,38052 days 16:47:18.670863,240,2.0,0.0,-260,-1160,610.0
400000.0,3,2.0,3000,17800,1.0,3,8,1500,1500.0,1962,2400,8300,21981 days 16:47:18.670863,282,1.5,1.0,600,9500,0.0
255000.0,2,1.0,920,43560,1.0,4,5,920,0.0,1923,1530,11875,36226 days 16:47:18.670863,282,2.0,0.0,-610,31685,920.0
152000.0,3,1.75,1070,7754,1.0,3,6,1070,0.0,1953,950,7740,25268 days 16:47:18.670863,021,1.7142857142857142,0.0,120,14,1070.0
599000.0,4,2.0,3410,15143,2.0,4,8,3410,0.0,1972,2350,25936,18329 days 16:47:18.670863,335,2.0,0.0,1060,-10793,3410.0
330000.0,4,2.5,1820,3905,2.0,3,7,1820,0.0,2001,1820,3863,7736 days 16:47:18.670863,297,1.6,0.0,0,42,1820.0
461000.0,2,1.0,1060,7193,1.0,3,7,1060,0.0,1926,1980,7560,35130 days 16:47:18.670863,139,2.0,0.0,-920,-367,1060.0
620000.0,5,2.5,3070,34991,2.0,3,9,3070,0.0,1995,2150,19515,9928 days 16:47:18.670863,069,2.0,0.0,920,15476,3070.0
352500.0,4,2.5,2300,219106,1.0,4,7,1840,460.0,1958,2120,123710,23442 days 16:47:18.670863,279,1.6,4.0,180,95396,1380.0
435000.0,3,2.0,1610,6911,1.0,3,7,1260,350.0,1988,1630,6911,12485 days 16:47:18.670863,218,1.5,3.6,-20,0,910.0
725000.0,5,2.75,2830,5310,2.0,3,9,2830,0.0,2006,3150,6581,5910 days 16:47:18.670863,136,1.8181818181818181,0.0,-320,-1271,2830.0
300000.0,3,1.0,970,12300,1.0,3,7,970,0.0,1982,2040,9994,14676 days 16:47:18.670863,309,3.0,0.0,-1070,2306,970.0
252000.0,3,2.5,1680,8284,2.0,3,7,1680,0.0,1989,1550,8284,12119 days 16:47:18.670863,315,1.2,0.0,130,0,1680.0
464625.0,4,2.75,2040,8996,1.0,4,8,1260,780.0,1974,2470,9180,17598 days 16:47:18.670863,278,1.4545454545454546,1.6153846153846154,-430,-184,480.0
340000.0,3,1.0,1450,9586,2.0,3,7,1450,0.0,1950,1500,8592,26364 days 16:47:18.670863,346,3.0,0.0,-50,994,1450.0
1330000.0,4,2.25,2870,6280,1.5,4,9,1980,890.0,1905,2370,4760,42800 days 16:47:18.670863,171,1.7777777777777777,2.2247191011235956,500,1520,1090.0
495000.0,4,3.5,2490,18042,2.0,3,8,2490,0.0,2003,1960,21107,7006 days 16:47:18.670863,133,1.1428571428571428,0.0,530,-3065,2490.0
925000.0,4,2.5,3350,4501,2.0,3,9,2640,710.0,2002,1000,4500,7371 days 16:47:18.670863,111,1.6,3.7183098591549295,2350,1,1930.0
587000.0,4,2.75,3190,8737,2.0,3,9,3190,0.0,2006,3240,7131,5910 days 16:47:18.670863,345,1.4545454545454546,0.0,-50,1606,3190.0
524000.0,3,1.75,1560,5520,1.0,4,6,780,780.0,1944,1470,6000,28556 days 16:47:18.670863,125,1.7142857142857142,1.0,90,-480,0.0
1030000.0,4,2.5,2750,4800,2.0,3,9,1960,790.0,1905,2400,5300,42800 days 16:47:18.670863,164,1.6,2.481012658227848,350,-500,1170.0
176000.0,2,1.0,920,2332,1.0,4,8,920,0.0,1980,1310,2853,15407 days 16:47:18.670863,273,2.0,0.0,-390,-521,920.0
249900.0,2,1.0,1140,5500,1.0,3,6,1140,0.0,1947,1110,5500,27460 days 16:47:18.670863,141,2.0,0.0,30,0,1140.0
499500.0,3,2.5,2520,53143,1.5,3,7,2520,0.0,1988,2020,56628,12485 days 16:47:18.670863,156,1.2,0.0,500,-3485,2520.0
600000.0,5,3.5,3150,10542,1.0,5,9,1620,1530.0,1974,3150,11807,17598 days 16:47:18.670863,254,1.4285714285714286,1.0588235294117647,0,-1265,90.0
294000.0,4,2.5,2040,7800,2.0,3,7,2040,0.0,2003,1860,10954,7006 days 16:47:18.670863,226,1.6,0.0,180,-3154,2040.0
272000.0,4,2.0,1780,19843,1.0,3,7,1780,0.0,1963,2210,13500,21616 days 16:47:18.670863,105,2.0,0.0,-430,6343,1780.0
390000.0,3,2.5,2240,10800,2.0,3,8,2240,0.0,1996,1900,9900,9563 days 16:47:18.670863,135,1.2,0.0,340,900,2240.0
700000.0,4,2.5,3270,9650,1.0,4,9,2320,950.0,1971,2340,17357,18694 days 16:47:18.670863,009,1.6,2.442105263157895,930,-7707,1370.0
635000.0,5,2.75,3110,6621,2.0,3,9,3110,0.0,2006,3550,7953,5910 days 16:47:18.670863,110,1.8181818181818181,0.0,-440,-1332,3110.0
920000.0,4,1.5,1850,3600,2.0,3,8,1660,190.0,1929,1970,3600,34034 days 16:47:18.670863,106,2.6666666666666665,8.736842105263158,-120,0,1470.0
500000.0,3,1.75,1570,8530,1.0,4,7,1190,380.0,1983,1530,8708,14311 days 16:47:18.670863,216,1.7142857142857142,3.1315789473684212,40,-178,810.0
263500.0,2,1.0,750,4515,1.0,3,6,750,0.0,1942,1020,5000,29286 days 16:47:18.670863,233,2.0,0.0,-270,-485,750.0
975000.0,4,2.25,2240,9990,2.0,4,1,2240,0.0,1967,2600,11480,20155 days 16:47:18.670863,072,1.7777777777777777,0.0,-360,-1490,2240.0
575000.0,3,2.5,1870,3485,2.0,3,8,1870,0.0,2001,1940,3485,7736 days 16:47:18.670863,318,1.2,0.0,-70,0,1870.0
822000.0,4,2.5,2683,40386,2.0,4,9,2683,0.0,1987,2683,34800,12850 days 16:47:18.670863,163,1.6,0.0,0,5586,2683.0
300000.0,3,1.0,1490,7200,1.0,3,7,1490,0.0,1954,1280,7200,24903 days 16:47:18.670863,016,3.0,0.0,210,0,1490.0
487600.0,4,2.5,2340,12080,2.0,3,8,2340,0.0,1999,2200,12403,8467 days 16:47:18.670863,089,1.6,0.0,140,-323,2340.0
500000.0,4,2.0,1700,8640,1.0,3,7,850,850.0,1955,1620,9000,24538 days 16:47:18.670863,188,2.0,1.0,80,-360,0.0
419000.0,3,2.5,3310,21096,2.0,3,9,3310,0.0,2004,3310,13835,6641 days 16:47:18.670863,253,1.2,0.0,0,7261,3310.0
450000.0,4,1.75,1520,5250,1.0,3,6,1520,0.0,1949,1530,5250,26729 days 16:47:18.670863,219,2.2857142857142856,0.0,-10,0,1520.0
650000.0,5,1.75,1260,4500,1.5,3,7,1260,0.0,1926,1410,4388,35130 days 16:47:18.670863,169,2.857142857142857,0.0,-150,112,1260.0
550000.0,3,1.75,1840,8086,1.0,4,8,1840,0.0,1964,1840,8060,21251 days 16:47:18.670863,174,1.7142857142857142,0.0,0,26,1840.0
330000.0,4,2.0,1750,5202,1.0,4,6,1070,680.0,1942,2090,5400,29286 days 16:47:18.670863,337,2.0,1.5735294117647058,-340,-198,390.0
282510.0,4,1.0,1450,32234,1.5,4,6,1450,0.0,1932,1530,10125,32939 days 16:47:18.670863,023,4.0,0.0,-80,22109,1450.0
2390000.0,4,4.0,6330,13296,2.0,3,1,4900,1430.0,2000,2200,9196,8102 days 16:47:18.670863,324,1.0,3.4265734265734267,4130,4100,3470.0
230000.0,2,2.0,1260,10200,1.0,3,7,1020,240.0,1983,1560,10200,14311 days 16:47:18.670863,324,1.0,4.25,-300,0,780.0
750000.0,4,1.75,2100,6613,2.0,3,8,2100,0.0,1909,1630,5750,41339 days 16:47:18.670863,277,2.2857142857142856,0.0,470,863,2100.0
321000.0,4,2.5,2430,5366,2.0,3,8,2430,0.0,2002,2100,5414,7371 days 16:47:18.670863,259,1.6,0.0,330,-48,2430.0
2200000.0,4,3.25,4250,18000,2.0,5,1,3350,900.0,1980,3790,14537,15407 days 16:47:18.670863,300,1.2307692307692308,3.7222222222222223,460,3463,2450.0
245000.0,4,2.0,1830,10416,1.0,3,7,1370,460.0,1958,1830,9271,23442 days 16:47:18.670863,077,2.0,2.9782608695652173,0,1145,910.0
510000.0,2,1.0,1310,4000,1.0,3,6,1310,0.0,1913,1550,4000,39878 days 16:47:18.670863,357,2.0,0.0,-240,0,1310.0
751000.0,4,3.25,3090,9571,2.0,3,9,2370,720.0,2004,3630,9110,6641 days 16:47:18.670863,175,1.2307692307692308,3.2916666666666665,-540,461,1650.0
675000.0,4,2.5,2560,36601,2.0,4,9,2560,0.0,1987,2790,36601,12850 days 16:47:18.670863,143,1.6,0.0,-230,0,2560.0
295000.0,3,1.75,1930,13350,1.0,3,8,1930,0.0,1967,2270,13350,20155 days 16:47:18.670863,026,1.7142857142857142,0.0,-340,0,1930.0
312000.0,2,1.0,1460,6000,1.0,2,7,1260,200.0,1925,1580,6380,35495 days 16:47:18.670863,301,2.0,6.3,-120,-380,1060.0
730000.0,3,3.0,3460,13129,2.0,3,9,2560,900.0,1988,3460,12568,12485 days 16:47:18.670863,268,1.0,2.8444444444444446,0,561,1660.0
762500.0,5,3.5,3290,5880,2.0,3,9,2670,620.0,2005,3090,5680,6275 days 16:47:18.670863,002,1.4285714285714286,4.306451612903226,200,200,2050.0
150000.0,3,1.0,820,7680,1.5,3,6,820,0.0,1910,1470,6912,40974 days 16:47:18.670863,148,3.0,0.0,-650,768,820.0
270000.0,3,1.0,1480,7374,1.0,3,6,760,720.0,1954,1480,8934,24903 days 16:47:18.670863,068,3.0,1.0555555555555556,0,-1560,40.0
400000.0,4,2.0,1420,9301,1.0,4,7,1420,0.0,1963,1530,8075,21616 days 16:47:18.670863,096,2.0,0.0,-110,1226,1420.0
530000.0,2,1.5,1390,5000,1.0,4,8,970,420.0,1954,1610,5000,24903 days 16:47:18.670863,279,1.3333333333333333,2.3095238095238093,-220,0,550.0
248000.0,3,1.0,950,9400,1.0,4,7,950,0.0,1954,1260,9400,24903 days 16:47:18.670863,181,3.0,0.0,-310,0,950.0
760000.0,4,3.5,3000,5300,1.0,5,7,1780,1220.0,1949,1360,5450,26729 days 16:47:18.670863,008,1.1428571428571428,1.459016393442623,1640,-150,560.0
199000.0,4,1.0,1280,10521,1.5,3,7,1280,0.0,1960,1540,9384,22712 days 16:47:18.670863,051,4.0,0.0,-260,1137,1280.0
240000.0,2,1.0,870,8400,1.0,3,7,870,0.0,1960,1070,12465,22712 days 16:47:18.670863,293,2.0,0.0,-200,-4065,870.0
415000.0,3,1.5,1360,1795,2.0,3,7,1360,0.0,1945,1580,1795,28190 days 16:47:18.670863,124,2.0,0.0,-220,0,1360.0
228000.0,3,1.0,1000,16376,1.0,3,7,1000,0.0,1959,1420,16192,23077 days 16:47:18.670863,336,3.0,0.0,-420,184,1000.0
525000.0,4,2.5,2740,12106,1.0,3,8,1980,760.0,1992,2170,11156,11024 days 16:47:18.670863,056,1.6,2.6052631578947367,570,950,1220.0
399950.0,3,1.75,1560,5223,1.0,4,7,810,750.0,1940,1440,8491,30017 days 16:47:18.670863,174,1.7142857142857142,1.08,120,-3268,60.0
781000.0,4,2.5,2590,8571,2.0,3,9,2590,0.0,1988,2360,8155,12485 days 16:47:18.670863,103,1.6,0.0,230,416,2590.0
827000.0,3,2.5,1850,1330,2.5,3,9,1560,290.0,2004,1810,2071,6641 days 16:47:18.670863,118,1.2,5.379310344827586,40,-741,1270.0
525000.0,5,2.25,2500,8621,1.5,4,7,2500,0.0,1968,1980,7395,19790 days 16:47:18.670863,197,2.2222222222222223,0.0,520,1226,2500.0
671300.0,4,2.5,3280,5232,2.0,3,7,3280,0.0,2004,2600,5080,6641 days 16:47:18.670863,055,1.6,0.0,680,152,3280.0
175000.0,2,1.0,670,2378,1.0,3,5,670,0.0,1919,700,2970,37687 days 16:47:18.670863,155,2.0,0.0,-30,-592,670.0
1100000.0,5,2.75,2890,22547,1.0,4,1,2150,740.0,1963,3010,17809,21616 days 16:47:18.670863,061,1.8181818181818181,2.9054054054054053,-120,4738,1410.0
800000.0,5,2.5,3000,10560,1.0,3,8,1500,1500.0,1966,2690,11616,20520 days 16:47:18.670863,126,2.0,1.0,310,-1056,0.0
329950.0,4,2.5,1920,4600,2.0,3,7,1920,0.0,2002,2200,6600,7371 days 16:47:18.670863,192,1.6,0.0,-280,-2000,1920.0
445000.0,4,3.25,1960,7200,2.0,3,7,1960,0.0,1979,1980,7529,15772 days 16:47:18.670863,217,1.2307692307692308,0.0,-20,-329,1960.0
237000.0,3,1.75,2000,12208,1.0,3,7,1140,860.0,1979,1060,8194,15772 days 16:47:18.670863,231,1.7142857142857142,1.3255813953488371,940,4014,280.0
1110000.0,6,4.0,3600,6224,2.0,3,9,2610,990.0,1945,1430,6224,28190 days 16:47:18.670863,266,1.5,2.6363636363636362,2170,0,1620.0
1280000.0,9,4.5,3650,5000,2.0,3,8,2530,1120.0,1915,2510,5000,39148 days 16:47:18.670863,220,2.0,2.2589285714285716,1140,0,1410.0
670000.0,4,2.5,2095,4569,2.0,3,9,2095,0.0,2002,2095,4385,7371 days 16:47:18.670863,020,1.6,0.0,0,184,2095.0
519000.0,2,2.0,1560,4823,1.0,3,8,1560,0.0,2004,1855,4989,6641 days 16:47:18.670863,124,1.0,0.0,-295,-166,1560.0
320000.0,3,2.25,1880,7350,1.0,3,8,1390,490.0,1984,1910,8400,13946 days 16:47:18.670863,070,1.3333333333333333,2.836734693877551,-30,-1050,900.0
270000.0,2,1.5,840,867,2.0,3,7,840,0.0,2005,840,1322,6275 days 16:47:18.670863,142,1.3333333333333333,0.0,0,-455,840.0
1000000.0,3,2.5,2730,5832,2.0,3,9,2730,0.0,1998,2360,5832,8832 days 16:47:18.670863,153,1.2,0.0,370,0,2730.0
657500.0,3,2.0,2320,10960,1.0,3,7,1510,810.0,1956,2160,10960,24173 days 16:47:18.670863,191,1.5,1.8641975308641976,160,0,700.0
450000.0,3,1.75,1540,61419,1.0,3,7,1540,0.0,1967,3790,8529,20155 days 16:47:18.670863,240,1.7142857142857142,0.0,-2250,52890,1540.0
150000.0,3,1.0,890,6488,1.5,3,5,890,0.0,1928,1330,16250,34400 days 16:47:18.670863,106,3.0,0.0,-440,-9762,890.0
792500.0,4,2.5,4290,175421,2.0,3,1,4290,0.0,2004,3370,63162,6641 days 16:47:18.670863,167,1.6,0.0,920,112259,4290.0
540000.0,3,2.5,1950,13227,2.0,4,9,1950,0.0,1978,2650,12943,16137 days 16:47:18.670863,051,1.2,0.0,-700,284,1950.0
229900.0,3,1.0,1010,8848,1.0,4,7,1010,0.0,1968,1380,10650,19790 days 16:47:18.670863,202,3.0,0.0,-370,-1802,1010.0
533000.0,4,2.5,2830,6536,2.0,3,8,2830,0.0,2003,2830,6872,7006 days 16:47:18.670863,126,1.6,0.0,0,-336,2830.0
239000.0,4,1.75,1500,12560,1.0,4,7,1000,500.0,1977,1700,9020,16502 days 16:47:18.670863,356,2.2857142857142856,2.0,-200,3540,500.0
713900.0,3,2.5,3370,167706,1.0,3,1,3370,0.0,2000,3350,213444,8102 days 16:47:18.670863,065,1.2,0.0,20,-45738,3370.0
427500.0,4,2.5,3160,8726,2.0,3,9,3160,0.0,1999,2500,8648,8467 days 16:47:18.670863,301,1.6,0.0,660,78,3160.0
302000.0,3,1.0,1110,7000,1.5,4,7,1110,0.0,1955,1800,7000,24538 days 16:47:18.670863,203,3.0,0.0,-690,0,1110.0
1150000.0,3,2.5,3830,48743,2.0,3,1,3830,0.0,1991,2950,8299,11389 days 16:47:18.670863,189,1.2,0.0,880,40444,3830.0
555000.0,3,2.5,3160,4270,2.0,3,8,2650,510.0,2006,2720,12523,5910 days 16:47:18.670863,148,1.2,5.196078431372549,440,-8253,2140.0
495000.0,3,2.25,2100,3000,2.0,3,7,2100,0.0,1996,1650,4500,9563 days 16:47:18.670863,364,1.3333333333333333,0.0,450,-1500,2100.0
495000.0,3,1.5,2240,13288,1.0,3,7,2240,0.0,1953,2150,9900,25268 days 16:47:18.670863,203,2.0,0.0,90,3388,2240.0
340000.0,2,0.75,1060,48292,1.0,5,6,560,500.0,1947,750,80201,27460 days 16:47:18.670863,260,2.6666666666666665,1.12,310,-31909,60.0
464950.0,4,2.25,2350,36116,1.0,4,9,2350,0.0,1983,2580,36116,14311 days 16:47:18.670863,132,1.7777777777777777,0.0,-230,0,2350.0
320000.0,4,2.5,1940,7040,2.0,3,8,1940,0.0,1998,2400,7145,8832 days 16:47:18.670863,086,1.6,0.0,-460,-105,1940.0
440000.0,1,1.0,1160,64469,1.0,3,7,1160,0.0,2009,1580,48352,4814 days 16:47:18.670863,029,1.0,0.0,-420,16117,1160.0
686000.0,3,1.5,1840,9990,2.0,5,8,1840,0.0,1961,2100,12474,22346 days 16:47:18.670863,153,2.0,0.0,-260,-2484,1840.0
555000.0,4,1.75,2260,11000,1.0,3,8,1620,640.0,1976,1960,10000,16868 days 16:47:18.670863,335,2.2857142857142856,2.53125,300,1000,980.0
361500.0,2,1.0,840,3860,1.0,4,6,840,0.0,1909,1390,3860,41339 days 16:47:18.670863,300,2.0,0.0,-550,0,840.0
1240000.0,5,3.0,2830,7500,2.0,3,9,2460,370.0,1923,2900,5000,36226 days 16:47:18.670863,161,1.6666666666666667,6.648648648648648,-70,2500,2090.0
154950.0,4,1.0,1600,10183,1.0,4,6,1600,0.0,1966,1410,10416,20520 days 16:47:18.670863,190,4.0,0.0,190,-233,1600.0
247200.0,3,1.75,1370,8719,1.0,3,7,1370,0.0,1982,1370,7525,14676 days 16:47:18.670863,168,1.7142857142857142,0.0,0,1194,1370.0
250000.0,3,2.25,1960,7414,1.0,3,7,1490,470.0,1984,1580,8038,13946 days 16:47:18.670863,234,1.3333333333333333,3.1702127659574466,380,-624,1020.0
590300.0,3,1.5,1470,7200,2.0,4,7,1470,0.0,1907,1530,7200,42070 days 16:47:18.670863,170,2.0,0.0,-60,0,1470.0
541125.0,5,2.75,2740,8426,1.0,4,8,1370,1370.0,1960,2020,8783,22712 days 16:47:18.670863,125,1.8181818181818181,1.0,720,-357,0.0
310000.0,2,2.5,1090,923,2.0,3,7,1090,0.0,2004,1410,1326,6641 days 16:47:18.670863,049,0.8,0.0,-320,-403,1090.0
704111.0,4,2.75,2460,9520,1.0,3,8,1680,780.0,1976,2380,9600,16868 days 16:47:18.670863,069,1.4545454545454546,2.1538461538461537,80,-80,900.0
277500.0,3,2.25,1820,19602,1.0,4,7,1820,0.0,1964,1520,8773,21251 days 16:47:18.670863,301,1.3333333333333333,0.0,300,10829,1820.0
325000.0,4,2.75,1960,8937,1.0,5,7,980,980.0,1954,1480,10016,24903 days 16:47:18.670863,048,1.4545454545454546,1.0,480,-1079,0.0
289200.0,3,2.25,1760,7023,2.0,3,7,1760,0.0,1995,1760,7082,9928 days 16:47:18.670863,325,1.3333333333333333,0.0,0,-59,1760.0
185000.0,1,1.0,720,5000,1.0,4,6,720,0.0,1908,1170,5000,41705 days 16:47:18.670863,247,1.0,0.0,-450,0,720.0
1450000.0,4,3.5,3470,8580,2.0,3,1,2500,970.0,2007,1940,7920,5545 days 16:47:18.670863,091,1.1428571428571428,2.577319587628866,1530,660,1530.0
420550.0,4,2.0,1370,8100,1.0,2,7,1370,0.0,1947,1280,8100,27460 days 16:47:18.670863,077,2.0,0.0,90,0,1370.0
603000.0,4,2.25,2370,11310,1.0,3,8,1550,820.0,1968,1890,8621,19790 days 16:47:18.670863,100,1.7777777777777777,1.8902439024390243,480,2689,730.0
345000.0,3,1.0,1390,2640,1.5,3,7,1230,160.0,1903,1780,3920,43531 days 16:47:18.670863,330,3.0,7.6875,-390,-1280,1070.0
650000.0,3,2.0,1840,3075,1.0,5,7,920,920.0,1928,1480,3774,34400 days 16:47:18.670863,106,1.5,1.0,360,-699,0.0
589950.0,5,3.0,2790,19439,1.0,5,7,1500,1290.0,1973,1620,19439,17963 days 16:47:18.670863,176,1.6666666666666667,1.1627906976744187,1170,0,210.0
309950.0,2,2.25,1460,1607,2.0,3,8,1460,0.0,2007,1460,1826,5545 days 16:47:18.670863,231,0.8888888888888888,0.0,0,-219,1460.0
775000.0,3,2.5,2620,241200,1.5,4,9,2620,0.0,1998,2620,172933,8832 days 16:47:18.670863,254,1.2,0.0,0,68267,2620.0
590000.0,4,1.5,2230,5109,1.5,3,7,1330,900.0,1918,1630,5109,38052 days 16:47:18.670863,302,2.6666666666666665,1.4777777777777779,600,0,430.0
863500.0,4,3.0,3250,2760,2.5,3,8,2420,830.0,1905,1260,2780,42800 days 16:47:18.670863,118,1.3333333333333333,2.9156626506024095,1990,-20,1590.0
517500.0,3,1.0,1190,7000,1.0,3,7,1190,0.0,1943,1350,7000,28921 days 16:47:18.670863,323,3.0,0.0,-160,0,1190.0
700000.0,3,3.0,2090,7440,1.5,5,7,1290,800.0,1922,1570,4960,36591 days 16:47:18.670863,358,1.0,1.6125,520,2480,490.0
699000.0,3,2.5,2580,8154,1.0,3,1,2090,490.0,1956,1660,8155,24173 days 16:47:18.670863,203,1.2,4.26530612244898,920,-1,1600.0
350000.0,3,2.5,2100,3574,2.0,3,7,1690,410.0,2005,1970,2962,6275 days 16:47:18.670863,203,1.2,4.121951219512195,130,612,1280.0
795000.0,4,2.5,3160,16564,2.0,3,1,3160,0.0,1987,3160,12415,12850 days 16:47:18.670863,198,1.6,0.0,0,4149,3160.0
543000.0,3,2.5,2090,7640,1.0,3,7,1360,730.0,1962,2090,7668,21981 days 16:47:18.670863,134,1.2,1.8630136986301369,0,-28,630.0
325000.0,3,2.5,1570,3143,2.0,3,7,1570,0.0,2001,1740,3591,7736 days 16:47:18.670863,054,1.2,0.0,-170,-448,1570.0
337500.0,3,1.0,1020,6000,1.5,3,7,1020,0.0,1900,1240,6000,44626 days 16:47:18.670863,128,3.0,0.0,-220,0,1020.0
425000.0,2,1.0,1300,11080,1.0,4,7,1300,0.0,1955,1600,9259,24538 days 16:47:18.670863,058,2.0,0.0,-300,1821,1300.0
780000.0,3,2.5,2110,9773,1.0,3,9,2110,0.0,1986,2560,11787,13215 days 16:47:18.670863,076,1.2,0.0,-450,-2014,2110.0
259000.0,2,1.0,1210,17389,1.0,4,5,1210,0.0,1948,2140,14419,27095 days 16:47:18.670863,204,2.0,0.0,-930,2970,1210.0
524400.0,4,1.75,1990,12950,1.0,4,8,1850,140.0,1968,2090,12850,19790 days 16:47:18.670863,225,2.2857142857142856,13.214285714285714,-100,100,1710.0
260000.0,3,2.0,1630,8018,1.0,3,7,1630,0.0,2003,1610,8397,7006 days 16:47:18.670863,147,1.5,0.0,20,-379,1630.0
273000.0,2,2.0,1384,1822,2.0,3,7,1384,0.0,1990,1078,1315,11754 days 16:47:18.670863,110,1.0,0.0,306,507,1384.0
420000.0,4,2.5,2480,8626,2.0,3,1,2480,0.0,2001,2990,9033,7736 days 16:47:18.670863,238,1.6,0.0,-510,-407,2480.0
510500.0,3,1.0,1270,8000,1.0,4,7,1270,0.0,1957,1470,8000,23807 days 16:47:18.670863,225,3.0,0.0,-200,0,1270.0
290000.0,4,1.0,1010,7200,1.5,3,6,1010,0.0,1947,1360,7200,27460 days 16:47:18.670863,098,4.0,0.0,-350,0,1010.0
226000.0,3,1.75,1490,6269,1.0,4,6,990,500.0,1944,1490,7722,28556 days 16:47:18.670863,118,1.7142857142857142,1.98,0,-1453,490.0
300000.0,2,1.0,820,3844,1.0,4,6,820,0.0,1916,1520,3844,38783 days 16:47:18.670863,149,2.0,0.0,-700,0,820.0
407450.0,3,2.0,1810,10860,1.0,3,7,1810,0.0,1967,1420,11982,20155 days 16:47:18.670863,209,1.5,0.0,390,-1122,1810.0
390000.0,4,2.25,3060,7920,1.0,3,7,1530,1530.0,1965,1850,7800,20885 days 16:47:18.670863,126,1.7777777777777777,1.0,1210,120,0.0
1060000.0,6,2.75,2980,20000,1.0,3,8,2130,850.0,1965,2730,20000,20885 days 16:47:18.670863,121,2.1818181818181817,2.5058823529411764,250,0,1280.0
610000.0,3,2.5,3440,18167,2.0,3,1,3440,0.0,1991,3990,20239,11389 days 16:47:18.670863,229,1.2,0.0,-550,-2072,3440.0
239975.0,3,2.5,1820,7242,1.0,3,7,1220,600.0,1959,1350,8214,23077 days 16:47:18.670863,023,1.2,2.033333333333333,470,-972,620.0
375000.0,3,2.5,2320,5760,1.0,3,7,1480,840.0,1987,1660,5762,12850 days 16:47:18.670863,219,1.2,1.7619047619047619,660,-2,640.0
742500.0,4,2.5,2620,4400,2.0,3,9,2620,0.0,2004,2640,4554,6641 days 16:47:18.670863,118,1.6,0.0,-20,-154,2620.0
450000.0,4,1.75,2190,11625,1.0,4,8,2020,170.0,1956,1920,8855,24173 days 16:47:18.670863,119,2.2857142857142856,11.882352941176471,270,2770,1850.0
300000.0,3,2.25,1780,10395,1.0,3,8,1780,0.0,1967,2080,9360,20155 days 16:47:18.670863,177,1.3333333333333333,0.0,-300,1035,1780.0
216600.0,3,1.75,2200,7700,1.0,3,7,1240,960.0,1975,1770,7360,17233 days 16:47:18.670863,121,1.7142857142857142,1.2916666666666667,430,340,280.0
525000.0,3,1.75,1600,6120,1.5,3,7,1600,0.0,1924,1670,4590,35861 days 16:47:18.670863,134,1.7142857142857142,0.0,-70,1530,1600.0
455000.0,4,2.25,2450,21000,1.0,4,8,1650,800.0,1954,1820,12480,24903 days 16:47:18.670863,171,1.7777777777777777,2.0625,630,8520,850.0
390000.0,4,2.25,2680,35218,2.0,3,8,2680,0.0,1986,2980,35218,13215 days 16:47:18.670863,276,1.7777777777777777,0.0,-300,0,2680.0
450000.0,3,1.75,1850,8667,1.0,4,7,880,970.0,1982,1450,10530,14676 days 16:47:18.670863,259,1.7142857142857142,0.9072164948453608,400,-1863,-90.0
382000.0,4,1.0,1740,4400,1.5,3,7,1740,0.0,1924,1590,4400,35861 days 16:47:18.670863,336,4.0,0.0,150,0,1740.0
287000.0,3,2.25,1490,9600,1.0,4,7,1170,320.0,1987,1590,10104,12850 days 16:47:18.670863,133,1.3333333333333333,3.65625,-100,-504,850.0
460000.0,4,2.0,1960,190357,1.0,2,8,1960,0.0,1971,2560,189100,18694 days 16:47:18.670863,013,2.0,0.0,-600,1257,1960.0
435000.0,3,2.25,1380,3015,2.0,3,7,1380,0.0,2009,1930,3612,4814 days 16:47:18.670863,301,1.3333333333333333,0.0,-550,-597,1380.0
575000.0,2,1.0,1510,4032,1.5,3,8,1310,200.0,1935,1700,4042,31843 days 16:47:18.670863,163,2.0,6.55,-190,-10,1110.0
626700.0,3,1.5,1410,3600,1.0,3,7,1410,0.0,1906,1370,3600,42435 days 16:47:18.670863,124,2.0,0.0,40,0,1410.0
352000.0,4,1.5,1440,8680,1.5,3,7,1440,0.0,1922,1440,9000,36591 days 16:47:18.670863,077,2.6666666666666665,0.0,0,-320,1440.0
650000.0,3,1.0,920,6750,1.0,4,7,920,0.0,1951,1460,8933,25999 days 16:47:18.670863,075,3.0,0.0,-540,-2183,920.0
197000.0,3,1.0,1090,17630,1.0,4,7,1090,0.0,1962,1300,12000,21981 days 16:47:18.670863,279,3.0,0.0,-210,5630,1090.0
340000.0,8,2.75,2790,6695,1.0,3,7,1470,1320.0,1977,1760,7624,16502 days 16:47:18.670863,184,2.909090909090909,1.1136363636363635,1030,-929,150.0
560000.0,3,2.0,1840,14985,1.0,3,7,1840,0.0,1968,2300,16067,19790 days 16:47:18.670863,202,1.5,0.0,-460,-1082,1840.0
354000.0,3,1.75,1340,6300,1.0,3,7,1340,0.0,1972,1780,7200,18329 days 16:47:18.670863,007,1.7142857142857142,0.0,-440,-900,1340.0
670000.0,4,2.5,2570,9086,2.0,3,9,2570,0.0,1999,2760,6733,8467 days 16:47:18.670863,213,1.6,0.0,-190,2353,2570.0
769000.0,4,3.5,3010,6202,2.0,3,9,3010,0.0,2005,2520,5001,6275 days 16:47:18.670863,026,1.1428571428571428,0.0,490,1201,3010.0
650000.0,4,2.5,2160,3139,1.0,3,7,1080,1080.0,1940,1650,3740,30017 days 16:47:18.670863,248,1.6,1.0,510,-601,0.0
650000.0,3,1.75,2140,9484,1.0,3,7,1290,850.0,1953,1960,9630,25268 days 16:47:18.670863,166,1.7142857142857142,1.5176470588235293,180,-146,440.0
289950.0,4,1.75,2090,7416,1.0,4,7,1050,1040.0,1970,1710,7527,19059 days 16:47:18.670863,346,2.2857142857142856,1.0096153846153846,380,-111,10.0
300000.0,3,1.75,1810,21138,1.0,4,7,1240,570.0,1977,1850,12200,16502 days 16:47:18.670863,335,1.7142857142857142,2.175438596491228,-40,8938,670.0
471000.0,4,1.75,1760,5750,1.0,5,7,1070,690.0,1962,1860,5750,21981 days 16:47:18.670863,337,2.2857142857142856,1.5507246376811594,-100,0,380.0
639000.0,4,2.5,2500,8540,2.0,3,9,2500,0.0,1990,2560,8475,11754 days 16:47:18.670863,199,1.6,0.0,-60,65,2500.0
287000.0,2,1.0,930,6900,1.0,3,7,930,0.0,1952,1910,7194,25634 days 16:47:18.670863,282,2.0,0.0,-980,-294,930.0
740000.0,4,2.5,3030,8335,2.0,3,1,3030,0.0,1992,2850,8678,11024 days 16:47:18.670863,091,1.6,0.0,180,-343,3030.0
499922.0,3,2.0,1460,3000,1.0,4,7,940,520.0,1990,1460,3000,11754 days 16:47:18.670863,107,1.5,1.8076923076923077,0,0,420.0
675000.0,4,2.5,2940,14071,2.0,3,9,2940,0.0,1986,2670,10982,13215 days 16:47:18.670863,353,1.6,0.0,270,3089,2940.0
738515.0,5,2.75,3360,9200,2.0,3,9,3360,0.0,2014,3360,9713,2988 days 16:47:18.670863,252,1.8181818181818181,0.0,0,-513,3360.0
445000.0,3,1.75,2110,4800,1.0,3,8,1210,900.0,1956,1660,4800,24173 days 16:47:18.670863,303,1.7142857142857142,1.3444444444444446,450,0,310.0
1040000.0,4,2.25,2740,11343,1.0,5,1,1980,760.0,1953,2790,10027,25268 days 16:47:18.670863,121,1.7777777777777777,2.6052631578947367,-50,1316,1220.0
346000.0,2,1.0,1070,2196,1.0,4,7,880,190.0,1917,1160,3600,38417 days 16:47:18.670863,274,2.0,4.631578947368421,-90,-1404,690.0
450000.0,3,2.0,1680,4886,2.0,3,7,1180,500.0,1940,1400,4900,30017 days 16:47:18.670863,098,1.5,2.36,280,-14,680.0
350000.0,4,2.5,2260,13755,1.0,4,9,2260,0.0,1975,2650,13650,17233 days 16:47:18.670863,224,1.6,0.0,-390,105,2260.0
2400000.0,4,3.5,5860,7200,2.0,5,1,3690,2170.0,1907,4150,7200,42070 days 16:47:18.670863,209,1.1428571428571428,1.7004608294930876,1710,0,1520.0
594950.0,4,2.25,2380,35008,1.0,3,8,2380,0.0,1977,2250,34794,16502 days 16:47:18.670863,213,1.7777777777777777,0.0,130,214,2380.0
1700000.0,5,3.0,3320,5354,2.0,3,9,3320,0.0,2004,2330,4040,6641 days 16:47:18.670863,134,1.6666666666666667,0.0,990,1314,3320.0
219000.0,2,1.0,1050,9000,1.5,4,7,1050,0.0,1984,1550,9600,13946 days 16:47:18.670863,283,2.0,0.0,-500,-600,1050.0
450000.0,4,2.5,2070,3982,2.0,3,7,2070,0.0,2004,2340,4067,6641 days 16:47:18.670863,099,1.6,0.0,-270,-85,2070.0
402000.0,4,2.25,1790,7311,2.0,3,7,1790,0.0,1992,1400,7203,11024 days 16:47:18.670863,105,1.7777777777777777,0.0,390,108,1790.0
275000.0,2,1.0,840,4000,1.0,3,6,840,0.0,1942,1100,4000,29286 days 16:47:18.670863,048,2.0,0.0,-260,0,840.0
421500.0,3,1.5,990,4500,1.0,5,7,990,0.0,1948,1490,4000,27095 days 16:47:18.670863,274,2.0,0.0,-500,500,990.0
560000.0,3,3.0,4120,60392,2.0,3,9,3180,940.0,1994,2770,64033,10293 days 16:47:18.670863,127,1.0,3.382978723404255,1350,-3641,2240.0
314000.0,3,1.75,1620,9600,1.0,4,7,1620,0.0,1966,1660,10200,20520 days 16:47:18.670863,077,1.7142857142857142,0.0,-40,-600,1620.0
287000.0,4,2.0,1340,8190,1.0,4,7,1340,0.0,1942,1410,9721,29286 days 16:47:18.670863,113,2.0,0.0,-70,-1531,1340.0
277000.0,4,1.0,1500,5750,1.5,3,6,1500,0.0,1925,1330,5750,35495 days 16:47:18.670863,093,4.0,0.0,170,0,1500.0
337500.0,2,1.0,1300,6731,1.0,3,7,1300,0.0,1950,1240,6731,26364 days 16:47:18.670863,356,2.0,0.0,60,0,1300.0
792000.0,4,2.75,3100,10245,2.0,3,1,3100,0.0,1999,3140,9028,8467 days 16:47:18.670863,231,1.4545454545454546,0.0,-40,1217,3100.0
435000.0,3,2.5,3380,7074,2.0,3,8,2200,1180.0,1999,2060,6548,8467 days 16:47:18.670863,317,1.2,1.8644067796610169,1320,526,1020.0
313100.0,4,2.5,2660,9030,1.0,4,7,1450,1210.0,1977,1870,9030,16502 days 16:47:18.670863,084,1.6,1.1983471074380165,790,0,240.0
575000.0,3,2.25,1700,3333,1.5,3,7,1100,600.0,1924,1700,3750,35861 days 16:47:18.670863,176,1.3333333333333333,1.8333333333333333,0,-417,500.0
510000.0,4,2.5,1840,7800,1.0,3,8,1240,600.0,1972,2010,9100,18329 days 16:47:18.670863,033,1.6,2.066666666666667,-170,-1300,640.0
299950.0,2,1.0,890,5200,1.0,4,6,890,0.0,1941,950,5200,29651 days 16:47:18.670863,078,2.0,0.0,-60,0,890.0
1030000.0,3,3.0,2800,5800,1.0,3,9,1580,1220.0,1953,2580,5800,25268 days 16:47:18.670863,082,1.0,1.2950819672131149,220,0,360.0
364000.0,4,1.75,2010,8625,1.0,4,7,1340,670.0,1957,1500,8400,23807 days 16:47:18.670863,134,2.2857142857142856,2.0,510,225,670.0
335000.0,3,1.0,1380,7470,1.0,5,7,1380,0.0,1965,1440,7473,20885 days 16:47:18.670863,210,3.0,0.0,-60,-3,1380.0
219950.0,3,1.0,1210,8000,1.0,3,6,1210,0.0,1954,1430,8000,24903 days 16:47:18.670863,343,3.0,0.0,-220,0,1210.0
215000.0,3,2.0,1280,6994,1.0,3,7,1280,0.0,1991,1290,7514,11389 days 16:47:18.670863,013,1.5,0.0,-10,-520,1280.0
640000.0,4,2.5,4090,215186,2.0,4,8,3670,420.0,1979,2430,142005,15772 days 16:47:18.670863,131,1.6,8.738095238095237,1660,73181,3250.0
535000.0,3,1.0,1580,6300,1.0,3,7,1180,400.0,1925,1560,1601,35495 days 16:47:18.670863,181,3.0,2.95,20,4699,780.0
253000.0,4,2.0,1910,7826,1.0,4,7,1140,770.0,1973,1540,7826,17963 days 16:47:18.670863,231,2.0,1.4805194805194806,370,0,370.0
650000.0,2,2.5,1740,2500,2.0,3,8,1210,530.0,1994,1640,2500,10293 days 16:47:18.670863,150,0.8,2.2830188679245285,100,0,680.0
672000.0,3,2.25,1130,4445,1.5,4,8,1130,0.0,1930,1330,4445,33669 days 16:47:18.670863,098,1.3333333333333333,0.0,-200,0,1130.0
606000.0,3,1.75,1970,8540,1.0,4,8,1130,840.0,1950,2280,8540,26364 days 16:47:18.670863,280,1.7142857142857142,1.3452380952380953,-310,0,290.0
292000.0,3,2.25,1780,9720,1.0,3,8,1280,500.0,1981,1710,9790,15041 days 16:47:18.670863,064,1.3333333333333333,2.56,70,-70,780.0
289950.0,3,2.0,1670,7757,1.0,3,8,1670,0.0,1992,2290,7859,11024 days 16:47:18.670863,155,1.5,0.0,-620,-102,1670.0
257500.0,4,1.5,1360,9323,1.0,4,7,1360,0.0,1968,1180,9611,19790 days 16:47:18.670863,203,2.6666666666666665,0.0,180,-288,1360.0
380000.0,3,2.5,1840,6985,1.0,3,7,1290,550.0,1971,2160,7990,18694 days 16:47:18.670863,308,1.2,2.3454545454545452,-320,-1005,740.0
360000.0,3,1.75,1255,1113,3.0,3,8,1255,0.0,2010,1010,1038,4449 days 16:47:18.670863,356,1.7142857142857142,0.0,245,75,1255.0
269500.0,3,1.75,1840,7412,1.0,4,7,1240,600.0,1976,1980,7350,16868 days 16:47:18.670863,174,1.7142857142857142,2.066666666666667,-140,62,640.0
449000.0,4,2.5,2960,6031,2.0,3,9,2960,0.0,2005,2570,5012,6275 days 16:47:18.670863,181,1.6,0.0,390,1019,2960.0
375000.0,4,1.5,1430,7232,1.5,3,7,1430,0.0,1948,1540,7232,27095 days 16:47:18.670863,276,2.6666666666666665,0.0,-110,0,1430.0
2200000.0,5,4.75,5990,10450,2.0,3,1,4050,1940.0,2002,3330,14810,7371 days 16:47:18.670863,170,1.0526315789473684,2.0876288659793816,2660,-4360,2110.0
810000.0,4,2.5,3480,59242,2.0,3,1,3480,0.0,1988,2930,39400,12485 days 16:47:18.670863,139,1.6,0.0,550,19842,3480.0
275000.0,5,2.25,1820,10500,1.0,4,7,1080,740.0,1979,1820,7500,15772 days 16:47:18.670863,056,2.2222222222222223,1.4594594594594594,0,3000,340.0
300000.0,2,1.0,1290,2482,2.0,3,7,1290,0.0,2008,1290,2482,5180 days 16:47:18.670863,119,2.0,0.0,0,0,1290.0
380000.0,5,2.5,2130,8428,2.0,3,7,2130,0.0,2013,1500,11810,3353 days 16:47:18.670863,104,2.0,0.0,630,-3382,2130.0
200000.0,3,2.0,1170,10051,1.0,4,7,1170,0.0,1957,1440,9800,23807 days 16:47:18.670863,061,1.5,0.0,-270,251,1170.0
635000.0,3,3.5,1730,1349,3.0,3,9,1350,380.0,2009,1830,3300,4814 days 16:47:18.670863,245,0.8571428571428571,3.5526315789473686,-100,-1951,970.0
280000.0,2,1.0,880,5750,1.0,3,6,880,0.0,1939,1190,5750,30382 days 16:47:18.670863,310,2.0,0.0,-310,0,880.0
574000.0,3,2.5,2380,6832,2.0,3,8,2380,0.0,2002,2580,6832,7371 days 16:47:18.670863,176,1.2,0.0,-200,0,2380.0
1050000.0,4,1.0,1330,9729,1.0,3,6,1330,0.0,1952,2920,10353,25634 days 16:47:18.670863,035,4.0,0.0,-1590,-624,1330.0
545000.0,3,2.25,1780,191228,2.0,3,8,1780,0.0,1988,2440,87120,12485 days 16:47:18.670863,128,1.3333333333333333,0.0,-660,104108,1780.0
271950.0,3,1.5,1220,8400,1.0,4,7,1220,0.0,1962,2110,9119,21981 days 16:47:18.670863,086,2.0,0.0,-890,-719,1220.0
630000.0,5,1.75,2490,24969,1.0,4,8,1540,950.0,1959,2790,15600,23077 days 16:47:18.670863,197,2.857142857142857,1.6210526315789473,-300,9369,590.0
400000.0,2,1.0,1180,10800,1.0,3,7,1180,0.0,1984,1600,10800,13946 days 16:47:18.670863,231,2.0,0.0,-420,0,1180.0
334000.0,4,2.5,2310,6200,2.0,3,8,2310,0.0,1998,2480,6200,8832 days 16:47:18.670863,253,1.6,0.0,-170,0,2310.0
332500.0,4,2.0,1440,4855,2.0,4,7,1440,0.0,1972,1300,4080,18329 days 16:47:18.670863,356,2.0,0.0,140,775,1440.0
525000.0,2,1.5,1620,1444,2.0,3,9,1080,540.0,2007,1660,1642,5545 days 16:47:18.670863,266,1.3333333333333333,2.0,-40,-198,540.0
408000.0,3,2.5,2620,8403,2.0,3,8,2620,0.0,1991,2190,7842,11389 days 16:47:18.670863,055,1.2,0.0,430,561,2620.0
846450.0,4,2.5,3710,7491,2.0,3,9,3710,0.0,2003,3040,7491,7006 days 16:47:18.670863,117,1.6,0.0,670,0,3710.0
411100.0,3,1.5,1040,10323,1.0,4,7,1040,0.0,1958,1580,7200,23442 days 16:47:18.670863,293,2.0,0.0,-540,3123,1040.0
409124.0,5,3.25,3320,11340,2.0,4,8,2480,840.0,1999,2330,8339,8467 days 16:47:18.670863,190,1.5384615384615385,2.9523809523809526,990,3001,1640.0
335950.0,2,1.5,800,5192,1.0,5,7,800,0.0,1951,1190,5320,25999 days 16:47:18.670863,188,1.3333333333333333,0.0,-390,-128,800.0
480000.0,5,2.5,2040,9597,1.0,4,7,1240,800.0,1963,1800,8553,21616 days 16:47:18.670863,090,2.0,1.55,240,1044,440.0
280000.0,2,1.75,1960,30144,1.0,3,7,980,980.0,1957,1960,10140,23807 days 16:47:18.670863,358,1.1428571428571428,1.0,0,20004,0.0
668000.0,4,2.5,2670,4410,2.0,3,8,2670,0.0,1999,2670,4410,8467 days 16:47:18.671860,202,1.6,0.0,0,0,2670.0
750000.0,4,2.5,2930,8641,2.0,3,8,2930,0.0,2010,2120,11175,4449 days 16:47:18.671860,117,1.6,0.0,810,-2534,2930.0
394475.0,2,1.0,830,4000,1.0,3,6,830,0.0,1955,950,4000,24538 days 16:47:18.671860,134,2.0,0.0,-120,0,830.0
848000.0,5,1.75,2290,4320,2.0,3,7,1980,310.0,1928,2870,4320,34400 days 16:47:18.671860,085,2.857142857142857,6.387096774193548,-580,0,1670.0
675000.0,3,1.5,2510,3600,2.5,4,8,2510,0.0,1907,1740,1885,42070 days 16:47:18.671860,267,2.0,0.0,770,1715,2510.0
175000.0,3,1.0,1280,7572,1.0,4,6,1280,0.0,1958,1170,7667,23442 days 16:47:18.671860,310,3.0,0.0,110,-95,1280.0
560000.0,4,1.5,1810,6000,1.0,3,8,1350,460.0,1952,2020,6000,25634 days 16:47:18.671860,310,2.6666666666666665,2.9347826086956523,-210,0,890.0
538888.0,5,2.75,2080,13189,2.0,3,8,2080,0.0,1987,2030,11847,12850 days 16:47:18.671860,151,1.8181818181818181,0.0,50,1342,2080.0
359000.0,4,1.75,1680,9244,2.0,3,8,1680,0.0,1991,1840,9387,11389 days 16:47:18.671860,251,2.2857142857142856,0.0,-160,-143,1680.0
300000.0,3,2.25,1660,5128,2.0,3,7,1660,0.0,2001,1680,4652,7736 days 16:47:18.671860,182,1.3333333333333333,0.0,-20,476,1660.0
273000.0,3,2.5,1650,5994,2.0,4,7,1650,0.0,1989,1930,6666,12119 days 16:47:18.671860,260,1.2,0.0,-280,-672,1650.0
670000.0,3,2.5,1420,1438,2.0,3,9,1280,140.0,2003,1490,1439,7006 days 16:47:18.671860,191,1.2,9.142857142857142,-70,-1,1140.0
530000.0,4,2.25,2240,8376,1.0,3,8,1740,500.0,1984,1890,7875,13946 days 16:47:18.671860,322,1.7777777777777777,3.48,350,501,1240.0
625000.0,3,1.5,1230,3060,1.0,3,7,910,320.0,1927,1260,4488,34765 days 16:47:18.671860,192,2.0,2.84375,-30,-1428,590.0
248000.0,3,1.0,1260,6000,1.0,4,6,1260,0.0,1954,1520,6600,24903 days 16:47:18.671860,125,3.0,0.0,-260,-600,1260.0
533000.0,3,2.5,2060,4812,2.0,3,8,2060,0.0,1990,1930,5264,11754 days 16:47:18.671860,231,1.2,0.0,130,-452,2060.0
549950.0,4,3.5,3090,10510,1.0,3,8,2190,900.0,1991,2200,7408,11389 days 16:47:18.671860,345,1.1428571428571428,2.433333333333333,890,3102,1290.0
485000.0,4,1.75,3220,7392,1.0,4,8,2010,1210.0,1959,1660,8363,23077 days 16:47:18.671860,287,2.2857142857142856,1.6611570247933884,1560,-971,800.0
353500.0,3,2.5,2020,4845,2.0,3,7,2020,0.0,2001,1930,5134,7736 days 16:47:18.671860,126,1.2,0.0,90,-289,2020.0
435000.0,2,1.75,1910,12142,1.0,3,9,1910,0.0,1976,2580,12326,16868 days 16:47:18.671860,258,1.1428571428571428,0.0,-670,-184,1910.0
241000.0,3,1.0,1150,10000,1.0,3,6,1000,150.0,1951,1340,10000,25999 days 16:47:18.671860,308,3.0,6.666666666666667,-190,0,850.0
885000.0,4,2.75,2730,3560,1.5,3,8,1550,1180.0,1921,1860,3560,36956 days 16:47:18.671860,139,1.4545454545454546,1.3135593220338984,870,0,370.0
799200.0,6,3.0,2890,2370,2.5,3,7,2290,600.0,1906,2180,2460,42435 days 16:47:18.671860,133,2.0,3.816666666666667,710,-90,1690.0
760000.0,3,2.5,2280,12746,1.0,4,8,1490,790.0,1973,2100,12746,17963 days 16:47:18.671860,014,1.2,1.8860759493670887,180,0,700.0
270000.0,2,1.0,1040,5700,1.0,3,6,1040,0.0,1922,1380,5700,36591 days 16:47:18.671860,317,2.0,0.0,-340,0,1040.0
675000.0,4,1.75,2440,7475,1.0,4,9,2040,400.0,1969,2040,8480,19424 days 16:47:18.671860,048,2.2857142857142856,5.1,400,-1005,1640.0
499000.0,3,2.5,1720,5940,1.0,4,8,1000,720.0,1977,1720,6136,16502 days 16:47:18.671860,356,1.2,1.3888888888888888,0,-196,280.0
1200000.0,3,2.5,3430,28718,1.5,3,1,3430,0.0,1984,3440,35021,13946 days 16:47:18.671860,195,1.2,0.0,-10,-6303,3430.0
320000.0,4,2.5,2570,4865,2.0,3,8,2570,0.0,2005,2570,4933,6275 days 16:47:18.671860,178,1.6,0.0,0,-68,2570.0
890000.0,4,3.25,4360,210254,1.0,3,1,2320,2040.0,2000,2410,87120,8102 days 16:47:18.671860,125,1.2307692307692308,1.1372549019607843,1950,123134,280.0
275000.0,4,2.75,2060,7350,1.0,3,7,1210,850.0,1978,1940,7420,16137 days 16:47:18.671860,234,1.4545454545454546,1.423529411764706,120,-70,360.0
490000.0,4,2.5,3020,8302,2.0,4,1,3020,0.0,1994,3020,8406,10293 days 16:47:18.671860,161,1.6,0.0,0,-104,3020.0
550000.0,3,2.5,2340,4200,1.5,3,7,1540,800.0,1906,1590,4200,42435 days 16:47:18.671860,206,1.2,1.925,750,0,740.0
390000.0,5,2.0,2400,9537,1.0,5,7,1210,1190.0,1959,1760,9533,23077 days 16:47:18.671860,127,2.5,1.0168067226890756,640,4,20.0
277000.0,3,2.25,1610,11920,1.0,4,7,1110,500.0,1968,1690,11839,19790 days 16:47:18.671860,293,1.3333333333333333,2.22,-80,81,610.0
236000.0,3,1.75,1090,7647,1.0,3,7,1090,0.0,1994,1660,9219,10293 days 16:47:18.671860,076,1.7142857142857142,0.0,-570,-1572,1090.0
265953.0,3,1.75,1470,13068,1.0,4,7,1470,0.0,1975,2090,16988,17233 days 16:47:18.671860,063,1.7142857142857142,0.0,-620,-3920,1470.0
545000.0,3,2.25,1670,6240,1.0,4,8,1240,430.0,1974,1910,7000,17598 days 16:47:18.671860,061,1.3333333333333333,2.883720930232558,-240,-760,810.0
535000.0,3,2.5,1850,10109,2.0,3,8,1850,0.0,1991,1780,9660,11389 days 16:47:18.671860,126,1.2,0.0,70,449,1850.0
1450000.0,3,2.75,3940,9671,1.0,5,9,2140,1800.0,1967,3390,9360,20155 days 16:47:18.671860,280,1.0909090909090908,1.1888888888888889,550,311,340.0
490000.0,4,3.0,2330,3497,2.0,3,9,1920,410.0,2003,2330,5242,7006 days 16:47:18.671860,181,1.3333333333333333,4.682926829268292,0,-1745,1510.0
319950.0,4,2.5,2020,7200,1.5,4,6,2020,0.0,1954,1440,7200,24903 days 16:47:18.671860,098,1.6,0.0,580,0,2020.0
625000.0,3,1.5,1300,7200,1.0,5,7,1300,0.0,1960,2280,7200,22712 days 16:47:18.671860,185,2.0,0.0,-980,0,1300.0
248000.0,3,1.0,1180,6947,1.0,4,7,1180,0.0,1968,1760,8657,19790 days 16:47:18.671860,051,3.0,0.0,-580,-1710,1180.0
475000.0,3,1.75,1320,7840,1.0,3,8,1320,0.0,1966,2050,7644,20520 days 16:47:18.671860,111,1.7142857142857142,0.0,-730,196,1320.0
410000.0,6,2.75,2520,9324,1.0,4,7,1320,1200.0,1962,1820,11000,21981 days 16:47:18.671860,170,2.1818181818181817,1.1,700,-1676,120.0
670000.0,3,2.5,1680,2000,3.0,3,9,1680,0.0,1909,1950,5000,41339 days 16:47:18.671860,125,1.2,0.0,-270,-3000,1680.0
430000.0,3,2.5,2000,35438,2.0,3,7,2000,0.0,1968,2000,51836,19790 days 16:47:18.671860,090,1.2,0.0,0,-16398,2000.0
313000.0,2,1.0,1180,4900,1.0,5,6,1180,0.0,1954,1650,7121,24903 days 16:47:18.671860,301,2.0,0.0,-470,-2221,1180.0
950000.0,3,3.25,3330,15093,2.5,3,9,3330,0.0,1988,4340,20031,12485 days 16:47:18.671860,195,0.9230769230769231,0.0,-1010,-4938,3330.0
751750.0,2,2.0,1880,5400,1.5,3,8,1880,0.0,1902,1590,5400,43896 days 16:47:18.671860,147,1.0,0.0,290,0,1880.0
760000.0,4,2.5,2990,5280,2.0,3,9,2210,780.0,2003,2990,6299,7006 days 16:47:18.671860,252,1.6,2.8333333333333335,0,-1019,1430.0
310650.0,3,1.75,1510,12408,1.0,4,7,1510,0.0,1969,1480,17800,19424 days 16:47:18.671860,028,1.7142857142857142,0.0,30,-5392,1510.0
367500.0,4,3.0,3110,7231,2.0,3,8,3110,0.0,1997,2820,7311,9197 days 16:47:18.671860,122,1.3333333333333333,0.0,290,-80,3110.0
580000.0,4,2.5,2150,5000,2.0,3,8,2150,0.0,2001,2030,6380,7736 days 16:47:18.671860,216,1.6,0.0,120,-1380,2150.0
580000.0,3,2.25,1900,3960,1.5,3,8,1200,700.0,1905,1310,3960,42800 days 16:47:18.671860,183,1.3333333333333333,1.7142857142857142,590,0,500.0
665000.0,4,2.5,2720,10000,2.0,3,1,2720,0.0,1987,2720,10020,12850 days 16:47:18.671860,153,1.6,0.0,0,-20,2720.0
239950.0,3,2.25,1560,8280,2.0,4,7,1560,0.0,1979,1920,8120,15772 days 16:47:18.671860,309,1.3333333333333333,0.0,-360,160,1560.0
470000.0,4,2.5,1990,30083,2.0,3,8,1990,0.0,1998,2220,11627,8832 days 16:47:18.671860,225,1.6,0.0,-230,18456,1990.0
250000.0,4,2.0,2130,8400,1.0,3,7,1350,780.0,1962,1550,8596,21981 days 16:47:18.671860,030,2.0,1.7307692307692308,580,-196,570.0
402000.0,4,1.75,1510,9176,1.0,5,7,1510,0.0,1957,1480,9176,23807 days 16:47:18.671860,251,2.2857142857142856,0.0,30,0,1510.0
295000.0,5,3.5,2100,5107,2.0,3,7,1410,690.0,1999,1410,5650,8467 days 16:47:18.671860,162,1.4285714285714286,2.0434782608695654,690,-543,720.0
355000.0,5,2.5,2344,8000,1.0,4,8,1560,784.0,1976,2344,8000,16868 days 16:47:18.671860,289,2.0,1.989795918367347,0,0,776.0
289000.0,3,1.5,1970,22486,1.0,4,6,1970,0.0,1968,1850,20160,19790 days 16:47:18.671860,252,2.0,0.0,120,2326,1970.0
376000.0,3,2.25,1470,9140,2.0,3,7,1470,0.0,1982,1400,8204,14676 days 16:47:18.671860,316,1.3333333333333333,0.0,70,936,1470.0
212700.0,2,1.0,940,5040,1.0,3,7,940,0.0,1926,940,5040,35130 days 16:47:18.671860,178,2.0,0.0,0,0,940.0
325000.0,3,1.75,1780,13095,1.0,4,9,1780,0.0,1983,2750,13095,14311 days 16:47:18.671860,147,1.7142857142857142,0.0,-970,0,1780.0
415000.0,4,2.5,2230,5743,2.0,3,7,2230,0.0,2002,2490,6300,7371 days 16:47:18.671860,223,1.6,0.0,-260,-557,2230.0
935000.0,3,2.5,3570,15151,1.0,4,8,2400,1170.0,1981,3140,14375,15041 days 16:47:18.671860,092,1.2,2.051282051282051,430,776,1230.0
372000.0,3,2.5,1920,15260,2.0,3,7,1920,0.0,1990,2370,15235,11754 days 16:47:18.671860,016,1.2,0.0,-450,25,1920.0
240000.0,3,1.5,1290,8366,1.0,3,7,1020,270.0,1957,1770,8400,23807 days 16:47:18.671860,294,2.0,3.7777777777777777,-480,-34,750.0
334950.0,3,1.75,1880,16262,1.0,5,7,1880,0.0,1980,1900,7972,15407 days 16:47:18.671860,258,1.7142857142857142,0.0,-20,8290,1880.0
430000.0,2,1.75,1840,14874,1.0,3,8,1300,540.0,1952,2920,15084,25634 days 16:47:18.671860,055,1.1428571428571428,2.4074074074074074,-1080,-210,760.0
400000.0,3,1.5,1890,6183,1.0,3,7,1090,800.0,1967,1750,6183,20155 days 16:47:18.671860,345,2.0,1.3625,140,0,290.0
455850.0,3,2.25,1820,6000,1.0,4,7,1120,700.0,1964,1970,6232,21251 days 16:47:18.671860,118,1.3333333333333333,1.6,-150,-232,420.0
1970000.0,4,3.5,4370,8510,2.0,3,1,3610,760.0,2003,2960,10347,7006 days 16:47:18.671860,153,1.1428571428571428,4.75,1410,-1837,2850.0
400000.0,3,1.75,1530,10731,1.0,3,7,1530,0.0,1986,2100,12593,13215 days 16:47:18.671860,155,1.7142857142857142,0.0,-570,-1862,1530.0
397500.0,3,1.0,1030,10480,1.0,4,7,1030,0.0,1954,1480,12200,24903 days 16:47:18.671860,220,3.0,0.0,-450,-1720,1030.0
755000.0,3,2.5,2000,1950,3.0,3,8,2000,0.0,2005,1560,1340,6275 days 16:47:18.671860,345,1.2,0.0,440,610,2000.0
287000.0,5,1.5,1730,9230,1.0,3,7,1010,720.0,1962,1730,9230,21981 days 16:47:18.671860,190,3.3333333333333335,1.4027777777777777,0,0,290.0
480000.0,4,2.5,3620,16000,2.0,3,9,3620,0.0,1976,2590,16000,16868 days 16:47:18.671860,197,1.6,0.0,1030,0,3620.0
490000.0,3,2.5,2040,9622,2.0,3,8,2040,0.0,1995,2390,9868,9928 days 16:47:18.671860,106,1.2,0.0,-350,-246,2040.0
365000.0,3,2.5,2640,6715,2.0,3,8,1680,960.0,1991,2260,7373,11389 days 16:47:18.671860,169,1.2,1.75,380,-658,720.0
260000.0,3,2.5,1600,2244,2.0,3,7,1600,0.0,2005,1600,1700,6275 days 16:47:18.671860,055,1.2,0.0,0,544,1600.0
505000.0,4,1.0,1480,12675,1.5,4,7,1480,0.0,1929,1820,7995,34034 days 16:47:18.671860,104,4.0,0.0,-340,4680,1480.0
260000.0,2,1.0,700,4800,1.0,3,7,700,0.0,1922,1440,4800,36591 days 16:47:18.671860,178,2.0,0.0,-740,0,700.0
430000.0,2,1.0,700,4800,1.0,3,7,700,0.0,1922,1440,4800,36591 days 16:47:18.671860,006,2.0,0.0,-740,0,700.0
905000.0,4,2.5,3520,12193,2.0,4,1,3520,0.0,1993,3470,11318,10658 days 16:47:18.671860,205,1.6,0.0,50,875,3520.0
440000.0,3,2.0,1650,6408,2.0,4,8,1650,0.0,1977,1750,6402,16502 days 16:47:18.671860,337,1.5,0.0,-100,6,1650.0
439500.0,4,1.0,1360,5500,1.5,3,7,1360,0.0,1950,1530,5790,26364 days 16:47:18.671860,256,4.0,0.0,-170,-290,1360.0
270000.0,3,2.0,1350,6696,1.0,5,6,680,670.0,1944,1350,6700,28556 days 16:47:18.671860,027,1.5,1.0149253731343284,0,-4,10.0
306500.0,3,2.5,1970,6291,2.0,4,7,1970,0.0,1998,1980,8852,8832 days 16:47:18.671860,119,1.2,0.0,-10,-2561,1970.0
380000.0,3,2.0,1470,1656,2.0,3,8,1310,160.0,2003,1470,2288,7006 days 16:47:18.671860,292,1.5,8.1875,0,-632,1150.0
215000.0,4,1.75,1610,9652,1.0,5,7,1610,0.0,1969,1220,9800,19424 days 16:47:18.671860,203,2.2857142857142856,0.0,390,-148,1610.0
299900.0,2,1.0,810,6150,1.0,3,7,810,0.0,1950,1080,7200,26364 days 16:47:18.671860,037,2.0,0.0,-270,-1050,810.0
1450000.0,4,3.5,2820,7809,2.0,3,1,2820,0.0,1995,2630,7904,9928 days 16:47:18.671860,086,1.1428571428571428,0.0,190,-95,2820.0
239950.0,3,1.0,1900,33888,1.5,4,5,1900,0.0,1942,1430,19200,29286 days 16:47:18.671860,133,3.0,0.0,470,14688,1900.0
494000.0,4,2.5,1830,7345,1.0,4,8,1540,290.0,1973,1990,7700,17963 days 16:47:18.671860,174,1.6,5.310344827586207,-160,-355,1250.0
317500.0,4,1.5,1730,7700,1.0,4,7,1010,720.0,1963,1650,8066,21616 days 16:47:18.671860,005,2.6666666666666665,1.4027777777777777,80,-366,290.0
650000.0,3,2.5,3060,7831,2.0,3,9,3060,0.0,2004,3140,7438,6641 days 16:47:18.671860,232,1.2,0.0,-80,393,3060.0
852000.0,4,2.5,2620,7328,2.0,3,8,2620,0.0,1983,1670,5080,14311 days 16:47:18.671860,079,1.6,0.0,950,2248,2620.0
250000.0,2,1.5,1088,1360,2.0,3,7,1088,0.0,1983,1098,1469,14311 days 16:47:18.671860,168,1.3333333333333333,0.0,-10,-109,1088.0
264950.0,3,1.5,1400,10853,1.0,4,7,1400,0.0,1964,1620,10849,21251 days 16:47:18.671860,344,2.0,0.0,-220,4,1400.0
582500.0,2,2.0,1540,6804,1.0,5,7,1020,520.0,1942,1380,6930,29286 days 16:47:18.671860,268,1.0,1.9615384615384615,160,-126,500.0
384000.0,3,2.5,1540,1564,2.0,3,7,1300,240.0,1998,1540,2875,8832 days 16:47:18.671860,070,1.2,5.416666666666667,0,-1311,1060.0
817000.0,3,1.5,2310,3360,1.5,3,8,1790,520.0,1926,1930,4320,35130 days 16:47:18.671860,301,2.0,3.4423076923076925,380,-960,1270.0
320000.0,4,1.75,1730,9520,1.0,4,7,1730,0.0,1971,1550,11211,18694 days 16:47:18.671860,335,2.2857142857142856,0.0,180,-1691,1730.0
445800.0,4,2.25,2070,39446,1.0,3,8,1470,600.0,1977,2140,12043,16502 days 16:47:18.671860,181,1.7777777777777777,2.45,-70,27403,870.0
263300.0,2,1.0,900,4500,1.0,3,7,900,0.0,1951,1175,5320,25999 days 16:47:18.671860,066,2.0,0.0,-275,-820,900.0
215000.0,3,1.0,860,6635,1.0,3,6,860,0.0,1952,1170,8000,25634 days 16:47:18.671860,028,3.0,0.0,-310,-1365,860.0
842500.0,5,4.0,2980,4500,1.5,3,7,2070,910.0,1921,1560,4225,36956 days 16:47:18.671860,319,1.25,2.2747252747252746,1420,275,1160.0
850000.0,5,4.0,2980,4500,1.5,3,7,2070,910.0,1921,1560,4225,36956 days 16:47:18.671860,101,1.25,2.2747252747252746,1420,275,1160.0
386000.0,5,2.5,2740,12413,2.0,3,7,2740,0.0,1990,1900,7416,11754 days 16:47:18.671860,274,2.0,0.0,840,4997,2740.0
251100.0,4,2.5,1790,5257,2.0,3,7,1790,0.0,1996,1680,5320,9563 days 16:47:18.671860,343,1.6,0.0,110,-63,1790.0
435000.0,3,1.75,1750,16748,1.0,3,7,1330,420.0,1978,1750,16050,16137 days 16:47:18.671860,330,1.7142857142857142,3.1666666666666665,0,698,910.0
870000.0,4,4.0,3610,12811,2.0,3,1,3610,0.0,2000,3530,11783,8102 days 16:47:18.671860,265,1.0,0.0,80,1028,3610.0
800000.0,6,1.0,1430,20620,2.0,3,7,1430,0.0,1954,2450,10080,24903 days 16:47:18.671860,037,6.0,0.0,-1020,10540,1430.0
555000.0,3,1.75,1570,15500,1.0,4,7,1570,0.0,1968,1610,7500,19790 days 16:47:18.671860,195,1.7142857142857142,0.0,-40,8000,1570.0
280000.0,2,1.0,2280,37500,2.0,3,7,2280,0.0,1932,2360,6000,32939 days 16:47:18.671860,204,2.0,0.0,-80,31500,2280.0
356000.0,3,1.0,940,2366,1.0,3,6,940,0.0,1916,1500,5000,38783 days 16:47:18.671860,076,3.0,0.0,-560,-2634,940.0
675000.0,4,2.5,2920,6000,2.0,3,9,2920,0.0,2004,3100,6001,6641 days 16:47:18.671860,337,1.6,0.0,-180,-1,2920.0
605000.0,4,2.25,2260,11900,2.0,3,9,2260,0.0,1976,2470,11900,16868 days 16:47:18.671860,360,1.7777777777777777,0.0,-210,0,2260.0
690500.0,5,2.0,2000,4211,1.5,4,7,1280,720.0,1908,1680,4000,41705 days 16:47:18.671860,176,2.5,1.7777777777777777,320,211,560.0
437000.0,2,1.75,1440,4225,1.0,3,8,1440,0.0,2005,1680,6200,6275 days 16:47:18.671860,170,1.1428571428571428,0.0,-240,-1975,1440.0
850000.0,5,2.0,2310,13430,1.5,4,8,2310,0.0,1966,2810,13906,20520 days 16:47:18.671860,191,2.5,0.0,-500,-476,2310.0
350000.0,4,2.25,2300,4600,1.5,4,7,1340,960.0,1904,1540,3000,43166 days 16:47:18.671860,163,1.7777777777777777,1.3958333333333333,760,1600,380.0
480000.0,2,2.25,1490,6770,1.5,3,8,1490,0.0,1926,1820,7875,35130 days 16:47:18.671860,173,0.8888888888888888,0.0,-330,-1105,1490.0
379500.0,3,2.25,1830,25641,2.0,3,8,1830,0.0,1989,1500,25641,12119 days 16:47:18.671860,204,1.3333333333333333,0.0,330,0,1830.0
600000.0,5,4.5,4440,9784,2.0,3,1,4440,0.0,2012,2720,10080,3719 days 16:47:18.671860,267,1.1111111111111112,0.0,1720,-296,4440.0
1440000.0,4,3.5,4970,16582,2.0,4,1,3930,1040.0,1992,3580,13335,11024 days 16:47:18.671860,089,1.1428571428571428,3.7788461538461537,1390,3247,2890.0
303000.0,2,1.5,1000,1075,2.0,3,7,840,160.0,2007,1000,1083,5545 days 16:47:18.671860,352,1.3333333333333333,5.25,0,-8,680.0
800000.0,4,2.5,4940,10037,1.0,3,9,3450,1490.0,1953,2430,9272,25268 days 16:47:18.671860,037,1.6,2.315436241610738,2510,765,1960.0
549000.0,2,2.0,1980,6000,1.5,5,7,1220,760.0,1906,1280,3900,42435 days 16:47:18.671860,205,1.0,1.605263157894737,700,2100,460.0
170000.0,2,1.0,870,6537,1.0,3,6,870,0.0,1948,1100,8701,27095 days 16:47:18.671860,269,2.0,0.0,-230,-2164,870.0
178000.0,3,1.0,840,6500,1.0,5,6,840,0.0,1969,870,5200,19424 days 16:47:18.671860,196,3.0,0.0,-30,1300,840.0
144000.0,3,1.0,1250,8314,1.0,3,6,1250,0.0,1958,1188,7700,23442 days 16:47:18.671860,111,3.0,0.0,62,614,1250.0
1580000.0,4,2.75,3120,20031,1.0,4,9,1980,1140.0,1954,3330,18777,24903 days 16:47:18.671860,076,1.4545454545454546,1.736842105263158,-210,1254,840.0
258000.0,2,1.0,750,7000,1.0,3,6,750,0.0,1932,1100,8777,32939 days 16:47:18.671860,117,2.0,0.0,-350,-1777,750.0
345000.0,3,1.75,710,5050,1.0,4,6,710,0.0,1950,900,5050,26364 days 16:47:18.671860,289,1.7142857142857142,0.0,-190,0,710.0
470000.0,3,1.75,2290,14800,1.0,3,8,1620,670.0,1965,2320,12474,20885 days 16:47:18.671860,161,1.7142857142857142,2.417910447761194,-30,2326,950.0
2900000.0,5,2.5,3750,91681,2.0,3,1,3750,0.0,1925,3540,24293,35495 days 16:47:18.671860,072,2.0,0.0,210,67388,3750.0
350000.0,3,1.5,980,7790,1.0,5,7,980,0.0,1969,1390,7280,19424 days 16:47:18.671860,141,2.0,0.0,-410,510,980.0
225500.0,2,1.75,1590,11276,1.0,4,7,1590,0.0,1972,1750,10687,18329 days 16:47:18.671860,177,1.1428571428571428,0.0,-160,589,1590.0
473000.0,2,1.0,940,4000,1.0,3,6,720,220.0,1942,1180,6000,29286 days 16:47:18.671860,055,2.0,3.272727272727273,-240,-2000,500.0
279000.0,3,1.75,1750,9623,1.0,3,7,1150,600.0,1962,1820,9623,21981 days 16:47:18.671860,057,1.7142857142857142,1.9166666666666667,-70,0,550.0
470000.0,3,1.0,1460,8227,1.0,3,6,880,580.0,1948,1530,8128,27095 days 16:47:18.671860,104,3.0,1.5172413793103448,-70,99,300.0
565000.0,3,1.75,1540,4800,1.0,4,6,770,770.0,1925,1510,4080,35495 days 16:47:18.671860,232,1.7142857142857142,1.0,30,720,0.0
695000.0,3,2.0,2560,6800,1.0,4,8,1380,1180.0,1952,1780,6800,25634 days 16:47:18.671860,112,1.5,1.1694915254237288,780,0,200.0
315000.0,3,1.75,1660,37642,1.0,4,7,1660,0.0,1991,2070,54450,11389 days 16:47:18.671860,192,1.7142857142857142,0.0,-410,-16808,1660.0
529000.0,3,2.5,1880,4499,2.0,3,8,1880,0.0,1993,2130,5114,10658 days 16:47:18.671860,063,1.2,0.0,-250,-615,1880.0
750000.0,5,3.75,3500,101494,1.5,3,8,3500,0.0,1967,3250,38636,20155 days 16:47:18.671860,026,1.3333333333333333,0.0,250,62858,3500.0
481500.0,3,2.25,1840,10500,2.0,3,7,1840,0.0,1993,1840,7374,10658 days 16:47:18.671860,302,1.3333333333333333,0.0,0,3126,1840.0
211000.0,3,2.0,1060,7412,1.0,3,7,1060,0.0,1987,1080,7093,12850 days 16:47:18.671860,086,1.5,0.0,-20,319,1060.0
455000.0,3,2.25,1790,7500,1.0,3,7,1390,400.0,1973,1940,7192,17963 days 16:47:18.671860,100,1.3333333333333333,3.475,-150,308,990.0
722500.0,4,3.5,2600,5100,2.0,3,8,1820,780.0,2003,2000,6720,7006 days 16:47:18.671860,261,1.1428571428571428,2.3333333333333335,600,-1620,1040.0
795000.0,4,2.5,3230,19193,1.0,4,8,2000,1230.0,1973,3230,13420,17963 days 16:47:18.671860,211,1.6,1.6260162601626016,0,5773,770.0
327500.0,4,2.25,2240,9600,2.0,3,8,2240,0.0,1971,2050,9240,18694 days 16:47:18.671860,127,1.7777777777777777,0.0,190,360,2240.0
775000.0,4,2.0,3140,10875,1.0,3,7,1940,1200.0,1939,3300,10080,30382 days 16:47:18.671860,164,2.0,1.6166666666666667,-160,795,740.0
645000.0,4,2.5,2780,4200,2.0,3,8,2780,0.0,2001,2510,4200,7736 days 16:47:18.671860,297,1.6,0.0,270,0,2780.0
445000.0,4,2.75,2320,12368,1.0,3,8,1670,650.0,1968,2070,9575,19790 days 16:47:18.671860,005,1.4545454545454546,2.5692307692307694,250,2793,1020.0
257950.0,3,1.75,1370,5858,1.0,3,7,1370,0.0,1987,1400,7500,12850 days 16:47:18.671860,122,1.7142857142857142,0.0,-30,-1642,1370.0
375000.0,5,1.75,2230,7560,1.0,3,7,1230,1000.0,1959,1380,6570,23077 days 16:47:18.671860,083,2.857142857142857,1.23,850,990,230.0
245000.0,3,2.5,1610,7223,2.0,3,7,1610,0.0,1994,1610,7162,10293 days 16:47:18.671860,190,1.2,0.0,0,61,1610.0
725000.0,3,2.5,3410,41022,2.0,3,1,3410,0.0,1990,2150,21429,11754 days 16:47:18.671860,223,1.2,0.0,1260,19593,3410.0
702000.0,4,2.5,2810,4922,2.0,3,9,2810,0.0,2005,2920,4922,6275 days 16:47:18.671860,063,1.6,0.0,-110,0,2810.0
330000.0,3,1.75,1850,14986,2.0,3,6,1850,0.0,1943,2660,10650,28921 days 16:47:18.671860,230,1.7142857142857142,0.0,-810,4336,1850.0
940000.0,3,1.5,1790,4800,1.5,3,8,1790,0.0,1912,1780,3600,40244 days 16:47:18.671860,106,2.0,0.0,10,1200,1790.0
354500.0,3,1.0,1150,11396,1.5,4,7,1150,0.0,1950,1600,8146,26364 days 16:47:18.671860,064,3.0,0.0,-450,3250,1150.0
279950.0,4,2.75,2420,8700,1.5,4,7,2420,0.0,1914,1070,4804,39513 days 16:47:18.671860,053,1.4545454545454546,0.0,1350,3896,2420.0
284000.0,3,2.25,1580,7034,1.0,4,7,1180,400.0,1989,1470,7358,12119 days 16:47:18.671860,127,1.3333333333333333,2.95,110,-324,780.0
480000.0,5,2.0,1760,21562,1.0,3,8,1560,200.0,1959,2150,12676,23077 days 16:47:18.671860,286,2.5,7.8,-390,8886,1360.0
647500.0,5,2.0,1760,21562,1.0,3,8,1560,200.0,1959,2150,12676,23077 days 16:47:18.671860,098,2.5,7.8,-390,8886,1360.0
625000.0,3,2.5,2750,35000,2.0,3,9,2750,0.0,1993,2780,35862,10658 days 16:47:18.671860,096,1.2,0.0,-30,-862,2750.0
152000.0,3,1.0,920,4875,1.0,4,7,920,0.0,1978,1160,4875,16137 days 16:47:18.671860,191,3.0,0.0,-240,0,920.0
322000.0,3,1.0,960,10181,1.0,3,7,960,0.0,1961,1740,10194,22346 days 16:47:18.671860,027,3.0,0.0,-780,-13,960.0
445000.0,3,1.75,1120,4000,1.0,4,7,870,250.0,1916,1470,4000,38783 days 16:47:18.671860,212,1.7142857142857142,3.48,-350,0,620.0
595000.0,3,1.0,1560,3960,1.5,4,7,1560,0.0,1907,1280,3960,42070 days 16:47:18.671860,211,3.0,0.0,280,0,1560.0
165000.0,3,1.0,1380,7334,1.0,3,7,980,400.0,1981,1910,7859,15041 days 16:47:18.671860,133,3.0,2.45,-530,-525,580.0
278500.0,4,2.5,1940,6206,2.0,3,7,1940,0.0,1990,2060,7092,11754 days 16:47:18.671860,161,1.6,0.0,-120,-886,1940.0
517500.0,3,1.75,1810,10625,1.0,3,8,1370,440.0,1973,2140,10922,17963 days 16:47:18.671860,072,1.7142857142857142,3.1136363636363638,-330,-297,930.0
343566.0,2,1.0,1100,4200,1.0,3,7,1100,0.0,1954,1240,4000,24903 days 16:47:18.671860,169,2.0,0.0,-140,200,1100.0
286285.0,4,2.25,1980,9714,1.0,3,7,1170,810.0,1977,1610,9272,16502 days 16:47:18.671860,309,1.7777777777777777,1.4444444444444444,370,442,360.0
474905.0,4,1.5,1340,6200,1.0,5,6,1340,0.0,1959,1210,7178,23077 days 16:47:18.671860,037,2.6666666666666665,0.0,130,-978,1340.0
550000.0,3,1.75,1680,4800,1.0,4,7,1400,280.0,1960,1540,5000,22712 days 16:47:18.671860,195,1.7142857142857142,5.0,140,-200,1120.0
286000.0,4,2.5,2060,16000,2.0,3,6,2060,0.0,1993,1530,8000,10658 days 16:47:18.671860,029,1.6,0.0,530,8000,2060.0
900000.0,3,3.25,2620,7215,1.0,4,8,1770,850.0,1980,2180,8931,15407 days 16:47:18.671860,220,0.9230769230769231,2.0823529411764707,440,-1716,920.0
449950.0,3,2.25,1610,5159,2.0,3,7,1610,0.0,1985,1610,5210,13580 days 16:47:18.671860,232,1.3333333333333333,0.0,0,-51,1610.0
259000.0,4,1.5,1490,7560,2.0,3,7,1490,0.0,1966,1490,7689,20520 days 16:47:18.671860,163,2.6666666666666665,0.0,0,-129,1490.0
340000.0,3,2.25,1900,8125,1.0,3,7,1540,360.0,1969,1480,8284,19424 days 16:47:18.671860,336,1.3333333333333333,4.277777777777778,420,-159,1180.0
785000.0,4,2.5,3440,56192,2.0,3,9,3440,0.0,1994,3150,44431,10293 days 16:47:18.671860,105,1.6,0.0,290,11761,3440.0
490000.0,2,1.0,1840,3300,1.5,4,6,1130,710.0,1910,1320,4000,40974 days 16:47:18.671860,129,2.0,1.591549295774648,520,-700,420.0
344950.0,4,2.0,2330,6250,1.0,4,7,1400,930.0,1941,2050,9000,29651 days 16:47:18.671860,147,2.0,1.5053763440860215,280,-2750,470.0
950000.0,3,2.0,2250,2975,2.0,4,9,1880,370.0,1905,2690,4800,42800 days 16:47:18.671860,239,1.5,5.081081081081081,-440,-1825,1510.0
810000.0,4,1.75,2000,3988,1.0,4,7,1000,1000.0,1958,1690,4144,23442 days 16:47:18.671860,190,2.2857142857142856,1.0,310,-156,0.0
998160.0,2,2.5,3010,16050,1.0,4,9,1260,1750.0,1976,3010,11612,16868 days 16:47:18.671860,068,0.8,0.72,0,4438,-490.0
377000.0,3,1.75,1680,7389,1.0,3,8,1150,530.0,1979,2100,10348,15772 days 16:47:18.671860,344,1.7142857142857142,2.169811320754717,-420,-2959,620.0
595000.0,3,2.0,1530,6773,1.0,4,8,1530,0.0,1984,2240,7201,13946 days 16:47:18.671860,238,1.5,0.0,-710,-428,1530.0
313300.0,2,1.0,970,4800,1.0,3,6,970,0.0,1911,1180,5900,40609 days 16:47:18.671860,230,2.0,0.0,-210,-1100,970.0
360000.0,5,1.75,1550,5225,1.5,4,7,1550,0.0,1941,1220,5225,29651 days 16:47:18.671860,206,2.857142857142857,0.0,330,0,1550.0
188000.0,3,1.75,1660,7350,1.0,2,8,1660,0.0,1979,1840,7673,15772 days 16:47:18.671860,082,1.7142857142857142,0.0,-180,-323,1660.0
755000.0,3,2.5,3680,203860,1.5,3,9,3680,0.0,1994,2410,144183,10293 days 16:47:18.671860,255,1.2,0.0,1270,59677,3680.0
1290000.0,5,3.5,3210,4060,2.0,3,1,2290,920.0,1917,1940,5000,38417 days 16:47:18.671860,253,1.4285714285714286,2.489130434782609,1270,-940,1370.0
455000.0,3,1.0,1480,13280,2.5,3,6,1480,0.0,1940,1510,8723,30017 days 16:47:18.671860,195,3.0,0.0,-30,4557,1480.0
817500.0,5,3.5,3600,9312,2.0,3,1,2680,920.0,2005,3420,9860,6275 days 16:47:18.671860,282,1.4285714285714286,2.9130434782608696,180,-548,1760.0
550000.0,3,2.25,1700,1481,3.0,3,8,1700,0.0,2002,1560,1350,7371 days 16:47:18.671860,265,1.3333333333333333,0.0,140,131,1700.0
260000.0,3,1.75,1680,8725,1.0,3,8,1240,440.0,1978,2020,8352,16137 days 16:47:18.671860,125,1.7142857142857142,2.8181818181818183,-340,373,800.0
320000.0,3,2.0,1550,34175,1.5,3,7,1550,0.0,1999,2300,35174,8467 days 16:47:18.671860,177,1.5,0.0,-750,-999,1550.0
1150000.0,3,3.25,3780,10623,1.0,3,1,2650,1130.0,1999,3850,11170,8467 days 16:47:18.671860,259,0.9230769230769231,2.3451327433628317,-70,-547,1520.0
362000.0,4,2.5,2360,7370,1.0,3,7,1460,900.0,1985,1590,9906,13580 days 16:47:18.671860,110,1.6,1.6222222222222222,770,-2536,560.0
503500.0,3,2.5,1810,1750,2.0,3,7,1350,460.0,1997,1640,1563,9197 days 16:47:18.671860,113,1.2,2.9347826086956523,170,187,890.0
653000.0,3,2.5,2290,3475,2.0,3,9,2290,0.0,2006,2340,3626,5910 days 16:47:18.671860,153,1.2,0.0,-50,-151,2290.0
760000.0,4,2.75,3370,12447,2.0,3,1,3370,0.0,1991,3700,13129,11389 days 16:47:18.671860,155,1.4545454545454546,0.0,-330,-682,3370.0
775000.0,4,1.75,2090,5050,1.0,4,7,1090,1000.0,1916,1760,5000,38783 days 16:47:18.671860,329,2.2857142857142856,1.09,330,50,90.0
1340000.0,4,3.75,2130,34689,1.5,3,9,2130,0.0,1955,3030,28598,24538 days 16:47:18.671860,294,1.0666666666666667,0.0,-900,6091,2130.0
417500.0,5,1.75,2060,10911,1.0,4,7,1360,700.0,1954,2060,9688,24903 days 16:47:18.671860,055,2.857142857142857,1.9428571428571428,0,1223,660.0
525000.0,3,1.5,1560,9350,1.0,4,7,1220,340.0,1969,1870,8671,19424 days 16:47:18.671860,192,2.0,3.588235294117647,-310,679,880.0
217000.0,2,1.0,730,2400,1.0,3,4,730,0.0,1934,1220,4382,32208 days 16:47:18.671860,104,2.0,0.0,-490,-1982,730.0
525000.0,4,2.75,2910,6308,1.0,3,8,1640,1270.0,1985,1970,7127,13580 days 16:47:18.671860,190,1.4545454545454546,1.2913385826771653,940,-819,370.0
442500.0,4,2.25,2490,8700,1.0,3,7,1890,600.0,1976,1470,7975,16868 days 16:47:18.671860,083,1.7777777777777777,3.15,1020,725,1290.0
525000.0,4,1.75,1710,10440,1.0,4,7,1710,0.0,1955,1480,10440,24538 days 16:47:18.671860,190,2.2857142857142856,0.0,230,0,1710.0
425500.0,4,1.75,1520,10630,1.0,4,7,1520,0.0,1967,1550,8039,20155 days 16:47:18.671860,056,2.2857142857142856,0.0,-30,2591,1520.0
710000.0,3,2.75,2930,218235,2.0,3,8,2930,0.0,1990,2450,218235,11754 days 16:47:18.671860,227,1.0909090909090908,0.0,480,0,2930.0
545000.0,4,3.0,3160,10948,1.0,3,8,1930,1230.0,1991,2380,13623,11389 days 16:47:18.671860,318,1.3333333333333333,1.5691056910569106,780,-2675,700.0
410000.0,5,2.75,2910,16410,1.5,4,8,2910,0.0,1967,1980,18000,20155 days 16:47:18.671860,043,1.8181818181818181,0.0,930,-1590,2910.0
245000.0,3,2.25,1700,8100,1.0,3,7,1200,500.0,1980,1700,8100,15407 days 16:47:18.671860,112,1.3333333333333333,2.4,0,0,700.0
194900.0,2,1.0,810,6697,1.0,4,6,810,0.0,1923,1140,6695,36226 days 16:47:18.671860,192,2.0,0.0,-330,2,810.0
284000.0,4,2.5,2000,5390,2.0,3,7,2000,0.0,2003,2330,5390,7006 days 16:47:18.671860,126,1.6,0.0,-330,0,2000.0
280000.0,2,1.75,1894,52769,1.5,4,6,1520,374.0,1936,1820,50529,31478 days 16:47:18.671860,231,1.1428571428571428,4.064171122994653,74,2240,1146.0
280000.0,3,1.75,2080,87991,1.0,3,6,1040,1040.0,1970,2080,84300,19059 days 16:47:18.671860,275,1.7142857142857142,1.0,0,3691,0.0
360000.0,4,2.0,1730,5500,1.0,5,7,1010,720.0,1943,1080,4900,28921 days 16:47:18.671860,132,2.0,1.4027777777777777,650,600,290.0
405000.0,2,1.0,720,4323,1.0,3,6,720,0.0,1942,1460,3300,29286 days 16:47:18.671860,248,2.0,0.0,-740,1023,720.0
865000.0,4,2.5,3560,13981,2.0,3,1,3560,0.0,2000,3840,13624,8102 days 16:47:18.671860,104,1.6,0.0,-280,357,3560.0
483300.0,4,2.0,1210,11100,1.0,4,7,1210,0.0,1955,1280,11100,24538 days 16:47:18.671860,161,2.0,0.0,-70,0,1210.0
355000.0,4,2.5,2130,9268,2.0,4,8,2130,0.0,1985,2100,8400,13580 days 16:47:18.671860,077,1.6,0.0,30,868,2130.0
274950.0,3,2.25,1570,8767,1.0,3,7,1180,390.0,1990,1570,7434,11754 days 16:47:18.671860,120,1.3333333333333333,3.0256410256410255,0,1333,790.0
1930000.0,3,4.5,3950,6134,2.0,3,1,2880,1070.0,1998,3050,5281,8832 days 16:47:18.671860,339,0.6666666666666666,2.691588785046729,900,853,1810.0
755000.0,3,3.25,3450,15586,2.0,3,1,2690,760.0,1989,3560,15046,12119 days 16:47:18.671860,365,0.9230769230769231,3.539473684210526,-110,540,1930.0
1940000.0,4,5.75,7220,223462,2.0,3,1,6220,1000.0,2000,2680,7593,8102 days 16:47:18.671860,040,0.6956521739130435,6.22,4540,215869,5220.0
309212.0,3,1.75,1150,9600,1.0,3,7,1150,0.0,1979,1520,9976,15772 days 16:47:18.671860,167,1.7142857142857142,0.0,-370,-376,1150.0
219950.0,3,2.25,1500,7615,1.0,3,7,1150,350.0,1984,1540,8649,13946 days 16:47:18.671860,155,1.3333333333333333,3.2857142857142856,-40,-1034,800.0
690000.0,3,2.5,1300,5150,1.5,4,7,1300,0.0,1920,1400,4017,37322 days 16:47:18.671860,204,1.2,0.0,-100,1133,1300.0
250800.0,3,1.75,1290,4000,1.0,3,6,1170,120.0,1943,1140,4000,28921 days 16:47:18.671860,278,1.7142857142857142,9.75,150,0,1050.0
557500.0,3,2.0,2510,35255,1.0,3,9,2510,0.0,1994,3140,36450,10293 days 16:47:18.671860,084,1.5,0.0,-630,-1195,2510.0
941000.0,4,1.75,2320,3825,1.5,5,8,1820,500.0,1926,1940,3825,35130 days 16:47:18.671860,175,2.2857142857142856,3.64,380,0,1320.0
3650000.0,6,4.75,5480,19401,1.5,5,1,3910,1570.0,1936,3510,15810,31478 days 16:47:18.671860,111,1.263157894736842,2.4904458598726116,1970,3591,2340.0
305000.0,4,2.75,2030,8600,1.0,4,7,1230,800.0,1977,1810,8600,16502 days 16:47:18.671860,112,1.4545454545454546,1.5375,220,0,430.0
815000.0,4,1.5,2060,16110,1.0,4,8,2060,0.0,1949,2060,16110,26729 days 16:47:18.671860,210,2.6666666666666665,0.0,0,0,2060.0
1020000.0,3,2.5,2920,34527,1.0,4,9,1800,1120.0,1954,2480,7933,24903 days 16:47:18.671860,132,1.2,1.6071428571428572,440,26594,680.0
1240000.0,4,3.0,3330,6990,1.5,5,9,2330,1000.0,1928,2620,5310,34400 days 16:47:18.671860,251,1.3333333333333333,2.33,710,1680,1330.0
535000.0,3,2.5,2110,8164,2.0,3,9,2110,0.0,1990,2390,7499,11754 days 16:47:18.671860,360,1.2,0.0,-280,665,2110.0
775000.0,3,1.0,1175,10454,1.0,4,6,1175,0.0,1949,2010,10800,26729 days 16:47:18.671860,202,3.0,0.0,-835,-346,1175.0
255000.0,3,2.0,1590,8670,1.0,3,7,1590,0.0,1994,1590,9253,10293 days 16:47:18.671860,199,1.5,0.0,0,-583,1590.0
327000.0,2,1.0,1070,9750,1.0,3,7,1070,0.0,1947,1500,8775,27460 days 16:47:18.671860,223,2.0,0.0,-430,975,1070.0
560000.0,4,2.0,2720,8819,2.0,3,8,2240,480.0,1976,2960,9672,16868 days 16:47:18.671860,324,2.0,4.666666666666667,-240,-853,1760.0
1340000.0,4,3.5,2980,6349,2.0,3,9,2980,0.0,1998,2870,6349,8832 days 16:47:18.671860,030,1.1428571428571428,0.0,110,0,2980.0
199500.0,3,1.75,1160,5200,1.0,4,7,1160,0.0,1977,1470,5200,16502 days 16:47:18.671860,338,1.7142857142857142,0.0,-310,0,1160.0
760000.0,4,2.5,3580,97574,2.0,3,9,3580,0.0,2004,2510,27068,6641 days 16:47:18.671860,357,1.6,0.0,1070,70506,3580.0
439000.0,3,2.25,3020,6000,3.0,3,8,1980,1040.0,1994,1150,6000,10293 days 16:47:18.671860,089,1.3333333333333333,1.9038461538461537,1870,0,940.0
527000.0,4,2.25,2380,5250,1.0,4,7,1410,970.0,1961,2150,8560,22346 days 16:47:18.671860,273,1.7777777777777777,1.4536082474226804,230,-3310,440.0
199950.0,3,2.75,2270,13590,1.5,4,6,1300,970.0,1948,1160,13545,27095 days 16:47:18.671860,197,1.0909090909090908,1.3402061855670102,1110,45,330.0
254000.0,3,2.25,1660,8188,2.0,4,7,1660,0.0,1988,1660,7000,12485 days 16:47:18.671860,035,1.3333333333333333,0.0,0,1188,1660.0
393000.0,2,1.0,830,5000,1.0,4,7,830,0.0,1921,1110,5000,36956 days 16:47:18.671860,082,2.0,0.0,-280,0,830.0
585000.0,5,2.25,2480,12614,1.0,4,8,1860,620.0,1979,2470,12392,15772 days 16:47:18.671860,325,2.2222222222222223,3.0,10,222,1240.0
450000.0,2,2.0,1900,7740,1.0,4,7,1150,750.0,1923,1140,7740,36226 days 16:47:18.671860,197,1.0,1.5333333333333334,760,0,400.0
565000.0,2,1.75,1670,4008,1.0,3,9,1670,0.0,2005,2330,3752,6275 days 16:47:18.671860,176,1.1428571428571428,0.0,-660,256,1670.0
330000.0,5,2.25,2000,7900,1.0,4,7,1300,700.0,1986,2000,9132,13215 days 16:47:18.671860,142,2.2222222222222223,1.8571428571428572,0,-1232,600.0
870000.0,3,2.0,2320,65340,1.5,3,9,2320,0.0,1992,3100,59603,11024 days 16:47:18.671860,131,1.5,0.0,-780,5737,2320.0
585000.0,4,2.5,1860,8117,1.0,4,8,1460,400.0,1966,2040,8199,20520 days 16:47:18.671860,204,1.6,3.65,-180,-82,1060.0
500000.0,3,2.5,2110,208737,2.0,3,9,2110,0.0,1977,2390,125017,16502 days 16:47:18.671860,310,1.2,0.0,-280,83720,2110.0
225000.0,3,2.0,1400,7384,1.0,3,7,1150,250.0,1979,1820,7992,15772 days 16:47:18.671860,135,1.5,4.6,-420,-608,900.0
295000.0,3,2.0,1400,7384,1.0,3,7,1150,250.0,1979,1820,7992,15772 days 16:47:18.671860,084,1.5,4.6,-420,-608,900.0
775000.0,3,2.75,2850,14800,1.0,4,9,1920,930.0,1976,3300,10809,16868 days 16:47:18.671860,177,1.0909090909090908,2.064516129032258,-450,3991,990.0
280000.0,3,1.0,1370,11050,1.0,3,7,1370,0.0,1981,1520,10000,15041 days 16:47:18.671860,198,3.0,0.0,-150,1050,1370.0
539000.0,3,2.5,2170,3200,1.5,5,7,1280,890.0,1923,1180,1224,36226 days 16:47:18.671860,251,1.2,1.4382022471910112,990,1976,390.0
567500.0,3,1.75,2570,14033,1.0,4,8,2570,0.0,1953,2550,16100,25268 days 16:47:18.671860,083,1.7142857142857142,0.0,20,-2067,2570.0
442500.0,4,2.25,1970,7902,1.0,3,8,1310,660.0,1960,1860,8021,22712 days 16:47:18.671860,036,1.7777777777777777,1.9848484848484849,110,-119,650.0
598200.0,5,3.75,2980,4635,3.0,3,8,2980,0.0,1997,1100,5150,9197 days 16:47:18.671860,127,1.3333333333333333,0.0,1880,-515,2980.0
610000.0,4,2.5,2300,10843,2.0,5,8,2300,0.0,1955,1780,10843,24538 days 16:47:18.671860,287,1.6,0.0,520,0,2300.0
544900.0,3,2.5,1990,4936,2.0,3,8,1990,0.0,2004,2250,4815,6641 days 16:47:18.671860,325,1.2,0.0,-260,121,1990.0
557500.0,4,2.5,2390,38258,2.0,3,8,2390,0.0,2001,1960,17113,7736 days 16:47:18.671860,350,1.6,0.0,430,21145,2390.0
532500.0,3,2.5,2160,7500,1.0,3,7,1430,730.0,1979,1560,7500,15772 days 16:47:18.671860,223,1.2,1.9589041095890412,600,0,700.0
1350000.0,4,3.25,3300,15907,2.0,5,1,3300,0.0,1985,2740,11358,13580 days 16:47:18.671860,160,1.2307692307692308,0.0,560,4549,3300.0
750000.0,3,2.0,1840,2825,1.0,3,7,1040,800.0,1920,1820,3750,37322 days 16:47:18.671860,120,1.5,1.3,20,-925,240.0
530000.0,3,2.5,2030,10958,2.0,3,8,2030,0.0,1983,1960,10282,14311 days 16:47:18.671860,323,1.2,0.0,70,676,2030.0
346100.0,3,2.5,1400,2036,2.0,3,7,1400,0.0,2003,1500,2036,7006 days 16:47:18.671860,198,1.2,0.0,-100,0,1400.0
260000.0,4,2.25,2320,16800,2.0,4,9,2320,0.0,1977,2700,15680,16502 days 16:47:18.671860,222,1.7777777777777777,0.0,-380,1120,2320.0
365000.0,3,1.75,1410,9150,1.0,5,7,1410,0.0,1959,1800,9940,23077 days 16:47:18.671860,241,1.7142857142857142,0.0,-390,-790,1410.0
615000.0,3,2.0,1860,42800,1.0,4,7,930,930.0,1983,1980,11250,14311 days 16:47:18.671860,251,1.5,1.0,-120,31550,0.0
318400.0,4,2.5,1820,6916,2.0,3,7,1820,0.0,1994,1680,6995,10293 days 16:47:18.671860,205,1.6,0.0,140,-79,1820.0
498500.0,4,2.5,1910,7172,2.0,3,8,1910,0.0,1993,1630,10127,10658 days 16:47:18.671860,062,1.6,0.0,280,-2955,1910.0
450000.0,3,1.75,1540,7490,1.0,5,7,1540,0.0,1971,1270,7350,18694 days 16:47:18.671860,098,1.7142857142857142,0.0,270,140,1540.0
200000.0,3,2.0,1430,7905,1.0,4,7,1430,0.0,1988,1870,8400,12485 days 16:47:18.671860,086,1.5,0.0,-440,-495,1430.0
234000.0,3,1.0,1010,8906,1.0,5,7,1010,0.0,1968,1150,10414,19790 days 16:47:18.671860,252,3.0,0.0,-140,-1508,1010.0
121800.0,2,1.0,940,8384,1.0,3,5,940,0.0,1947,1290,8384,27460 days 16:47:18.671860,216,2.0,0.0,-350,0,940.0
805000.0,3,2.75,2600,5875,1.5,5,8,1600,1000.0,1929,2260,5492,34034 days 16:47:18.671860,177,1.0909090909090908,1.6,340,383,600.0
410000.0,4,2.25,2060,7283,1.0,3,8,1220,840.0,1963,1500,8134,21616 days 16:47:18.671860,189,1.7777777777777777,1.4523809523809523,560,-851,380.0
475000.0,3,2.5,1920,4534,2.0,3,8,1920,0.0,1986,1380,5100,13215 days 16:47:18.671860,049,1.2,0.0,540,-566,1920.0
1340000.0,4,2.5,2900,21074,2.0,3,1,2900,0.0,1986,3390,20000,13215 days 16:47:18.671860,303,1.6,0.0,-490,1074,2900.0
269000.0,1,1.0,1020,7920,1.0,3,7,1020,0.0,1947,1000,7168,27460 days 16:47:18.671860,261,1.0,0.0,20,752,1020.0
573000.0,4,2.25,2150,9520,2.0,4,8,2150,0.0,1979,2000,9520,15772 days 16:47:18.671860,205,1.7777777777777777,0.0,150,0,2150.0
330000.0,3,2.5,1660,2890,2.0,3,7,1660,0.0,2001,1540,2890,7736 days 16:47:18.671860,086,1.2,0.0,120,0,1660.0
252750.0,4,1.0,1230,7410,1.5,3,7,1230,0.0,1944,1020,7648,28556 days 16:47:18.671860,177,4.0,0.0,210,-238,1230.0
745000.0,2,2.5,2170,7546,1.0,3,8,2170,0.0,2007,2170,7083,5545 days 16:47:18.671860,096,0.8,0.0,0,463,2170.0
280000.0,3,2.0,1280,7633,1.0,3,7,1280,0.0,1991,1450,6783,11389 days 16:47:18.671860,063,1.5,0.0,-170,850,1280.0
535000.0,4,2.5,2240,6920,1.0,5,8,1380,860.0,1974,1540,7000,17598 days 16:47:18.671860,120,1.6,1.6046511627906976,700,-80,520.0
301000.0,3,1.75,1840,7200,1.0,4,7,1220,620.0,1968,1770,8075,19790 days 16:47:18.671860,346,1.7142857142857142,1.967741935483871,70,-875,600.0
600000.0,4,1.75,1740,7700,1.0,5,7,1740,0.0,1968,1740,8120,19790 days 16:47:18.671860,175,2.2857142857142856,0.0,0,-420,1740.0
538900.0,5,3.0,3040,6604,2.0,3,9,3040,0.0,2005,1650,6825,6275 days 16:47:18.671860,223,1.6666666666666667,0.0,1390,-221,3040.0
366000.0,3,2.5,2370,4375,2.0,3,8,2370,0.0,2006,2380,4606,5910 days 16:47:18.671860,040,1.2,0.0,-10,-231,2370.0
303000.0,4,2.5,2100,6783,2.0,3,8,2100,0.0,2003,2100,6192,7006 days 16:47:18.671860,231,1.6,0.0,0,591,2100.0
432000.0,3,2.25,1470,1578,2.0,3,8,1090,380.0,2007,1470,1668,5545 days 16:47:18.671860,142,1.3333333333333333,2.8684210526315788,0,-90,710.0
300000.0,2,1.5,1300,6120,1.0,3,6,820,480.0,1945,1250,6120,28190 days 16:47:18.671860,099,1.3333333333333333,1.7083333333333333,50,0,340.0
908800.0,3,3.0,3420,7826,2.0,4,8,2430,990.0,1939,980,6300,30382 days 16:47:18.671860,293,1.0,2.4545454545454546,2440,1526,1440.0
500000.0,3,1.5,1190,4750,1.0,3,7,970,220.0,1940,1460,4750,30017 days 16:47:18.671860,176,2.0,4.409090909090909,-270,0,750.0
254000.0,5,2.0,2080,16117,1.0,5,7,1740,340.0,1959,1510,13068,23077 days 16:47:18.671860,177,2.5,5.117647058823529,570,3049,1400.0
470000.0,5,1.5,2180,4268,1.5,4,7,1340,840.0,1924,1530,3880,35861 days 16:47:18.671860,260,3.3333333333333335,1.5952380952380953,650,388,500.0
480000.0,3,2.0,1460,7860,1.0,5,7,1460,0.0,1967,1850,8148,20155 days 16:47:18.671860,076,1.5,0.0,-390,-288,1460.0
536000.0,3,1.75,1530,8503,1.0,4,7,1150,380.0,1983,1610,8549,14311 days 16:47:18.671860,030,1.7142857142857142,3.026315789473684,-80,-46,770.0
1350000.0,4,3.5,4740,8611,2.0,3,1,3640,1100.0,2006,4042,8321,5910 days 16:47:18.671860,120,1.1428571428571428,3.309090909090909,698,290,2540.0
550000.0,3,2.25,1980,40887,1.0,4,8,1980,0.0,1980,2460,35700,15407 days 16:47:18.671860,135,1.3333333333333333,0.0,-480,5187,1980.0
260000.0,3,1.75,1710,6400,1.0,4,7,1240,470.0,1976,1600,6400,16868 days 16:47:18.671860,336,1.7142857142857142,2.6382978723404253,110,0,770.0
740000.0,3,2.5,2200,3000,2.0,3,9,1530,670.0,2002,2200,3300,7371 days 16:47:18.671860,302,1.2,2.283582089552239,0,-300,860.0
425000.0,2,1.0,1170,5000,1.0,4,7,1030,140.0,1920,1170,5850,37322 days 16:47:18.671860,275,2.0,7.357142857142857,0,-850,890.0
230000.0,3,1.0,1120,7500,1.0,3,7,1120,0.0,1965,1120,5000,20885 days 16:47:18.671860,245,3.0,0.0,0,2500,1120.0
675000.0,3,1.5,1710,4000,2.0,3,8,1710,0.0,1926,1910,4000,35130 days 16:47:18.671860,103,2.0,0.0,-200,0,1710.0
267500.0,3,1.75,1650,7807,1.0,3,7,1650,0.0,1986,1810,8475,13215 days 16:47:18.671860,210,1.7142857142857142,0.0,-160,-668,1650.0
814000.0,4,2.5,2840,8820,1.0,5,8,1420,1420.0,1952,2310,8750,25634 days 16:47:18.671860,237,1.6,1.0,530,70,0.0
1250000.0,4,3.0,3310,217800,1.5,3,9,3310,0.0,1989,2810,217800,12119 days 16:47:18.671860,117,1.3333333333333333,0.0,500,0,3310.0
460000.0,3,2.0,1860,7232,1.0,3,7,1320,540.0,1985,1830,7220,13580 days 16:47:18.671860,259,1.5,2.4444444444444446,30,12,780.0
445000.0,3,2.5,2250,9608,2.0,3,8,2250,0.0,1994,2020,9834,10293 days 16:47:18.671860,020,1.2,0.0,230,-226,2250.0
715000.0,3,2.5,2890,7027,2.0,3,8,2890,0.0,2004,2890,7197,6641 days 16:47:18.671860,267,1.2,0.0,0,-170,2890.0
425000.0,3,1.75,2120,5992,1.0,3,7,1060,1060.0,1947,1840,11000,27460 days 16:47:18.671860,050,1.7142857142857142,1.0,280,-5008,0.0
370000.0,4,2.5,2130,4750,2.0,3,8,2130,0.0,2009,2130,4071,4814 days 16:47:18.671860,196,1.6,0.0,0,679,2130.0
302000.0,2,1.75,1170,8200,1.0,4,6,780,390.0,1937,1780,9020,31112 days 16:47:18.671860,119,1.1428571428571428,2.0,-610,-820,390.0
453000.0,4,1.75,2120,7420,1.0,4,7,1060,1060.0,1956,1540,7420,24173 days 16:47:18.671860,174,2.2857142857142856,1.0,580,0,0.0
290000.0,3,1.75,1280,10716,1.0,4,7,1280,0.0,1969,1440,9870,19424 days 16:47:18.671860,140,1.7142857142857142,0.0,-160,846,1280.0
1040000.0,4,2.5,3170,47502,2.0,3,1,3170,0.0,1988,3190,35110,12485 days 16:47:18.671860,363,1.6,0.0,-20,12392,3170.0
925000.0,4,2.25,2260,41984,1.0,4,9,2260,0.0,1967,2650,37318,20155 days 16:47:18.671860,140,1.7777777777777777,0.0,-390,4666,2260.0
600000.0,3,1.75,2930,19876,1.0,3,9,2030,900.0,1993,2740,11499,10658 days 16:47:18.671860,149,1.7142857142857142,2.2555555555555555,190,8377,1130.0
354000.0,3,1.5,1060,5750,1.0,4,7,1060,0.0,1981,1060,5750,15041 days 16:47:18.671860,217,2.0,0.0,0,0,1060.0
204950.0,4,1.75,1740,9344,1.0,3,7,1180,560.0,1978,1440,12884,16137 days 16:47:18.671860,168,2.2857142857142856,2.107142857142857,300,-3540,620.0
675000.0,4,2.5,2990,5400,2.0,3,8,2990,0.0,2005,2890,6538,6275 days 16:47:18.671860,112,1.6,0.0,100,-1138,2990.0
995000.0,4,3.25,3530,20012,2.0,3,1,3530,0.0,1986,3850,20707,13215 days 16:47:18.671860,112,1.2307692307692308,0.0,-320,-695,3530.0
800000.0,5,2.0,2960,10960,1.0,4,7,1500,1460.0,1957,2160,10960,23807 days 16:47:18.671860,090,2.5,1.0273972602739727,800,0,40.0
472500.0,3,2.5,1650,3711,2.0,3,8,1650,0.0,1996,1760,3762,9563 days 16:47:18.671860,252,1.2,0.0,-110,-51,1650.0
549950.0,4,2.5,2720,13500,1.0,3,8,1510,1210.0,1969,2510,12350,19424 days 16:47:18.671860,336,1.6,1.2479338842975207,210,1150,300.0
575575.0,3,1.75,1516,2897,1.0,3,7,998,518.0,1925,2100,3854,35495 days 16:47:18.671860,286,1.7142857142857142,1.9266409266409266,-584,-957,480.0
545000.0,4,3.25,4386,12275,1.0,3,1,2356,2030.0,2006,3060,10925,5910 days 16:47:18.671860,062,1.2307692307692308,1.1605911330049261,1326,1350,326.0
340000.0,3,2.25,2580,7434,1.0,3,7,1630,950.0,1963,1920,7737,21616 days 16:47:18.671860,323,1.3333333333333333,1.7157894736842105,660,-303,680.0
225000.0,3,1.0,960,5512,1.0,4,6,960,0.0,1963,1090,5837,21616 days 16:47:18.671860,090,3.0,0.0,-130,-325,960.0
299950.0,2,1.75,1460,10506,1.0,3,7,1460,0.0,1983,1460,8153,14311 days 16:47:18.671860,301,1.1428571428571428,0.0,0,2353,1460.0
829900.0,4,3.5,3840,4000,2.0,3,8,2640,1200.0,2001,1620,4000,7736 days 16:47:18.671860,054,1.1428571428571428,2.2,2220,0,1440.0
340000.0,4,2.5,2090,4200,2.0,3,7,2090,0.0,2007,2090,4200,5545 days 16:47:18.671860,089,1.6,0.0,0,0,2090.0
515000.0,4,2.25,2470,7800,1.0,3,8,1470,1000.0,1975,2050,8050,17233 days 16:47:18.671860,281,1.7777777777777777,1.47,420,-250,470.0
601000.0,4,2.5,2090,6906,2.0,4,8,2090,0.0,1992,2090,6370,11024 days 16:47:18.671860,192,1.6,0.0,0,536,2090.0
470000.0,3,2.5,2070,8581,2.0,3,8,2070,0.0,1994,2440,7849,10293 days 16:47:18.671860,124,1.2,0.0,-370,732,2070.0
371500.0,3,1.0,1650,6400,1.0,4,7,980,670.0,1954,1230,6400,24903 days 16:47:18.671860,189,3.0,1.462686567164179,420,0,310.0
550000.0,3,1.75,1880,45738,1.0,4,8,1410,470.0,1980,2340,38556,15407 days 16:47:18.671860,323,1.7142857142857142,3.0,-460,7182,940.0
242550.0,4,2.5,2060,7720,2.0,3,8,2060,0.0,1995,1630,7720,9928 days 16:47:18.671860,348,1.6,0.0,430,0,2060.0
367500.0,3,1.5,1410,9647,1.0,3,8,1410,0.0,1961,2090,9272,22346 days 16:47:18.671860,126,2.0,0.0,-680,375,1410.0
359000.0,4,3.5,2770,8763,2.0,3,8,2100,670.0,1996,2030,7242,9563 days 16:47:18.671860,267,1.1428571428571428,3.1343283582089554,740,1521,1430.0
204900.0,3,2.0,1390,8245,1.0,2,7,1390,0.0,1984,1260,8245,13946 days 16:47:18.671860,070,1.5,0.0,130,0,1390.0
850000.0,4,2.75,5440,239580,1.0,2,9,2720,2720.0,1969,1970,40392,19424 days 16:47:18.671860,273,1.4545454545454546,1.0,3470,199188,0.0
187000.0,3,1.5,1280,4452,2.0,3,6,1280,0.0,1985,1070,4366,13580 days 16:47:18.671860,294,2.0,0.0,210,86,1280.0
326000.0,3,2.75,1720,28000,1.0,4,7,1720,0.0,1958,2000,41817,23442 days 16:47:18.671860,148,1.0909090909090908,0.0,-280,-13817,1720.0
340000.0,3,2.75,1720,28000,1.0,4,7,1720,0.0,1958,2000,41817,23442 days 16:47:18.671860,056,1.0909090909090908,0.0,-280,-13817,1720.0
330000.0,6,2.25,3040,28535,1.0,3,8,1890,1150.0,1951,1360,8250,25999 days 16:47:18.671860,176,2.6666666666666665,1.6434782608695653,1680,20285,740.0
782000.0,4,3.5,3780,7769,2.0,3,9,3110,670.0,2001,3310,7945,7736 days 16:47:18.671860,002,1.1428571428571428,4.641791044776119,470,-176,2440.0
612000.0,4,2.5,2670,5974,2.0,3,8,2670,0.0,1999,2140,5729,8467 days 16:47:18.671860,307,1.6,0.0,530,245,2670.0
400000.0,3,2.0,1350,7216,1.0,3,7,1350,0.0,1964,1920,7600,21251 days 16:47:18.671860,304,1.5,0.0,-570,-384,1350.0
941500.0,5,3.5,3490,9680,2.0,3,9,2460,1030.0,1980,3080,13489,15407 days 16:47:18.671860,154,1.4285714285714286,2.3883495145631066,410,-3809,1430.0
735000.0,4,2.25,2410,4250,1.5,5,7,1460,950.0,1929,1360,5074,34034 days 16:47:18.671860,099,1.7777777777777777,1.5368421052631578,1050,-824,510.0
471000.0,3,1.75,1640,10123,1.0,3,8,1340,300.0,1977,2210,10852,16502 days 16:47:18.671860,078,1.7142857142857142,4.466666666666667,-570,-729,1040.0
350000.0,3,1.0,1540,9800,1.0,4,7,1540,0.0,1950,1560,9450,26364 days 16:47:18.671860,055,3.0,0.0,-20,350,1540.0
530000.0,4,2.5,2370,9601,1.0,3,8,1570,800.0,1976,2550,10500,16868 days 16:47:18.671860,204,1.6,1.9625,-180,-899,770.0
415000.0,4,3.0,1830,9548,2.0,3,7,1830,0.0,1991,1740,9750,11389 days 16:47:18.671860,127,1.3333333333333333,0.0,90,-202,1830.0
639500.0,4,2.25,2330,8994,2.0,3,8,2330,0.0,1986,2330,8396,13215 days 16:47:18.671860,172,1.7777777777777777,0.0,0,598,2330.0
580379.0,4,2.75,2240,27820,1.5,4,8,2240,0.0,1976,2330,20000,16868 days 16:47:18.671860,162,1.4545454545454546,0.0,-90,7820,2240.0
378000.0,2,2.5,1700,2513,2.0,3,8,1700,0.0,2009,1760,2891,4814 days 16:47:18.671860,323,0.8,0.0,-60,-378,1700.0
265000.0,3,2.25,1750,9298,1.0,4,7,1410,340.0,1969,1720,7875,19424 days 16:47:18.671860,015,1.3333333333333333,4.147058823529412,30,1423,1070.0
212000.0,3,1.75,1100,9750,1.0,4,6,1100,0.0,1967,1100,9900,20155 days 16:47:18.671860,267,1.7142857142857142,0.0,0,-150,1100.0
400000.0,4,3.0,2320,13068,2.0,3,8,2320,0.0,1998,2220,25265,8832 days 16:47:18.671860,023,1.3333333333333333,0.0,100,-12197,2320.0
750000.0,4,2.5,2540,6491,2.0,3,8,2540,0.0,1997,1990,8447,9197 days 16:47:18.671860,037,1.6,0.0,550,-1956,2540.0
384900.0,5,2.5,3090,12750,1.0,3,8,1750,1340.0,1968,1760,25919,19790 days 16:47:18.671860,125,2.0,1.3059701492537314,1330,-13169,410.0
176000.0,2,1.0,770,5200,1.0,5,6,770,0.0,1969,1150,5330,19424 days 16:47:18.671860,218,2.0,0.0,-380,-130,770.0
350000.0,3,2.75,2370,4632,2.0,3,7,2370,0.0,2002,2290,5012,7371 days 16:47:18.671860,252,1.0909090909090908,0.0,80,-380,2370.0
168000.0,3,1.0,1200,7210,1.0,4,6,1200,0.0,1977,1200,7650,16502 days 16:47:18.671860,210,3.0,0.0,0,-440,1200.0
358000.0,4,2.0,2200,3060,1.0,3,7,1100,1100.0,1908,1410,5100,41705 days 16:47:18.671860,318,2.0,1.0,790,-2040,0.0
580000.0,3,2.75,2660,32757,1.0,4,8,2660,0.0,1975,2720,35191,17233 days 16:47:18.671860,118,1.0909090909090908,0.0,-60,-2434,2660.0
442500.0,3,1.75,1600,10280,1.0,3,7,1050,550.0,1977,1590,8100,16502 days 16:47:18.671860,174,1.7142857142857142,1.9090909090909092,10,2180,500.0
515000.0,2,2.5,1330,1249,3.0,3,8,1330,0.0,2004,1430,1328,6641 days 16:47:18.671860,076,0.8,0.0,-100,-79,1330.0
554000.0,5,2.5,3440,12900,1.0,4,8,1720,1720.0,1958,2100,10751,23442 days 16:47:18.671860,321,2.0,1.0,1340,2149,0.0
659000.0,3,2.5,2510,6320,2.0,3,9,2510,0.0,1996,2518,5819,9563 days 16:47:18.671860,161,1.2,0.0,-8,501,2510.0
414999.0,4,2.5,2150,10098,1.0,3,7,1090,1060.0,1963,1880,10000,21616 days 16:47:18.671860,076,1.6,1.028301886792453,270,98,30.0
193000.0,2,1.0,680,8640,1.0,4,5,680,0.0,1951,1320,13140,25999 days 16:47:18.671860,323,2.0,0.0,-640,-4500,680.0
525000.0,4,2.5,2840,4750,2.0,3,9,2840,0.0,2002,2460,4750,7371 days 16:47:18.671860,232,1.6,0.0,380,0,2840.0
424000.0,3,2.5,1820,7500,2.0,3,8,1820,0.0,1985,2040,8304,13580 days 16:47:18.671860,282,1.2,0.0,-220,-804,1820.0
455000.0,2,1.0,1070,5150,1.0,4,6,870,200.0,1908,1520,3860,41705 days 16:47:18.671860,008,2.0,4.35,-450,1290,670.0
463000.0,2,1.0,1250,5650,2.0,4,7,1250,0.0,1943,1210,5650,28921 days 16:47:18.671860,234,2.0,0.0,40,0,1250.0
1100000.0,4,2.5,2190,6300,1.0,3,7,1240,950.0,1960,2730,14659,22712 days 16:47:18.671860,124,1.6,1.305263157894737,-540,-8359,290.0
523000.0,3,1.75,3000,5413,2.0,4,8,1900,1100.0,1963,1550,5413,21616 days 16:47:18.671860,342,1.7142857142857142,1.7272727272727273,1450,0,800.0
615000.0,4,1.75,2270,9830,1.0,4,8,2270,0.0,1959,2540,11990,23077 days 16:47:18.671860,220,2.2857142857142856,0.0,-270,-2160,2270.0
1520000.0,4,4.0,4500,11795,2.0,3,1,4500,0.0,1991,3930,11576,11389 days 16:47:18.671860,307,1.0,0.0,570,219,4500.0
870000.0,5,4.0,3400,5000,2.0,3,8,2320,1080.0,1900,1910,5000,44626 days 16:47:18.671860,220,1.25,2.1481481481481484,1490,0,1240.0
710000.0,3,2.5,2830,9680,2.0,3,1,2830,0.0,1991,2970,8691,11389 days 16:47:18.671860,229,1.2,0.0,-140,989,2830.0
215000.0,3,1.0,960,9563,1.0,5,7,960,0.0,1967,1280,9600,20155 days 16:47:18.671860,188,3.0,0.0,-320,-37,960.0
590000.0,2,1.0,1530,6450,1.0,4,7,1530,0.0,1920,1530,5000,37322 days 16:47:18.671860,251,2.0,0.0,0,1450,1530.0
323000.0,5,2.5,2500,13034,1.0,3,7,1300,1200.0,1962,2440,13300,21981 days 16:47:18.671860,226,2.0,1.0833333333333333,60,-266,100.0
279000.0,4,2.0,1560,7569,1.5,4,7,1560,0.0,1966,1480,8755,20520 days 16:47:18.671860,203,2.0,0.0,80,-1186,1560.0
535100.0,3,2.25,2070,7207,1.0,3,8,1720,350.0,1973,2350,7980,17963 days 16:47:18.671860,262,1.3333333333333333,4.914285714285715,-280,-773,1370.0
830000.0,5,2.25,2710,19800,1.0,5,9,1910,800.0,1959,2120,16400,23077 days 16:47:18.671860,300,2.2222222222222223,2.3875,590,3400,1110.0
815000.0,4,2.5,3150,4203,2.0,3,9,3150,0.0,2002,3150,5169,7371 days 16:47:18.671860,184,1.6,0.0,0,-966,3150.0
535900.0,3,2.25,1880,10880,1.0,3,8,1480,400.0,1975,2120,10240,17233 days 16:47:18.671860,068,1.3333333333333333,3.7,-240,640,1080.0
230000.0,3,1.0,1250,8800,1.0,3,7,1250,0.0,1955,1480,8200,24538 days 16:47:18.671860,068,3.0,0.0,-230,600,1250.0
325500.0,4,1.75,2290,8142,1.0,4,7,1490,800.0,1969,1840,8142,19424 days 16:47:18.671860,048,2.2857142857142856,1.8625,450,0,690.0
359000.0,3,2.25,1990,4331,2.0,3,7,1990,0.0,1997,1690,3688,9197 days 16:47:18.671860,030,1.3333333333333333,0.0,300,643,1990.0
505000.0,3,2.5,2100,5824,2.0,3,8,2100,0.0,1999,1890,4140,8467 days 16:47:18.671860,129,1.2,0.0,210,1684,2100.0
253905.0,3,1.0,940,8400,1.0,5,7,940,0.0,1958,950,8400,23442 days 16:47:18.671860,273,3.0,0.0,-10,0,940.0
369950.0,3,1.75,1640,4860,1.0,3,8,1200,440.0,1965,1480,7200,20885 days 16:47:18.671860,192,1.7142857142857142,2.727272727272727,160,-2340,760.0
350000.0,3,2.25,1860,8378,2.0,3,7,1860,0.0,1995,1870,8378,9928 days 16:47:18.671860,021,1.3333333333333333,0.0,-10,0,1860.0
650000.0,4,2.25,2100,2500,3.0,3,8,2100,0.0,2001,1660,4000,7736 days 16:47:18.671860,219,1.7777777777777777,0.0,440,-1500,2100.0
295000.0,3,1.75,1500,15246,1.0,3,6,1500,0.0,1925,1500,16988,35495 days 16:47:18.671860,237,1.7142857142857142,0.0,0,-1742,1500.0
620000.0,3,1.75,1680,28046,1.0,3,8,1180,500.0,1948,2190,26308,27095 days 16:47:18.671860,127,1.7142857142857142,2.36,-510,1738,680.0
2000000.0,2,2.5,3900,920423,2.0,3,1,3900,0.0,2009,2720,411962,4814 days 16:47:18.671860,079,0.8,0.0,1180,508461,3900.0
246000.0,3,1.0,1400,7410,1.0,3,6,1400,0.0,1944,1070,7410,28556 days 16:47:18.671860,127,3.0,0.0,330,0,1400.0
430000.0,3,2.75,2600,12860,1.0,3,7,1350,1250.0,1965,2260,12954,20885 days 16:47:18.671860,259,1.0909090909090908,1.08,340,-94,100.0
509990.0,3,2.0,1440,4859,2.0,2,6,1440,0.0,1921,1360,4558,36956 days 16:47:18.671860,023,1.5,0.0,80,301,1440.0
490000.0,4,1.75,1870,9500,1.0,4,7,1090,780.0,1962,2010,10000,21981 days 16:47:18.671860,343,2.2857142857142856,1.3974358974358974,-140,-500,310.0
385000.0,4,2.75,2960,10454,1.0,3,8,2360,600.0,1979,1870,10500,15772 days 16:47:18.672858,336,1.4545454545454546,3.933333333333333,1090,-46,1760.0
769000.0,4,2.5,2440,6733,2.0,3,9,2440,0.0,1999,2570,6496,8467 days 16:47:18.672858,119,1.6,0.0,-130,237,2440.0
185000.0,2,1.0,1122,9100,1.0,4,6,1122,0.0,1960,840,9344,22712 days 16:47:18.672858,043,2.0,0.0,282,-244,1122.0
303500.0,3,1.5,1060,10464,1.0,4,7,1060,0.0,1973,1420,10464,17963 days 16:47:18.672858,129,2.0,0.0,-360,0,1060.0
468000.0,4,2.5,2150,8165,1.0,3,8,1430,720.0,1957,2360,7980,23807 days 16:47:18.672858,042,1.6,1.9861111111111112,-210,185,710.0
449950.0,4,2.5,3100,10000,2.0,3,9,3100,0.0,1978,1850,9438,16137 days 16:47:18.672858,202,1.6,0.0,1250,562,3100.0
235000.0,2,1.5,880,1805,2.0,3,7,880,0.0,1999,880,5060,8467 days 16:47:18.672858,167,1.3333333333333333,0.0,0,-3255,880.0
520000.0,4,2.5,2490,34947,2.0,3,9,2150,340.0,1985,2490,39639,13580 days 16:47:18.672858,336,1.6,6.323529411764706,0,-4692,1810.0
203000.0,2,1.0,1080,9067,1.0,3,6,1080,0.0,1951,1080,6647,25999 days 16:47:18.672858,310,2.0,0.0,0,2420,1080.0
657000.0,5,2.5,2530,10190,1.0,4,7,1290,1240.0,1960,2040,8560,22712 days 16:47:18.672858,238,2.0,1.0403225806451613,490,1630,50.0
275000.0,3,1.0,1200,7800,1.0,4,7,1200,0.0,1954,1230,7070,24903 days 16:47:18.672858,190,3.0,0.0,-30,730,1200.0
540000.0,4,2.25,2850,7453,2.0,3,9,2850,0.0,1991,2700,8468,11389 days 16:47:18.672858,297,1.7777777777777777,0.0,150,-1015,2850.0
455000.0,4,2.5,2950,4502,2.0,3,7,2950,0.0,2005,2360,4502,6275 days 16:47:18.672858,175,1.6,0.0,590,0,2950.0
458500.0,2,1.75,1160,6828,1.0,3,7,860,300.0,1941,1250,6828,29651 days 16:47:18.672858,289,1.1428571428571428,2.8666666666666667,-90,0,560.0
549900.0,4,3.5,3420,4751,2.0,3,1,3420,0.0,2003,3490,5700,7006 days 16:47:18.672858,114,1.1428571428571428,0.0,-70,-949,3420.0
750000.0,3,1.75,2240,10578,2.0,5,8,1550,690.0,1923,1570,10578,36226 days 16:47:18.672858,122,1.7142857142857142,2.246376811594203,670,0,860.0
235000.0,4,1.75,1450,8891,1.5,3,7,1180,270.0,1962,1450,9013,21981 days 16:47:18.672858,174,2.2857142857142856,4.37037037037037,0,-122,910.0
286000.0,4,2.5,1820,7930,2.0,5,7,1820,0.0,1989,1490,7930,12119 days 16:47:18.672858,254,1.6,0.0,330,0,1820.0
2650000.0,4,3.5,4700,13730,2.0,3,1,3500,1200.0,1958,3210,15306,23442 days 16:47:18.672858,077,1.1428571428571428,2.9166666666666665,1490,-1576,2300.0
602000.0,4,1.75,2430,14000,1.0,4,7,1580,850.0,1963,1910,8285,21616 days 16:47:18.672858,041,2.2857142857142856,1.8588235294117648,520,5715,730.0
640000.0,3,1.5,1960,4080,1.5,3,7,1960,0.0,1915,1880,4080,39148 days 16:47:18.672858,232,2.0,0.0,80,0,1960.0
267000.0,3,1.75,1440,10920,1.0,4,8,1440,0.0,1977,1720,8260,16502 days 16:47:18.672858,282,1.7142857142857142,0.0,-280,2660,1440.0
244500.0,2,1.0,910,9000,1.0,3,5,910,0.0,1923,1290,9000,36226 days 16:47:18.672858,283,2.0,0.0,-380,0,910.0
301000.0,2,1.0,910,9000,1.0,3,5,910,0.0,1923,1290,9000,36226 days 16:47:18.672858,132,2.0,0.0,-380,0,910.0
990000.0,4,2.5,2430,6325,2.0,4,8,2020,410.0,1919,2340,4375,37687 days 16:47:18.672858,230,1.6,4.926829268292683,90,1950,1610.0
739999.0,4,2.75,3350,6500,2.0,3,1,3350,0.0,1999,2960,6970,8467 days 16:47:18.672858,112,1.4545454545454546,0.0,390,-470,3350.0
480000.0,4,1.75,2320,4322,1.0,3,7,1140,1180.0,1910,1820,4322,40974 days 16:47:18.672858,161,2.2857142857142856,0.9661016949152542,500,0,-40.0
305000.0,3,2.5,1260,1622,3.0,3,8,1260,0.0,2009,1340,1188,4814 days 16:47:18.672858,210,1.2,0.0,-80,434,1260.0
703300.0,3,2.0,1980,3525,1.5,4,8,1590,390.0,1932,1760,3760,32939 days 16:47:18.672858,015,1.5,4.076923076923077,220,-235,1200.0
265000.0,4,1.5,1580,8468,2.0,4,7,1580,0.0,1971,1580,8260,18694 days 16:47:18.672858,089,2.6666666666666665,0.0,0,208,1580.0
600000.0,4,2.5,2710,35009,2.0,3,9,2710,0.0,1992,2330,35040,11024 days 16:47:18.672858,112,1.6,0.0,380,-31,2710.0
253000.0,3,1.0,1400,9750,1.0,3,7,1400,0.0,1968,1640,8050,19790 days 16:47:18.672858,202,3.0,0.0,-240,1700,1400.0
617950.0,4,2.5,2410,7950,2.0,3,8,2410,0.0,1997,1920,7713,9197 days 16:47:18.672858,085,1.6,0.0,490,237,2410.0
385000.0,4,3.25,1790,2460,2.0,4,7,1100,690.0,2000,1260,4040,8102 days 16:47:18.672858,346,1.2307692307692308,1.5942028985507246,530,-1580,410.0
319000.0,3,2.0,1640,9234,1.0,5,7,1060,580.0,1967,2230,10354,20155 days 16:47:18.672858,353,1.5,1.8275862068965518,-590,-1120,480.0
696000.0,3,2.5,1670,8023,1.0,5,7,1170,500.0,1960,1960,8964,22712 days 16:47:18.672858,113,1.2,2.34,-290,-941,670.0
345000.0,2,1.0,970,5750,1.0,4,6,970,0.0,1932,1650,8625,32939 days 16:47:18.672858,181,2.0,0.0,-680,-2875,970.0
380000.0,3,2.5,1610,1778,3.0,3,7,1610,0.0,2002,1120,2187,7371 days 16:47:18.672858,295,1.2,0.0,490,-409,1610.0
647500.0,4,1.75,2060,26036,1.0,4,8,1160,900.0,1947,2590,21891,27460 days 16:47:18.672858,128,2.2857142857142856,1.288888888888889,-530,4145,260.0
725000.0,3,2.5,3570,35271,2.0,3,9,3570,0.0,1997,3510,37194,9197 days 16:47:18.672858,268,1.2,0.0,60,-1923,3570.0
269950.0,3,1.75,1400,7735,1.0,4,7,1400,0.0,1989,1530,7754,12119 days 16:47:18.672858,353,1.7142857142857142,0.0,-130,-19,1400.0
875000.0,4,2.5,3470,32109,2.0,3,1,3470,0.0,1995,3800,35181,9928 days 16:47:18.672858,162,1.6,0.0,-330,-3072,3470.0
299950.0,3,1.0,1210,9525,1.0,3,7,1210,0.0,1955,1680,7620,24538 days 16:47:18.672858,150,3.0,0.0,-470,1905,1210.0
1880000.0,4,3.25,3930,10929,2.0,3,1,3930,0.0,2006,1780,9999,5910 days 16:47:18.672858,184,1.2307692307692308,0.0,2150,930,3930.0
430000.0,2,1.0,990,4802,1.0,3,7,990,0.0,1947,1180,5000,27460 days 16:47:18.672858,153,2.0,0.0,-190,-198,990.0
495000.0,5,2.5,2200,4942,2.0,3,8,2200,0.0,1989,2200,5924,12119 days 16:47:18.672858,029,2.0,0.0,0,-982,2200.0
275000.0,3,1.5,1510,16200,1.0,3,7,1510,0.0,1970,1650,13950,19059 days 16:47:18.672858,317,2.0,0.0,-140,2250,1510.0
333000.0,3,1.0,1620,5040,1.0,3,7,1120,500.0,1964,1790,6178,21251 days 16:47:18.672858,259,3.0,2.24,-170,-1138,620.0
247000.0,3,2.25,1580,7941,2.0,4,7,1580,0.0,1986,1730,8051,13215 days 16:47:18.672858,139,1.3333333333333333,0.0,-150,-110,1580.0
204555.0,3,1.75,1260,15000,1.5,4,7,1260,0.0,1983,2400,21715,14311 days 16:47:18.672858,068,1.7142857142857142,0.0,-1140,-6715,1260.0
432000.0,3,2.0,2190,13673,1.0,4,9,2190,0.0,1994,2770,13804,10293 days 16:47:18.672858,196,1.5,0.0,-580,-131,2190.0
175000.0,3,1.75,1230,13056,1.0,4,7,1230,0.0,1962,1690,15750,21981 days 16:47:18.672858,141,1.7142857142857142,0.0,-460,-2694,1230.0
556300.0,4,2.5,2030,7140,1.0,4,7,1400,630.0,1968,1800,7565,19790 days 16:47:18.672858,079,1.6,2.2222222222222223,230,-425,770.0
286000.0,2,1.0,780,3475,1.0,4,5,780,0.0,1930,1210,6769,33669 days 16:47:18.672858,176,2.0,0.0,-430,-3294,780.0
320000.0,2,1.5,1110,1200,3.0,3,8,1110,0.0,2000,1110,1363,8102 days 16:47:18.672858,249,1.3333333333333333,0.0,0,-163,1110.0
815000.0,3,2.5,2790,53143,2.0,4,9,2790,0.0,1991,2740,47916,11389 days 16:47:18.672858,110,1.2,0.0,50,5227,2790.0
1040000.0,4,1.0,3410,5000,2.0,5,8,2190,1220.0,1910,2550,5000,40974 days 16:47:18.672858,128,4.0,1.7950819672131149,860,0,970.0
350000.0,4,2.25,2390,13002,2.0,3,8,2390,0.0,1987,2450,11200,12850 days 16:47:18.672858,301,1.7777777777777777,0.0,-60,1802,2390.0
277000.0,4,2.5,1850,5880,2.0,3,8,1850,0.0,1998,2370,6500,8832 days 16:47:18.672858,210,1.6,0.0,-520,-620,1850.0
415000.0,6,2.0,2500,5200,1.0,3,8,1250,1250.0,1966,1800,5200,20520 days 16:47:18.672858,050,3.0,1.0,700,0,0.0
295000.0,3,1.0,1000,8320,1.0,5,6,1000,0.0,1951,1090,8450,25999 days 16:47:18.672858,338,3.0,0.0,-90,-130,1000.0
969000.0,4,2.0,2450,5000,2.0,5,8,2200,250.0,1919,2360,6090,37687 days 16:47:18.672858,217,2.0,8.8,90,-1090,1950.0
339888.0,4,1.75,1440,6144,1.0,5,6,720,720.0,1947,960,5160,27460 days 16:47:18.672858,308,2.2857142857142856,1.0,480,984,0.0
269950.0,3,2.25,1660,7003,2.0,3,7,1660,0.0,1996,1840,6680,9563 days 16:47:18.672858,234,1.3333333333333333,0.0,-180,323,1660.0
1190000.0,3,2.5,2510,4600,2.0,3,1,2510,0.0,2006,2560,7500,5910 days 16:47:18.672858,274,1.2,0.0,-50,-2900,2510.0
780000.0,4,2.5,3090,12511,2.0,4,1,3090,0.0,1998,3100,10882,8832 days 16:47:18.672858,350,1.6,0.0,-10,1629,3090.0
198000.0,3,1.0,860,5185,1.0,4,6,860,0.0,1968,1120,5494,19790 days 16:47:18.672858,098,3.0,0.0,-260,-309,860.0
350000.0,2,1.0,1220,28703,1.0,4,7,1220,0.0,1953,2740,6720,25268 days 16:47:18.672858,128,2.0,0.0,-1520,21983,1220.0
350000.0,3,1.0,1010,7680,1.0,4,7,1010,0.0,1967,1320,7373,20155 days 16:47:18.672858,335,3.0,0.0,-310,307,1010.0
319000.0,4,2.25,2390,7350,2.0,3,8,2390,0.0,1990,2390,7350,11754 days 16:47:18.672858,340,1.7777777777777777,0.0,0,0,2390.0
311000.0,4,2.25,3340,8000,2.0,4,8,3340,0.0,1973,2230,8000,17963 days 16:47:18.672858,251,1.7777777777777777,0.0,1110,0,3340.0
1340000.0,5,2.25,4200,5800,2.5,4,9,2910,1290.0,1906,3060,5800,42435 days 16:47:18.672858,164,2.2222222222222223,2.255813953488372,1140,0,1620.0
2700000.0,5,2.75,3831,13800,2.0,3,9,3831,0.0,1959,3850,36563,23077 days 16:47:18.672858,175,1.8181818181818181,0.0,-19,-22763,3831.0
396000.0,3,1.0,1980,9540,1.0,3,7,1080,900.0,1949,1680,9529,26729 days 16:47:18.672858,329,3.0,1.2,300,11,180.0
809000.0,4,1.75,1790,8372,1.0,4,8,1340,450.0,1976,2180,10500,16868 days 16:47:18.672858,092,2.2857142857142856,2.977777777777778,-390,-2128,890.0
480000.0,3,2.0,1580,7400,1.0,3,7,1050,530.0,1977,1560,7458,16502 days 16:47:18.672858,203,1.5,1.9811320754716981,20,-58,520.0
535000.0,6,1.75,2460,6000,1.0,4,7,1230,1230.0,1913,1560,4275,39878 days 16:47:18.672858,252,3.4285714285714284,1.0,900,1725,0.0
425000.0,5,2.75,2110,5120,2.0,3,7,1870,240.0,1947,1580,5120,27460 days 16:47:18.672858,044,1.8181818181818181,7.791666666666667,530,0,1630.0
408000.0,3,2.5,1470,1204,3.0,3,8,1470,0.0,2006,1460,1245,5910 days 16:47:18.672858,213,1.2,0.0,10,-41,1470.0
1260000.0,4,2.5,3510,13100,2.0,4,1,3510,0.0,1966,3230,12745,20520 days 16:47:18.672858,099,1.6,0.0,280,355,3510.0
310000.0,1,0.75,520,2885,1.0,4,6,520,0.0,1947,980,4241,27460 days 16:47:18.672858,110,1.3333333333333333,0.0,-460,-1356,520.0
292000.0,3,2.5,1950,7421,2.0,3,8,1950,0.0,1996,2200,4668,9563 days 16:47:18.672858,307,1.2,0.0,-250,2753,1950.0
217000.0,2,1.0,770,9715,1.0,4,6,770,0.0,1942,1140,9715,29286 days 16:47:18.672858,058,2.0,0.0,-370,0,770.0
398500.0,4,2.5,2250,6064,2.0,3,8,2250,0.0,2005,1520,7840,6275 days 16:47:18.672858,027,1.6,0.0,730,-1776,2250.0
2250000.0,3,3.0,4040,7200,1.5,4,9,3340,700.0,1930,3450,10800,33669 days 16:47:18.672858,085,1.0,4.771428571428571,590,-3600,2640.0
700000.0,4,1.75,2360,6000,1.0,3,7,1280,1080.0,1955,1700,3460,24538 days 16:47:18.672858,084,2.2857142857142856,1.1851851851851851,660,2540,200.0
585000.0,4,2.5,2330,45860,2.0,3,9,2330,0.0,1989,2930,5020,12119 days 16:47:18.672858,255,1.6,0.0,-600,40840,2330.0
399950.0,3,1.0,1720,8910,1.0,4,7,1720,0.0,1954,1870,8640,24903 days 16:47:18.672858,281,3.0,0.0,-150,270,1720.0
235000.0,3,1.75,1900,8540,1.0,3,6,950,950.0,1980,1370,10204,15407 days 16:47:18.672858,164,1.7142857142857142,1.0,530,-1664,0.0
212000.0,3,1.0,1040,6800,1.0,5,6,1040,0.0,1951,1430,6080,25999 days 16:47:18.672858,196,3.0,0.0,-390,720,1040.0
310000.0,3,2.0,2070,9195,1.0,3,8,1220,850.0,1982,2080,9551,14676 days 16:47:18.672858,233,1.5,1.4352941176470588,-10,-356,370.0
539000.0,3,2.0,2070,9195,1.0,3,8,1220,850.0,1982,2080,9551,14676 days 16:47:18.672858,350,1.5,1.4352941176470588,-10,-356,370.0
390000.0,3,3.0,1550,1608,2.0,3,8,1280,270.0,2001,1940,1883,7736 days 16:47:18.672858,339,1.0,4.7407407407407405,-390,-275,1010.0
560000.0,3,2.5,2020,11935,1.0,4,9,2020,0.0,1976,2410,12350,16868 days 16:47:18.672858,335,1.2,0.0,-390,-415,2020.0
1900000.0,4,3.25,4130,112521,2.0,3,1,4130,0.0,1978,3140,26147,16137 days 16:47:18.672858,160,1.2307692307692308,0.0,990,86374,4130.0
472000.0,5,2.0,2030,9804,1.0,3,7,1110,920.0,1963,1930,7990,21616 days 16:47:18.672858,300,2.5,1.2065217391304348,100,1814,190.0
502550.0,3,1.75,1770,7875,1.0,4,7,1170,600.0,1958,1670,8000,23442 days 16:47:18.672858,266,1.7142857142857142,1.95,100,-125,570.0
830000.0,4,3.25,3330,7809,2.0,3,9,3330,0.0,2004,3100,6465,6641 days 16:47:18.672858,086,1.2307692307692308,0.0,230,1344,3330.0
224950.0,4,2.5,2260,9686,1.0,4,7,1520,740.0,1965,1750,9916,20885 days 16:47:18.672858,204,1.6,2.054054054054054,510,-230,780.0
375000.0,3,2.5,1950,6871,2.0,3,8,1950,0.0,1997,1950,7663,9197 days 16:47:18.672858,169,1.2,0.0,0,-792,1950.0
645000.0,3,2.5,2930,19900,1.5,3,9,2930,0.0,1983,3160,20492,14311 days 16:47:18.672858,342,1.2,0.0,-230,-592,2930.0
599000.0,3,2.75,1960,2500,1.5,5,7,1410,550.0,1926,2040,5000,35130 days 16:47:18.672858,143,1.0909090909090908,2.5636363636363635,-80,-2500,860.0
515000.0,4,2.5,2980,12534,2.0,3,9,2980,0.0,1996,2630,12534,9563 days 16:47:18.672858,129,1.6,0.0,350,0,2980.0
135000.0,2,1.0,780,6685,1.0,4,5,780,0.0,1948,880,6695,27095 days 16:47:18.672858,148,2.0,0.0,-100,-10,780.0
485000.0,3,2.5,1650,4218,2.0,3,8,1650,0.0,2000,1650,4559,8102 days 16:47:18.672858,296,1.2,0.0,0,-341,1650.0
890000.0,3,3.25,4030,12765,2.0,4,9,2800,1230.0,1975,2670,13447,17233 days 16:47:18.672858,195,0.9230769230769231,2.2764227642276422,1360,-682,1570.0
215000.0,3,1.0,1010,10125,1.0,4,7,1010,0.0,1972,1230,10125,18329 days 16:47:18.672858,098,3.0,0.0,-220,0,1010.0
299500.0,3,1.0,1190,9600,1.0,3,7,1190,0.0,1981,1360,10140,15041 days 16:47:18.672858,351,3.0,0.0,-170,-540,1190.0
800000.0,2,1.0,1050,8750,1.0,4,7,1050,0.0,1951,3360,20115,25999 days 16:47:18.672858,225,2.0,0.0,-2310,-11365,1050.0
275000.0,3,2.5,1560,4244,2.0,3,7,1560,0.0,2002,1670,4251,7371 days 16:47:18.672858,040,1.2,0.0,-110,-7,1560.0
256400.0,3,1.5,1490,7800,1.0,3,7,1010,480.0,1963,1570,7800,21616 days 16:47:18.672858,050,2.0,2.1041666666666665,-80,0,530.0
310000.0,2,1.0,770,8149,1.0,4,6,770,0.0,1948,820,8149,27095 days 16:47:18.672858,055,2.0,0.0,-50,0,770.0
385000.0,1,1.0,620,5100,1.0,3,6,620,0.0,1954,1540,2676,24903 days 16:47:18.672858,063,1.0,0.0,-920,2424,620.0
203000.0,3,1.5,1200,9120,1.0,3,7,1000,200.0,1963,1640,9200,21616 days 16:47:18.672858,069,2.0,5.0,-440,-80,800.0
285000.0,4,2.0,2120,6865,1.0,3,7,1060,1060.0,1954,1460,7780,24903 days 16:47:18.672858,069,2.0,1.0,660,-915,0.0
473975.0,3,2.5,2330,3610,2.0,3,8,2330,0.0,1999,1830,2948,8467 days 16:47:18.672858,027,1.2,0.0,500,662,2330.0
320000.0,3,1.75,2000,9760,1.0,4,8,1400,600.0,1978,1890,8089,16137 days 16:47:18.672858,195,1.7142857142857142,2.3333333333333335,110,1671,800.0
599000.0,5,2.75,2820,4608,1.0,3,7,1450,1370.0,1967,1620,3840,20155 days 16:47:18.672858,163,1.8181818181818181,1.0583941605839415,1200,768,80.0
580000.0,3,2.0,2040,4800,1.0,4,7,1020,1020.0,1925,1640,4800,35495 days 16:47:18.672858,195,1.5,1.0,400,0,0.0
269500.0,4,2.25,1700,7056,2.0,3,7,1700,0.0,1999,1650,6025,8467 days 16:47:18.672858,343,1.7777777777777777,0.0,50,1031,1700.0
274000.0,2,1.0,820,6200,1.0,4,6,820,0.0,1954,1410,14000,24903 days 16:47:18.672858,321,2.0,0.0,-590,-7800,820.0
347000.0,2,1.75,1315,2162,2.0,4,8,1315,0.0,1974,1640,2128,17598 days 16:47:18.672858,085,1.1428571428571428,0.0,-325,34,1315.0
270000.0,3,1.75,1390,10905,1.0,3,6,860,530.0,1957,1390,10839,23807 days 16:47:18.672858,141,1.7142857142857142,1.6226415094339623,0,66,330.0
1430000.0,3,2.0,1890,12017,1.0,3,8,1890,0.0,1949,2000,12210,26729 days 16:47:18.672858,062,1.5,0.0,-110,-193,1890.0
220000.0,3,1.75,1460,7226,1.0,3,7,1460,0.0,1993,1760,7226,10658 days 16:47:18.672858,051,1.7142857142857142,0.0,-300,0,1460.0
243000.0,3,1.0,1480,15416,1.0,4,8,1480,0.0,1955,1190,10758,24538 days 16:47:18.672858,063,3.0,0.0,290,4658,1480.0
457500.0,3,1.75,1840,4030,1.0,5,7,1050,790.0,1925,1840,5040,35495 days 16:47:18.672858,147,1.7142857142857142,1.3291139240506329,0,-1010,260.0
340000.0,2,1.75,1880,7208,1.0,3,7,940,940.0,1951,1880,8051,25999 days 16:47:18.672858,353,1.1428571428571428,1.0,0,-843,0.0
657500.0,4,1.5,1910,5000,1.5,3,7,1610,300.0,1912,2170,5000,40244 days 16:47:18.672858,261,2.6666666666666665,5.366666666666666,-260,0,1310.0
332500.0,4,2.5,2220,4720,2.0,3,7,2220,0.0,1998,2090,4717,8832 days 16:47:18.672858,012,1.6,0.0,130,3,2220.0
340000.0,3,2.0,1410,10015,1.0,3,6,1410,0.0,1993,1570,10485,10658 days 16:47:18.672858,198,1.5,0.0,-160,-470,1410.0
350000.0,4,3.0,3380,16133,1.0,3,8,2330,1050.0,1959,2500,11100,23077 days 16:47:18.672858,245,1.3333333333333333,2.219047619047619,880,5033,1280.0
428000.0,4,2.5,1950,5602,1.0,5,7,1120,830.0,1966,2000,6050,20520 days 16:47:18.672858,044,1.6,1.3493975903614457,-50,-448,290.0
515055.0,4,2.5,2400,8320,2.0,3,8,2400,0.0,1999,2430,9258,8467 days 16:47:18.672858,124,1.6,0.0,-30,-938,2400.0
450000.0,3,1.75,1560,8968,1.0,4,8,1560,0.0,1972,1990,8034,18329 days 16:47:18.672858,035,1.7142857142857142,0.0,-430,934,1560.0
190000.0,3,1.0,1040,8910,1.0,3,6,1040,0.0,1943,1330,9720,28921 days 16:47:18.672858,057,3.0,0.0,-290,-810,1040.0
1000000.0,4,2.75,3090,16538,3.0,4,8,2590,500.0,1919,1500,5130,37687 days 16:47:18.672858,198,1.4545454545454546,5.18,1590,11408,2090.0
299000.0,3,2.5,1850,4600,2.0,3,7,1850,0.0,2005,2160,4751,6275 days 16:47:18.672858,323,1.2,0.0,-310,-151,1850.0
508000.0,2,1.0,1200,2500,2.0,3,7,1090,110.0,1927,2690,4800,34765 days 16:47:18.672858,307,2.0,9.909090909090908,-1490,-2300,980.0
294000.0,4,2.25,2190,3746,2.0,3,8,2190,0.0,2005,2200,3591,6275 days 16:47:18.672858,274,1.7777777777777777,0.0,-10,155,2190.0
320000.0,2,1.0,1380,5820,1.0,3,7,1380,0.0,1918,1540,4076,38052 days 16:47:18.672858,297,2.0,0.0,-160,1744,1380.0
641000.0,5,2.75,3710,8674,2.0,3,9,3710,0.0,1996,3250,8678,9563 days 16:47:18.672858,096,1.8181818181818181,0.0,460,-4,3710.0
675000.0,3,2.5,2320,98445,1.0,4,8,1380,940.0,1978,2830,54014,16137 days 16:47:18.672858,294,1.2,1.4680851063829787,-510,44431,440.0
255000.0,3,1.5,1110,10296,1.0,5,7,1110,0.0,1964,1330,10296,21251 days 16:47:18.672858,358,2.0,0.0,-220,0,1110.0
286651.0,3,2.5,1830,4997,2.0,3,7,1830,0.0,2004,2488,4998,6641 days 16:47:18.672858,120,1.2,0.0,-658,-1,1830.0
607500.0,4,2.5,2460,45738,1.0,4,8,1650,810.0,1969,2550,32040,19424 days 16:47:18.672858,044,1.6,2.037037037037037,-90,13698,840.0
765000.0,3,1.0,1270,6500,1.0,4,7,1270,0.0,1956,2260,7200,24173 days 16:47:18.672858,034,3.0,0.0,-990,-700,1270.0
334950.0,4,1.75,1700,40973,1.0,3,8,1700,0.0,1961,2760,40973,22346 days 16:47:18.672858,293,2.2857142857142856,0.0,-1060,0,1700.0
426000.0,3,1.0,1130,9147,1.0,5,7,1130,0.0,1952,1930,9906,25634 days 16:47:18.672858,231,3.0,0.0,-800,-759,1130.0
775000.0,3,1.75,1640,18730,1.5,4,7,1640,0.0,1946,1670,12154,27825 days 16:47:18.672858,237,1.7142857142857142,0.0,-30,6576,1640.0
343000.0,2,1.5,1040,8526,1.0,5,6,1040,0.0,1953,1310,8504,25268 days 16:47:18.672858,338,1.3333333333333333,0.0,-270,22,1040.0
470101.0,4,2.5,2320,7800,2.0,3,8,2320,0.0,1986,2090,5721,13215 days 16:47:18.672858,251,1.6,0.0,230,2079,2320.0
195000.0,3,1.5,1200,7800,1.0,4,7,1200,0.0,1958,1390,8415,23442 days 16:47:18.672858,125,2.0,0.0,-190,-615,1200.0
772500.0,4,1.0,1720,4410,1.5,3,7,1720,0.0,1928,2140,4500,34400 days 16:47:18.672858,062,4.0,0.0,-420,-90,1720.0
450000.0,3,1.5,2330,11740,1.0,3,8,1330,1000.0,1954,2630,11740,24903 days 16:47:18.672858,176,2.0,1.33,-300,0,330.0
1440000.0,4,3.75,4410,9231,3.0,3,1,4410,0.0,2001,2160,6600,7736 days 16:47:18.672858,245,1.0666666666666667,0.0,2250,2631,4410.0
525000.0,4,1.75,1650,8560,1.0,3,8,1650,0.0,1970,1700,8560,19059 days 16:47:18.672858,261,2.2857142857142856,0.0,-50,0,1650.0
280000.0,3,1.5,1370,11400,2.0,3,7,1370,0.0,1980,1390,9600,15407 days 16:47:18.672858,281,2.0,0.0,-20,1800,1370.0
270000.0,3,2.5,1770,8640,1.0,3,7,1420,350.0,1986,1894,7974,13215 days 16:47:18.672858,199,1.2,4.057142857142857,-124,666,1070.0
406100.0,3,2.25,1410,1332,3.0,3,8,1410,0.0,2005,1430,1448,6275 days 16:47:18.672858,125,1.3333333333333333,0.0,-20,-116,1410.0
332544.0,2,1.75,1710,4187,1.0,3,7,1710,0.0,1987,1760,4084,12850 days 16:47:18.672858,293,1.1428571428571428,0.0,-50,103,1710.0
110000.0,2,1.0,790,8250,1.0,3,6,790,0.0,1947,900,8250,27460 days 16:47:18.672858,117,2.0,0.0,-110,0,790.0
685000.0,6,2.25,2770,5854,1.5,3,8,2120,650.0,1921,2300,5450,36956 days 16:47:18.672858,343,2.6666666666666665,3.2615384615384615,470,404,1470.0
461000.0,4,1.0,1260,8505,1.5,5,7,1260,0.0,1951,1480,8100,25999 days 16:47:18.672858,210,4.0,0.0,-220,405,1260.0
615000.0,3,2.25,2300,8067,1.0,4,8,1300,1000.0,1979,2120,9524,15772 days 16:47:18.672858,104,1.3333333333333333,1.3,180,-1457,300.0
550000.0,2,1.0,1070,3000,1.0,4,7,870,200.0,1926,1890,3300,35130 days 16:47:18.672858,123,2.0,4.35,-820,-300,670.0
1060000.0,4,3.5,3850,8100,2.0,3,1,2430,1420.0,1995,2620,9346,9928 days 16:47:18.672858,295,1.1428571428571428,1.7112676056338028,1230,-1246,1010.0
685000.0,3,2.5,2320,219978,2.0,4,8,2320,0.0,1993,2340,88862,10658 days 16:47:18.672858,295,1.2,0.0,-20,131116,2320.0
1560000.0,5,2.5,2870,16238,2.0,4,8,2870,0.0,1962,2870,16238,21981 days 16:47:18.672858,330,2.0,0.0,0,0,2870.0
312000.0,4,2.5,1830,5175,2.0,3,7,1830,0.0,2003,1830,5175,7006 days 16:47:18.672858,154,1.6,0.0,0,0,1830.0
507500.0,3,1.75,1990,9594,1.0,3,8,1190,800.0,1977,1930,9765,16502 days 16:47:18.672858,182,1.7142857142857142,1.4875,60,-171,390.0
217000.0,3,1.0,1110,9827,1.0,3,7,1110,0.0,1966,1540,10187,20520 days 16:47:18.672858,261,3.0,0.0,-430,-360,1110.0
439000.0,3,2.25,1830,13477,1.0,4,7,1170,660.0,1981,1960,11344,15041 days 16:47:18.672858,346,1.3333333333333333,1.7727272727272727,-130,2133,510.0
620000.0,6,3.5,3600,6875,2.0,3,8,2740,860.0,2004,3150,6663,6641 days 16:47:18.672858,177,1.7142857142857142,3.186046511627907,450,212,1880.0
915000.0,4,2.5,3210,8532,2.0,3,1,3210,0.0,1998,2950,6753,8832 days 16:47:18.672858,224,1.6,0.0,260,1779,3210.0
425000.0,4,2.0,1490,5300,1.0,3,7,1110,380.0,1977,1330,1499,16502 days 16:47:18.672858,338,2.0,2.9210526315789473,160,3801,730.0
435000.0,2,1.0,990,5643,1.0,3,7,870,120.0,1947,1280,5700,27460 days 16:47:18.672858,058,2.0,7.25,-290,-57,750.0
305000.0,3,2.25,1646,12414,2.0,3,7,1646,0.0,1996,1654,8734,9563 days 16:47:18.672858,363,1.3333333333333333,0.0,-8,3680,1646.0
276000.0,2,1.0,720,4000,1.0,3,6,720,0.0,1918,1630,4000,38052 days 16:47:18.672858,085,2.0,0.0,-910,0,720.0
327500.0,3,2.25,2310,7200,2.0,3,8,2310,0.0,1990,1960,7201,11754 days 16:47:18.672858,181,1.3333333333333333,0.0,350,-1,2310.0
810000.0,3,2.5,2670,10481,2.0,3,9,2670,0.0,2003,2620,8895,7006 days 16:47:18.672858,168,1.2,0.0,50,1586,2670.0
715000.0,3,3.25,3060,9055,2.0,3,1,2460,600.0,1994,2990,9598,10293 days 16:47:18.672858,325,0.9230769230769231,4.1,70,-543,1860.0
272000.0,3,1.5,1380,11760,1.0,4,7,1380,0.0,1963,1650,9855,21616 days 16:47:18.672858,217,2.0,0.0,-270,1905,1380.0
266000.0,2,1.0,700,5559,1.0,5,6,700,0.0,1949,1230,8100,26729 days 16:47:18.672858,111,2.0,0.0,-530,-2541,700.0
543000.0,3,1.5,1710,8364,2.0,3,7,1710,0.0,1944,2430,9040,28556 days 16:47:18.672858,117,2.0,0.0,-720,-676,1710.0
400000.0,3,2.5,1450,8064,1.0,3,8,1450,0.0,1984,1710,9554,13946 days 16:47:18.672858,280,1.2,0.0,-260,-1490,1450.0
509500.0,5,2.25,2060,9000,1.0,4,7,1320,740.0,1961,2050,8800,22346 days 16:47:18.672858,218,2.2222222222222223,1.7837837837837838,10,200,580.0
495000.0,3,3.5,2380,6250,2.0,3,8,1670,710.0,1997,2540,4010,9197 days 16:47:18.672858,141,0.8571428571428571,2.352112676056338,-160,2240,960.0
424950.0,4,2.5,2760,5564,2.0,3,7,2760,0.0,2001,2670,5626,7736 days 16:47:18.672858,072,1.6,0.0,90,-62,2760.0
230000.0,3,1.0,940,10875,1.0,3,7,940,0.0,1957,1250,11200,23807 days 16:47:18.672858,269,3.0,0.0,-310,-325,940.0
235000.0,4,1.5,1760,6150,1.5,3,7,1760,0.0,1951,1760,8276,25999 days 16:47:18.672858,218,2.6666666666666665,0.0,0,-2126,1760.0
763000.0,3,2.0,1360,8752,1.0,4,6,1360,0.0,1942,2530,7680,29286 days 16:47:18.672858,068,1.5,0.0,-1170,1072,1360.0
350000.0,3,1.75,2010,6150,2.0,5,7,2010,0.0,1939,1770,7380,30382 days 16:47:18.672858,262,1.7142857142857142,0.0,240,-1230,2010.0
900000.0,3,1.5,2160,2260,2.0,5,8,1620,540.0,1917,2570,2400,38417 days 16:47:18.672858,330,2.0,3.0,-410,-140,1080.0
250000.0,3,1.0,930,6060,1.0,4,6,930,0.0,1973,1640,6364,17963 days 16:47:18.672858,280,3.0,0.0,-710,-304,930.0
225000.0,3,2.5,1020,2040,2.0,3,7,720,300.0,2004,1060,1478,6641 days 16:47:18.672858,026,1.2,2.4,-40,562,420.0
255000.0,2,2.0,1360,5433,1.0,3,8,1360,0.0,1974,1160,5264,17598 days 16:47:18.672858,360,1.0,0.0,200,169,1360.0
161700.0,4,1.75,1720,7200,1.0,3,7,1220,500.0,1974,1790,7200,17598 days 16:47:18.672858,155,2.2857142857142856,2.44,-70,0,720.0
336000.0,3,3.0,1790,13350,1.0,3,7,1190,600.0,1988,1740,10624,12485 days 16:47:18.672858,033,1.0,1.9833333333333334,50,2726,590.0
410500.0,3,1.0,1150,6800,1.0,3,7,1150,0.0,1954,1210,6800,24903 days 16:47:18.672858,296,3.0,0.0,-60,0,1150.0
502700.0,4,3.5,2710,14016,2.0,4,8,2710,0.0,1968,1590,27903,19790 days 16:47:18.672858,315,1.1428571428571428,0.0,1120,-13887,2710.0
505000.0,3,2.5,2400,9601,1.0,5,7,1390,1010.0,1977,2010,9943,16502 days 16:47:18.672858,266,1.2,1.3762376237623761,390,-342,380.0
250000.0,3,1.0,1660,7650,1.5,3,7,1350,310.0,1910,1750,5760,40974 days 16:47:18.672858,350,3.0,4.354838709677419,-90,1890,1040.0
570000.0,3,1.0,1660,7650,1.5,3,7,1350,310.0,1910,1750,5760,40974 days 16:47:18.672858,112,3.0,4.354838709677419,-90,1890,1040.0
349900.0,4,2.5,2290,8796,2.0,3,8,2290,0.0,1994,2130,8796,10293 days 16:47:18.672858,077,1.6,0.0,160,0,2290.0
465000.0,3,2.5,2870,25663,2.0,3,1,2870,0.0,1988,2950,24347,12485 days 16:47:18.672858,343,1.2,0.0,-80,1316,2870.0
625000.0,4,3.25,4240,25639,2.0,3,1,3550,690.0,1989,3590,24967,12119 days 16:47:18.672858,150,1.2307692307692308,5.144927536231884,650,672,2860.0
655000.0,3,1.75,1800,5102,1.0,3,7,1170,630.0,1952,1720,5102,25634 days 16:47:18.672858,050,1.7142857142857142,1.8571428571428572,80,0,540.0
469000.0,4,1.75,2960,11347,1.0,4,8,1570,1390.0,1946,1660,8911,27825 days 16:47:18.672858,086,2.2857142857142856,1.129496402877698,1300,2436,180.0
355000.0,3,2.25,1980,7200,1.0,3,8,1300,680.0,1964,1820,8250,21251 days 16:47:18.672858,282,1.3333333333333333,1.911764705882353,160,-1050,620.0
596000.0,3,2.5,1730,2631,2.0,3,8,1730,0.0,2001,1730,2751,7736 days 16:47:18.672858,055,1.2,0.0,0,-120,1730.0
790000.0,4,2.5,3020,36893,2.0,3,9,3020,0.0,1986,3020,36444,13215 days 16:47:18.672858,092,1.6,0.0,0,449,3020.0
885000.0,4,2.25,4470,86225,2.0,3,1,4470,0.0,1991,3850,97049,11389 days 16:47:18.672858,281,1.7777777777777777,0.0,620,-10824,4470.0
1030000.0,4,3.25,2830,4000,2.0,3,9,1910,920.0,1912,2740,4000,40244 days 16:47:18.672858,255,1.2307692307692308,2.0760869565217392,90,0,990.0
710000.0,4,1.75,2120,5400,1.0,4,8,1060,1060.0,1941,2052,6000,29651 days 16:47:18.672858,093,2.2857142857142856,1.0,68,-600,0.0
428040.0,3,2.5,2150,9266,2.0,3,8,2150,0.0,1988,2150,12550,12485 days 16:47:18.672858,226,1.2,0.0,0,-3284,2150.0
1370000.0,5,2.25,3510,13843,1.0,3,8,1850,1660.0,1959,2680,8750,23077 days 16:47:18.672858,104,2.2222222222222223,1.1144578313253013,830,5093,190.0
546000.0,2,1.0,970,3400,1.0,3,7,970,0.0,1924,1180,3600,35861 days 16:47:18.672858,156,2.0,0.0,-210,-200,970.0
540000.0,4,1.0,1360,5766,1.5,5,7,1360,0.0,1951,1500,5704,25999 days 16:47:18.672858,215,4.0,0.0,-140,62,1360.0
435000.0,3,2.5,1470,3000,1.0,3,7,930,540.0,1985,1470,5588,13580 days 16:47:18.672858,251,1.2,1.7222222222222223,0,-2588,390.0
540000.0,4,2.25,3040,10283,1.0,4,8,1430,1610.0,1984,1870,11074,13946 days 16:47:18.672858,096,1.7777777777777777,0.8881987577639752,1170,-791,-180.0
284000.0,2,1.0,860,7204,1.0,3,7,860,0.0,1918,1200,7500,38052 days 16:47:18.672858,317,2.0,0.0,-340,-296,860.0
208000.0,2,1.0,820,5700,1.0,5,5,820,0.0,1942,1000,5700,29286 days 16:47:18.672858,195,2.0,0.0,-180,0,820.0
315000.0,3,1.75,1900,7076,1.0,3,7,1130,770.0,1977,1540,10113,16502 days 16:47:18.672858,337,1.7142857142857142,1.4675324675324675,360,-3037,360.0
417500.0,2,1.0,1330,5510,1.0,3,6,850,480.0,1910,1200,4150,40974 days 16:47:18.672858,212,2.0,1.7708333333333333,130,1360,370.0
345000.0,3,1.75,1240,38095,1.0,3,7,1240,0.0,1978,2060,38552,16137 days 16:47:18.672858,260,1.7142857142857142,0.0,-820,-457,1240.0
375000.0,3,2.5,1330,1064,3.0,3,8,1330,0.0,2004,1330,1113,6641 days 16:47:18.672858,245,1.2,0.0,0,-49,1330.0
389800.0,3,1.75,1880,12821,1.0,3,7,1880,0.0,1959,1540,12868,23077 days 16:47:18.672858,174,1.7142857142857142,0.0,340,-47,1880.0
475000.0,3,1.75,1890,7560,1.0,3,8,1430,460.0,1973,1890,9095,17963 days 16:47:18.672858,098,1.7142857142857142,3.108695652173913,0,-1535,970.0
569000.0,4,2.25,2250,41688,2.0,3,8,2250,0.0,1980,2350,37920,15407 days 16:47:18.672858,128,1.7777777777777777,0.0,-100,3768,2250.0
985000.0,5,4.25,4650,108464,2.0,3,1,3260,1390.0,1999,2810,155509,8467 days 16:47:18.672858,090,1.1764705882352942,2.3453237410071943,1840,-47045,1870.0
532000.0,3,2.5,1830,8022,2.0,3,8,1830,0.0,1987,2030,7736,12850 days 16:47:18.672858,029,1.2,0.0,-200,286,1830.0
280000.0,2,1.0,720,5000,1.0,5,6,720,0.0,1951,810,5000,25999 days 16:47:18.672858,223,2.0,0.0,-90,0,720.0
435000.0,4,2.0,1960,50112,1.0,4,7,1050,910.0,1963,2340,44967,21616 days 16:47:18.672858,048,2.0,1.1538461538461537,-380,5145,140.0
223000.0,3,1.0,1220,71191,1.0,3,6,1220,0.0,1952,1960,15378,25634 days 16:47:18.672858,075,3.0,0.0,-740,55813,1220.0
390000.0,2,1.0,1800,119790,1.0,4,7,1200,600.0,1947,2320,79208,27460 days 16:47:18.672858,015,2.0,2.0,-520,40582,600.0
315000.0,3,1.75,1340,12800,1.0,3,7,880,460.0,1981,1500,7875,15041 days 16:47:18.672858,300,1.7142857142857142,1.9130434782608696,-160,4925,420.0
612000.0,3,3.0,1740,3700,1.0,3,7,1740,0.0,1982,1830,2480,14676 days 16:47:18.672858,287,1.0,0.0,-90,1220,1740.0
591000.0,3,1.75,1680,2400,1.0,5,7,870,810.0,1922,1440,3600,36591 days 16:47:18.672858,133,1.7142857142857142,1.0740740740740742,240,-1200,60.0
800000.0,4,2.25,3220,8436,2.0,3,8,3220,0.0,1968,2500,7632,19790 days 16:47:18.672858,192,1.7777777777777777,0.0,720,804,3220.0
225000.0,3,2.0,1610,8400,1.0,3,8,1610,0.0,1990,1930,8459,11754 days 16:47:18.672858,022,1.5,0.0,-320,-59,1610.0
589900.0,2,3.0,3160,66646,2.0,3,7,3160,0.0,1993,3140,38790,10658 days 16:47:18.672858,128,0.6666666666666666,0.0,20,27856,3160.0
565000.0,4,2.5,2520,13156,1.0,3,8,1520,1000.0,1979,2050,10940,15772 days 16:47:18.672858,330,1.6,1.52,470,2216,520.0
650000.0,3,1.5,2120,8448,1.0,3,7,1060,1060.0,1940,1620,7920,30017 days 16:47:18.672858,050,2.0,1.0,500,528,0.0
499000.0,3,2.5,2090,8505,2.0,3,8,2090,0.0,1951,1640,8100,25999 days 16:47:18.672858,261,1.2,0.0,450,405,2090.0
280000.0,3,1.0,1330,20562,1.5,3,5,1330,0.0,1959,1350,20562,23077 days 16:47:18.672858,135,3.0,0.0,-20,0,1330.0
649950.0,3,2.5,2420,7500,1.0,4,8,1210,1210.0,1944,2340,7500,28556 days 16:47:18.672858,028,1.2,1.0,80,0,0.0
420000.0,3,1.75,1510,6360,1.0,4,7,1510,0.0,1954,1480,7260,24903 days 16:47:18.672858,190,1.7142857142857142,0.0,30,-900,1510.0
319990.0,4,2.5,2120,5293,2.0,3,7,2120,0.0,2003,1990,5313,7006 days 16:47:18.672858,349,1.6,0.0,130,-20,2120.0
265000.0,3,2.0,1850,16535,1.0,3,7,1850,0.0,1992,1528,13295,11024 days 16:47:18.672858,224,1.5,0.0,322,3240,1850.0
482000.0,3,1.75,2300,16474,1.0,3,7,1220,1080.0,1984,1940,15601,13946 days 16:47:18.672858,054,1.7142857142857142,1.1296296296296295,360,873,140.0
452000.0,3,2.25,2600,14810,1.0,4,8,1490,1110.0,1956,2450,16715,24173 days 16:47:18.672858,217,1.3333333333333333,1.3423423423423424,150,-1905,380.0
1490000.0,4,4.25,5180,13077,2.0,3,1,4280,900.0,1998,5030,15069,8832 days 16:47:18.672858,199,0.9411764705882353,4.7555555555555555,150,-1992,3380.0
375000.0,2,1.0,1810,8527,1.5,4,7,1810,0.0,1943,1490,6800,28921 days 16:47:18.672858,233,2.0,0.0,320,1727,1810.0
588000.0,5,3.0,2190,4900,2.0,5,7,1490,700.0,1940,1370,4606,30017 days 16:47:18.672858,184,1.6666666666666667,2.1285714285714286,820,294,790.0
635000.0,4,2.5,2500,10215,2.0,3,9,2500,0.0,1998,2890,10240,8832 days 16:47:18.672858,114,1.6,0.0,-390,-25,2500.0
280500.0,4,2.5,1890,6962,2.0,3,8,1890,0.0,1997,2170,6803,9197 days 16:47:18.672858,184,1.6,0.0,-280,159,1890.0
210500.0,2,1.75,2040,8600,1.0,4,6,1430,610.0,1985,1310,7859,13580 days 16:47:18.672858,268,1.1428571428571428,2.3442622950819674,730,741,820.0
196500.0,3,2.0,1310,7000,1.0,4,7,1310,0.0,1979,1390,7500,15772 days 16:47:18.672858,269,1.5,0.0,-80,-500,1310.0
1400000.0,5,3.5,4010,8510,2.0,5,9,2850,1160.0,1971,2610,6128,18694 days 16:47:18.672858,125,1.4285714285714286,2.456896551724138,1400,2382,1690.0
475000.0,3,1.75,1780,8033,1.0,2,7,1210,570.0,1977,1630,7508,16502 days 16:47:18.672858,037,1.7142857142857142,2.1228070175438596,150,525,640.0
550000.0,3,2.5,1980,9061,2.0,4,8,1980,0.0,1987,1930,8869,12850 days 16:47:18.672858,124,1.2,0.0,50,192,1980.0
1580000.0,3,3.25,3690,7200,2.0,3,1,3690,0.0,2007,1880,7200,5545 days 16:47:18.672858,141,0.9230769230769231,0.0,1810,0,3690.0
240000.0,3,1.75,1540,6687,1.0,3,7,1200,340.0,1991,1540,7242,11389 days 16:47:18.672858,112,1.7142857142857142,3.5294117647058822,0,-555,860.0
272000.0,3,1.0,1130,8100,1.5,3,6,1130,0.0,1934,1080,8100,32208 days 16:47:18.672858,119,3.0,0.0,50,0,1130.0
408506.0,3,2.75,2480,209199,1.5,3,8,1870,610.0,2000,2040,219229,8102 days 16:47:18.672858,083,1.0909090909090908,3.0655737704918034,440,-10030,1260.0
640000.0,3,2.5,2580,7500,2.0,3,9,2580,0.0,1991,910,6500,11389 days 16:47:18.672858,230,1.2,0.0,1670,1000,2580.0
316000.0,4,2.5,2010,7226,2.0,3,8,2010,0.0,1995,2160,7696,9928 days 16:47:18.672858,134,1.6,0.0,-150,-470,2010.0
299000.0,4,2.0,2320,12000,1.0,3,7,1720,600.0,1943,1390,6000,28921 days 16:47:18.672858,232,2.0,2.8666666666666667,930,6000,1120.0
447500.0,2,2.25,1180,2090,2.0,3,7,1180,0.0,2004,1550,2812,6641 days 16:47:18.672858,064,0.8888888888888888,0.0,-370,-722,1180.0
736500.0,4,2.5,3180,21904,2.0,3,9,3180,0.0,2000,3715,29170,8102 days 16:47:18.672858,125,1.6,0.0,-535,-7266,3180.0
665000.0,4,2.0,2970,52567,2.0,3,8,2970,0.0,1924,3280,46676,35861 days 16:47:18.672858,209,2.0,0.0,-310,5891,2970.0
215000.0,4,1.75,1630,8000,1.0,3,7,1630,0.0,1959,1630,7700,23077 days 16:47:18.672858,241,2.2857142857142856,0.0,0,300,1630.0
275000.0,3,2.25,1620,6415,2.0,4,7,1620,0.0,1989,1640,7253,12119 days 16:47:18.672858,345,1.3333333333333333,0.0,-20,-838,1620.0
648000.0,4,2.25,2170,8240,2.0,4,8,2170,0.0,1983,2600,9898,14311 days 16:47:18.672858,084,1.7777777777777777,0.0,-430,-1658,2170.0
415000.0,4,2.5,2150,8173,2.0,3,8,2150,0.0,1987,2080,7620,12850 days 16:47:18.672858,301,1.6,0.0,70,553,2150.0
690000.0,3,2.0,1770,1800,3.0,3,8,1770,0.0,1999,1890,3200,8467 days 16:47:18.672858,323,1.5,0.0,-120,-1400,1770.0
320000.0,4,2.75,2110,13260,1.0,4,7,1290,820.0,1979,1980,11016,15772 days 16:47:18.672858,267,1.4545454545454546,1.5731707317073171,130,2244,470.0
750000.0,3,1.75,1590,8285,1.0,4,8,1590,0.0,1956,1970,8970,24173 days 16:47:18.672858,245,1.7142857142857142,0.0,-380,-685,1590.0
355000.0,3,2.25,1370,1524,3.0,3,8,1370,0.0,2005,1370,1418,6275 days 16:47:18.672858,181,1.3333333333333333,0.0,0,106,1370.0
246000.0,3,1.75,1390,7399,1.0,4,7,1390,0.0,1975,1460,7800,17233 days 16:47:18.672858,128,1.7142857142857142,0.0,-70,-401,1390.0
1160000.0,3,1.75,1640,10464,1.0,4,8,1640,0.0,1968,2630,18872,19790 days 16:47:18.672858,274,1.7142857142857142,0.0,-990,-8408,1640.0
744000.0,3,2.5,2670,12187,2.0,3,8,2670,0.0,1986,2400,8999,13215 days 16:47:18.672858,157,1.2,0.0,270,3188,2670.0
1210000.0,3,3.75,5400,24740,2.0,3,1,5400,0.0,1997,1690,20000,9197 days 16:47:18.672858,254,0.8,0.0,3710,4740,5400.0
217000.0,3,2.0,1690,6750,1.0,3,7,1210,480.0,1977,1930,7350,16502 days 16:47:18.672858,344,1.5,2.5208333333333335,-240,-600,730.0
583000.0,3,2.5,2600,5100,2.0,3,8,2600,0.0,1998,2270,5400,8832 days 16:47:18.672858,190,1.2,0.0,330,-300,2600.0
515000.0,2,1.5,1400,5000,1.0,4,7,1150,250.0,1904,1530,4200,43166 days 16:47:18.672858,315,1.3333333333333333,4.6,-130,800,900.0
594000.0,4,1.75,2140,8000,1.0,4,8,1410,730.0,1965,2080,8000,20885 days 16:47:18.672858,078,2.2857142857142856,1.9315068493150684,60,0,680.0
303100.0,3,1.5,1640,5650,1.0,3,8,1640,0.0,1952,1640,5650,25634 days 16:47:18.672858,295,2.0,0.0,0,0,1640.0
708000.0,5,3.25,3060,11778,2.0,3,8,3060,0.0,2004,1840,10403,6641 days 16:47:18.672858,342,1.5384615384615385,0.0,1220,1375,3060.0
221000.0,3,1.0,1150,7260,1.0,3,7,1150,0.0,1959,1200,7888,23077 days 16:47:18.672858,225,3.0,0.0,-50,-628,1150.0
325000.0,3,2.5,2000,7205,2.0,3,8,2000,0.0,1998,2180,7611,8832 days 16:47:18.672858,083,1.2,0.0,-180,-406,2000.0
385000.0,3,1.75,1560,5950,1.0,4,6,780,780.0,1944,1320,7830,28556 days 16:47:18.672858,050,1.7142857142857142,1.0,240,-1880,0.0
359500.0,3,2.5,2070,4689,2.0,3,8,2070,0.0,2013,1880,4593,3353 days 16:47:18.672858,086,1.2,0.0,190,96,2070.0
433000.0,3,2.0,1920,7200,1.0,3,7,1300,620.0,1984,2010,7200,13946 days 16:47:18.672858,219,1.5,2.096774193548387,-90,0,680.0
525000.0,2,1.0,1000,4950,1.0,3,7,800,200.0,1948,1060,5500,27095 days 16:47:18.672858,082,2.0,4.0,-60,-550,600.0
356200.0,3,2.0,1690,10062,1.0,5,7,940,750.0,1928,2390,6650,34400 days 16:47:18.672858,203,1.5,1.2533333333333334,-700,3412,190.0
595000.0,4,2.0,3090,87120,1.0,4,7,1590,1500.0,1974,2560,88426,17598 days 16:47:18.672858,210,2.0,1.06,530,-1306,90.0
560000.0,4,1.5,1790,3420,1.0,4,7,1020,770.0,1923,1680,3420,36226 days 16:47:18.672858,258,2.6666666666666665,1.3246753246753247,110,0,250.0
2180000.0,4,3.0,4750,21701,1.5,5,1,4750,0.0,1976,3120,18551,16868 days 16:47:18.672858,342,1.3333333333333333,0.0,1630,3150,4750.0
513000.0,4,2.0,2090,4000,1.0,3,7,1480,610.0,1951,1510,5000,25999 days 16:47:18.672858,300,2.0,2.4262295081967213,580,-1000,870.0
365000.0,2,1.0,680,2550,1.0,4,5,680,0.0,1901,1120,5100,44261 days 16:47:18.672858,202,2.0,0.0,-440,-2550,680.0
368000.0,4,1.75,2100,11942,1.0,3,7,1030,1070.0,1964,1170,6986,21251 days 16:47:18.672858,189,2.2857142857142856,0.9626168224299065,930,4956,-40.0
870000.0,4,2.75,2840,4000,1.5,5,8,1960,880.0,1912,2750,4000,40244 days 16:47:18.672858,176,1.4545454545454546,2.227272727272727,90,0,1080.0
225000.0,3,2.25,1470,6808,1.0,3,7,1160,310.0,1984,1570,7881,13946 days 16:47:18.672858,205,1.3333333333333333,3.7419354838709675,-100,-1073,850.0
1390000.0,4,4.5,4490,24767,2.0,3,1,3800,690.0,1998,3370,32700,8832 days 16:47:18.672858,111,0.8888888888888888,5.507246376811594,1120,-7933,3110.0
177000.0,3,1.75,1150,8079,1.0,4,7,1150,0.0,1983,1540,7399,14311 days 16:47:18.672858,170,1.7142857142857142,0.0,-390,680,1150.0
465000.0,3,1.5,1460,9879,1.0,3,7,1460,0.0,1956,1610,10050,24173 days 16:47:18.672858,027,2.0,0.0,-150,-171,1460.0
750000.0,4,2.75,3150,6343,1.0,3,8,1810,1340.0,1976,2250,6343,16868 days 16:47:18.672858,270,1.4545454545454546,1.3507462686567164,900,0,470.0
149000.0,3,1.0,1090,2800,1.0,3,6,1090,0.0,1969,1040,2960,19424 days 16:47:18.672858,265,3.0,0.0,50,-160,1090.0
605000.0,3,2.5,2670,47480,2.0,3,9,2670,0.0,1981,2760,42800,15041 days 16:47:18.672858,160,1.2,0.0,-90,4680,2670.0
725000.0,3,2.0,2110,5800,1.5,4,7,1990,120.0,1927,1620,4300,34765 days 16:47:18.672858,297,1.5,16.583333333333332,490,1500,1870.0
413900.0,4,2.25,1770,5236,2.0,3,7,1770,0.0,2007,2470,5064,5545 days 16:47:18.672858,265,1.7777777777777777,0.0,-700,172,1770.0
199950.0,3,1.5,1510,6600,1.0,3,6,1510,0.0,1938,990,6600,30747 days 16:47:18.672858,212,2.0,0.0,520,0,1510.0
400000.0,1,1.0,530,13679,1.0,4,6,530,0.0,1949,1930,20624,26729 days 16:47:18.672858,267,1.0,0.0,-1400,-6945,530.0
870000.0,3,1.5,2420,5000,2.0,4,8,2200,220.0,1925,2070,5000,35495 days 16:47:18.672858,224,2.0,10.0,350,0,1980.0
292000.0,5,2.5,2490,7666,1.0,4,7,1490,1000.0,1989,1930,7415,12119 days 16:47:18.672858,156,2.0,1.49,560,251,490.0
225000.0,3,1.0,990,8012,1.0,4,7,990,0.0,1966,1260,9060,20520 days 16:47:18.672858,132,3.0,0.0,-270,-1048,990.0
466750.0,4,2.0,1730,9139,2.0,3,8,1730,0.0,1957,1410,7311,23807 days 16:47:18.672858,075,2.0,0.0,320,1828,1730.0
330000.0,2,1.5,1440,11954,1.0,4,8,1440,0.0,1978,1460,9730,16137 days 16:47:18.672858,082,1.3333333333333333,0.0,-20,2224,1440.0
770000.0,7,2.25,3260,8145,2.0,5,8,3260,0.0,1967,2340,8145,20155 days 16:47:18.672858,275,3.111111111111111,0.0,920,0,3260.0
802500.0,4,2.25,1950,7000,1.0,3,8,1450,500.0,1957,1840,6440,23807 days 16:47:18.672858,044,1.7777777777777777,2.9,110,560,950.0
378800.0,5,2.5,2740,5400,2.0,3,8,2740,0.0,2005,2900,5476,6275 days 16:47:18.672858,199,2.0,0.0,-160,-76,2740.0
795000.0,3,2.75,2940,12487,2.0,3,1,2940,0.0,1997,3110,10837,9197 days 16:47:18.672858,121,1.0909090909090908,0.0,-170,1650,2940.0
460000.0,3,2.0,1200,7320,1.0,3,7,1200,0.0,1955,1750,8220,24538 days 16:47:18.672858,112,1.5,0.0,-550,-900,1200.0
567000.0,3,2.5,2070,10908,2.0,3,8,2070,0.0,1986,2220,10975,13215 days 16:47:18.672858,353,1.2,0.0,-150,-67,2070.0
209950.0,3,1.75,1570,15570,1.0,3,7,1570,0.0,1981,2000,28200,15041 days 16:47:18.672858,203,1.7142857142857142,0.0,-430,-12630,1570.0
415000.0,2,1.0,1050,60113,1.0,4,7,1050,0.0,1943,1380,27442,28921 days 16:47:18.672858,140,2.0,0.0,-330,32671,1050.0
424500.0,4,1.5,1830,6985,1.0,3,7,1080,750.0,1967,1650,9501,20155 days 16:47:18.672858,349,2.6666666666666665,1.44,180,-2516,330.0
261000.0,2,1.0,970,12500,1.0,3,6,970,0.0,1941,1280,6250,29651 days 16:47:18.672858,125,2.0,0.0,-310,6250,970.0
365000.0,3,2.5,2200,9696,2.0,3,8,2200,0.0,1987,2200,9915,12850 days 16:47:18.672858,239,1.2,0.0,0,-219,2200.0
631000.0,4,2.0,1930,3240,1.5,4,7,1930,0.0,1911,1480,3600,40609 days 16:47:18.672858,098,2.0,0.0,450,-360,1930.0
3800000.0,5,5.5,7050,42840,1.0,4,1,4320,2730.0,1978,5070,20570,16137 days 16:47:18.672858,182,0.9090909090909091,1.5824175824175823,1980,22270,1590.0
584000.0,3,2.5,1790,3962,2.0,3,8,1790,0.0,1992,1340,3960,11024 days 16:47:18.672858,281,1.2,0.0,450,2,1790.0
310000.0,3,1.75,1560,82328,1.0,3,7,1560,0.0,1974,2100,205603,17598 days 16:47:18.672858,210,1.7142857142857142,0.0,-540,-123275,1560.0
717000.0,4,2.5,2780,7985,2.0,4,1,2780,0.0,1992,2650,8094,11024 days 16:47:18.672858,071,1.6,0.0,130,-109,2780.0
667000.0,3,1.5,1720,8100,2.0,3,8,1720,0.0,1907,2210,8100,42070 days 16:47:18.672858,167,2.0,0.0,-490,0,1720.0
190000.0,3,1.0,1640,8100,1.0,3,6,1040,600.0,1939,1600,8100,30382 days 16:47:18.672858,364,3.0,1.7333333333333334,40,0,440.0
430000.0,3,2.0,1730,9000,1.0,3,8,1370,360.0,1978,2390,10000,16137 days 16:47:18.672858,168,1.5,3.8055555555555554,-660,-1000,1010.0
213000.0,2,1.0,740,7380,1.0,4,6,740,0.0,1951,1500,10075,25999 days 16:47:18.672858,114,2.0,0.0,-760,-2695,740.0
475000.0,3,2.5,2280,3710,1.0,3,8,1550,730.0,1990,2030,3710,11754 days 16:47:18.672858,280,1.2,2.1232876712328768,250,0,820.0
649000.0,2,2.75,2090,23962,2.0,4,8,2090,0.0,1988,1820,32340,12485 days 16:47:18.672858,068,0.7272727272727273,0.0,270,-8378,2090.0
715000.0,3,2.5,2550,13458,2.0,3,9,2550,0.0,1990,3180,13458,11754 days 16:47:18.672858,157,1.2,0.0,-630,0,2550.0
845000.0,4,3.5,3350,19487,1.0,3,1,2460,890.0,1992,3360,19460,11024 days 16:47:18.672858,077,1.1428571428571428,2.764044943820225,-10,27,1570.0
390000.0,3,2.5,2770,8820,1.0,3,7,1900,870.0,1980,1850,10920,15407 days 16:47:18.672858,314,1.2,2.1839080459770117,920,-2100,1030.0
390000.0,4,3.0,2860,5724,1.0,3,7,1730,1130.0,1983,2340,7200,14311 days 16:47:18.672858,267,1.3333333333333333,1.5309734513274336,520,-1476,600.0
328000.0,4,1.75,1990,7194,1.0,4,8,1400,590.0,1978,1820,7400,16137 days 16:47:18.672858,210,2.2857142857142856,2.3728813559322033,170,-206,810.0
239999.0,3,2.75,1740,8436,1.0,3,7,1140,600.0,1967,1550,8436,20155 days 16:47:18.672858,339,1.0909090909090908,1.9,190,0,540.0
225000.0,3,2.0,1460,7740,1.0,3,7,1460,0.0,1968,1540,7644,19790 days 16:47:18.672858,294,1.5,0.0,-80,96,1460.0
920000.0,3,1.75,3670,11884,1.0,4,9,1950,1720.0,1979,3020,9747,15772 days 16:47:18.672858,289,1.7142857142857142,1.1337209302325582,650,2137,230.0
940000.0,4,2.75,3270,9231,2.0,3,1,3270,0.0,1995,3380,10154,9928 days 16:47:18.672858,076,1.4545454545454546,0.0,-110,-923,3270.0
465000.0,3,1.0,1210,4872,1.0,4,6,1210,0.0,1949,1070,4872,26729 days 16:47:18.672858,121,3.0,0.0,140,0,1210.0
241000.0,3,2.0,1770,7000,1.0,3,7,1770,0.0,1986,1510,10462,13215 days 16:47:18.672858,182,1.5,0.0,260,-3462,1770.0
307550.0,4,2.5,1980,5909,2.0,3,8,1980,0.0,2003,2550,5487,7006 days 16:47:18.672858,160,1.6,0.0,-570,422,1980.0
490000.0,4,2.5,2650,9627,1.0,4,8,1610,1040.0,1976,2650,9221,16868 days 16:47:18.672858,304,1.6,1.5480769230769231,0,406,570.0
647000.0,4,2.5,3040,6887,2.0,3,8,3040,0.0,1999,2790,7196,8467 days 16:47:18.672858,132,1.6,0.0,250,-309,3040.0
780000.0,4,2.75,3640,231739,1.5,3,1,3640,0.0,1999,2670,91040,8467 days 16:47:18.672858,239,1.4545454545454546,0.0,970,140699,3640.0
517500.0,3,2.5,1810,4332,2.0,3,8,1810,0.0,1992,1740,4332,11024 days 16:47:18.672858,318,1.2,0.0,70,0,1810.0
295000.0,3,2.0,1380,8682,1.0,4,7,1380,0.0,1966,1410,10594,20520 days 16:47:18.672858,169,1.5,0.0,-30,-1912,1380.0
560000.0,4,1.5,1810,3400,2.0,3,8,1810,0.0,1926,1770,3600,35130 days 16:47:18.672858,338,2.6666666666666665,0.0,40,-200,1810.0
319450.0,5,2.0,2250,5472,1.5,5,7,1750,500.0,1930,1540,5472,33669 days 16:47:18.672858,309,2.5,3.5,710,0,1250.0
1500000.0,4,3.25,3860,7199,2.0,3,9,2870,990.0,2005,2940,9600,6275 days 16:47:18.672858,346,1.2307692307692308,2.898989898989899,920,-2401,1880.0
340000.0,4,3.0,2380,20277,1.0,3,8,1500,880.0,1999,2370,15440,8467 days 16:47:18.672858,262,1.3333333333333333,1.7045454545454546,10,4837,620.0
249950.0,3,1.0,1370,11658,1.0,4,6,1370,0.0,1958,1080,9198,23442 days 16:47:18.672858,227,3.0,0.0,290,2460,1370.0
499950.0,3,1.0,1830,3000,1.5,3,7,1430,400.0,1926,1510,2500,35130 days 16:47:18.672858,164,3.0,3.575,320,500,1030.0
1040000.0,4,1.75,1440,13296,1.0,4,8,1440,0.0,1967,3520,10802,20155 days 16:47:18.672858,183,2.2857142857142856,0.0,-2080,2494,1440.0
750000.0,4,2.5,2510,17200,1.0,4,9,1540,970.0,1977,2370,14621,16502 days 16:47:18.672858,047,1.6,1.5876288659793814,140,2579,570.0
875000.0,4,2.5,3230,256132,2.0,3,9,3230,0.0,2006,3080,217800,5910 days 16:47:18.672858,082,1.6,0.0,150,38332,3230.0
678000.0,3,1.75,1670,7210,1.0,5,8,1670,0.0,1967,2200,7210,20155 days 16:47:18.672858,104,1.7142857142857142,0.0,-530,0,1670.0
360000.0,2,1.0,780,4200,1.0,3,6,780,0.0,1920,1620,6000,37322 days 16:47:18.672858,210,2.0,0.0,-840,-1800,780.0
354900.0,3,1.0,1720,16552,1.0,4,7,1720,0.0,1971,1550,15457,18694 days 16:47:18.672858,266,3.0,0.0,170,1095,1720.0
632000.0,5,2.5,2260,10087,1.0,3,8,1520,740.0,1967,2500,9440,20155 days 16:47:18.672858,239,2.0,2.054054054054054,-240,647,780.0
350000.0,3,1.75,1480,9375,1.0,4,7,1480,0.0,1957,1370,9000,23807 days 16:47:18.672858,352,1.7142857142857142,0.0,110,375,1480.0
990000.0,3,4.0,2550,3900,2.0,3,8,2050,500.0,1940,2340,6400,30017 days 16:47:18.672858,211,0.75,4.1,210,-2500,1550.0
481000.0,4,2.5,2286,8269,2.0,3,8,2286,0.0,2002,2110,4711,7371 days 16:47:18.672858,188,1.6,0.0,176,3558,2286.0
485000.0,3,2.5,1500,5412,1.0,5,7,900,600.0,1920,1090,5412,37322 days 16:47:18.672858,175,1.2,1.5,410,0,300.0
477000.0,3,2.5,1740,4960,2.0,3,8,1740,0.0,1992,1740,5021,11024 days 16:47:18.672858,103,1.2,0.0,0,-61,1740.0
560000.0,5,2.5,2880,9000,1.0,5,8,1440,1440.0,1966,2010,9000,20520 days 16:47:18.672858,210,2.0,1.0,870,0,0.0
600000.0,6,3.0,2600,9350,1.0,4,8,1340,1260.0,1963,2090,9102,21616 days 16:47:18.672858,321,2.0,1.0634920634920635,510,248,80.0
622500.0,5,2.75,3320,23760,2.0,4,8,2190,1130.0,1975,2520,36720,17233 days 16:47:18.672858,164,1.8181818181818181,1.9380530973451326,800,-12960,1060.0
410000.0,2,2.25,1660,2128,2.0,4,8,1660,0.0,1974,1640,2128,17598 days 16:47:18.672858,119,0.8888888888888888,0.0,20,0,1660.0
318200.0,3,2.5,1990,3644,2.0,3,7,1990,0.0,2010,2580,3800,4449 days 16:47:18.672858,092,1.2,0.0,-590,-156,1990.0
289000.0,3,2.0,1680,8424,1.0,3,7,1680,0.0,1993,1990,8545,10658 days 16:47:18.672858,156,1.5,0.0,-310,-121,1680.0
263000.0,3,1.75,1570,7775,2.0,3,7,1570,0.0,1982,1580,8622,14676 days 16:47:18.672858,140,1.7142857142857142,0.0,-10,-847,1570.0
240000.0,3,1.0,1150,4825,1.0,4,6,1150,0.0,1957,1760,7121,23807 days 16:47:18.672858,156,3.0,0.0,-610,-2296,1150.0
281500.0,3,1.0,1270,7500,1.0,3,7,1270,0.0,1953,1340,3000,25268 days 16:47:18.672858,097,3.0,0.0,-70,4500,1270.0
587206.0,3,3.5,1890,1710,2.0,3,8,1640,250.0,1999,1680,1562,8467 days 16:47:18.672858,171,0.8571428571428571,6.56,210,148,1390.0
482000.0,2,2.25,1350,1248,2.0,3,7,1180,170.0,2000,1760,3360,8102 days 16:47:18.672858,211,0.8888888888888888,6.9411764705882355,-410,-2112,1010.0
485000.0,3,1.75,1650,9500,1.0,3,8,1650,0.0,1967,1880,9375,20155 days 16:47:18.672858,069,1.7142857142857142,0.0,-230,125,1650.0
309000.0,3,2.5,1450,11480,2.0,3,7,1450,0.0,1990,2080,87991,11754 days 16:47:18.672858,043,1.2,0.0,-630,-76511,1450.0
221000.0,3,2.25,1640,7350,1.0,3,7,1140,500.0,1984,1480,8041,13946 days 16:47:18.672858,170,1.3333333333333333,2.28,160,-691,640.0
700000.0,3,2.5,2030,8398,2.0,4,9,2030,0.0,1975,2450,8104,17233 days 16:47:18.672858,133,1.2,0.0,-420,294,2030.0
411500.0,5,3.0,2420,7740,1.0,5,7,1360,1060.0,1929,1840,6780,34034 days 16:47:18.672858,272,1.6666666666666667,1.2830188679245282,580,960,300.0
285000.0,4,3.5,2770,10505,2.0,3,8,2770,0.0,1940,1760,10505,30017 days 16:47:18.672858,301,1.1428571428571428,0.0,1010,0,2770.0
395000.0,4,3.0,1980,7931,1.0,4,7,1160,820.0,1983,1910,7931,14311 days 16:47:18.672858,156,1.3333333333333333,1.4146341463414633,70,0,340.0
237950.0,2,1.75,1460,7926,1.0,4,7,1460,0.0,1987,1680,8206,12850 days 16:47:18.672858,190,1.1428571428571428,0.0,-220,-280,1460.0
680000.0,3,2.5,1610,8064,1.0,4,7,1160,450.0,1981,2260,8328,15041 days 16:47:18.672858,069,1.2,2.577777777777778,-650,-264,710.0
199950.0,2,1.0,1010,10057,1.0,3,6,1010,0.0,1961,1040,8591,22346 days 16:47:18.672858,360,2.0,0.0,-30,1466,1010.0
765000.0,4,3.5,2760,4000,2.0,3,8,2000,760.0,1926,1690,4000,35130 days 16:47:18.672858,346,1.1428571428571428,2.6315789473684212,1070,0,1240.0
515000.0,2,1.0,1060,4960,1.0,3,7,1060,0.0,1926,1420,4960,35130 days 16:47:18.672858,128,2.0,0.0,-360,0,1060.0
470000.0,3,1.5,1510,8000,1.0,4,7,1510,0.0,1956,1430,8000,24173 days 16:47:18.672858,167,2.0,0.0,80,0,1510.0
330000.0,2,1.0,880,4000,1.0,3,6,780,100.0,1937,950,4000,31112 days 16:47:18.672858,232,2.0,7.8,-70,0,680.0
284000.0,3,2.5,2150,9375,1.0,3,8,1550,600.0,1968,1950,9100,19790 days 16:47:18.672858,057,1.2,2.5833333333333335,200,275,950.0
295000.0,3,2.5,1660,8125,1.0,3,7,1150,510.0,1999,1250,8125,8467 days 16:47:18.672858,255,1.2,2.2549019607843137,410,0,640.0
555000.0,4,2.5,2160,10987,1.0,4,8,1440,720.0,1981,1280,11617,15041 days 16:47:18.672858,089,1.6,2.0,880,-630,720.0
350000.0,3,1.0,1370,8162,1.5,3,6,1370,0.0,1949,1560,8250,26729 days 16:47:18.672858,218,3.0,0.0,-190,-88,1370.0
240000.0,3,2.25,1460,5818,1.0,3,7,1140,320.0,1986,1490,6031,13215 days 16:47:18.672858,337,1.3333333333333333,3.5625,-30,-213,820.0
419900.0,3,1.5,1450,7000,1.0,3,7,1450,0.0,1955,1490,7245,24538 days 16:47:18.672858,035,2.0,0.0,-40,-245,1450.0
528000.0,3,2.0,1560,6300,1.0,3,7,1560,0.0,1924,1620,6300,35861 days 16:47:18.672858,120,1.5,0.0,-60,0,1560.0
481000.0,4,2.5,2480,9869,1.0,4,8,1240,1240.0,1963,2230,10310,21616 days 16:47:18.672858,070,1.6,1.0,250,-441,0.0
304700.0,2,1.0,740,5995,1.0,4,7,740,0.0,1949,1140,5995,26729 days 16:47:18.672858,160,2.0,0.0,-400,0,740.0
715000.0,4,2.5,2927,12171,2.0,3,1,2927,0.0,1998,2967,12166,8832 days 16:47:18.672858,035,1.6,0.0,-40,5,2927.0
738950.0,4,2.75,2260,12005,1.0,4,8,2260,0.0,1956,1870,10800,24173 days 16:47:18.672858,232,1.4545454545454546,0.0,390,1205,2260.0
215000.0,3,1.5,1240,9405,1.0,4,7,1240,0.0,1966,2260,7611,20520 days 16:47:18.672858,295,2.0,0.0,-1020,1794,1240.0
300000.0,6,2.0,2040,10812,1.0,4,5,2040,0.0,1943,1440,10200,28921 days 16:47:18.672858,142,3.0,0.0,600,612,2040.0
346000.0,3,1.75,1270,8100,1.0,3,6,880,390.0,1950,1650,8173,26364 days 16:47:18.672858,174,1.7142857142857142,2.2564102564102564,-380,-73,490.0
473000.0,4,3.5,4370,37193,2.0,3,8,2780,1590.0,1996,2860,39356,9563 days 16:47:18.672858,086,1.1428571428571428,1.748427672955975,1510,-2163,1190.0
500000.0,3,1.75,1700,6120,1.0,3,7,1700,0.0,1952,1330,6120,25634 days 16:47:18.672858,005,1.7142857142857142,0.0,370,0,1700.0
750000.0,2,1.5,1300,7632,1.0,3,7,1300,0.0,1943,1420,1676,28921 days 16:47:18.672858,268,1.3333333333333333,0.0,-120,5956,1300.0
519900.0,4,2.0,1820,9350,1.0,4,8,1820,0.0,1967,2260,9299,20155 days 16:47:18.672858,140,2.0,0.0,-440,51,1820.0
378500.0,2,1.0,880,6171,1.0,4,7,880,0.0,1949,2260,12769,26729 days 16:47:18.672858,231,2.0,0.0,-1380,-6598,880.0
314500.0,3,1.75,1870,12381,1.0,4,8,1870,0.0,1957,1950,12667,23807 days 16:47:18.672858,127,1.7142857142857142,0.0,-80,-286,1870.0
499950.0,3,1.5,1350,9315,1.0,3,7,1350,0.0,1968,1840,9920,19790 days 16:47:18.672858,119,2.0,0.0,-490,-605,1350.0
1740000.0,5,3.5,4870,7700,2.5,5,1,3650,1220.0,1929,3220,7700,34034 days 16:47:18.672858,337,1.4285714285714286,2.9918032786885247,1650,0,2430.0
630000.0,3,2.5,2460,38794,2.0,3,9,2460,0.0,1999,2470,51400,8467 days 16:47:18.672858,112,1.2,0.0,-10,-12606,2460.0
360000.0,4,1.5,1720,6417,1.0,3,7,1720,0.0,1953,1430,6240,25268 days 16:47:18.672858,174,2.6666666666666665,0.0,290,177,1720.0
460000.0,2,1.5,2730,19877,1.0,4,8,1570,1160.0,1976,1450,19509,16868 days 16:47:18.672858,146,1.3333333333333333,1.353448275862069,1280,368,410.0
361000.0,3,1.0,1100,4046,1.5,4,6,1100,0.0,1922,2550,7847,36591 days 16:47:18.672858,142,3.0,0.0,-1450,-3801,1100.0
713400.0,3,2.25,1810,9845,1.0,4,8,1810,0.0,1959,1900,10083,23077 days 16:47:18.672858,191,1.3333333333333333,0.0,-90,-238,1810.0
445000.0,2,1.0,930,3150,1.0,5,6,930,0.0,1918,1900,5000,38052 days 16:47:18.672858,301,2.0,0.0,-970,-1850,930.0
305000.0,4,1.5,1590,131551,1.0,4,7,1590,0.0,1966,2280,108028,20520 days 16:47:18.672858,134,2.6666666666666665,0.0,-690,23523,1590.0
1430000.0,3,2.75,2710,9204,1.5,3,9,1480,1230.0,1975,2960,10080,17233 days 16:47:18.672858,063,1.0909090909090908,1.2032520325203253,-250,-876,250.0
222000.0,3,1.0,1460,8400,1.0,4,6,1460,0.0,1962,1060,8563,21981 days 16:47:18.672858,114,3.0,0.0,400,-163,1460.0
510000.0,5,3.25,3400,4499,2.0,3,8,2740,660.0,2005,3400,6163,6275 days 16:47:18.672858,047,1.5384615384615385,4.151515151515151,0,-1664,2080.0
500000.0,5,3.0,2920,11440,2.0,3,8,2920,0.0,2003,1720,9348,7006 days 16:47:18.672858,155,1.6666666666666667,0.0,1200,2092,2920.0
605000.0,2,1.0,910,3600,1.0,4,7,910,0.0,1909,1720,3600,41339 days 16:47:18.672858,136,2.0,0.0,-810,0,910.0
393000.0,3,2.0,1320,10720,2.0,3,8,1320,0.0,1981,1910,13639,15041 days 16:47:18.672858,232,1.5,0.0,-590,-2919,1320.0
725000.0,4,2.5,2490,5170,2.0,4,9,2490,0.0,2000,2490,5170,8102 days 16:47:18.672858,176,1.6,0.0,0,0,2490.0
320000.0,3,1.75,2220,11646,1.0,3,7,1270,950.0,1950,1490,10003,26364 days 16:47:18.672858,188,1.7142857142857142,1.3368421052631578,730,1643,320.0
210000.0,4,1.5,1130,7840,1.0,4,7,1130,0.0,1970,1690,7840,19059 days 16:47:18.672858,163,2.6666666666666665,0.0,-560,0,1130.0
419900.0,4,2.5,2750,5767,2.0,3,9,2750,0.0,2005,2800,5376,6275 days 16:47:18.672858,210,1.6,0.0,-50,391,2750.0
410000.0,4,2.5,2240,4447,2.0,3,7,2240,0.0,2006,2000,3800,5910 days 16:47:18.673855,061,1.6,0.0,240,647,2240.0
721000.0,3,2.25,2680,10440,1.0,3,8,1540,1140.0,1963,2140,7560,21616 days 16:47:18.673855,350,1.3333333333333333,1.3508771929824561,540,2880,400.0
605000.0,2,2.0,1270,5500,1.5,4,8,1270,0.0,1921,1870,4400,36956 days 16:47:18.673855,195,1.0,0.0,-600,1100,1270.0
738000.0,3,1.75,1520,5500,1.5,5,7,1520,0.0,1936,2310,5500,31478 days 16:47:18.673855,337,1.7142857142857142,0.0,-790,0,1520.0
725000.0,6,3.0,2480,12000,2.0,3,8,2480,0.0,1972,2220,8580,18329 days 16:47:18.673855,092,2.0,0.0,260,3420,2480.0
255000.0,2,1.0,960,20954,1.0,3,7,960,0.0,1977,1240,9752,16502 days 16:47:18.673855,231,2.0,0.0,-280,11202,960.0
303000.0,3,2.25,1340,873,3.0,3,8,1340,0.0,2009,1340,1186,4814 days 16:47:18.673855,079,1.3333333333333333,0.0,0,-313,1340.0
394950.0,3,2.5,1090,7700,1.0,4,7,1090,0.0,1957,1740,7700,23807 days 16:47:18.673855,204,1.2,0.0,-650,0,1090.0
530000.0,4,3.0,2240,5580,2.0,5,7,1830,410.0,1949,1530,4800,26729 days 16:47:18.673855,245,1.3333333333333333,4.463414634146342,710,780,1420.0
475000.0,4,2.5,3740,8700,1.0,3,1,2260,1480.0,2004,2650,6333,6641 days 16:47:18.673855,133,1.6,1.527027027027027,1090,2367,780.0
250000.0,4,2.5,1800,8100,2.0,3,7,1800,0.0,1998,1590,8100,8832 days 16:47:18.673855,168,1.6,0.0,210,0,1800.0
180000.0,3,1.0,780,3540,1.0,2,6,780,0.0,1920,1260,3540,37322 days 16:47:18.673855,342,3.0,0.0,-480,0,780.0
443500.0,2,1.0,1330,4140,1.0,4,7,930,400.0,1919,1410,5100,37687 days 16:47:18.673855,216,2.0,2.325,-80,-960,530.0
390000.0,4,2.0,1900,76877,1.0,3,8,1900,0.0,2004,1740,34848,6641 days 16:47:18.673855,184,2.0,0.0,160,42029,1900.0
430000.0,4,1.75,1570,7650,1.0,3,7,1100,470.0,1975,1580,7650,17233 days 16:47:18.673855,051,2.2857142857142856,2.3404255319148937,-10,0,630.0
460000.0,5,4.5,3100,7260,2.0,3,8,3100,0.0,1963,1650,7700,21616 days 16:47:18.673855,056,1.1111111111111112,0.0,1450,-440,3100.0
660000.0,3,3.5,2740,3785,2.0,3,9,2190,550.0,2001,2060,3457,7736 days 16:47:18.673855,071,0.8571428571428571,3.981818181818182,680,328,1640.0
515000.0,3,1.75,1570,10939,1.0,3,8,1200,370.0,1974,1760,10200,17598 days 16:47:18.673855,210,1.7142857142857142,3.2432432432432434,-190,739,830.0
482500.0,3,2.0,1330,6490,1.0,4,7,1330,0.0,1954,1580,7202,24903 days 16:47:18.673855,111,1.5,0.0,-250,-712,1330.0
305000.0,2,1.5,1140,2980,2.0,3,7,1140,0.0,1988,1150,2981,12485 days 16:47:18.673855,153,1.3333333333333333,0.0,-10,-1,1140.0
237000.0,3,2.0,1290,7952,1.0,3,7,1290,0.0,1998,1670,7280,8832 days 16:47:18.673855,338,1.5,0.0,-380,672,1290.0
445000.0,2,1.5,1510,2001,2.0,4,8,1510,0.0,1985,1510,2055,13580 days 16:47:18.673855,330,1.3333333333333333,0.0,0,-54,1510.0
710000.0,4,2.5,2720,8000,1.0,4,7,1360,1360.0,1955,1790,8000,24538 days 16:47:18.673855,096,1.6,1.0,930,0,0.0
180000.0,3,1.0,840,5700,1.0,4,5,840,0.0,1945,1430,12600,28190 days 16:47:18.673855,233,3.0,0.0,-590,-6900,840.0
280017.0,3,2.5,1850,8770,2.0,3,8,1850,0.0,1996,2350,8606,9563 days 16:47:18.673855,296,1.2,0.0,-500,164,1850.0
436500.0,4,2.5,2290,11173,2.0,4,8,2290,0.0,1988,2290,10404,12485 days 16:47:18.673855,181,1.6,0.0,0,769,2290.0
1260000.0,4,2.5,3200,7535,2.0,3,9,3200,0.0,2006,1650,6850,5910 days 16:47:18.673855,135,1.6,0.0,1550,685,3200.0
420000.0,3,2.25,1800,9800,1.0,4,7,1300,500.0,1959,1680,9545,23077 days 16:47:18.673855,352,1.3333333333333333,2.6,120,255,800.0
205000.0,3,1.0,860,7467,1.0,3,6,860,0.0,1944,1280,7467,28556 days 16:47:18.673855,200,3.0,0.0,-420,0,860.0
570000.0,3,1.5,1980,10203,1.0,4,7,1680,300.0,1946,1980,13664,27825 days 16:47:18.673855,245,2.0,5.6,0,-3461,1380.0
565000.0,4,1.75,2140,7102,1.0,4,7,1070,1070.0,1948,1950,7102,27095 days 16:47:18.673855,192,2.2857142857142856,1.0,190,0,0.0
287000.0,2,2.5,2410,7500,1.0,3,7,1550,860.0,1978,1840,8800,16137 days 16:47:18.673855,345,0.8,1.802325581395349,570,-1300,690.0
260000.0,4,1.75,1650,7276,1.0,3,7,1010,640.0,1977,1840,8550,16502 days 16:47:18.673855,266,2.2857142857142856,1.578125,-190,-1274,370.0
470000.0,4,1.75,1650,7276,1.0,3,7,1010,640.0,1977,1840,8550,16502 days 16:47:18.673855,037,2.2857142857142856,1.578125,-190,-1274,370.0
700000.0,3,2.5,2410,9916,2.0,4,1,2410,0.0,1989,2310,8212,12119 days 16:47:18.673855,248,1.2,0.0,100,1704,2410.0
249000.0,3,1.75,1520,7500,1.0,3,8,1520,0.0,1985,2180,7506,13580 days 16:47:18.673855,056,1.7142857142857142,0.0,-660,-6,1520.0
568000.0,3,1.75,2050,3520,1.0,4,7,1070,980.0,1977,2050,16083,16502 days 16:47:18.673855,160,1.7142857142857142,1.0918367346938775,0,-12563,90.0
500000.0,4,1.0,1720,4011,1.5,4,7,1720,0.0,1904,1580,3784,43166 days 16:47:18.673855,157,4.0,0.0,140,227,1720.0
358000.0,5,2.5,2390,8775,1.0,4,7,1270,1120.0,1980,1800,8000,15407 days 16:47:18.673855,330,2.0,1.1339285714285714,590,775,150.0
225000.0,3,2.5,1680,6755,2.0,3,8,1680,0.0,1994,1860,7257,10293 days 16:47:18.673855,148,1.2,0.0,-180,-502,1680.0
275500.0,3,1.0,1060,7246,1.0,4,6,1060,0.0,1981,1090,6694,15041 days 16:47:18.673855,057,3.0,0.0,-30,552,1060.0
495000.0,3,2.5,1860,3150,2.0,3,8,1860,0.0,2001,2050,3375,7736 days 16:47:18.673855,033,1.2,0.0,-190,-225,1860.0
758800.0,5,2.25,1750,5000,1.0,3,8,960,790.0,1940,2580,5000,30017 days 16:47:18.673855,085,2.2222222222222223,1.2151898734177216,-830,0,170.0
280000.0,3,1.75,1480,8165,1.0,4,7,1480,0.0,1985,1450,7939,13580 days 16:47:18.673855,093,1.7142857142857142,0.0,30,226,1480.0
380500.0,3,2.5,1900,7361,2.0,3,8,1900,0.0,1994,2100,7361,10293 days 16:47:18.673855,056,1.2,0.0,-200,0,1900.0
3200000.0,7,4.5,6210,8856,2.5,5,1,4760,1450.0,1910,2940,5400,40974 days 16:47:18.673855,127,1.5555555555555556,3.282758620689655,3270,3456,3310.0
260000.0,3,1.75,1440,12888,1.0,3,7,1090,350.0,1958,1710,12888,23442 days 16:47:18.673855,168,1.7142857142857142,3.1142857142857143,-270,0,740.0
630000.0,4,2.5,1910,1502,3.0,3,8,1910,0.0,2014,1520,3888,2988 days 16:47:18.673855,217,1.6,0.0,390,-2386,1910.0
875000.0,3,2.0,2010,4000,1.0,5,7,1210,800.0,1915,1770,4000,39148 days 16:47:18.673855,232,1.5,1.5125,240,0,410.0
457500.0,3,1.0,960,4600,1.5,4,6,960,0.0,1927,1380,5175,34765 days 16:47:18.673855,093,3.0,0.0,-420,-575,960.0
900000.0,2,1.0,1240,5500,1.0,3,7,1240,0.0,1954,2080,4400,24903 days 16:47:18.673855,323,2.0,0.0,-840,1100,1240.0
235000.0,2,2.0,870,6450,1.0,4,6,740,130.0,1954,1640,5775,24903 days 16:47:18.673855,301,1.0,5.6923076923076925,-770,675,610.0
410000.0,3,2.0,1400,45738,2.0,4,8,1400,0.0,1981,2390,56628,15041 days 16:47:18.673855,178,1.5,0.0,-990,-10890,1400.0
355000.0,3,3.0,1850,9600,1.0,3,7,1230,620.0,1981,1970,10000,15041 days 16:47:18.673855,239,1.0,1.9838709677419355,-120,-400,610.0
1300000.0,4,4.0,4270,6002,2.0,3,1,3180,1090.0,2004,4280,5942,6641 days 16:47:18.673855,157,1.0,2.9174311926605503,-10,60,2090.0
467500.0,3,1.75,2260,8512,1.0,3,7,1130,1130.0,1948,2240,8040,27095 days 16:47:18.673855,272,1.7142857142857142,1.0,20,472,0.0
500000.0,4,4.5,2690,7350,1.5,5,7,2690,0.0,1949,1660,9000,26729 days 16:47:18.673855,329,0.8888888888888888,0.0,1030,-1650,2690.0
995000.0,4,3.5,2780,9550,2.0,5,1,2530,250.0,1978,2724,10634,16137 days 16:47:18.673855,106,1.1428571428571428,10.12,56,-1084,2280.0
277000.0,3,1.0,1140,8144,1.0,3,7,1140,0.0,1956,1150,8144,24173 days 16:47:18.673855,239,3.0,0.0,-10,0,1140.0
630000.0,4,2.25,2900,9680,2.0,3,7,1990,910.0,1947,1850,7540,27460 days 16:47:18.673855,351,1.7777777777777777,2.1868131868131866,1050,2140,1080.0
628000.0,5,2.75,2830,11795,1.0,4,7,1710,1120.0,1960,2460,10880,22712 days 16:47:18.673855,325,1.8181818181818181,1.5267857142857142,370,915,590.0
655000.0,5,2.5,2560,46786,2.0,3,8,2560,0.0,1995,2430,46929,9928 days 16:47:18.673855,226,2.0,0.0,130,-143,2560.0
170000.0,2,1.0,1240,9900,1.0,3,7,940,300.0,1950,1050,9375,26364 days 16:47:18.673855,022,2.0,3.1333333333333333,190,525,640.0
352500.0,4,2.5,2100,10750,1.0,4,8,2100,0.0,1967,2310,10425,20155 days 16:47:18.673855,351,1.6,0.0,-210,325,2100.0
615000.0,4,2.75,3120,34040,2.0,3,9,3120,0.0,1997,2420,25201,9197 days 16:47:18.673855,050,1.4545454545454546,0.0,700,8839,3120.0
165000.0,3,1.0,970,6600,1.0,3,7,970,0.0,1965,1200,6600,20885 days 16:47:18.673855,161,3.0,0.0,-230,0,970.0
243500.0,4,2.5,2300,15188,2.0,4,7,2300,0.0,1966,1820,10125,20520 days 16:47:18.673855,266,1.6,0.0,480,5063,2300.0
304000.0,2,1.5,950,676,2.0,3,7,850,100.0,2003,950,1280,7006 days 16:47:18.673855,218,1.3333333333333333,8.5,0,-604,750.0
369000.0,3,1.5,2110,5195,1.0,3,7,1210,900.0,1959,1950,5195,23077 days 16:47:18.673855,289,2.0,1.3444444444444446,160,0,310.0
779950.0,4,2.75,2990,4298,2.0,3,9,2990,0.0,2014,2990,4837,2988 days 16:47:18.673855,280,1.4545454545454546,0.0,0,-539,2990.0
605000.0,4,2.25,2940,48788,1.0,5,7,1520,1420.0,1961,2470,14900,22346 days 16:47:18.673855,183,1.7777777777777777,1.0704225352112675,470,33888,100.0
292500.0,4,2.5,1860,8709,2.0,3,8,1860,0.0,1994,1990,6825,10293 days 16:47:18.673855,357,1.6,0.0,-130,1884,1860.0
500007.0,2,1.75,1820,6050,1.0,3,7,910,910.0,1950,1730,6050,26364 days 16:47:18.673855,082,1.1428571428571428,1.0,90,0,0.0
449999.0,4,2.5,1950,4947,2.0,3,8,1950,0.0,2000,1760,5611,8102 days 16:47:18.673855,119,1.6,0.0,190,-664,1950.0
258000.0,4,3.0,2710,7199,1.0,4,7,1710,1000.0,1967,2070,9271,20155 days 16:47:18.673855,329,1.3333333333333333,1.71,640,-2072,710.0
380000.0,4,2.25,2150,20181,1.0,3,7,1090,1060.0,1963,2150,10480,21616 days 16:47:18.673855,170,1.7777777777777777,1.028301886792453,0,9701,30.0
650000.0,4,3.0,3720,57499,1.0,3,9,1880,1840.0,2003,2560,26372,7006 days 16:47:18.673855,189,1.3333333333333333,1.0217391304347827,1160,31127,40.0
456500.0,4,2.5,2580,11780,2.0,3,9,2580,0.0,2003,2410,8403,7006 days 16:47:18.673855,134,1.6,0.0,170,3377,2580.0
259950.0,4,2.0,1540,10212,1.5,5,7,1540,0.0,1948,1480,10212,27095 days 16:47:18.673855,237,2.0,0.0,60,0,1540.0
123000.0,2,1.0,1050,6600,1.5,3,6,1050,0.0,1964,1330,6600,21251 days 16:47:18.673855,183,2.0,0.0,-280,0,1050.0
520000.0,3,2.25,1210,1250,3.0,3,8,1210,0.0,2014,1780,5000,2988 days 16:47:18.673855,211,1.3333333333333333,0.0,-570,-3750,1210.0
506000.0,4,2.25,2040,12000,1.0,4,7,1300,740.0,1963,1930,12000,21616 days 16:47:18.673855,106,1.7777777777777777,1.7567567567567568,110,0,560.0
425000.0,3,1.0,980,4800,1.5,3,7,980,0.0,1926,2030,7200,35130 days 16:47:18.673855,211,3.0,0.0,-1050,-2400,980.0
438000.0,5,2.5,1990,6840,2.0,4,7,1990,0.0,1974,1990,7150,17598 days 16:47:18.673855,339,2.0,0.0,0,-310,1990.0
1490000.0,4,2.5,2420,18480,1.0,4,9,2420,0.0,1967,3330,19910,20155 days 16:47:18.673855,029,1.6,0.0,-910,-1430,2420.0
375000.0,4,2.0,1240,3000,1.0,3,7,1040,200.0,1908,1480,3500,41705 days 16:47:18.673855,167,2.0,5.2,-240,-500,840.0
337500.0,3,2.25,1530,6600,1.0,4,7,1240,290.0,1968,1500,7700,19790 days 16:47:18.673855,119,1.3333333333333333,4.275862068965517,30,-1100,950.0
300000.0,4,2.25,2080,7700,1.0,3,7,1450,630.0,1968,1900,7980,19790 days 16:47:18.673855,273,1.7777777777777777,2.3015873015873014,180,-280,820.0
627000.0,5,3.25,3570,5425,2.0,3,7,3570,0.0,2005,2690,5347,6275 days 16:47:18.673855,209,1.5384615384615385,0.0,880,78,3570.0
1400000.0,5,4.25,4230,6907,2.0,3,1,3450,780.0,2008,2650,8076,5180 days 16:47:18.673855,295,1.1764705882352942,4.423076923076923,1580,-1169,2670.0
674725.0,4,2.5,2700,10160,2.0,3,9,2700,0.0,1988,2760,9219,12485 days 16:47:18.673855,132,1.6,0.0,-60,941,2700.0
325000.0,3,2.75,2200,7000,1.0,4,7,1280,920.0,1977,1670,7000,16502 days 16:47:18.673855,169,1.0909090909090908,1.391304347826087,530,0,360.0
230000.0,5,2.0,1210,12538,2.0,3,7,1210,0.0,1982,1510,7700,14676 days 16:47:18.673855,092,2.5,0.0,-300,4838,1210.0
485000.0,5,1.75,2140,43124,1.0,4,7,1220,920.0,1962,2520,14677,21981 days 16:47:18.673855,210,2.857142857142857,1.326086956521739,-380,28447,300.0
315000.0,4,2.5,2740,8400,1.5,3,8,2740,0.0,1993,2030,8638,10658 days 16:47:18.673855,266,1.6,0.0,710,-238,2740.0
560000.0,3,2.75,1370,1193,3.0,3,8,1370,0.0,2003,1320,1180,7006 days 16:47:18.673855,093,1.0909090909090908,0.0,50,13,1370.0
444000.0,4,3.0,2800,7198,2.0,3,8,2800,0.0,2002,3610,7845,7371 days 16:47:18.673855,224,1.3333333333333333,0.0,-810,-647,2800.0
325000.0,3,1.5,1060,7488,1.0,5,7,1060,0.0,1977,1300,6780,16502 days 16:47:18.673855,127,2.0,0.0,-240,708,1060.0
118125.0,2,1.0,790,7153,1.0,4,6,790,0.0,1944,810,7128,28556 days 16:47:18.673855,259,2.0,0.0,-20,25,790.0
212000.0,2,1.0,790,7153,1.0,4,6,790,0.0,1944,810,7128,28556 days 16:47:18.673855,014,2.0,0.0,-20,25,790.0
428900.0,4,2.5,2820,5056,2.0,3,9,2820,0.0,2006,2820,5150,5910 days 16:47:18.673855,068,1.6,0.0,0,-94,2820.0
510000.0,3,2.0,1850,9600,1.0,3,7,1850,0.0,1968,1770,9600,19790 days 16:47:18.673855,023,1.5,0.0,80,0,1850.0
416000.0,3,1.5,1110,9762,1.0,4,7,1110,0.0,1963,1900,9720,21616 days 16:47:18.673855,143,2.0,0.0,-790,42,1110.0
950000.0,4,3.0,3230,438213,2.0,3,9,3230,0.0,1999,1600,144619,8467 days 16:47:18.673855,282,1.3333333333333333,0.0,1630,293594,3230.0
204000.0,3,1.5,1460,7140,1.0,4,7,980,480.0,1980,1400,8572,15407 days 16:47:18.673855,058,2.0,2.0416666666666665,60,-1432,500.0
7700000.0,6,8.0,12050,27600,2.5,4,1,8570,3480.0,1910,3940,8800,40974 days 16:47:18.673855,286,0.75,2.4626436781609193,8110,18800,5090.0
878000.0,4,2.5,3480,13421,2.0,3,1,3480,0.0,1995,3290,9642,9928 days 16:47:18.673855,280,1.6,0.0,190,3779,3480.0
1050000.0,4,3.0,3560,4000,3.0,3,9,2970,590.0,1996,1190,4000,9563 days 16:47:18.673855,238,1.3333333333333333,5.033898305084746,2370,0,2380.0
350000.0,2,1.0,840,5551,1.0,3,6,840,0.0,1952,1270,4652,25634 days 16:47:18.673855,030,2.0,0.0,-430,899,840.0
659500.0,3,1.75,1820,5500,1.0,4,8,1620,200.0,1957,2330,6050,23807 days 16:47:18.673855,161,1.7142857142857142,8.1,-510,-550,1420.0
395000.0,3,2.5,1630,15200,1.0,3,7,1120,510.0,1988,2050,15200,12485 days 16:47:18.673855,072,1.2,2.196078431372549,-420,0,610.0
308950.0,4,2.5,1920,8562,2.0,4,7,1920,0.0,1994,1820,8628,10293 days 16:47:18.673855,189,1.6,0.0,100,-66,1920.0
410000.0,3,2.0,1750,2550,1.0,3,7,1750,0.0,1955,1370,1533,24538 days 16:47:18.673855,121,1.5,0.0,380,1017,1750.0
710000.0,4,3.0,2750,7500,1.0,5,8,1630,1120.0,1966,2440,7500,20520 days 16:47:18.673855,289,1.3333333333333333,1.4553571428571428,310,0,510.0
175000.0,1,1.0,620,8685,1.0,4,5,620,0.0,1976,1300,12150,16868 days 16:47:18.673855,118,1.0,0.0,-680,-3465,620.0
508800.0,3,2.0,1720,10098,1.0,4,8,1140,580.0,1981,1840,10098,15041 days 16:47:18.673855,086,1.5,1.9655172413793103,-120,0,560.0
606400.0,3,3.0,1800,5000,1.5,3,8,1500,300.0,1929,1670,5000,34034 days 16:47:18.673855,282,1.0,5.0,130,0,1200.0
245100.0,3,1.75,1300,7958,1.0,3,7,1300,0.0,1996,1640,8698,9563 days 16:47:18.673855,148,1.7142857142857142,0.0,-340,-740,1300.0
540000.0,3,2.5,1970,14876,1.0,3,7,1320,650.0,1981,2030,8008,15041 days 16:47:18.673855,121,1.2,2.0307692307692307,-60,6868,670.0
415000.0,3,1.5,1740,9046,1.0,3,7,1740,0.0,1956,1830,9513,24173 days 16:47:18.673855,127,2.0,0.0,-90,-467,1740.0
469500.0,4,2.75,1930,13041,1.0,4,8,1180,750.0,1980,1880,10234,15407 days 16:47:18.673855,005,1.4545454545454546,1.5733333333333333,50,2807,430.0
195000.0,3,1.75,1190,14777,1.0,4,7,1190,0.0,1965,2240,8325,20885 days 16:47:18.673855,310,1.7142857142857142,0.0,-1050,6452,1190.0
1620000.0,4,3.25,4250,12281,2.0,3,1,3020,1230.0,1996,4940,12941,9563 days 16:47:18.673855,279,1.2307692307692308,2.4552845528455283,-690,-660,1790.0
1450000.0,4,3.5,4360,24603,2.0,3,1,4360,0.0,1998,4770,27521,8832 days 16:47:18.673855,286,1.1428571428571428,0.0,-410,-2918,4360.0
1200000.0,3,2.5,3420,16622,1.0,3,1,2410,1010.0,1991,3460,14566,11389 days 16:47:18.673855,303,1.2,2.386138613861386,-40,2056,1400.0
1070000.0,4,3.75,4260,9800,2.0,3,1,4260,0.0,2008,1950,8970,5180 days 16:47:18.673855,190,1.0666666666666667,0.0,2310,830,4260.0
555500.0,2,1.0,920,10000,1.0,4,7,920,0.0,1981,1340,10000,15041 days 16:47:18.673855,127,2.0,0.0,-420,0,920.0
440000.0,3,1.0,1040,4000,1.0,3,7,1040,0.0,1950,1170,4000,26364 days 16:47:18.673855,132,3.0,0.0,-130,0,1040.0
485000.0,3,1.0,1260,7250,1.0,3,7,960,300.0,1940,1540,7250,30017 days 16:47:18.673855,113,3.0,3.2,-280,0,660.0
693000.0,3,2.5,2460,12028,2.0,3,9,2460,0.0,1996,2540,12229,9563 days 16:47:18.673855,151,1.2,0.0,-80,-201,2460.0
295000.0,3,1.0,830,3386,1.0,3,6,830,0.0,1942,1300,3844,29286 days 16:47:18.673855,205,3.0,0.0,-470,-458,830.0
700000.0,3,2.5,2060,10650,1.0,5,8,1050,1010.0,1976,2690,8850,16868 days 16:47:18.673855,089,1.2,1.0396039603960396,-630,1800,40.0
767500.0,2,1.75,2210,9374,1.0,4,8,1560,650.0,1951,2140,5640,25999 days 16:47:18.673855,350,1.1428571428571428,2.4,70,3734,910.0
800000.0,6,4.25,5480,189050,2.0,4,1,5140,340.0,1991,2470,10429,11389 days 16:47:18.673855,335,1.411764705882353,15.117647058823529,3010,178621,4800.0
440000.0,3,2.0,1860,217800,2.0,3,8,1860,0.0,1998,2500,217800,8832 days 16:47:18.673855,189,1.5,0.0,-640,0,1860.0
600000.0,3,2.5,1350,187313,1.0,4,7,1350,0.0,1997,2310,49222,9197 days 16:47:18.673855,302,1.2,0.0,-960,138091,1350.0
1160000.0,4,2.5,2790,5450,2.0,3,1,1930,860.0,1925,2320,5450,35495 days 16:47:18.673855,260,1.6,2.244186046511628,470,0,1070.0
506000.0,2,1.0,1570,8210,1.0,4,8,1150,420.0,1952,1680,8196,25634 days 16:47:18.673855,170,2.0,2.738095238095238,-110,14,730.0
474950.0,4,1.75,2030,15400,1.0,3,9,1130,900.0,1975,2040,12425,17233 days 16:47:18.673855,070,2.2857142857142856,1.2555555555555555,-10,2975,230.0
654000.0,3,2.5,2570,5500,1.0,4,7,1320,1250.0,1961,1460,6250,22346 days 16:47:18.673855,345,1.2,1.056,1110,-750,70.0
710000.0,2,1.0,1210,6000,1.0,4,7,1000,210.0,1942,1840,6000,29286 days 16:47:18.673855,254,2.0,4.761904761904762,-630,0,790.0
620000.0,4,2.25,1530,7845,1.0,4,7,1030,500.0,1981,1710,7627,15041 days 16:47:18.673855,223,1.7777777777777777,2.06,-180,218,530.0
390000.0,3,2.0,1510,10827,2.0,3,7,1510,0.0,1984,1900,10908,13946 days 16:47:18.673855,301,1.5,0.0,-390,-81,1510.0
550000.0,3,2.25,1720,9600,1.0,4,7,1220,500.0,1967,1720,9600,20155 days 16:47:18.673855,181,1.3333333333333333,2.44,0,0,720.0
353000.0,3,1.75,2190,7021,1.0,4,7,1390,800.0,1953,2180,7155,25268 days 16:47:18.673855,275,1.7142857142857142,1.7375,10,-134,590.0
465000.0,4,2.5,3030,47958,1.0,3,8,1660,1370.0,1980,2740,36017,15407 days 16:47:18.673855,239,1.6,1.2116788321167884,290,11941,290.0
279900.0,3,2.0,1410,6600,1.0,4,7,1410,0.0,1990,1750,7150,11754 days 16:47:18.673855,028,1.5,0.0,-340,-550,1410.0
700000.0,2,1.75,1679,577605,2.0,3,9,1679,0.0,2001,1850,358934,7736 days 16:47:18.673855,324,1.1428571428571428,0.0,-171,218671,1679.0
395000.0,4,1.0,1980,10350,1.0,4,7,1430,550.0,1968,1890,13140,19790 days 16:47:18.673855,170,4.0,2.6,90,-2790,880.0
375000.0,4,2.5,1900,9428,2.0,3,8,1900,0.0,1978,1830,10480,16137 days 16:47:18.673855,253,1.6,0.0,70,-1052,1900.0
547000.0,4,1.0,1720,2800,1.5,4,7,1200,520.0,1926,1530,3500,35130 days 16:47:18.673855,168,4.0,2.3076923076923075,190,-700,680.0
525000.0,5,3.25,2480,10277,2.0,5,8,1640,840.0,1993,2270,10277,10658 days 16:47:18.673855,093,1.5384615384615385,1.9523809523809523,210,0,800.0
285000.0,3,1.0,1210,4731,1.5,3,7,1210,0.0,1901,1450,5264,44261 days 16:47:18.673855,170,3.0,0.0,-240,-533,1210.0
570000.0,2,1.75,1540,4025,1.0,4,7,1190,350.0,1908,1950,4420,41705 days 16:47:18.673855,140,1.1428571428571428,3.4,-410,-395,840.0
409000.0,3,2.5,2740,9168,2.0,3,9,2740,0.0,1991,2690,10554,11389 days 16:47:18.673855,083,1.2,0.0,50,-1386,2740.0
260000.0,4,2.5,1811,4381,2.0,3,8,1811,0.0,2007,1811,4150,5545 days 16:47:18.673855,159,1.6,0.0,0,231,1811.0
348000.0,4,2.5,2720,7697,1.0,4,8,2120,600.0,1987,2340,7700,12850 days 16:47:18.673855,259,1.6,3.533333333333333,380,-3,1520.0
389000.0,4,1.0,1520,9800,1.5,4,7,1520,0.0,1971,1540,7700,18694 days 16:47:18.673855,218,4.0,0.0,-20,2100,1520.0
445000.0,4,2.75,2160,7200,1.0,4,7,1220,940.0,1976,1790,7614,16868 days 16:47:18.673855,351,1.4545454545454546,1.297872340425532,370,-414,280.0
400000.0,3,1.75,1390,4602,1.0,3,7,930,460.0,1981,1230,4800,15041 days 16:47:18.673855,202,1.7142857142857142,2.0217391304347827,160,-198,470.0
302000.0,4,2.5,1740,7895,2.0,3,7,1740,0.0,1999,1720,6813,8467 days 16:47:18.673855,258,1.6,0.0,20,1082,1740.0
798000.0,3,2.5,2849,9588,2.0,3,1,2849,0.0,2001,3190,8897,7736 days 16:47:18.673855,294,1.2,0.0,-341,691,2849.0
335000.0,2,1.0,1440,8842,1.0,3,7,840,600.0,1950,1650,8461,26364 days 16:47:18.673855,205,2.0,1.4,-210,381,240.0
585000.0,4,2.5,3000,6892,2.0,3,8,3000,0.0,2005,3000,6589,6275 days 16:47:18.673855,007,1.6,0.0,0,303,3000.0
2500000.0,4,4.0,3330,24354,1.0,4,1,3330,0.0,1961,3880,25493,22346 days 16:47:18.673855,118,1.0,0.0,-550,-1139,3330.0
555000.0,4,2.25,1720,2300,1.0,3,7,860,860.0,1940,1720,4680,30017 days 16:47:18.673855,335,1.7777777777777777,1.0,0,-2380,0.0
3100000.0,3,3.0,3920,13085,2.0,4,1,3920,0.0,1996,3450,13287,9563 days 16:47:18.673855,237,1.0,0.0,470,-202,3920.0
295000.0,3,2.5,1500,3060,2.0,3,7,1500,0.0,1994,2700,7734,10293 days 16:47:18.673855,049,1.2,0.0,-1200,-4674,1500.0
265000.0,4,1.5,2050,7100,1.0,3,7,1050,1000.0,1963,1950,7350,21616 days 16:47:18.673855,169,2.6666666666666665,1.05,100,-250,50.0
330000.0,4,2.0,1180,7275,1.0,3,7,1180,0.0,1965,1210,7275,20885 days 16:47:18.673855,005,2.0,0.0,-30,0,1180.0
286000.0,4,1.5,1600,5750,2.0,4,6,1600,0.0,1902,1690,5750,43896 days 16:47:18.673855,049,2.6666666666666665,0.0,-90,0,1600.0
970000.0,2,1.0,1290,5376,1.0,3,6,1290,0.0,1945,1180,5376,28190 days 16:47:18.673855,093,2.0,0.0,110,0,1290.0
525000.0,4,2.0,2680,14157,1.0,3,8,1460,1220.0,1966,2100,9199,20520 days 16:47:18.673855,104,2.0,1.1967213114754098,580,4958,240.0
355000.0,3,1.75,2370,9750,1.0,4,7,1280,1090.0,1979,1230,9775,15772 days 16:47:18.673855,336,1.7142857142857142,1.1743119266055047,1140,-25,190.0
469950.0,5,2.5,2310,8303,1.0,3,7,1300,1010.0,1975,1930,8303,17233 days 16:47:18.673855,283,2.0,1.2871287128712872,380,0,290.0
435000.0,4,1.0,1450,8800,1.0,4,7,1450,0.0,1954,1260,8942,24903 days 16:47:18.673855,122,4.0,0.0,190,-142,1450.0
363500.0,4,2.5,2680,7700,2.0,4,8,2680,0.0,1990,2400,7700,11754 days 16:47:18.673855,265,1.6,0.0,280,0,2680.0
595000.0,2,1.5,1030,4500,1.0,3,7,830,200.0,1924,1250,4000,35861 days 16:47:18.673855,143,1.3333333333333333,4.15,-220,500,630.0
275000.0,3,1.0,1320,11090,1.0,3,7,1320,0.0,1955,1320,8319,24538 days 16:47:18.673855,316,3.0,0.0,0,2771,1320.0
295000.0,2,1.0,670,7952,1.0,4,6,670,0.0,1942,1080,9525,29286 days 16:47:18.673855,098,2.0,0.0,-410,-1573,670.0
345000.0,3,2.25,2670,37089,2.0,3,9,2670,0.0,1990,2290,36284,11754 days 16:47:18.673855,016,1.3333333333333333,0.0,380,805,2670.0
485000.0,3,2.25,2440,47916,2.0,3,8,2090,350.0,1991,2150,24000,11389 days 16:47:18.673855,182,1.3333333333333333,5.9714285714285715,290,23916,1740.0
1250000.0,5,2.5,3370,8113,2.0,3,9,3370,0.0,2005,2470,8113,6275 days 16:47:18.673855,349,2.0,0.0,900,0,3370.0
340500.0,2,1.0,940,5413,1.0,3,7,940,0.0,1923,1340,5296,36226 days 16:47:18.673855,029,2.0,0.0,-400,117,940.0
449888.0,3,2.25,2520,78408,2.0,3,9,2520,0.0,1988,1490,29972,12485 days 16:47:18.673855,345,1.3333333333333333,0.0,1030,48436,2520.0
483000.0,2,1.75,1400,4720,1.0,4,7,820,580.0,1927,1330,6786,34765 days 16:47:18.673855,301,1.1428571428571428,1.4137931034482758,70,-2066,240.0
445500.0,3,1.75,1880,9360,1.0,4,7,940,940.0,1941,1390,7200,29651 days 16:47:18.673855,324,1.7142857142857142,1.0,490,2160,0.0
379900.0,5,3.5,2800,7350,2.0,3,7,2800,0.0,1995,2190,7620,9928 days 16:47:18.673855,168,1.4285714285714286,0.0,610,-270,2800.0
599950.0,4,3.5,2500,3080,2.0,3,8,1810,690.0,2008,2060,3295,5180 days 16:47:18.673855,183,1.1428571428571428,2.6231884057971016,440,-215,1120.0
215000.0,3,1.0,810,5240,1.0,3,6,810,0.0,1942,1700,5245,29286 days 16:47:18.673855,282,3.0,0.0,-890,-5,810.0
263000.0,3,2.5,1720,6847,2.0,3,7,1720,0.0,1987,1610,7790,12850 days 16:47:18.673855,199,1.2,0.0,110,-943,1720.0
565000.0,4,1.0,2170,12100,1.0,5,7,2170,0.0,1961,1270,12844,22346 days 16:47:18.673855,040,4.0,0.0,900,-744,2170.0
950000.0,5,3.0,4530,258746,1.5,4,9,3200,1330.0,2003,3430,83199,7006 days 16:47:18.673855,132,1.6666666666666667,2.406015037593985,1100,175547,1870.0
395000.0,4,1.0,1440,8320,1.5,3,7,1440,0.0,1946,1440,9230,27825 days 16:47:18.673855,252,4.0,0.0,0,-910,1440.0
1540000.0,4,3.25,2850,4100,2.0,3,1,1820,1030.0,1908,2130,4200,41705 days 16:47:18.673855,364,1.2307692307692308,1.766990291262136,720,-100,790.0
922000.0,4,2.5,2620,14126,1.0,4,8,1620,1000.0,1941,2620,8905,29651 days 16:47:18.673855,302,1.6,1.62,0,5221,620.0
330000.0,3,2.5,1676,18778,2.0,3,7,1676,0.0,1997,1410,18778,9197 days 16:47:18.673855,346,1.2,0.0,266,0,1676.0
1530000.0,4,3.75,5850,35070,2.0,4,1,4410,1440.0,1990,4830,36200,11754 days 16:47:18.673855,041,1.0666666666666667,3.0625,1020,-1130,2970.0
323000.0,3,1.75,1910,8329,1.0,3,8,1910,0.0,2004,2510,9259,6641 days 16:47:18.673855,343,1.7142857142857142,0.0,-600,-930,1910.0
554000.0,2,2.0,1670,4996,1.0,3,8,1670,0.0,2004,1670,4996,6641 days 16:47:18.673855,191,1.0,0.0,0,0,1670.0
500000.0,3,2.0,2050,11454,1.0,3,8,2050,0.0,1987,1980,11424,12850 days 16:47:18.673855,100,1.5,0.0,70,30,2050.0
775000.0,5,3.5,3730,16679,1.0,3,1,2760,970.0,1990,3280,16679,11754 days 16:47:18.673855,133,1.4285714285714286,2.845360824742268,450,0,1790.0
340000.0,4,1.75,1800,5210,1.0,5,7,1080,720.0,1979,1870,5365,15772 days 16:47:18.673855,196,2.2857142857142856,1.5,-70,-155,360.0
560000.0,4,1.75,2230,6838,1.0,3,7,1320,910.0,1985,1580,7500,13580 days 16:47:18.673855,096,2.2857142857142856,1.4505494505494505,650,-662,410.0
304000.0,3,2.5,1670,5298,2.0,3,8,1670,0.0,2002,1920,5298,7371 days 16:47:18.673855,096,1.2,0.0,-250,0,1670.0
279900.0,3,1.0,1400,10800,1.0,3,6,1400,0.0,1962,1430,10000,21981 days 16:47:18.673855,311,3.0,0.0,-30,800,1400.0
315000.0,5,3.0,2110,10766,2.0,3,7,2110,0.0,2005,1460,10400,6275 days 16:47:18.673855,063,1.6666666666666667,0.0,650,366,2110.0
849000.0,4,2.0,2160,6300,1.5,4,8,2160,0.0,1928,1980,5152,34400 days 16:47:18.673855,172,2.0,0.0,180,1148,2160.0
325000.0,3,1.75,2420,14862,1.0,3,8,1380,1040.0,1977,2550,14675,16502 days 16:47:18.673855,041,1.7142857142857142,1.3269230769230769,-130,187,340.0
786000.0,4,3.5,3320,8808,2.0,3,9,3320,0.0,2005,3160,9226,6275 days 16:47:18.673855,269,1.1428571428571428,0.0,160,-418,3320.0
384000.0,5,2.75,3220,8160,2.0,3,9,3220,0.0,1999,2876,11521,8467 days 16:47:18.673855,258,1.8181818181818181,0.0,344,-3361,3220.0
907000.0,3,1.5,1340,6000,1.5,3,9,1340,0.0,1927,2600,6000,34765 days 16:47:18.673855,328,2.0,0.0,-1260,0,1340.0
700000.0,3,2.5,2490,23891,2.0,3,9,2490,0.0,1993,2900,34705,10658 days 16:47:18.673855,183,1.2,0.0,-410,-10814,2490.0
269500.0,3,2.0,1640,8395,1.0,4,7,1640,0.0,1991,1510,7180,11389 days 16:47:18.673855,238,1.5,0.0,130,1215,1640.0
749950.0,4,2.5,3340,123600,2.0,3,1,3340,0.0,2005,3730,123600,6275 days 16:47:18.673855,315,1.6,0.0,-390,0,3340.0
325000.0,3,2.75,1580,4007,2.0,3,7,1580,0.0,2001,1770,3799,7736 days 16:47:18.673855,075,1.0909090909090908,0.0,-190,208,1580.0
1150000.0,3,1.5,2170,16600,1.0,3,1,1130,1040.0,1979,3130,13875,15772 days 16:47:18.673855,157,2.0,1.0865384615384615,-960,2725,90.0
406000.0,3,1.5,1370,7853,1.0,4,7,1370,0.0,1962,1730,9465,21981 days 16:47:18.673855,350,2.0,0.0,-360,-1612,1370.0
650000.0,4,2.5,2840,9354,2.0,3,1,2840,0.0,1990,2540,10200,11754 days 16:47:18.673855,157,1.6,0.0,300,-846,2840.0
295000.0,3,1.75,1940,7500,1.5,4,8,1940,0.0,1918,1650,7500,38052 days 16:47:18.673855,188,1.7142857142857142,0.0,290,0,1940.0
375000.0,4,2.0,1757,19370,1.0,5,7,1757,0.0,1955,1850,11125,24538 days 16:47:18.673855,282,2.0,0.0,-93,8245,1757.0
395000.0,2,1.0,980,5100,1.0,4,6,980,0.0,1907,1190,5100,42070 days 16:47:18.673855,058,2.0,0.0,-210,0,980.0
609000.0,6,3.0,2470,9267,2.0,3,8,2470,0.0,1982,2470,9151,14676 days 16:47:18.673855,365,2.0,0.0,0,116,2470.0
510000.0,3,1.75,1610,11950,1.0,3,7,1210,400.0,1984,1610,9363,13946 days 16:47:18.673855,253,1.7142857142857142,3.025,0,2587,810.0
190000.0,3,2.25,1590,11745,1.0,3,7,1090,500.0,1978,1540,12530,16137 days 16:47:18.673855,150,1.3333333333333333,2.18,50,-785,590.0
250000.0,1,1.0,780,1033,1.0,3,7,780,0.0,1922,1040,1319,36591 days 16:47:18.673855,217,1.0,0.0,-260,-286,780.0
295000.0,3,1.5,720,7450,1.0,1,5,720,0.0,1924,2600,7360,35861 days 16:47:18.673855,311,2.0,0.0,-1880,90,720.0
740000.0,3,1.5,1630,4080,1.5,4,8,1630,0.0,1927,1950,4080,34765 days 16:47:18.673855,111,2.0,0.0,-320,0,1630.0
323000.0,3,1.0,1590,7759,2.0,4,7,1590,0.0,1912,1600,7200,40244 days 16:47:18.673855,048,3.0,0.0,-10,559,1590.0
713000.0,3,2.75,2310,1850,2.0,3,1,2020,290.0,2011,2340,2155,4084 days 16:47:18.673855,062,1.0909090909090908,6.9655172413793105,-30,-305,1730.0
1070000.0,3,1.75,2320,6090,2.0,3,8,2040,280.0,1939,3110,7052,30382 days 16:47:18.673855,309,1.7142857142857142,7.285714285714286,-790,-962,1760.0
460000.0,3,1.75,1660,9900,2.0,3,8,1660,0.0,1978,1720,6600,16137 days 16:47:18.673855,300,1.7142857142857142,0.0,-60,3300,1660.0
880000.0,3,1.75,2070,5000,1.5,3,8,2070,0.0,1920,2630,5000,37322 days 16:47:18.673855,097,1.7142857142857142,0.0,-560,0,2070.0
585000.0,4,1.75,2500,7000,1.0,3,7,1250,1250.0,1947,1680,7000,27460 days 16:47:18.673855,061,2.2857142857142856,1.0,820,0,0.0
249950.0,2,1.0,940,8532,1.0,4,7,940,0.0,1959,1050,8100,23077 days 16:47:18.673855,142,2.0,0.0,-110,432,940.0
450000.0,3,2.5,1990,3478,2.0,3,1,1520,470.0,1990,1710,6157,11754 days 16:47:18.673855,311,1.2,3.234042553191489,280,-2679,1050.0
450000.0,3,2.5,2620,14096,2.0,4,9,2620,0.0,1989,3010,14096,12119 days 16:47:18.673855,269,1.2,0.0,-390,0,2620.0
1780000.0,4,3.25,3730,7071,3.0,3,1,3730,0.0,1985,3730,7680,13580 days 16:47:18.673855,007,1.2307692307692308,0.0,0,-609,3730.0
350000.0,3,3.25,1600,1298,3.0,3,8,1600,0.0,1999,1600,1348,8467 days 16:47:18.673855,266,0.9230769230769231,0.0,0,-50,1600.0
292500.0,3,2.5,2095,3438,2.0,3,7,2095,0.0,2008,1805,3402,5180 days 16:47:18.673855,084,1.2,0.0,290,36,2095.0
879000.0,4,2.75,4230,31747,2.0,4,1,4230,0.0,1985,4080,35576,13580 days 16:47:18.673855,177,1.4545454545454546,0.0,150,-3829,4230.0
1180000.0,4,2.5,3200,7500,1.5,5,8,1860,1340.0,1948,2500,6500,27095 days 16:47:18.673855,163,1.6,1.3880597014925373,700,1000,520.0
584999.0,4,2.75,2050,17859,1.0,4,7,1300,750.0,1967,2960,20908,20155 days 16:47:18.673855,044,1.4545454545454546,1.7333333333333334,-910,-3049,550.0
366000.0,4,2.75,2020,8093,1.0,5,7,1300,720.0,1961,1920,8089,22346 days 16:47:18.673855,324,1.4545454545454546,1.8055555555555556,100,4,580.0
987500.0,4,2.25,3270,15760,1.0,4,1,2000,1270.0,1974,4100,15760,17598 days 16:47:18.673855,008,1.7777777777777777,1.5748031496062993,-830,0,730.0
300000.0,3,1.0,1320,7200,1.0,4,7,1320,0.0,1959,1720,7249,23077 days 16:47:18.673855,082,3.0,0.0,-400,-49,1320.0
299000.0,2,1.75,1270,7800,1.0,4,7,890,380.0,1981,2020,8025,15041 days 16:47:18.673855,098,1.1428571428571428,2.3421052631578947,-750,-225,510.0
560000.0,4,1.75,1980,2700,1.5,3,8,1210,770.0,1931,1720,2910,33304 days 16:47:18.673855,195,2.2857142857142856,1.5714285714285714,260,-210,440.0
695000.0,3,2.5,2620,51354,2.0,3,9,2620,0.0,1998,2620,37042,8832 days 16:47:18.673855,182,1.2,0.0,0,14312,2620.0
360000.0,4,1.75,1750,18810,1.0,3,7,1220,530.0,1977,1840,17424,16502 days 16:47:18.673855,339,2.2857142857142856,2.30188679245283,-90,1386,690.0
183500.0,3,1.0,1040,8892,1.0,4,6,800,240.0,1958,820,9000,23442 days 16:47:18.673855,189,3.0,3.3333333333333335,220,-108,560.0
311000.0,3,1.75,1900,3000,1.5,5,7,1070,830.0,1903,1130,6000,43531 days 16:47:18.673855,170,1.7142857142857142,1.2891566265060241,770,-3000,240.0
263000.0,3,1.75,1660,7210,1.0,4,7,1660,0.0,1977,2150,7350,16502 days 16:47:18.673855,294,1.7142857142857142,0.0,-490,-140,1660.0
269000.0,3,1.75,1530,7930,1.0,5,7,1530,0.0,1986,1610,7930,13215 days 16:47:18.673855,055,1.7142857142857142,0.0,-80,0,1530.0
1600000.0,4,3.5,4280,9583,2.0,3,1,4280,0.0,2005,2360,10031,6275 days 16:47:18.673855,157,1.1428571428571428,0.0,1920,-448,4280.0
564000.0,4,2.5,2870,6658,2.0,3,8,2870,0.0,2004,2770,6658,6641 days 16:47:18.673855,062,1.6,0.0,100,0,2870.0
425000.0,3,2.5,2540,5612,2.0,3,9,2540,0.0,1999,2380,6303,8467 days 16:47:18.673855,171,1.2,0.0,160,-691,2540.0
679000.0,4,2.75,2100,4480,1.5,4,7,1780,320.0,1928,2050,4480,34400 days 16:47:18.673855,190,1.4545454545454546,5.5625,50,0,1460.0
410000.0,3,2.0,1740,9300,1.0,4,7,1740,0.0,1952,1540,9638,25634 days 16:47:18.673855,238,1.5,0.0,200,-338,1740.0
340000.0,4,2.5,2441,7316,2.0,3,8,2441,0.0,2007,2724,7357,5545 days 16:47:18.673855,293,1.6,0.0,-283,-41,2441.0
360000.0,3,1.75,1810,7200,1.0,5,7,1030,780.0,1959,1950,8384,23077 days 16:47:18.673855,131,1.7142857142857142,1.3205128205128205,-140,-1184,250.0
450000.0,3,1.5,2060,44866,1.0,3,8,2060,0.0,1953,2320,43995,25268 days 16:47:18.673855,140,2.0,0.0,-260,871,2060.0
552000.0,4,2.75,3160,8429,1.0,4,7,1620,1540.0,1982,1760,6780,14676 days 16:47:18.673855,085,1.4545454545454546,1.051948051948052,1400,1649,80.0
294000.0,4,2.0,2930,12840,1.5,4,8,2930,0.0,1965,1960,10920,20885 days 16:47:18.673855,217,2.0,0.0,970,1920,2930.0
663500.0,2,1.0,1310,5200,1.0,3,7,910,400.0,1946,1320,4794,27825 days 16:47:18.673855,072,2.0,2.275,-10,406,510.0
1980000.0,6,4.5,4800,9097,2.0,3,1,3580,1220.0,2007,2180,6037,5545 days 16:47:18.673855,191,1.3333333333333333,2.9344262295081966,2620,3060,2360.0
175409.0,4,1.5,1450,5530,1.0,4,6,1450,0.0,1969,1060,5200,19424 days 16:47:18.673855,281,2.6666666666666665,0.0,390,330,1450.0
459000.0,4,3.0,1900,9077,2.0,3,7,1900,0.0,1954,1900,12868,24903 days 16:47:18.673855,023,1.3333333333333333,0.0,0,-3791,1900.0
339950.0,3,1.0,1050,5402,1.5,4,7,1050,0.0,1906,1510,4685,42435 days 16:47:18.673855,134,3.0,0.0,-460,717,1050.0
393000.0,5,1.75,1610,15246,1.0,3,6,1610,0.0,1936,1410,10500,31478 days 16:47:18.673855,302,2.857142857142857,0.0,200,4746,1610.0
275500.0,2,1.0,720,11400,1.0,5,6,720,0.0,1951,1690,8075,25999 days 16:47:18.673855,178,2.0,0.0,-970,3325,720.0
485000.0,3,1.0,1020,9835,1.0,5,7,1020,0.0,1955,1210,9622,24538 days 16:47:18.673855,103,3.0,0.0,-190,213,1020.0
250000.0,3,1.0,1250,7920,1.0,4,7,1250,0.0,1960,1440,9648,22712 days 16:47:18.673855,203,3.0,0.0,-190,-1728,1250.0
935100.0,4,3.5,3200,8049,1.0,3,8,2700,500.0,1980,1640,8506,15407 days 16:47:18.673855,303,1.1428571428571428,5.4,1560,-457,2200.0
245000.0,3,1.0,990,9599,1.0,4,6,990,0.0,1959,1216,10364,23077 days 16:47:18.673855,104,3.0,0.0,-226,-765,990.0
670000.0,4,2.5,2850,25993,2.0,4,9,2850,0.0,1989,2480,12672,12119 days 16:47:18.673855,119,1.6,0.0,370,13321,2850.0
1390000.0,3,3.5,4240,21578,2.0,3,1,3500,740.0,1994,3120,16440,10293 days 16:47:18.673855,346,0.8571428571428571,4.72972972972973,1120,5138,2760.0
440000.0,4,1.75,2800,49149,1.0,4,7,1400,1400.0,1978,2560,61419,16137 days 16:47:18.673855,232,2.2857142857142856,1.0,240,-12270,0.0
1250000.0,2,2.5,2310,3313,2.0,3,9,2310,0.0,2006,2700,5670,5910 days 16:47:18.673855,281,0.8,0.0,-390,-2357,2310.0
203000.0,3,1.75,1490,8000,1.0,4,7,1200,290.0,1978,1540,8000,16137 days 16:47:18.673855,239,1.7142857142857142,4.137931034482759,-50,0,910.0
583000.0,4,2.5,1840,4011,2.0,3,9,1840,0.0,2005,2120,4011,6275 days 16:47:18.673855,244,1.6,0.0,-280,0,1840.0
575000.0,3,1.0,1740,9163,1.0,3,7,1740,0.0,1954,1490,6509,24903 days 16:47:18.673855,092,3.0,0.0,250,2654,1740.0
2580000.0,4,3.5,3280,3800,2.0,3,1,2880,400.0,2011,2050,3800,4084 days 16:47:18.673855,265,1.1428571428571428,7.2,1230,0,2480.0
1600000.0,5,3.5,4050,20925,2.0,3,1,3020,1030.0,1973,3880,18321,17963 days 16:47:18.673855,075,1.4285714285714286,2.9320388349514563,170,2604,1990.0
312500.0,4,2.5,2160,8755,2.0,3,7,2160,0.0,1993,1990,7971,10658 days 16:47:18.673855,106,1.6,0.0,170,784,2160.0
455000.0,3,2.75,2720,31314,3.0,3,8,2720,0.0,1986,2290,15188,13215 days 16:47:18.673855,223,1.0909090909090908,0.0,430,16126,2720.0
1310000.0,5,3.0,3650,16600,1.0,4,9,1860,1790.0,1978,3150,10400,16137 days 16:47:18.673855,329,1.6666666666666667,1.0391061452513966,500,6200,70.0
325000.0,3,2.25,2450,49658,1.0,3,7,1770,680.0,1978,1340,121097,16137 days 16:47:18.673855,199,1.3333333333333333,2.6029411764705883,1110,-71439,1090.0
630000.0,3,1.75,1940,7306,1.0,3,8,1470,470.0,1982,2360,8865,14676 days 16:47:18.673855,117,1.7142857142857142,3.127659574468085,-420,-1559,1000.0
928950.0,4,3.75,3280,6000,2.0,3,9,3280,0.0,2014,2900,10108,2988 days 16:47:18.673855,009,1.0666666666666667,0.0,380,-4108,3280.0
489950.0,3,1.75,2480,10804,1.0,3,8,1800,680.0,1976,2480,10400,16868 days 16:47:18.673855,283,1.7142857142857142,2.6470588235294117,0,404,1120.0
550000.0,3,2.25,2120,18255,1.0,3,8,1590,530.0,1984,2120,12997,13946 days 16:47:18.673855,105,1.3333333333333333,3.0,0,5258,1060.0
237000.0,3,2.0,1710,7920,1.0,3,8,1260,450.0,1968,1760,8120,19790 days 16:47:18.673855,217,1.5,2.8,-50,-200,810.0
390000.0,3,2.5,1690,10113,1.0,3,7,1310,380.0,1991,1690,10113,11389 days 16:47:18.673855,219,1.2,3.4473684210526314,0,0,930.0
665000.0,3,2.5,2190,10370,2.0,3,9,2190,0.0,1987,2470,10472,12850 days 16:47:18.673855,148,1.2,0.0,-280,-102,2190.0
277000.0,4,3.0,1960,5160,1.0,3,7,1170,790.0,2001,1960,5160,7736 days 16:47:18.673855,041,1.3333333333333333,1.481012658227848,0,0,380.0
545000.0,3,1.0,1510,5000,1.5,3,7,1510,0.0,1909,1680,4000,41339 days 16:47:18.673855,163,3.0,0.0,-170,1000,1510.0
615000.0,3,2.5,1490,1410,2.0,3,1,1300,190.0,2008,1490,1715,5180 days 16:47:18.673855,097,1.2,6.842105263157895,0,-305,1110.0
343000.0,3,1.75,2210,7920,1.0,3,7,1400,810.0,1966,2220,7920,20520 days 16:47:18.673855,105,1.7142857142857142,1.728395061728395,-10,0,590.0
597000.0,4,2.5,2340,7877,2.0,3,9,2340,0.0,2004,1920,9116,6641 days 16:47:18.673855,211,1.6,0.0,420,-1239,2340.0
600000.0,3,1.0,940,19000,1.0,3,6,940,0.0,1945,2280,19000,28190 days 16:47:18.673855,196,3.0,0.0,-1340,0,940.0
292000.0,3,1.75,1650,14633,1.0,4,7,1650,0.0,1958,1370,12495,23442 days 16:47:18.673855,350,1.7142857142857142,0.0,280,2138,1650.0
265000.0,3,1.5,1400,6527,1.0,3,7,1110,290.0,1957,1690,7597,23807 days 16:47:18.673855,255,2.0,3.8275862068965516,-290,-1070,820.0
623000.0,4,2.5,2710,49044,2.0,3,9,2710,0.0,1988,2560,38190,12485 days 16:47:18.673855,110,1.6,0.0,150,10854,2710.0
486000.0,4,2.5,2150,39449,1.0,3,7,1420,730.0,1978,2010,35717,16137 days 16:47:18.673855,134,1.6,1.9452054794520548,140,3732,690.0
520500.0,3,2.0,1900,8100,1.0,4,7,950,950.0,1940,1400,6380,30017 days 16:47:18.673855,166,1.5,1.0,500,1720,0.0
1300000.0,4,3.5,4380,74052,1.0,3,1,4380,0.0,2001,5170,62291,7736 days 16:47:18.673855,140,1.1428571428571428,0.0,-790,11761,4380.0
825000.0,4,1.0,2290,6300,1.5,4,7,2150,140.0,1921,2390,6300,36956 days 16:47:18.673855,267,4.0,15.357142857142858,-100,0,2010.0
259900.0,3,1.75,1690,7953,1.0,3,7,1690,0.0,1986,1680,7425,13215 days 16:47:18.673855,271,1.7142857142857142,0.0,10,528,1690.0
1170000.0,5,2.75,3090,12031,1.0,5,9,1600,1490.0,1968,2280,10800,19790 days 16:47:18.673855,092,1.8181818181818181,1.0738255033557047,810,1231,110.0
245000.0,2,1.0,1120,5650,1.0,3,6,720,400.0,1904,2160,6480,43166 days 16:47:18.673855,266,2.0,1.8,-1040,-830,320.0
830200.0,3,2.5,2680,4990,1.0,5,8,1440,1240.0,1951,2320,6000,25999 days 16:47:18.673855,079,1.2,1.1612903225806452,360,-1010,200.0
650000.0,4,2.5,2400,7351,2.0,3,9,2400,0.0,1990,2330,7756,11754 days 16:47:18.673855,174,1.6,0.0,70,-405,2400.0
305000.0,4,2.0,1610,6250,1.0,4,7,1610,0.0,1952,1310,6000,25634 days 16:47:18.673855,022,2.0,0.0,300,250,1610.0
599000.0,5,2.5,3470,12003,2.0,3,8,3470,0.0,1978,2220,12283,16137 days 16:47:18.673855,064,2.0,0.0,1250,-280,3470.0
272000.0,4,2.5,2070,6175,2.0,3,8,2070,0.0,1993,1940,6175,10658 days 16:47:18.673855,269,1.6,0.0,130,0,2070.0
415000.0,3,2.5,2420,10733,2.0,3,8,2420,0.0,1996,1950,8534,9563 days 16:47:18.673855,317,1.2,0.0,470,2199,2420.0
319000.0,4,2.25,2380,7400,1.0,4,8,1760,620.0,1979,1940,7400,15772 days 16:47:18.673855,325,1.7777777777777777,2.838709677419355,440,0,1140.0
425000.0,4,1.75,2120,15920,1.0,4,7,1060,1060.0,1960,2200,12580,22712 days 16:47:18.673855,205,2.2857142857142856,1.0,-80,3340,0.0
297500.0,4,2.5,2190,8100,1.0,4,8,1250,940.0,1978,2100,8840,16137 days 16:47:18.673855,118,1.6,1.3297872340425532,90,-740,310.0
725000.0,4,2.5,2740,12899,2.0,4,1,2740,0.0,1990,2830,9453,11754 days 16:47:18.673855,147,1.6,0.0,-90,3446,2740.0
325000.0,3,2.5,1830,7585,2.0,4,8,1830,0.0,1995,2070,7585,9928 days 16:47:18.673855,007,1.2,0.0,-240,0,1830.0
460000.0,3,1.75,1370,8467,1.0,4,7,970,400.0,1972,1650,8472,18329 days 16:47:18.673855,217,1.7142857142857142,2.425,-280,-5,570.0
396480.0,3,1.0,1000,10800,1.0,3,7,1000,0.0,1959,1140,16846,23077 days 16:47:18.673855,048,3.0,0.0,-140,-6046,1000.0
1030000.0,3,1.0,2050,4800,2.0,3,8,1950,100.0,1922,2220,4800,36591 days 16:47:18.673855,064,3.0,19.5,-170,0,1850.0
370000.0,3,2.75,1750,9166,1.0,4,7,1170,580.0,1979,1810,8760,15772 days 16:47:18.673855,324,1.0909090909090908,2.0172413793103448,-60,406,590.0
260656.0,3,1.0,1620,13803,1.0,4,6,1620,0.0,1969,1260,10370,19424 days 16:47:18.673855,106,3.0,0.0,360,3433,1620.0
431000.0,3,2.5,1710,12677,2.0,3,8,1710,0.0,1996,1610,12160,9563 days 16:47:18.673855,196,1.2,0.0,100,517,1710.0
320000.0,3,1.0,1060,5000,1.0,3,7,1060,0.0,1958,1220,4600,23442 days 16:47:18.673855,013,3.0,0.0,-160,400,1060.0
296500.0,3,2.75,2170,7900,1.0,4,8,1380,790.0,1978,2170,7700,16137 days 16:47:18.673855,139,1.0909090909090908,1.7468354430379747,0,200,590.0
679000.0,4,2.5,3080,8451,1.0,3,7,1540,1540.0,1969,1550,8125,19424 days 16:47:18.673855,068,1.6,1.0,1530,326,0.0
359000.0,3,3.0,1320,1071,2.0,3,7,1080,240.0,2003,1780,7715,7006 days 16:47:18.673855,213,1.0,4.5,-460,-6644,840.0
330000.0,4,3.0,1920,12040,1.0,3,7,1920,0.0,1962,1530,10230,21981 days 16:47:18.673855,092,1.3333333333333333,0.0,390,1810,1920.0
350000.0,4,2.5,2440,4000,2.0,3,7,2440,0.0,2009,2410,4502,4814 days 16:47:18.673855,136,1.6,0.0,30,-502,2440.0
242000.0,3,1.5,1640,8922,1.0,4,7,1640,0.0,1963,1540,9040,21616 days 16:47:18.673855,295,2.0,0.0,100,-118,1640.0
692500.0,3,2.5,2420,198198,2.0,3,9,2420,0.0,1997,2780,179467,9197 days 16:47:18.673855,085,1.2,0.0,-360,18731,2420.0
441000.0,2,1.5,1190,3400,1.0,3,7,990,200.0,1919,1410,3150,37687 days 16:47:18.673855,181,1.3333333333333333,4.95,-220,250,790.0
765000.0,4,2.5,2910,15016,2.0,3,1,2910,0.0,1990,2870,13992,11754 days 16:47:18.673855,346,1.6,0.0,40,1024,2910.0
375000.0,2,1.0,1010,4050,1.0,3,7,1010,0.0,1950,2310,5000,26364 days 16:47:18.673855,246,2.0,0.0,-1300,-950,1010.0
365000.0,3,1.75,2080,7800,1.0,5,7,1220,860.0,1955,1770,7860,24538 days 16:47:18.673855,085,1.7142857142857142,1.4186046511627908,310,-60,360.0
580000.0,2,1.5,1990,6000,1.0,3,6,1430,560.0,1944,1350,6000,28556 days 16:47:18.673855,251,1.3333333333333333,2.5535714285714284,640,0,870.0
1610000.0,4,3.5,3920,19088,1.0,3,1,2240,1680.0,2005,3800,13749,6275 days 16:47:18.673855,100,1.1428571428571428,1.3333333333333333,120,5339,560.0
841000.0,4,2.5,3080,13870,2.0,4,9,3080,0.0,1981,2920,12221,15041 days 16:47:18.673855,050,1.6,0.0,160,1649,3080.0
515000.0,5,3.0,2670,11761,1.0,3,7,1370,1300.0,1981,2580,10703,15041 days 16:47:18.673855,111,1.6666666666666667,1.0538461538461539,90,1058,70.0
565000.0,5,2.5,4320,107157,1.0,4,8,2160,2160.0,1967,2480,107157,20155 days 16:47:18.673855,297,2.0,1.0,1840,0,0.0
365000.0,2,1.5,1200,6380,1.0,3,7,1200,0.0,1929,1290,6598,34034 days 16:47:18.673855,349,1.3333333333333333,0.0,-90,-218,1200.0
295000.0,3,1.5,1640,7222,2.0,4,7,1640,0.0,1908,1240,5100,41705 days 16:47:18.673855,188,2.0,0.0,400,2122,1640.0
406500.0,2,1.0,870,5750,1.0,4,7,870,0.0,1947,1100,5750,27460 days 16:47:18.673855,181,2.0,0.0,-230,0,870.0
614905.0,3,2.5,2410,7225,2.0,3,8,2410,0.0,1991,1940,8347,11389 days 16:47:18.673855,043,1.2,0.0,470,-1122,2410.0
1400000.0,5,2.25,2640,14959,1.0,4,7,1770,870.0,1929,3240,17904,34034 days 16:47:18.673855,092,2.2222222222222223,2.0344827586206895,-600,-2945,900.0
250000.0,2,1.0,990,10556,2.0,3,7,990,0.0,1981,1350,7295,15041 days 16:47:18.673855,197,2.0,0.0,-360,3261,990.0
549000.0,5,1.0,1500,3978,2.0,3,7,1500,0.0,1929,1350,4080,34034 days 16:47:18.673855,316,5.0,0.0,150,-102,1500.0
397000.0,4,2.5,1790,6590,2.0,3,7,1790,0.0,2005,1950,5180,6275 days 16:47:18.673855,232,1.6,0.0,-160,1410,1790.0
184000.0,3,1.75,1490,10125,1.0,4,7,1490,0.0,1962,2488,4981,21981 days 16:47:18.673855,125,1.7142857142857142,0.0,-998,5144,1490.0
2500000.0,4,3.25,3960,16224,2.0,3,1,3100,860.0,1938,3960,15050,30747 days 16:47:18.673855,125,1.2307692307692308,3.604651162790698,0,1174,2240.0
499100.0,3,1.5,1620,5108,1.0,3,7,1620,0.0,1954,1380,6130,24903 days 16:47:18.673855,209,2.0,0.0,240,-1022,1620.0
676101.0,4,1.5,2270,6010,1.0,3,8,1290,980.0,1954,2120,5987,24903 days 16:47:18.673855,268,2.6666666666666665,1.316326530612245,150,23,310.0
290000.0,3,1.0,1150,8145,1.0,4,6,990,160.0,1932,1200,8145,32939 days 16:47:18.673855,174,3.0,6.1875,-50,0,830.0
390000.0,4,1.75,2180,7560,1.0,4,7,1560,620.0,1962,1810,7352,21981 days 16:47:18.673855,063,2.2857142857142856,2.5161290322580645,370,208,940.0
465000.0,3,1.0,910,4500,1.0,3,7,910,0.0,1948,1370,5000,27095 days 16:47:18.673855,155,3.0,0.0,-460,-500,910.0
470000.0,3,2.75,2770,54707,1.5,3,8,2370,400.0,1938,1640,54707,30747 days 16:47:18.674853,269,1.0909090909090908,5.925,1130,0,1970.0
435000.0,3,1.0,940,7590,1.0,4,6,940,0.0,1959,1250,7590,23077 days 16:47:18.674853,050,3.0,0.0,-310,0,940.0
415000.0,3,1.75,2410,8944,1.0,4,8,1860,550.0,1967,2750,9600,20155 days 16:47:18.674853,178,1.7142857142857142,3.381818181818182,-340,-656,1310.0
450000.0,3,2.0,1010,2820,1.5,3,7,1010,0.0,1905,1330,3000,42800 days 16:47:18.674853,056,1.5,0.0,-320,-180,1010.0
645000.0,3,2.5,2120,196995,1.0,3,9,2120,0.0,1997,1304,92423,9197 days 16:47:18.674853,086,1.2,0.0,816,104572,2120.0
231000.0,4,2.0,1530,6375,2.0,3,7,1530,0.0,1942,1500,8712,29286 days 16:47:18.674853,149,2.0,0.0,30,-2337,1530.0
358000.0,3,1.5,1810,100188,1.0,5,7,1810,0.0,1969,1540,40415,19424 days 16:47:18.674853,175,2.0,0.0,270,59773,1810.0
330000.0,3,1.0,1040,11900,1.0,5,6,1040,0.0,1972,1250,9600,18329 days 16:47:18.674853,227,3.0,0.0,-210,2300,1040.0
229950.0,2,1.5,1160,1848,2.0,3,7,1160,0.0,1972,1160,1566,18329 days 16:47:18.674853,324,1.3333333333333333,0.0,0,282,1160.0
403250.0,2,1.5,1430,8137,1.0,3,7,1130,300.0,1934,1430,8137,32208 days 16:47:18.674853,289,1.3333333333333333,3.7666666666666666,0,0,830.0
470000.0,3,2.5,2280,6134,2.0,3,8,2280,0.0,2004,2640,6167,6641 days 16:47:18.674853,255,1.2,0.0,-360,-33,2280.0
239000.0,3,1.0,1200,7810,1.0,4,7,1200,0.0,1967,1590,7800,20155 days 16:47:18.674853,115,3.0,0.0,-390,10,1200.0
579000.0,4,1.5,2480,6000,1.0,3,8,1520,960.0,1955,1810,6000,24538 days 16:47:18.674853,086,2.6666666666666665,1.5833333333333333,670,0,560.0
380500.0,3,2.0,1270,1348,3.0,3,8,1270,0.0,2003,1180,1360,7006 days 16:47:18.674853,077,1.5,0.0,90,-12,1270.0
614285.0,5,2.75,2730,6401,2.0,3,8,2730,0.0,2015,2520,6126,2623 days 16:47:18.674853,365,1.8181818181818181,0.0,210,275,2730.0
376000.0,2,2.0,1340,1635,2.0,3,8,1340,0.0,2003,1410,1375,7006 days 16:47:18.674853,097,1.0,0.0,-70,260,1340.0
290000.0,3,1.0,1240,9300,1.0,3,7,1240,0.0,1954,1250,9300,24903 days 16:47:18.674853,048,3.0,0.0,-10,0,1240.0
487000.0,4,2.25,2400,7000,1.0,4,8,1800,600.0,1965,2210,7210,20885 days 16:47:18.674853,029,1.7777777777777777,3.0,190,-210,1200.0
935000.0,4,2.0,1220,7489,2.0,3,7,1220,0.0,1903,1220,3750,43531 days 16:47:18.674853,050,2.0,0.0,0,3739,1220.0
255000.0,4,2.5,2163,5882,2.0,3,7,2163,0.0,2006,1760,9600,5910 days 16:47:18.674853,086,1.6,0.0,403,-3718,2163.0
380000.0,2,2.5,1860,3504,2.0,3,7,1860,0.0,2000,1860,4246,8102 days 16:47:18.674853,238,0.8,0.0,0,-742,1860.0
450000.0,2,1.0,810,4368,1.0,3,6,810,0.0,1958,1890,5253,23442 days 16:47:18.674853,114,2.0,0.0,-1080,-885,810.0
622000.0,3,2.5,1950,7481,2.0,3,8,1950,0.0,1987,1980,8479,12850 days 16:47:18.674853,283,1.2,0.0,-30,-998,1950.0
1320000.0,4,3.0,2120,3600,2.0,4,8,1830,290.0,1908,2120,3600,41705 days 16:47:18.674853,354,1.3333333333333333,6.310344827586207,0,0,1540.0
410000.0,4,2.0,1510,3240,1.0,5,7,870,640.0,1901,1420,5160,44261 days 16:47:18.674853,037,2.0,1.359375,90,-1920,230.0
160000.0,3,1.75,1010,5355,1.0,3,6,1010,0.0,1950,750,4515,26364 days 16:47:18.674853,297,1.7142857142857142,0.0,260,840,1010.0
809000.0,4,1.5,1840,4337,2.0,4,8,1840,0.0,1917,2250,4337,38417 days 16:47:18.674853,153,2.6666666666666665,0.0,-410,0,1840.0
183750.0,5,2.75,1650,5453,1.0,3,7,1650,0.0,1970,1670,5885,19059 days 16:47:18.674853,071,1.8181818181818181,0.0,-20,-432,1650.0
411000.0,5,1.75,2860,12293,1.0,4,8,1430,1430.0,1947,1920,18110,27460 days 16:47:18.674853,286,2.857142857142857,1.0,940,-5817,0.0
1050000.0,3,1.75,2650,5512,2.0,3,9,2250,400.0,1984,1440,5100,13946 days 16:47:18.674853,040,1.7142857142857142,5.625,1210,412,1850.0
625000.0,2,1.0,1100,4160,1.0,3,7,1100,0.0,1919,1900,4000,37687 days 16:47:18.674853,234,2.0,0.0,-800,160,1100.0
305000.0,3,2.25,1646,9519,2.0,3,7,1646,0.0,1994,1975,8889,10293 days 16:47:18.674853,231,1.3333333333333333,0.0,-329,630,1646.0
915000.0,4,4.5,5250,48352,2.0,3,1,5250,0.0,1998,2500,48352,8832 days 16:47:18.674853,113,0.8888888888888888,0.0,2750,0,5250.0
317000.0,3,1.5,1390,8300,1.0,4,7,1390,0.0,1974,1470,7500,17598 days 16:47:18.674853,070,2.0,0.0,-80,800,1390.0
165000.0,2,1.0,780,6380,1.0,3,6,780,0.0,1947,1270,6960,27460 days 16:47:18.674853,020,2.0,0.0,-490,-580,780.0
575000.0,2,1.0,1490,6000,1.0,3,7,1090,400.0,1946,1590,6000,27825 days 16:47:18.674853,135,2.0,2.725,-100,0,690.0
219900.0,3,1.0,970,7742,1.0,4,6,970,0.0,1967,970,7650,20155 days 16:47:18.674853,161,3.0,0.0,0,92,970.0
1490000.0,4,3.25,3730,7200,2.0,3,1,2810,920.0,2006,2490,7200,5910 days 16:47:18.674853,274,1.2307692307692308,3.0543478260869565,1240,0,1890.0
300000.0,3,1.0,1090,9900,1.0,4,7,1090,0.0,1955,1720,10419,24538 days 16:47:18.674853,140,3.0,0.0,-630,-519,1090.0
520000.0,3,1.75,1940,219527,1.0,3,7,1940,0.0,1991,2060,108900,11389 days 16:47:18.674853,170,1.7142857142857142,0.0,-120,110627,1940.0
310000.0,4,2.25,1780,8820,1.0,4,8,1480,300.0,1966,1780,8625,20520 days 16:47:18.674853,127,1.7777777777777777,4.933333333333334,0,195,1180.0
322500.0,3,2.0,1190,6445,1.0,3,7,1190,0.0,1996,1920,8195,9563 days 16:47:18.674853,054,1.5,0.0,-730,-1750,1190.0
320000.0,4,2.25,2000,10374,2.0,4,7,2000,0.0,1967,2170,10374,20155 days 16:47:18.674853,107,1.7777777777777777,0.0,-170,0,2000.0
440000.0,3,2.5,1390,4997,2.0,3,7,1390,0.0,2004,2340,4125,6641 days 16:47:18.674853,093,1.2,0.0,-950,872,1390.0
578000.0,3,1.0,1500,4500,1.0,3,7,1120,380.0,1938,1440,4500,30747 days 16:47:18.674853,230,3.0,2.9473684210526314,60,0,740.0
382000.0,2,1.5,1070,877,3.0,3,8,1070,0.0,2005,1320,1193,6275 days 16:47:18.674853,323,1.3333333333333333,0.0,-250,-316,1070.0
535000.0,3,2.5,1720,4006,2.0,3,8,1720,0.0,1994,1780,3974,10293 days 16:47:18.674853,148,1.2,0.0,-60,32,1720.0
679000.0,4,2.5,3680,7236,2.0,3,1,3680,0.0,2006,3310,7180,5910 days 16:47:18.674853,128,1.6,0.0,370,56,3680.0
258900.0,3,2.25,1400,10436,1.0,4,7,1040,360.0,1985,1860,9318,13580 days 16:47:18.674853,335,1.3333333333333333,2.888888888888889,-460,1118,680.0
563000.0,3,1.5,1730,9509,2.0,3,8,1270,460.0,1955,1810,8795,24538 days 16:47:18.674853,075,2.0,2.760869565217391,-80,714,810.0
562000.0,5,3.0,2795,15101,2.0,3,8,2795,0.0,1996,2750,14567,9563 days 16:47:18.674853,169,1.6666666666666667,0.0,45,534,2795.0
725000.0,4,1.75,2000,3750,1.0,5,8,1120,880.0,1950,1370,5000,26364 days 16:47:18.674853,005,2.2857142857142856,1.2727272727272727,630,-1250,240.0
236775.0,3,2.5,1830,8372,2.0,3,8,1830,0.0,1987,1770,8372,12850 days 16:47:18.674853,051,1.2,0.0,60,0,1830.0
860000.0,4,3.5,3380,8098,1.0,5,9,1690,1690.0,1952,1890,8400,25634 days 16:47:18.674853,254,1.1428571428571428,1.0,1490,-302,0.0
270000.0,3,1.5,1500,6337,1.0,5,7,1500,0.0,1953,1420,6337,25268 days 16:47:18.674853,129,2.0,0.0,80,0,1500.0
621000.0,4,2.75,1950,6930,1.0,4,7,1250,700.0,1960,1950,8560,22712 days 16:47:18.674853,364,1.4545454545454546,1.7857142857142858,0,-1630,550.0
527900.0,3,2.5,2490,5928,2.0,3,8,2490,0.0,1998,2420,6381,8832 days 16:47:18.674853,086,1.2,0.0,70,-453,2490.0
320000.0,3,2.0,1110,10500,1.0,5,7,1110,0.0,1978,1230,10395,16137 days 16:47:18.674853,142,1.5,0.0,-120,105,1110.0
300000.0,4,2.5,2500,4750,2.0,3,8,2500,0.0,2003,2690,4750,7006 days 16:47:18.674853,106,1.6,0.0,-190,0,2500.0
625000.0,3,2.25,2570,47480,1.0,3,9,2570,0.0,1979,2570,106722,15772 days 16:47:18.674853,127,1.3333333333333333,0.0,0,-59242,2570.0
505000.0,2,1.0,810,5060,1.0,3,6,810,0.0,1941,900,5060,29651 days 16:47:18.674853,100,2.0,0.0,-90,0,810.0
300000.0,4,2.5,2700,10814,1.0,4,8,1560,1140.0,1966,2460,6310,20520 days 16:47:18.674853,164,1.6,1.368421052631579,240,4504,420.0
363000.0,4,2.5,2180,9281,2.0,3,8,2180,0.0,2004,2520,9520,6641 days 16:47:18.674853,043,1.6,0.0,-340,-239,2180.0
1700000.0,4,3.5,4330,15335,2.0,4,1,3230,1100.0,1988,3840,14311,12485 days 16:47:18.674853,220,1.1428571428571428,2.9363636363636365,490,1024,2130.0
1150000.0,4,3.5,4210,10308,2.0,3,1,4210,0.0,2006,3860,10200,5910 days 16:47:18.674853,135,1.1428571428571428,0.0,350,108,4210.0
680000.0,4,2.5,2880,9202,1.0,3,8,1780,1100.0,1977,2500,10265,16502 days 16:47:18.674853,076,1.6,1.6181818181818182,380,-1063,680.0
678940.0,5,2.25,2610,4080,2.0,5,7,1750,860.0,1909,2160,4080,41339 days 16:47:18.674853,343,2.2222222222222223,2.0348837209302326,450,0,890.0
299000.0,3,1.75,2010,8065,1.0,4,7,1090,920.0,1984,1560,8065,13946 days 16:47:18.674853,020,1.7142857142857142,1.184782608695652,450,0,170.0
379900.0,4,1.75,1500,11600,1.0,4,7,1000,500.0,1955,1740,11600,24538 days 16:47:18.674853,126,2.2857142857142856,2.0,-240,0,500.0
205000.0,3,1.0,1290,6566,1.0,5,7,1290,0.0,1976,1690,6860,16868 days 16:47:18.674853,164,3.0,0.0,-400,-294,1290.0
387500.0,4,1.0,1320,4440,1.5,3,7,1320,0.0,1929,1260,4440,34034 days 16:47:18.674853,140,4.0,0.0,60,0,1320.0
256000.0,3,1.0,1290,4720,1.0,3,6,790,500.0,1948,1110,4720,27095 days 16:47:18.674853,035,3.0,1.58,180,0,290.0
548000.0,4,2.5,2440,11005,2.0,3,9,2440,0.0,1994,2590,14754,10293 days 16:47:18.674853,182,1.6,0.0,-150,-3749,2440.0
163000.0,3,1.75,1290,4811,1.0,3,7,1290,0.0,1996,1310,4811,9563 days 16:47:18.674853,055,1.7142857142857142,0.0,-20,0,1290.0
367500.0,2,2.0,1030,600,2.0,3,8,680,350.0,2004,1120,1267,6641 days 16:47:18.674853,022,1.0,1.9428571428571428,-90,-667,330.0
390000.0,3,2.25,1640,2875,2.0,3,6,1240,400.0,1983,1500,3960,14311 days 16:47:18.674853,195,1.3333333333333333,3.1,140,-1085,840.0
415000.0,4,2.5,1160,16008,1.0,4,7,1160,0.0,1989,1570,12645,12119 days 16:47:18.674853,213,1.6,0.0,-410,3363,1160.0
449000.0,4,2.25,2230,8440,2.0,4,8,2230,0.0,1968,2160,9412,19790 days 16:47:18.674853,295,1.7777777777777777,0.0,70,-972,2230.0
460000.0,5,2.0,1910,12264,1.0,4,7,1010,900.0,1963,1700,9179,21616 days 16:47:18.674853,197,2.5,1.1222222222222222,210,3085,110.0
395000.0,4,2.0,1980,15354,1.0,3,7,1980,0.0,1977,1420,12300,16502 days 16:47:18.674853,357,2.0,0.0,560,3054,1980.0
825000.0,3,1.75,1930,8442,1.0,4,7,1930,0.0,1953,1790,8442,25268 days 16:47:18.674853,002,1.7142857142857142,0.0,140,0,1930.0
539950.0,3,2.5,1330,2180,3.0,3,8,1330,0.0,2014,1330,5000,2988 days 16:47:18.674853,086,1.2,0.0,0,-2820,1330.0
410000.0,4,2.0,1580,9581,1.0,3,7,1580,0.0,1953,1580,10552,25268 days 16:47:18.674853,167,2.0,0.0,0,-971,1580.0
245000.0,3,1.0,1370,6000,1.0,3,7,1370,0.0,1955,1370,9520,24538 days 16:47:18.674853,213,3.0,0.0,0,-3520,1370.0
482000.0,4,2.75,3010,15750,1.0,4,8,1560,1450.0,1973,2110,9450,17963 days 16:47:18.674853,231,1.4545454545454546,1.0758620689655172,900,6300,110.0
270000.0,3,1.75,1390,9000,1.0,4,7,1390,0.0,1978,1400,9697,16137 days 16:47:18.674853,223,1.7142857142857142,0.0,-10,-697,1390.0
475000.0,3,1.75,1330,14560,1.0,3,7,1330,0.0,1983,1510,9890,14311 days 16:47:18.674853,360,1.7142857142857142,0.0,-180,4670,1330.0
445800.0,3,2.0,1320,6500,1.0,3,7,1320,0.0,1947,1110,6592,27460 days 16:47:18.674853,287,1.5,0.0,210,-92,1320.0
518000.0,4,3.0,2430,11670,1.0,4,7,1330,1100.0,1978,1580,10464,16137 days 16:47:18.674853,050,1.3333333333333333,1.209090909090909,850,1206,230.0
785000.0,2,0.75,1260,4800,1.5,4,6,1080,180.0,1942,2660,7200,29286 days 16:47:18.674853,224,2.6666666666666665,6.0,-1400,-2400,900.0
430000.0,3,2.5,1690,1310,2.0,3,8,1140,550.0,2004,1640,1321,6641 days 16:47:18.674853,057,1.2,2.0727272727272728,50,-11,590.0
715000.0,4,1.75,3420,7200,1.0,5,8,1770,1650.0,1947,2450,6200,27460 days 16:47:18.674853,150,2.2857142857142856,1.0727272727272728,970,1000,120.0
560000.0,3,1.5,2790,6900,1.0,3,8,1700,1090.0,1955,2410,8100,24538 days 16:47:18.674853,282,2.0,1.5596330275229358,380,-1200,610.0
449000.0,3,1.75,1270,6600,1.5,5,7,1270,0.0,1903,1490,3600,43531 days 16:47:18.674853,311,1.7142857142857142,0.0,-220,3000,1270.0
805000.0,4,2.5,2910,9000,2.0,3,9,2910,0.0,1989,2530,9000,12119 days 16:47:18.674853,281,1.6,0.0,380,0,2910.0
296000.0,3,2.5,1560,5845,2.0,3,7,1560,0.0,2003,1860,5752,7006 days 16:47:18.674853,267,1.2,0.0,-300,93,1560.0
275000.0,2,1.0,770,4840,1.0,4,7,770,0.0,1927,930,4840,34765 days 16:47:18.674853,176,2.0,0.0,-160,0,770.0
419950.0,3,1.75,1770,16909,1.0,5,8,1770,0.0,1977,1960,9100,16502 days 16:47:18.674853,012,1.7142857142857142,0.0,-190,7809,1770.0
285000.0,3,1.75,1100,1307,2.0,3,7,780,320.0,2008,1170,4800,5180 days 16:47:18.674853,275,1.7142857142857142,2.4375,-70,-3493,460.0
775000.0,3,2.5,2890,8470,2.0,3,1,2890,0.0,1996,3000,8879,9563 days 16:47:18.674853,202,1.2,0.0,-110,-409,2890.0
288250.0,3,1.75,2110,15400,1.0,3,7,1380,730.0,1963,2110,9800,21616 days 16:47:18.674853,118,1.7142857142857142,1.8904109589041096,0,5600,650.0
257000.0,2,1.75,1220,2268,1.0,4,6,610,610.0,1909,1240,1675,41339 days 16:47:18.674853,117,1.1428571428571428,1.0,-20,593,0.0
377000.0,1,1.0,950,10585,1.5,3,6,950,0.0,1929,1400,7056,34034 days 16:47:18.674853,237,1.0,0.0,-450,3529,950.0
550000.0,2,1.0,1420,3100,1.0,3,7,820,600.0,1924,1420,3915,35861 days 16:47:18.674853,132,2.0,1.3666666666666667,0,-815,220.0
339000.0,3,1.0,1100,4128,1.0,4,7,720,380.0,1942,1510,4538,29286 days 16:47:18.674853,175,3.0,1.894736842105263,-410,-410,340.0
481500.0,3,1.75,2140,6000,1.0,3,7,1070,1070.0,1948,1240,4650,27095 days 16:47:18.674853,310,1.7142857142857142,1.0,900,1350,0.0
224500.0,3,1.75,1300,7735,1.0,4,7,1300,0.0,1980,1300,8941,15407 days 16:47:18.674853,311,1.7142857142857142,0.0,0,-1206,1300.0
260000.0,3,1.0,1790,11884,1.0,3,7,1790,0.0,1951,1660,11513,25999 days 16:47:18.674853,238,3.0,0.0,130,371,1790.0
865000.0,2,1.0,1470,5400,1.5,3,8,1470,0.0,1912,1760,3573,40244 days 16:47:18.674853,113,2.0,0.0,-290,1827,1470.0
730000.0,5,3.0,2500,11779,1.0,4,8,1550,950.0,1971,2580,12055,18694 days 16:47:18.674853,125,1.6666666666666667,1.631578947368421,-80,-276,600.0
645000.0,3,2.0,2130,4000,2.0,3,7,2130,0.0,1908,2010,4000,41705 days 16:47:18.674853,232,1.5,0.0,120,0,2130.0
250000.0,3,1.75,1360,16000,1.0,3,7,1360,0.0,1978,1360,12939,16137 days 16:47:18.674853,281,1.7142857142857142,0.0,0,3061,1360.0
507200.0,3,3.5,1630,1329,2.0,3,9,1360,270.0,2000,1580,1319,8102 days 16:47:18.674853,022,0.8571428571428571,5.037037037037037,50,10,1090.0
380000.0,4,2.5,2500,11070,1.0,4,8,1300,1200.0,1964,2500,11070,21251 days 16:47:18.674853,224,1.6,1.0833333333333333,0,0,100.0
540000.0,4,1.75,2260,19500,1.0,3,8,1450,810.0,1971,2980,19500,18694 days 16:47:18.674853,226,2.2857142857142856,1.7901234567901234,-720,0,640.0
738500.0,3,2.5,2300,6009,1.0,3,8,2300,0.0,2005,1640,5931,6275 days 16:47:18.674853,168,1.2,0.0,660,78,2300.0
206000.0,3,1.0,1060,10350,1.0,4,7,1060,0.0,1980,1500,9660,15407 days 16:47:18.674853,029,3.0,0.0,-440,690,1060.0
265000.0,2,1.0,940,9458,1.0,3,6,940,0.0,1948,1450,9458,27095 days 16:47:18.674853,076,2.0,0.0,-510,0,940.0
190000.0,1,0.75,780,77603,1.0,1,5,780,0.0,1945,1750,30847,28190 days 16:47:18.674853,020,1.3333333333333333,0.0,-970,46756,780.0
339900.0,3,1.0,1200,9087,1.0,5,7,1200,0.0,1969,1250,11826,19424 days 16:47:18.674853,179,3.0,0.0,-50,-2739,1200.0
250000.0,6,2.5,2590,10890,1.0,4,7,1340,1250.0,1970,2474,10454,19059 days 16:47:18.674853,360,2.4,1.072,116,436,90.0
416500.0,3,1.0,1100,4184,1.0,4,7,1100,0.0,1965,1630,4366,20885 days 16:47:18.674853,213,3.0,0.0,-530,-182,1100.0
575000.0,4,2.5,2890,9775,2.0,3,8,2890,0.0,2004,2640,7184,6641 days 16:47:18.674853,097,1.6,0.0,250,2591,2890.0
385000.0,3,1.75,1230,7500,1.0,3,7,1230,0.0,1987,1930,8747,12850 days 16:47:18.674853,160,1.7142857142857142,0.0,-700,-1247,1230.0
253000.0,3,1.0,1030,6250,1.0,3,7,1030,0.0,1960,1160,7250,22712 days 16:47:18.674853,282,3.0,0.0,-130,-1000,1030.0
460000.0,3,1.0,1140,4600,1.0,3,7,1140,0.0,1942,1370,5000,29286 days 16:47:18.674853,245,3.0,0.0,-230,-400,1140.0
1450000.0,4,2.5,3200,3600,3.0,4,9,2600,600.0,1997,2490,4080,9197 days 16:47:18.674853,219,1.6,4.333333333333333,710,-480,2000.0
492000.0,2,1.0,950,6000,1.0,3,7,950,0.0,1942,1440,6000,29286 days 16:47:18.674853,063,2.0,0.0,-490,0,950.0
275000.0,4,2.0,1960,30480,1.0,4,7,1060,900.0,1972,1460,8914,18329 days 16:47:18.674853,289,2.0,1.1777777777777778,500,21566,160.0
542500.0,5,3.25,3010,1074218,1.5,5,8,2010,1000.0,1931,2450,68825,33304 days 16:47:18.674853,141,1.5384615384615385,2.01,560,1005393,1010.0
345000.0,2,1.0,1080,7775,1.0,3,6,1080,0.0,1955,1730,7350,24538 days 16:47:18.674853,182,2.0,0.0,-650,425,1080.0
575000.0,4,2.75,2730,35075,1.0,3,8,1530,1200.0,1979,2310,35000,15772 days 16:47:18.674853,111,1.4545454545454546,1.275,420,75,330.0
275000.0,5,2.5,2570,17234,1.0,3,7,1300,1270.0,1959,1760,7969,23077 days 16:47:18.674853,124,2.0,1.0236220472440944,810,9265,30.0
510000.0,6,4.5,3300,7561,2.0,3,8,3300,0.0,1980,2470,7561,15407 days 16:47:18.674853,203,1.3333333333333333,0.0,830,0,3300.0
2540000.0,4,3.5,4350,6000,2.0,5,1,2970,1380.0,1908,4190,7200,41705 days 16:47:18.674853,091,1.1428571428571428,2.152173913043478,160,-1200,1590.0
830000.0,3,3.5,3820,145054,2.0,3,9,2870,950.0,1999,2500,95950,8467 days 16:47:18.674853,252,0.8571428571428571,3.0210526315789474,1320,49104,1920.0
640000.0,4,2.5,2260,5172,2.0,3,9,2260,0.0,2004,2680,5172,6641 days 16:47:18.674853,325,1.6,0.0,-420,0,2260.0
702000.0,4,2.75,3880,15025,2.0,3,7,3880,0.0,2004,2620,5300,6641 days 16:47:18.674853,287,1.4545454545454546,0.0,1260,9725,3880.0
960000.0,3,2.5,2010,6857,1.0,4,9,1450,560.0,1955,2380,6370,24538 days 16:47:18.674853,323,1.2,2.5892857142857144,-370,487,890.0
190000.0,3,1.0,950,7610,1.0,3,7,950,0.0,1983,1360,7938,14311 days 16:47:18.674853,119,3.0,0.0,-410,-328,950.0
500000.0,3,2.25,1730,13040,1.0,4,8,1290,440.0,1988,1730,11016,12485 days 16:47:18.674853,282,1.3333333333333333,2.9318181818181817,0,2024,850.0
435000.0,3,1.75,1500,8173,1.0,3,7,1500,0.0,1997,1970,8173,9197 days 16:47:18.674853,164,1.7142857142857142,0.0,-470,0,1500.0
670000.0,3,1.75,2160,5760,1.0,4,8,1260,900.0,1954,2090,5760,24903 days 16:47:18.674853,062,1.7142857142857142,1.4,70,0,360.0
365000.0,3,2.25,1960,1985,2.0,3,7,1750,210.0,2003,1760,1985,7006 days 16:47:18.674853,127,1.3333333333333333,8.333333333333334,200,0,1540.0
1270000.0,5,3.0,3950,9520,1.0,3,9,2250,1700.0,1953,1890,9520,25268 days 16:47:18.674853,338,1.6666666666666667,1.3235294117647058,2060,0,550.0
465000.0,3,1.0,1100,145490,1.5,4,6,1100,0.0,1915,1100,11610,39148 days 16:47:18.674853,268,3.0,0.0,0,133880,1100.0
285000.0,3,1.5,1400,7582,1.0,3,7,1400,0.0,1956,1280,7872,24173 days 16:47:18.674853,007,2.0,0.0,120,-290,1400.0
219950.0,3,1.0,1020,4960,1.5,3,6,920,100.0,1926,1230,7335,35130 days 16:47:18.674853,036,3.0,9.2,-210,-2375,820.0
220000.0,3,1.5,1600,10548,1.0,4,7,1600,0.0,1962,2880,13609,21981 days 16:47:18.674853,321,2.0,0.0,-1280,-3061,1600.0
1470000.0,6,4.5,4230,6420,2.0,4,8,2360,1870.0,1916,3450,4085,38783 days 16:47:18.674853,190,1.3333333333333333,1.2620320855614973,780,2335,490.0
1110000.0,5,3.5,3090,3600,2.0,3,9,2060,1030.0,2000,2240,3904,8102 days 16:47:18.674853,293,1.4285714285714286,2.0,850,-304,1030.0
694000.0,2,2.5,2320,9311,1.0,3,8,2320,0.0,2007,1680,4765,5545 days 16:47:18.674853,107,0.8,0.0,640,4546,2320.0
620000.0,3,2.5,2440,10363,2.0,3,9,2440,0.0,1988,2500,10728,12485 days 16:47:18.674853,093,1.2,0.0,-60,-365,2440.0
415000.0,3,1.0,2020,19210,1.0,3,6,1760,260.0,1949,1780,14469,26729 days 16:47:18.674853,233,3.0,6.769230769230769,240,4741,1500.0
765000.0,3,3.0,3270,38088,2.0,3,1,3270,0.0,1992,1870,37457,11024 days 16:47:18.674853,054,1.0,0.0,1400,631,3270.0
864000.0,4,1.75,2260,6600,1.0,5,8,1220,1040.0,1948,2240,6600,27095 days 16:47:18.674853,196,2.2857142857142856,1.1730769230769231,20,0,180.0
385000.0,5,2.0,2020,4000,2.0,3,7,2020,0.0,1950,1960,4000,26364 days 16:47:18.674853,338,2.5,0.0,60,0,2020.0
725000.0,3,1.0,1000,19969,1.0,3,7,1000,0.0,1951,1370,7962,25999 days 16:47:18.674853,013,3.0,0.0,-370,12007,1000.0
545000.0,4,2.25,2030,11585,1.0,4,7,1590,440.0,1967,1960,8977,20155 days 16:47:18.674853,168,1.7777777777777777,3.6136363636363638,70,2608,1150.0
299900.0,3,1.75,1730,9893,1.0,4,9,1730,0.0,1988,2120,9108,12485 days 16:47:18.674853,101,1.7142857142857142,0.0,-390,785,1730.0
639500.0,3,1.75,2010,8072,1.0,4,8,2010,0.0,1974,2030,8055,17598 days 16:47:18.674853,127,1.7142857142857142,0.0,-20,17,2010.0
345000.0,4,1.5,1540,7168,1.0,3,7,1160,380.0,1964,1540,7176,21251 days 16:47:18.674853,076,2.6666666666666665,3.0526315789473686,0,-8,780.0
1130000.0,6,4.0,5330,18116,2.0,3,1,3950,1380.0,2000,4590,16900,8102 days 16:47:18.674853,089,1.5,2.86231884057971,740,1216,2570.0
345000.0,2,1.0,960,2700,1.0,3,6,780,180.0,1904,1400,3000,43166 days 16:47:18.674853,075,2.0,4.333333333333333,-440,-300,600.0
600000.0,3,2.0,1460,2800,1.0,4,7,730,730.0,1921,1780,4560,36956 days 16:47:18.674853,111,1.5,1.0,-320,-1760,0.0
355000.0,4,1.75,2160,7417,1.0,4,7,1360,800.0,1983,1880,8022,14311 days 16:47:18.674853,308,2.2857142857142856,1.7,280,-605,560.0
698000.0,3,2.75,2640,11957,1.5,3,9,2260,380.0,1978,2640,12641,16137 days 16:47:18.674853,252,1.0909090909090908,5.947368421052632,0,-684,1880.0
566000.0,4,2.25,2170,7737,2.0,3,8,2170,0.0,1987,1850,8869,12850 days 16:47:18.674853,167,1.7777777777777777,0.0,320,-1132,2170.0
449950.0,3,2.5,1530,3840,2.0,3,8,1530,0.0,1994,1720,3985,10293 days 16:47:18.674853,204,1.2,0.0,-190,-145,1530.0
404600.0,3,1.0,1570,7727,1.0,4,8,1270,300.0,1958,2440,7727,23442 days 16:47:18.674853,016,3.0,4.233333333333333,-870,0,970.0
258000.0,3,1.0,1490,7435,1.0,3,7,1120,370.0,1969,1490,7530,19424 days 16:47:18.674853,175,3.0,3.027027027027027,0,-95,750.0
415000.0,4,2.0,1960,10559,2.0,4,7,1960,0.0,1955,1580,7769,24538 days 16:47:18.674853,119,2.0,0.0,380,2790,1960.0
320000.0,4,2.25,2190,9020,2.0,3,8,2190,0.0,1978,2170,8400,16137 days 16:47:18.674853,224,1.7777777777777777,0.0,20,620,2190.0
295000.0,3,2.5,1690,4102,2.0,3,7,1690,0.0,2003,1830,4733,7006 days 16:47:18.674853,330,1.2,0.0,-140,-631,1690.0
389000.0,5,2.0,2330,10750,1.0,4,7,1190,1140.0,1962,1830,10180,21981 days 16:47:18.674853,147,2.5,1.043859649122807,500,570,50.0
299900.0,3,1.75,1470,27000,1.0,3,7,1470,0.0,1958,2230,14186,23442 days 16:47:18.674853,233,1.7142857142857142,0.0,-760,12814,1470.0
394000.0,3,2.5,2550,5349,2.0,3,7,2550,0.0,2004,2640,5400,6641 days 16:47:18.674853,105,1.2,0.0,-90,-51,2550.0
762000.0,4,2.0,2130,5500,1.5,5,7,2130,0.0,1939,1490,6000,30382 days 16:47:18.674853,033,2.0,0.0,640,-500,2130.0
697000.0,4,2.75,3650,48351,1.5,4,8,3650,0.0,1978,2820,53143,16137 days 16:47:18.674853,164,1.4545454545454546,0.0,830,-4792,3650.0
485000.0,3,2.5,3340,70131,2.0,3,9,2420,920.0,1994,2760,116740,10293 days 16:47:18.674853,089,1.2,2.630434782608696,580,-46609,1500.0
189900.0,2,1.0,800,5600,1.0,5,6,800,0.0,1955,1100,6000,24538 days 16:47:18.674853,281,2.0,0.0,-300,-400,800.0
2150000.0,3,2.75,3470,9610,3.0,3,1,3470,0.0,1989,4130,11875,12119 days 16:47:18.674853,005,1.0909090909090908,0.0,-660,-2265,3470.0
345000.0,3,1.5,1030,6969,1.0,4,6,1030,0.0,1921,1420,6000,36956 days 16:47:18.674853,322,2.0,0.0,-390,969,1030.0
376500.0,3,2.0,1630,7800,1.0,5,7,1630,0.0,1950,1470,7800,26364 days 16:47:18.674853,210,1.5,0.0,160,0,1630.0
775000.0,3,2.0,2010,7017,2.0,3,7,2010,0.0,1951,2450,6045,25999 days 16:47:18.674853,297,1.5,0.0,-440,972,2010.0
450000.0,3,1.0,1360,3737,1.5,4,6,1360,0.0,1910,1820,4500,40974 days 16:47:18.674853,289,3.0,0.0,-460,-763,1360.0
760000.0,4,2.25,2040,8315,1.0,4,8,1480,560.0,1958,2330,8940,23442 days 16:47:18.674853,344,1.7777777777777777,2.642857142857143,-290,-625,920.0
569000.0,4,2.5,2830,10954,2.0,3,8,2830,0.0,2003,2470,10443,7006 days 16:47:18.674853,280,1.6,0.0,360,511,2830.0
500000.0,3,1.5,2040,6750,1.0,3,7,1280,760.0,1950,1970,6750,26364 days 16:47:18.674853,260,2.0,1.6842105263157894,70,0,520.0
592500.0,2,2.0,1340,5350,1.5,3,8,1340,0.0,1941,2210,5350,29651 days 16:47:18.674853,345,1.0,0.0,-870,0,1340.0
620000.0,4,2.5,2130,9139,2.0,3,9,2130,0.0,1988,2150,8178,12485 days 16:47:18.674853,063,1.6,0.0,-20,961,2130.0
1000000.0,5,4.25,3920,16258,2.0,3,9,2900,1020.0,1990,2540,12131,11754 days 16:47:18.674853,135,1.1764705882352942,2.843137254901961,1380,4127,1880.0
815000.0,3,2.5,2415,2186,2.0,3,9,2415,0.0,1981,2660,2165,15041 days 16:47:18.674853,078,1.2,0.0,-245,21,2415.0
775000.0,5,2.75,3750,12077,2.0,3,1,3750,0.0,2005,3120,7255,6275 days 16:47:18.674853,082,1.8181818181818181,0.0,630,4822,3750.0
340000.0,3,1.0,1010,7500,1.0,4,7,1010,0.0,1975,1230,7500,17233 days 16:47:18.674853,197,3.0,0.0,-220,0,1010.0
458000.0,2,1.75,990,5850,1.0,4,6,990,0.0,1942,840,6110,29286 days 16:47:18.674853,258,1.1428571428571428,0.0,150,-260,990.0
250000.0,2,1.5,1200,5773,2.0,3,7,1200,0.0,1985,1530,4576,13580 days 16:47:18.674853,260,1.3333333333333333,0.0,-330,1197,1200.0
151600.0,2,1.0,1060,16988,1.0,3,6,1060,0.0,1954,2320,10580,24903 days 16:47:18.674853,282,2.0,0.0,-1260,6408,1060.0
515000.0,4,2.5,3200,6473,2.0,3,7,3200,0.0,2005,2480,6140,6275 days 16:47:18.674853,147,1.6,0.0,720,333,3200.0
216000.0,2,1.0,1810,10360,1.0,3,6,1010,800.0,1946,1810,10360,27825 days 16:47:18.674853,086,2.0,1.2625,0,0,210.0
245000.0,3,1.75,1670,24650,1.0,4,7,1670,0.0,1974,1810,19465,17598 days 16:47:18.674853,068,1.7142857142857142,0.0,-140,5185,1670.0
645000.0,3,2.75,1850,16960,1.0,4,8,1850,0.0,1953,2470,13761,25268 days 16:47:18.674853,176,1.0909090909090908,0.0,-620,3199,1850.0
249900.0,3,1.0,1100,5000,1.0,3,7,1100,0.0,1960,1020,5000,22712 days 16:47:18.674853,246,3.0,0.0,80,0,1100.0
410000.0,3,1.75,1660,6250,1.0,3,7,830,830.0,1980,1660,5750,15407 days 16:47:18.674853,190,1.7142857142857142,1.0,0,500,0.0
499000.0,6,1.75,2400,7500,1.5,3,7,1400,1000.0,1975,1980,7500,17233 days 16:47:18.674853,072,3.4285714285714284,1.4,420,0,400.0
790000.0,5,3.25,2900,12160,1.0,4,8,1890,1010.0,1967,2590,12160,20155 days 16:47:18.674853,149,1.5384615384615385,1.8712871287128714,310,0,880.0
458000.0,1,2.25,2140,10350,1.0,3,7,1470,670.0,1976,1980,8400,16868 days 16:47:18.674853,140,0.4444444444444444,2.1940298507462686,160,1950,800.0
925000.0,4,2.5,2670,5100,2.0,3,8,1940,730.0,1929,1470,4080,34034 days 16:47:18.674853,217,1.6,2.6575342465753424,1200,1020,1210.0
152000.0,3,1.0,1090,3264,1.0,4,6,1090,0.0,1969,1090,3330,19424 days 16:47:18.674853,176,3.0,0.0,0,-66,1090.0
402000.0,3,2.5,1970,12205,2.0,4,8,1970,0.0,1990,2640,9636,11754 days 16:47:18.674853,266,1.2,0.0,-670,2569,1970.0
340000.0,2,2.0,1250,1178,2.0,3,7,980,270.0,1996,1270,1242,9563 days 16:47:18.674853,085,1.0,3.6296296296296298,-20,-64,710.0
1250000.0,4,2.5,4040,11350,2.0,4,1,3690,350.0,1984,3770,12382,13946 days 16:47:18.674853,085,1.6,10.542857142857143,270,-1032,3340.0
775000.0,4,2.5,3220,38448,2.0,3,1,3220,0.0,1993,3090,38448,10658 days 16:47:18.674853,321,1.6,0.0,130,0,3220.0
299800.0,2,1.0,1310,2814,1.0,3,6,810,500.0,1944,1300,1344,28556 days 16:47:18.674853,078,2.0,1.62,10,1470,310.0
340000.0,4,2.25,2060,8400,1.0,3,7,1300,760.0,1960,1990,7383,22712 days 16:47:18.674853,251,1.7777777777777777,1.7105263157894737,70,1017,540.0
626000.0,3,2.25,1750,1572,2.5,3,9,1470,280.0,2005,2410,3050,6275 days 16:47:18.674853,122,1.3333333333333333,5.25,-660,-1478,1190.0
324950.0,2,1.0,1150,9186,1.0,3,7,1150,0.0,1946,1390,10690,27825 days 16:47:18.674853,280,2.0,0.0,-240,-1504,1150.0
535500.0,3,2.5,2050,4976,2.0,3,8,2050,0.0,1994,2050,5153,10293 days 16:47:18.674853,054,1.2,0.0,0,-177,2050.0
817500.0,3,3.25,3230,7639,2.0,3,1,3230,0.0,1999,3230,7772,8467 days 16:47:18.674853,248,0.9230769230769231,0.0,0,-133,3230.0
810000.0,4,3.5,4170,4322,2.0,3,9,2940,1230.0,2005,2970,4922,6275 days 16:47:18.674853,224,1.1428571428571428,2.3902439024390243,1200,-600,1710.0
565000.0,5,1.5,1940,3430,1.5,4,6,1220,720.0,1926,1830,4120,35130 days 16:47:18.674853,098,3.3333333333333335,1.6944444444444444,110,-690,500.0
978000.0,3,1.5,2390,4000,1.5,3,9,1690,700.0,1936,2350,4000,31478 days 16:47:18.674853,329,2.0,2.414285714285714,40,0,990.0
530000.0,3,1.0,1440,27505,1.0,3,8,1440,0.0,1951,2430,16400,25999 days 16:47:18.674853,012,3.0,0.0,-990,11105,1440.0
305000.0,4,2.5,2230,6487,2.0,3,7,2230,0.0,2003,2230,6882,7006 days 16:47:18.674853,280,1.6,0.0,0,-395,2230.0
345000.0,3,2.5,1210,1420,3.0,3,8,1210,0.0,2008,1190,1407,5180 days 16:47:18.674853,160,1.2,0.0,20,13,1210.0
258000.0,2,2.0,750,6553,1.5,3,7,750,0.0,1945,1140,7500,28190 days 16:47:18.674853,050,1.0,0.0,-390,-947,750.0
275000.0,4,1.0,1770,7345,1.5,3,7,1770,0.0,1966,1580,7345,20520 days 16:47:18.674853,089,4.0,0.0,190,0,1770.0
310000.0,3,1.0,1020,55756,1.0,3,7,1020,0.0,1961,1490,12745,22346 days 16:47:18.674853,083,3.0,0.0,-470,43011,1020.0
713250.0,3,2.0,2050,9000,1.0,4,7,2050,0.0,1951,2910,8856,25999 days 16:47:18.674853,154,1.5,0.0,-860,144,2050.0
500000.0,3,1.0,2000,21780,1.0,3,8,1480,520.0,1978,2000,45738,16137 days 16:47:18.674853,128,3.0,2.8461538461538463,0,-23958,960.0
472000.0,3,1.75,2180,7200,1.0,4,8,1090,1090.0,1954,2180,7140,24903 days 16:47:18.674853,254,1.7142857142857142,1.0,0,60,0.0
250000.0,3,1.0,920,4429,1.0,3,7,920,0.0,1952,1320,7860,25634 days 16:47:18.674853,192,3.0,0.0,-400,-3431,920.0
725000.0,4,2.25,3440,14237,2.0,3,9,3440,0.0,1982,3250,18365,14676 days 16:47:18.674853,275,1.7777777777777777,0.0,190,-4128,3440.0
345000.0,3,2.0,1610,15005,1.0,4,7,1610,0.0,1986,1610,15479,13215 days 16:47:18.674853,180,1.5,0.0,0,-474,1610.0
460000.0,3,1.5,1870,15685,1.0,3,7,1470,400.0,1936,1340,7620,31478 days 16:47:18.674853,015,2.0,3.675,530,8065,1070.0
440150.0,2,1.0,1110,6800,1.0,5,7,1000,110.0,1947,1410,6963,27460 days 16:47:18.674853,153,2.0,9.090909090909092,-300,-163,890.0
390000.0,3,1.75,2200,8036,1.0,3,7,1270,930.0,1978,1850,7563,16137 days 16:47:18.674853,308,1.7142857142857142,1.3655913978494623,350,473,340.0
375000.0,2,1.0,790,5120,1.0,3,6,790,0.0,1950,1250,5120,26364 days 16:47:18.674853,124,2.0,0.0,-460,0,790.0
224950.0,3,1.5,1630,9282,1.0,4,7,1630,0.0,1963,1420,9282,21616 days 16:47:18.674853,345,2.0,0.0,210,0,1630.0
480000.0,3,1.5,2100,67269,1.0,4,7,1220,880.0,1949,1610,15999,26729 days 16:47:18.674853,241,2.0,1.3863636363636365,490,51270,340.0
721000.0,4,2.75,2690,5400,2.0,3,7,2210,480.0,1940,1620,5400,30017 days 16:47:18.674853,085,1.4545454545454546,4.604166666666667,1070,0,1730.0
174000.0,2,1.0,600,4854,1.0,5,6,600,0.0,1922,1470,5000,36591 days 16:47:18.674853,238,2.0,0.0,-870,-146,600.0
170000.0,2,1.0,810,9882,1.0,3,6,810,0.0,1944,950,7200,28556 days 16:47:18.674853,323,2.0,0.0,-140,2682,810.0
658000.0,3,1.5,1660,3190,1.5,3,7,1660,0.0,1919,2200,3240,37687 days 16:47:18.674853,015,2.0,0.0,-540,-50,1660.0
860000.0,3,2.0,1880,8494,1.0,4,7,1200,680.0,1968,1290,9128,19790 days 16:47:18.674853,086,1.5,1.7647058823529411,590,-634,520.0
407450.0,4,1.5,2310,68824,2.0,4,7,2310,0.0,1968,2020,39900,19790 days 16:47:18.674853,169,2.6666666666666665,0.0,290,28924,2310.0
615000.0,4,1.5,2650,34000,2.0,4,7,2650,0.0,1930,1960,34000,33669 days 16:47:18.674853,030,2.6666666666666665,0.0,690,0,2650.0
920000.0,4,3.0,3130,12381,2.0,3,9,3130,0.0,1995,3250,10049,9928 days 16:47:18.674853,097,1.3333333333333333,0.0,-120,2332,3130.0
195000.0,2,1.0,860,10400,1.0,4,6,860,0.0,1983,1390,9086,14311 days 16:47:18.674853,191,2.0,0.0,-530,1314,860.0
269950.0,3,1.0,990,9950,1.0,5,7,990,0.0,1961,1370,9260,22346 days 16:47:18.674853,199,3.0,0.0,-380,690,990.0
855000.0,4,3.5,4030,1024068,2.0,3,1,4030,0.0,2006,1830,11700,5910 days 16:47:18.674853,019,1.1428571428571428,0.0,2200,1012368,4030.0
620000.0,3,2.25,1780,1429,3.0,3,8,1570,210.0,2007,1470,1799,5545 days 16:47:18.674853,253,1.3333333333333333,7.476190476190476,310,-370,1360.0
276000.0,2,2.0,1480,6075,1.0,5,7,740,740.0,1919,1230,6053,37687 days 16:47:18.674853,343,1.0,1.0,250,22,0.0
329000.0,3,1.0,1140,5258,1.5,3,6,1140,0.0,1911,1140,5280,40609 days 16:47:18.674853,218,3.0,0.0,0,-22,1140.0
270000.0,3,1.5,1230,7500,1.0,3,7,1230,0.0,1962,1260,7800,21981 days 16:47:18.674853,280,2.0,0.0,-30,-300,1230.0
440000.0,4,2.5,3080,10646,2.0,3,9,3080,0.0,1993,2740,9994,10658 days 16:47:18.674853,317,1.6,0.0,340,652,3080.0
639000.0,4,2.5,1990,8034,2.0,4,1,1990,0.0,1989,2580,8034,12119 days 16:47:18.674853,276,1.6,0.0,-590,0,1990.0
403500.0,1,1.0,700,5621,1.0,4,6,700,0.0,1945,1020,5621,28190 days 16:47:18.674853,283,1.0,0.0,-320,0,700.0
585000.0,3,2.5,1700,1156,2.0,3,9,1320,380.0,2002,1710,1686,7371 days 16:47:18.674853,274,1.2,3.473684210526316,-10,-530,940.0
216000.0,2,1.0,860,9000,1.0,4,6,860,0.0,1942,990,9975,29286 days 16:47:18.674853,238,2.0,0.0,-130,-975,860.0
1150000.0,3,2.5,3160,24437,1.0,3,1,2160,1000.0,1991,3990,11977,11389 days 16:47:18.674853,254,1.2,2.16,-830,12460,1160.0
575000.0,3,2.0,2500,30056,1.0,5,8,1840,660.0,1954,2500,30000,24903 days 16:47:18.674853,106,1.5,2.787878787878788,0,56,1180.0
430000.0,4,2.5,3000,9460,2.0,3,9,3000,0.0,2001,3000,8450,7736 days 16:47:18.674853,318,1.6,0.0,0,1010,3000.0
660000.0,2,1.0,1670,8195,1.0,3,7,1670,0.0,1954,1980,7500,24903 days 16:47:18.674853,083,2.0,0.0,-310,695,1670.0
338000.0,2,1.0,690,6400,1.0,3,6,690,0.0,1943,1000,6400,28921 days 16:47:18.674853,103,2.0,0.0,-310,0,690.0
400000.0,4,2.75,1240,3867,1.0,3,7,800,440.0,1987,1150,7733,12850 days 16:47:18.674853,149,1.4545454545454546,1.8181818181818181,90,-3866,360.0
210000.0,2,1.0,900,5000,1.0,5,6,900,0.0,1930,1150,5000,33669 days 16:47:18.674853,051,2.0,0.0,-250,0,900.0
305000.0,4,1.75,2200,8100,1.5,5,6,1400,800.0,1942,1520,8100,29286 days 16:47:18.674853,142,2.2857142857142856,1.75,680,0,600.0
365000.0,2,1.0,960,223898,1.0,3,6,960,0.0,1985,1830,230868,13580 days 16:47:18.674853,232,2.0,0.0,-870,-6970,960.0
325000.0,5,2.75,2130,6222,1.0,3,7,1300,830.0,1991,2130,6222,11389 days 16:47:18.674853,180,1.8181818181818181,1.5662650602409638,0,0,470.0
245000.0,4,1.75,2020,8800,1.0,4,8,2020,0.0,1969,2320,8000,19424 days 16:47:18.674853,344,2.2857142857142856,0.0,-300,800,2020.0
182000.0,3,1.0,1060,7350,1.0,4,7,1060,0.0,1959,1060,7350,23077 days 16:47:18.674853,269,3.0,0.0,0,0,1060.0
440000.0,2,1.0,1230,6600,1.0,3,7,1130,100.0,1906,1260,5060,42435 days 16:47:18.674853,154,2.0,11.3,-30,1540,1030.0
225000.0,3,2.25,2510,12013,2.0,3,8,2510,0.0,1988,1870,8017,12485 days 16:47:18.674853,212,1.3333333333333333,0.0,640,3996,2510.0
358000.0,3,2.25,2510,12013,2.0,3,8,2510,0.0,1988,1870,8017,12485 days 16:47:18.674853,014,1.3333333333333333,0.0,640,3996,2510.0
580000.0,5,2.5,2720,5000,1.5,4,7,1530,1190.0,1939,1210,5000,30382 days 16:47:18.674853,336,2.0,1.2857142857142858,1510,0,340.0
240000.0,3,1.5,1070,8886,1.0,4,7,1070,0.0,1984,1730,9461,13946 days 16:47:18.674853,112,2.0,0.0,-660,-575,1070.0
700000.0,4,3.25,3580,43093,1.0,4,8,3580,0.0,1990,2070,43093,11754 days 16:47:18.674853,103,1.2307692307692308,0.0,1510,0,3580.0
325000.0,4,2.5,2230,8500,2.0,3,8,2230,0.0,1994,2270,8770,10293 days 16:47:18.674853,210,1.6,0.0,-40,-270,2230.0
488000.0,4,2.25,2500,10890,1.0,5,7,1800,700.0,1978,2500,7467,16137 days 16:47:18.674853,318,1.7777777777777777,2.5714285714285716,0,3423,1100.0
875000.0,4,1.0,1670,4600,1.5,5,8,1670,0.0,1906,1820,4600,42435 days 16:47:18.674853,253,4.0,0.0,-150,0,1670.0
615000.0,4,2.5,2150,9070,2.0,4,8,2150,0.0,1985,2230,8995,13580 days 16:47:18.674853,153,1.6,0.0,-80,75,2150.0
321000.0,3,2.5,2020,4183,2.0,3,7,2020,0.0,2012,2030,4140,3719 days 16:47:18.674853,324,1.2,0.0,-10,43,2020.0
1040000.0,3,2.5,2230,5750,2.0,3,9,2230,0.0,2003,1900,8238,7006 days 16:47:18.674853,153,1.2,0.0,330,-2488,2230.0
299500.0,2,1.0,740,6300,1.0,3,6,740,0.0,1942,740,6300,29286 days 16:47:18.674853,114,2.0,0.0,0,0,740.0
459000.0,4,1.5,2020,9583,2.0,4,7,2020,0.0,1963,1770,8625,21616 days 16:47:18.674853,104,2.6666666666666665,0.0,250,958,2020.0
435000.0,3,2.5,1730,4065,2.0,3,8,1730,0.0,1996,1730,4094,9563 days 16:47:18.674853,255,1.2,0.0,0,-29,1730.0
222000.0,3,1.75,1370,8280,1.0,4,7,1370,0.0,1980,1850,7820,15407 days 16:47:18.674853,283,1.7142857142857142,0.0,-480,460,1370.0
485000.0,4,1.0,1210,6380,1.5,3,7,1210,0.0,1936,1340,6380,31478 days 16:47:18.674853,300,4.0,0.0,-130,0,1210.0
750000.0,5,3.5,2160,2323,3.0,3,9,2160,0.0,2007,1750,4650,5545 days 16:47:18.674853,119,1.4285714285714286,0.0,410,-2327,2160.0
266000.0,3,2.25,1550,6022,2.0,3,8,1550,0.0,1989,1650,5627,12119 days 16:47:18.674853,356,1.3333333333333333,0.0,-100,395,1550.0
455000.0,2,1.0,1170,6000,1.0,4,7,970,200.0,1941,2130,6002,29651 days 16:47:18.674853,153,2.0,4.85,-960,-2,770.0
490000.0,3,1.75,2020,215622,2.0,4,7,2020,0.0,1975,1810,215622,17233 days 16:47:18.674853,128,1.7142857142857142,0.0,210,0,2020.0
280000.0,3,1.75,1740,8625,1.0,4,7,1240,500.0,1978,1980,8625,16137 days 16:47:18.674853,120,1.7142857142857142,2.48,-240,0,740.0
291000.0,4,1.0,1590,24330,1.5,3,6,1140,450.0,1942,1000,16228,29286 days 16:47:18.674853,351,4.0,2.533333333333333,590,8102,690.0
745000.0,5,3.0,2400,10126,2.0,3,8,2400,0.0,1981,2250,3946,15041 days 16:47:18.674853,107,1.6666666666666667,0.0,150,6180,2400.0
685900.0,3,2.5,2290,9142,1.0,3,8,2290,0.0,1972,1770,8035,18329 days 16:47:18.674853,219,1.2,0.0,520,1107,2290.0
160000.0,3,1.75,1610,7392,1.0,4,7,1610,0.0,1964,1450,7392,21251 days 16:47:18.674853,213,1.7142857142857142,0.0,160,0,1610.0
650000.0,4,2.5,2240,9934,1.0,4,8,1490,750.0,1968,2640,11622,19790 days 16:47:18.674853,119,1.6,1.9866666666666666,-400,-1688,740.0
250000.0,2,1.0,850,6370,1.0,3,6,850,0.0,1951,850,5170,25999 days 16:47:18.674853,050,2.0,0.0,0,1200,850.0
265000.0,2,1.5,920,1458,2.0,3,7,920,0.0,1995,1110,1598,9928 days 16:47:18.674853,049,1.3333333333333333,0.0,-190,-140,920.0
599000.0,5,3.25,2590,6180,1.0,3,7,1330,1260.0,1960,1560,6180,22712 days 16:47:18.674853,309,1.5384615384615385,1.0555555555555556,1030,0,70.0
199950.0,3,1.0,1340,7260,1.5,3,6,1340,0.0,1944,1210,7260,28556 days 16:47:18.674853,309,3.0,0.0,130,0,1340.0
712500.0,4,2.75,2420,11201,1.0,3,8,1420,1000.0,1948,3170,9385,27095 days 16:47:18.674853,118,1.4545454545454546,1.42,-750,1816,420.0
490000.0,2,1.0,1420,4305,1.0,4,7,920,500.0,1941,1420,4305,29651 days 16:47:18.674853,295,2.0,1.84,0,0,420.0
299000.0,3,1.0,1510,6200,1.0,3,6,1010,500.0,1955,1710,8623,24538 days 16:47:18.674853,078,3.0,2.02,-200,-2423,510.0
685000.0,4,2.5,2650,25248,1.0,3,9,2330,320.0,1954,3020,23135,24903 days 16:47:18.674853,226,1.6,7.28125,-370,2113,2010.0
597000.0,4,2.0,2120,4000,1.5,4,7,1720,400.0,1927,1760,4000,34765 days 16:47:18.674853,237,2.0,4.3,360,0,1320.0
210000.0,3,1.0,1200,7200,1.0,3,6,1200,0.0,1977,1200,7420,16502 days 16:47:18.674853,251,3.0,0.0,0,-220,1200.0
659000.0,4,2.5,3190,11375,1.0,5,8,2210,980.0,1946,1100,8500,27825 days 16:47:18.674853,150,1.6,2.2551020408163267,2090,2875,1230.0
540000.0,3,1.0,1050,4160,1.0,4,7,1050,0.0,1925,1580,3680,35495 days 16:47:18.674853,155,3.0,0.0,-530,480,1050.0
469000.0,3,2.0,1300,22605,1.0,3,7,1300,0.0,1998,2250,10215,8832 days 16:47:18.674853,089,1.5,0.0,-950,12390,1300.0
1070000.0,3,2.5,3970,263538,1.5,3,9,3970,0.0,1991,3970,194676,11389 days 16:47:18.674853,120,1.2,0.0,0,68862,3970.0
575000.0,5,2.5,2990,7500,1.0,3,9,1800,1190.0,1972,2800,9860,18329 days 16:47:18.674853,195,2.0,1.5126050420168067,190,-2360,610.0
299950.0,4,1.0,1170,5400,1.0,5,6,1170,0.0,1953,1100,5400,25268 days 16:47:18.674853,260,4.0,0.0,70,0,1170.0
375000.0,4,2.0,2270,18450,1.0,3,7,2270,0.0,1961,2150,18450,22346 days 16:47:18.674853,111,2.0,0.0,120,0,2270.0
342450.0,3,1.5,1280,5525,1.0,3,7,1280,0.0,1962,1330,5286,21981 days 16:47:18.674853,322,2.0,0.0,-50,239,1280.0
315000.0,4,2.5,1950,3225,2.0,3,7,1950,0.0,2002,1980,3225,7371 days 16:47:18.674853,302,1.6,0.0,-30,0,1950.0
328000.0,4,2.75,1930,3840,1.0,3,7,1170,760.0,1997,1610,3840,9197 days 16:47:18.674853,356,1.4545454545454546,1.5394736842105263,320,0,410.0
323000.0,4,2.75,1970,7213,1.0,3,8,1170,800.0,1977,1980,7045,16502 days 16:47:18.674853,129,1.4545454545454546,1.4625,-10,168,370.0
320000.0,4,3.0,1820,3120,1.0,3,7,1000,820.0,1997,1600,5001,9197 days 16:47:18.674853,295,1.3333333333333333,1.2195121951219512,220,-1881,180.0
550000.0,2,1.0,950,4080,1.0,4,7,950,0.0,1924,1120,4080,35861 days 16:47:18.674853,363,2.0,0.0,-170,0,950.0
1650000.0,6,3.5,4010,16200,1.0,3,8,2090,1920.0,1955,3560,16200,24538 days 16:47:18.674853,325,1.7142857142857142,1.0885416666666667,450,0,170.0
1210000.0,4,3.5,4560,16643,1.0,3,1,2230,2330.0,1995,4060,15177,9928 days 16:47:18.674853,140,1.1428571428571428,0.9570815450643777,500,1466,-100.0
1200000.0,4,3.5,4560,16643,1.0,3,1,2230,2330.0,1995,4060,15177,9928 days 16:47:18.674853,239,1.1428571428571428,0.9570815450643777,500,1466,-100.0
120000.0,3,1.0,1150,8924,1.0,3,6,1150,0.0,1943,1492,8924,28921 days 16:47:18.674853,021,3.0,0.0,-342,0,1150.0
175000.0,3,1.0,1150,8924,1.0,3,6,1150,0.0,1943,1492,8924,28921 days 16:47:18.674853,120,3.0,0.0,-342,0,1150.0
169900.0,3,1.0,910,5800,1.5,4,5,910,0.0,1900,1400,6766,44626 days 16:47:18.674853,259,3.0,0.0,-490,-966,910.0
508000.0,6,2.75,2890,7500,1.0,4,8,1830,1060.0,1976,1880,7500,16868 days 16:47:18.674853,223,2.1818181818181817,1.7264150943396226,1010,0,770.0
335000.0,2,1.0,1070,6678,1.0,4,7,1070,0.0,1951,1680,7788,25999 days 16:47:18.674853,345,2.0,0.0,-610,-1110,1070.0
613200.0,3,2.75,2050,3320,1.5,4,7,1580,470.0,1927,1760,4150,34765 days 16:47:18.674853,253,1.0909090909090908,3.3617021276595747,290,-830,1110.0
420000.0,2,1.5,1040,3500,1.5,4,6,1040,0.0,1904,1340,1213,43166 days 16:47:18.674853,127,1.3333333333333333,0.0,-300,2287,1040.0
1000000.0,4,3.25,3320,8587,3.0,3,1,2950,370.0,2008,1860,5668,5180 days 16:47:18.674853,237,1.2307692307692308,7.972972972972973,1460,2919,2580.0
342000.0,2,1.0,740,6180,1.0,3,6,740,0.0,1948,1330,4635,27095 days 16:47:18.674853,168,2.0,0.0,-590,1545,740.0
850000.0,4,2.0,3380,90968,1.0,4,9,1690,1690.0,1979,3380,42740,15772 days 16:47:18.674853,204,2.0,1.0,0,48228,0.0
582000.0,2,1.75,1210,4141,1.0,4,7,910,300.0,1942,1310,4141,29286 days 16:47:18.674853,352,1.1428571428571428,3.033333333333333,-100,0,610.0
475000.0,3,2.5,2480,6031,2.0,3,8,2480,0.0,2001,1850,7704,7736 days 16:47:18.674853,304,1.2,0.0,630,-1673,2480.0
570000.0,3,2.25,2010,6000,1.0,3,8,1330,680.0,1975,2080,8260,17233 days 16:47:18.674853,125,1.3333333333333333,1.9558823529411764,-70,-2260,650.0
826600.0,4,3.25,3230,5000,1.5,4,7,1750,1480.0,1916,1730,4000,38783 days 16:47:18.674853,083,1.2307692307692308,1.1824324324324325,1500,1000,270.0
387000.0,2,2.5,1170,1394,2.0,3,8,1170,0.0,2001,1250,3136,7736 days 16:47:18.674853,294,0.8,0.0,-80,-1742,1170.0
330000.0,3,1.0,1250,9126,1.0,3,7,1250,0.0,1969,1440,10620,19424 days 16:47:18.674853,141,3.0,0.0,-190,-1494,1250.0
653450.0,3,2.5,2070,49658,1.0,4,8,1540,530.0,1980,2620,35160,15407 days 16:47:18.674853,206,1.2,2.9056603773584904,-550,14498,1010.0
285000.0,2,1.0,1050,3088,1.0,3,7,1050,0.0,2005,1890,2772,6275 days 16:47:18.674853,254,2.0,0.0,-840,316,1050.0
217000.0,3,1.0,1400,7800,1.0,3,7,1400,0.0,1962,1400,7800,21981 days 16:47:18.674853,226,3.0,0.0,0,0,1400.0
615000.0,3,1.0,1120,12500,1.0,4,7,1120,0.0,1977,2380,10000,16502 days 16:47:18.674853,054,3.0,0.0,-1260,2500,1120.0
580135.0,4,2.5,3150,5886,2.0,3,8,3150,0.0,2014,2650,5886,2988 days 16:47:18.674853,154,1.6,0.0,500,0,3150.0
1150000.0,4,3.5,4540,19767,2.0,3,1,4200,340.0,1998,3990,12881,8832 days 16:47:18.674853,211,1.1428571428571428,12.352941176470589,550,6886,3860.0
231200.0,3,2.0,1400,8821,1.0,3,7,1400,0.0,1991,1450,8721,11389 days 16:47:18.674853,302,1.5,0.0,-50,100,1400.0
680000.0,4,2.75,2500,4950,2.0,3,8,2500,0.0,2010,2500,4950,4449 days 16:47:18.674853,167,1.4545454545454546,0.0,0,0,2500.0
267500.0,3,1.5,1390,2153,2.0,3,7,1390,0.0,2001,1100,2617,7736 days 16:47:18.674853,206,2.0,0.0,290,-464,1390.0
942000.0,4,2.75,3160,37200,2.0,3,8,2310,850.0,1939,3130,20000,30382 days 16:47:18.674853,216,1.4545454545454546,2.7176470588235295,30,17200,1460.0
435000.0,3,1.75,1310,8065,1.0,4,6,1310,0.0,1948,1420,8100,27095 days 16:47:18.674853,170,1.7142857142857142,0.0,-110,-35,1310.0
315000.0,2,1.0,1740,3622,1.0,4,7,950,790.0,1924,1270,3800,35861 days 16:47:18.674853,161,2.0,1.2025316455696202,470,-178,160.0
354901.0,3,2.5,1490,1709,3.0,3,8,1490,0.0,2004,1364,1709,6641 days 16:47:18.674853,133,1.2,0.0,126,0,1490.0
439888.0,2,2.0,1300,6515,1.0,3,8,1300,0.0,2005,1640,6009,6275 days 16:47:18.674853,287,1.0,0.0,-340,506,1300.0
360000.0,4,1.0,1460,3840,1.5,3,8,1340,120.0,1928,990,4200,34400 days 16:47:18.674853,022,4.0,11.166666666666666,470,-360,1220.0
205000.0,4,1.0,1030,6621,1.0,4,6,1030,0.0,1955,1420,6631,24538 days 16:47:18.674853,365,4.0,0.0,-390,-10,1030.0
299995.0,3,2.5,1970,7500,2.0,3,8,1970,0.0,1988,1950,8220,12485 days 16:47:18.674853,163,1.2,0.0,20,-720,1970.0
150000.0,2,1.0,790,7275,1.0,4,6,790,0.0,1944,850,7399,28556 days 16:47:18.674853,266,2.0,0.0,-60,-124,790.0
575000.0,3,2.25,3800,33825,1.0,4,1,3330,470.0,1976,3470,14484,16868 days 16:47:18.674853,154,1.3333333333333333,7.085106382978723,330,19341,2860.0
625000.0,3,2.0,2168,12616,2.0,4,7,2168,0.0,1950,2168,9750,26364 days 16:47:18.674853,125,1.5,0.0,0,2866,2168.0
950000.0,4,3.5,4140,13392,2.0,3,1,4140,0.0,2000,4140,11529,8102 days 16:47:18.674853,149,1.1428571428571428,0.0,0,1863,4140.0
278800.0,4,2.5,2440,7797,1.0,3,8,1560,880.0,1965,2090,8100,20885 days 16:47:18.674853,041,1.6,1.7727272727272727,350,-303,680.0
713500.0,3,2.0,1720,4200,2.0,3,8,1720,0.0,1908,1720,4200,41705 days 16:47:18.674853,314,1.5,0.0,0,0,1720.0
1900000.0,4,2.25,3020,11489,1.5,5,1,2110,910.0,1916,3890,11489,38783 days 16:47:18.674853,084,1.7777777777777777,2.318681318681319,-870,0,1200.0
439000.0,5,2.0,2610,5009,1.0,3,7,1710,900.0,1988,1600,5040,12485 days 16:47:18.674853,301,2.5,1.9,1010,-31,810.0
425000.0,3,2.0,1500,8086,1.0,3,7,1060,440.0,1981,1550,8086,15041 days 16:47:18.674853,269,1.5,2.409090909090909,-50,0,620.0
252500.0,4,2.5,2600,11280,1.5,3,7,1570,1030.0,1961,1660,11200,22346 days 16:47:18.674853,237,1.6,1.5242718446601942,940,80,540.0
185000.0,3,1.5,1370,8470,1.0,4,7,1370,0.0,1961,1710,8800,22346 days 16:47:18.674853,132,2.0,0.0,-340,-330,1370.0
406550.0,5,2.75,2400,15781,1.0,4,7,1200,1200.0,1974,2390,7500,17598 days 16:47:18.675850,266,1.8181818181818181,1.0,10,8281,0.0
243000.0,2,1.5,1068,1758,2.0,3,7,1068,0.0,1990,1078,1315,11754 days 16:47:18.675850,181,1.3333333333333333,0.0,-10,443,1068.0
500000.0,3,1.5,2220,8994,1.0,4,8,1110,1110.0,1962,2220,8994,21981 days 16:47:18.675850,335,2.0,1.0,0,0,0.0
204750.0,2,1.0,880,7575,1.0,4,7,880,0.0,1942,1800,7575,29286 days 16:47:18.675850,133,2.0,0.0,-920,0,880.0
222000.0,3,1.5,1310,9273,1.0,4,7,1310,0.0,1968,1710,9600,19790 days 16:47:18.675850,252,2.0,0.0,-400,-327,1310.0
200000.0,4,1.0,1350,11507,1.0,3,7,1350,0.0,1966,1320,25675,20520 days 16:47:18.675850,143,4.0,0.0,30,-14168,1350.0
367000.0,3,2.25,1400,1320,3.0,3,8,1400,0.0,2006,1490,1449,5910 days 16:47:18.675850,294,1.3333333333333333,0.0,-90,-129,1400.0
183000.0,3,1.0,1170,7320,1.0,3,7,1170,0.0,1962,2040,7320,21981 days 16:47:18.675850,134,3.0,0.0,-870,0,1170.0
300000.0,3,2.5,1020,1570,2.0,3,7,720,300.0,2004,1470,1249,6641 days 16:47:18.675850,344,1.2,2.4,-450,321,420.0
369000.0,3,1.75,1300,3844,1.0,3,7,1300,0.0,1985,1290,3844,13580 days 16:47:18.675850,231,1.7142857142857142,0.0,10,0,1300.0
380000.0,3,2.0,2010,16736,2.0,4,6,2010,0.0,1929,1890,11477,34034 days 16:47:18.675850,212,1.5,0.0,120,5259,2010.0
463000.0,3,2.0,1590,5009,2.0,4,6,1590,0.0,1985,1730,6380,13580 days 16:47:18.675850,034,1.5,0.0,-140,-1371,1590.0
475000.0,3,1.0,1470,9750,1.0,3,7,1470,0.0,1963,1300,9750,21616 days 16:47:18.675850,342,3.0,0.0,170,0,1470.0
225000.0,3,1.75,1580,14400,1.0,4,7,1580,0.0,1981,1480,9600,15041 days 16:47:18.675850,083,1.7142857142857142,0.0,100,4800,1580.0
371000.0,3,1.75,1970,9512,1.0,3,8,1970,0.0,1968,2250,10573,19790 days 16:47:18.675850,131,1.7142857142857142,0.0,-280,-1061,1970.0
625000.0,3,2.5,2330,3141,2.0,3,8,2330,0.0,2003,1980,5265,7006 days 16:47:18.675850,239,1.2,0.0,350,-2124,2330.0
3200000.0,6,5.0,7100,18200,2.5,3,1,5240,1860.0,1933,3130,6477,32573 days 16:47:18.675850,266,1.2,2.817204301075269,3970,11723,3380.0
329000.0,3,1.75,1230,10725,1.0,3,7,1230,0.0,1980,1250,10170,15407 days 16:47:18.675850,029,1.7142857142857142,0.0,-20,555,1230.0
634000.0,3,1.75,2570,13000,2.0,4,7,2570,0.0,1962,2570,8521,21981 days 16:47:18.675850,041,1.7142857142857142,0.0,0,4479,2570.0
616000.0,4,2.5,3440,6915,2.0,3,1,3440,0.0,2006,3200,6915,5910 days 16:47:18.675850,311,1.6,0.0,240,0,3440.0
1820000.0,3,2.25,3330,20053,2.0,3,9,3330,0.0,1968,2870,20053,19790 days 16:47:18.675850,114,1.3333333333333333,0.0,460,0,3330.0
435000.0,4,2.25,1780,2684,2.0,3,7,1780,0.0,2002,1670,2426,7371 days 16:47:18.675850,078,1.7777777777777777,0.0,110,258,1780.0
320000.0,4,2.5,2110,6295,2.0,3,8,2110,0.0,2000,2720,6311,8102 days 16:47:18.675850,105,1.6,0.0,-610,-16,2110.0
820000.0,4,3.5,2770,8049,2.0,3,9,2770,0.0,2002,3410,7447,7371 days 16:47:18.675850,014,1.1428571428571428,0.0,-640,602,2770.0
310000.0,3,2.5,1590,3359,2.0,3,7,1590,0.0,2000,1820,3383,8102 days 16:47:18.675850,234,1.2,0.0,-230,-24,1590.0
443750.0,3,2.25,1460,968,2.0,3,7,1140,320.0,2003,1460,1531,7006 days 16:47:18.675850,336,1.3333333333333333,3.5625,0,-563,820.0
795000.0,4,2.25,2070,13084,1.0,4,8,1700,370.0,1967,2520,10180,20155 days 16:47:18.675850,156,1.7777777777777777,4.594594594594595,-450,2904,1330.0
475000.0,3,2.5,2420,36862,1.0,4,8,1530,890.0,1957,1670,9046,23807 days 16:47:18.675850,308,1.2,1.7191011235955056,750,27816,640.0
585000.0,5,1.75,2000,3750,2.0,4,7,2000,0.0,1921,1520,3750,36956 days 16:47:18.675850,135,2.857142857142857,0.0,480,0,2000.0
315000.0,2,1.0,1010,7338,2.0,4,7,1010,0.0,1981,1220,7719,15041 days 16:47:18.675850,210,2.0,0.0,-210,-381,1010.0
635000.0,4,2.5,3050,7238,2.0,3,8,3050,0.0,1989,2580,7228,12119 days 16:47:18.675850,260,1.6,0.0,470,10,3050.0
305000.0,3,1.0,1160,11776,1.0,3,7,1160,0.0,1968,1160,10050,19790 days 16:47:18.675850,148,3.0,0.0,0,1726,1160.0
785000.0,3,2.0,2180,5440,1.0,5,7,1100,1080.0,1904,1470,4109,43166 days 16:47:18.675850,136,1.5,1.0185185185185186,710,1331,20.0
525000.0,3,1.75,1560,6000,1.0,3,6,780,780.0,1944,1560,1734,28556 days 16:47:18.675850,297,1.7142857142857142,1.0,0,4266,0.0
537000.0,4,1.75,1580,3635,1.0,4,7,790,790.0,1910,1190,3638,40974 days 16:47:18.675850,020,2.2857142857142856,1.0,390,-3,0.0
279950.0,3,1.75,1660,8303,1.0,3,7,1380,280.0,1974,1740,8320,17598 days 16:47:18.675850,048,1.7142857142857142,4.928571428571429,-80,-17,1100.0
659000.0,4,2.0,2350,9329,2.0,3,8,2350,0.0,1977,1640,9403,16502 days 16:47:18.675850,342,2.0,0.0,710,-74,2350.0
782500.0,4,2.5,2930,7806,2.0,3,9,2930,0.0,2005,2600,6051,6275 days 16:47:18.675850,252,1.6,0.0,330,1755,2930.0
250000.0,3,1.75,1590,7560,1.0,3,7,1130,460.0,1984,1500,7560,13946 days 16:47:18.675850,161,1.7142857142857142,2.4565217391304346,90,0,670.0
279000.0,3,1.0,1400,9450,1.0,4,7,1060,340.0,1955,1400,8108,24538 days 16:47:18.675850,217,3.0,3.1176470588235294,0,1342,720.0
664000.0,6,2.5,3190,12196,2.0,4,8,3190,0.0,1979,2790,13068,15772 days 16:47:18.675850,329,2.4,0.0,400,-872,3190.0
2900000.0,4,3.25,4580,4838,2.0,4,1,3080,1500.0,1991,3540,6483,11389 days 16:47:18.675850,260,1.2307692307692308,2.0533333333333332,1040,-1645,1580.0
378500.0,4,2.0,1830,6000,1.0,5,7,1070,760.0,1953,1830,5500,25268 days 16:47:18.675850,089,2.0,1.4078947368421053,0,500,310.0
535000.0,3,1.75,2720,149410,1.5,3,9,2720,0.0,1988,2560,149410,12485 days 16:47:18.675850,127,1.7142857142857142,0.0,160,0,2720.0
520000.0,2,1.0,1360,22508,1.0,3,7,1360,0.0,1932,2830,12600,32939 days 16:47:18.675850,197,2.0,0.0,-1470,9908,1360.0
369950.0,3,2.0,1520,4000,1.0,5,6,800,720.0,1943,1430,4000,28921 days 16:47:18.675850,124,1.5,1.1111111111111112,90,0,80.0
545000.0,3,2.25,2290,14585,2.0,3,8,2290,0.0,1981,1660,36961,15041 days 16:47:18.675850,267,1.3333333333333333,0.0,630,-22376,2290.0
360000.0,3,2.5,2150,14092,2.0,3,8,2150,0.0,1991,2400,10699,11389 days 16:47:18.675850,124,1.2,0.0,-250,3393,2150.0
760000.0,3,1.5,1170,7645,1.0,4,7,1170,0.0,1955,1870,7678,24538 days 16:47:18.675850,217,2.0,0.0,-700,-33,1170.0
450000.0,3,1.75,1830,5488,1.0,4,7,1010,820.0,1939,1200,5488,30382 days 16:47:18.675850,259,1.7142857142857142,1.2317073170731707,630,0,190.0
612500.0,4,2.5,2730,12261,2.0,3,9,2730,0.0,1991,2730,10872,11389 days 16:47:18.675850,122,1.6,0.0,0,1389,2730.0
280000.0,3,1.0,1090,10710,1.0,4,7,1090,0.0,1962,1090,10440,21981 days 16:47:18.675850,182,3.0,0.0,0,270,1090.0
750000.0,3,2.5,2560,9182,2.0,3,9,2560,0.0,1993,2800,8784,10658 days 16:47:18.675850,104,1.2,0.0,-240,398,2560.0
237000.0,3,1.0,1160,6132,1.0,4,7,1160,0.0,1958,1280,6132,23442 days 16:47:18.675850,196,3.0,0.0,-120,0,1160.0
441500.0,2,1.75,1010,4000,1.5,5,7,1010,0.0,1919,1470,4000,37687 days 16:47:18.675850,287,1.1428571428571428,0.0,-460,0,1010.0
251000.0,3,2.0,1650,7930,1.0,4,7,1650,0.0,1989,1510,7930,12119 days 16:47:18.675850,026,1.5,0.0,140,0,1650.0
200000.0,3,1.0,2120,31564,1.0,3,7,1220,900.0,1942,1790,11571,29286 days 16:47:18.675850,363,3.0,1.3555555555555556,330,19993,320.0
332000.0,1,1.0,960,2640,1.0,3,7,760,200.0,1908,1620,3759,41705 days 16:47:18.675850,167,1.0,3.8,-660,-1119,560.0
401500.0,3,2.5,1509,1114,3.0,3,8,1509,0.0,2014,1509,2431,2988 days 16:47:18.675850,238,1.2,0.0,0,-1317,1509.0
585000.0,4,1.75,2270,27122,1.0,5,8,1300,970.0,1957,2380,11822,23807 days 16:47:18.675850,269,2.2857142857142856,1.3402061855670102,-110,15300,330.0
340000.0,4,2.5,1954,4805,2.0,3,8,1954,0.0,2005,1714,3259,6275 days 16:47:18.675850,183,1.6,0.0,240,1546,1954.0
920000.0,3,3.5,2800,7694,1.0,3,9,2800,0.0,2005,2420,7694,6275 days 16:47:18.675850,012,0.8571428571428571,0.0,380,0,2800.0
153000.0,3,1.0,1270,6405,1.5,3,6,1270,0.0,1944,1110,6405,28556 days 16:47:18.675850,164,3.0,0.0,160,0,1270.0
299950.0,4,2.25,1810,7601,1.0,3,7,1080,730.0,1986,1570,7601,13215 days 16:47:18.675850,005,1.7777777777777777,1.4794520547945205,240,0,350.0
440000.0,4,2.5,2410,7517,2.0,3,8,2410,0.0,1983,2420,8095,14311 days 16:47:18.675850,132,1.6,0.0,-10,-578,2410.0
293000.0,3,2.5,1690,17383,2.0,3,7,1690,0.0,2003,2610,7999,7006 days 16:47:18.675850,258,1.2,0.0,-920,9384,1690.0
203000.0,3,1.75,1190,6000,1.0,3,7,1190,0.0,1952,1200,6000,25634 days 16:47:18.675850,088,1.7142857142857142,0.0,-10,0,1190.0
193000.0,2,1.75,1280,6774,1.0,3,7,1280,0.0,1991,1450,7810,11389 days 16:47:18.675850,079,1.1428571428571428,0.0,-170,-1036,1280.0
305000.0,3,1.75,1460,7862,1.0,3,7,1460,0.0,1965,2200,9293,20885 days 16:47:18.675850,075,1.7142857142857142,0.0,-740,-1431,1460.0
495000.0,4,1.75,1600,6380,1.0,3,8,1130,470.0,1959,1090,6380,23077 days 16:47:18.675850,122,2.2857142857142856,2.404255319148936,510,0,660.0
420000.0,3,1.75,1770,6000,1.0,3,7,1130,640.0,1952,1900,7200,25634 days 16:47:18.675850,245,1.7142857142857142,1.765625,-130,-1200,490.0
569500.0,4,2.5,2800,8190,1.0,3,8,1700,1100.0,1971,2460,8165,18694 days 16:47:18.675850,248,1.6,1.5454545454545454,340,25,600.0
620000.0,4,2.5,2680,9185,2.0,3,9,2680,0.0,1989,2810,8505,12119 days 16:47:18.675850,135,1.6,0.0,-130,680,2680.0
466000.0,3,1.75,1680,9460,1.0,4,7,1680,0.0,1959,1690,9448,23077 days 16:47:18.675850,345,1.7142857142857142,0.0,-10,12,1680.0
355500.0,3,1.0,1120,10032,1.0,3,7,1120,0.0,1962,1210,9918,21981 days 16:47:18.675850,083,3.0,0.0,-90,114,1120.0
687500.0,2,1.0,1040,7200,1.0,4,6,1040,0.0,1955,1640,7200,24538 days 16:47:18.675850,128,2.0,0.0,-600,0,1040.0
432100.0,3,2.25,1790,2240,2.0,4,8,1790,0.0,1975,1780,2560,17233 days 16:47:18.675850,101,1.3333333333333333,0.0,10,-320,1790.0
500000.0,3,2.5,2410,34848,1.5,3,8,2410,0.0,1976,2420,16424,16868 days 16:47:18.675850,202,1.2,0.0,-10,18424,2410.0
690000.0,5,3.25,3370,7313,2.0,4,8,2140,1230.0,1988,2990,7806,12485 days 16:47:18.675850,283,1.5384615384615385,1.7398373983739837,380,-493,910.0
350000.0,2,1.0,800,5150,1.0,4,6,800,0.0,1949,1280,5150,26729 days 16:47:18.675850,002,2.0,0.0,-480,0,800.0
268000.0,2,1.0,1380,5000,1.0,3,7,870,510.0,1943,1450,5000,28921 days 16:47:18.675850,161,2.0,1.7058823529411764,-70,0,360.0
120000.0,2,1.0,990,39964,1.0,2,4,990,0.0,1945,1560,8990,28190 days 16:47:18.675850,170,2.0,0.0,-570,30974,990.0
285000.0,4,2.5,1800,9229,2.0,3,7,1800,0.0,1994,1970,9231,10293 days 16:47:18.675850,049,1.6,0.0,-170,-2,1800.0
365000.0,4,1.5,1820,12327,1.0,4,7,1380,440.0,1955,1450,9256,24538 days 16:47:18.675850,281,2.6666666666666665,3.1363636363636362,370,3071,940.0
635000.0,3,2.5,2620,6842,2.0,3,7,2620,0.0,2002,2280,4800,7371 days 16:47:18.675850,098,1.2,0.0,340,2042,2620.0
630000.0,2,2.5,2290,3507,2.0,3,9,2290,0.0,2005,2290,3640,6275 days 16:47:18.675850,189,0.8,0.0,0,-133,2290.0
450000.0,4,3.0,2200,4466,2.0,3,7,2200,0.0,1968,1780,2250,19790 days 16:47:18.675850,064,1.3333333333333333,0.0,420,2216,2200.0
590000.0,4,2.5,2940,12600,1.0,4,8,1850,1090.0,1974,2030,11770,17598 days 16:47:18.675850,063,1.6,1.6972477064220184,910,830,760.0
895000.0,2,1.75,1700,3618,1.0,3,8,1260,440.0,1950,2200,5000,26364 days 16:47:18.675850,252,1.1428571428571428,2.8636363636363638,-500,-1382,820.0
160000.0,3,1.0,860,11900,1.0,4,6,860,0.0,1963,1660,10248,21616 days 16:47:18.675850,134,3.0,0.0,-800,1652,860.0
520000.0,2,1.0,910,5000,1.0,3,7,910,0.0,1924,1050,5000,35861 days 16:47:18.675850,273,2.0,0.0,-140,0,910.0
432000.0,4,3.25,2820,13059,2.0,4,8,2820,0.0,1976,2360,8600,16868 days 16:47:18.675850,218,1.2307692307692308,0.0,460,4459,2820.0
141800.0,2,1.0,930,4743,1.0,4,5,930,0.0,1942,930,4779,29286 days 16:47:18.675850,139,2.0,0.0,0,-36,930.0
980000.0,4,2.0,2190,4560,2.5,5,8,2190,0.0,1910,2190,4560,40974 days 16:47:18.675850,195,2.0,0.0,0,0,2190.0
1290000.0,4,2.5,3430,7200,2.0,3,9,3430,0.0,2014,1530,7800,2988 days 16:47:18.675850,106,1.6,0.0,1900,-600,3430.0
740000.0,4,2.75,2560,6900,1.0,3,8,1480,1080.0,1959,2600,7200,23077 days 16:47:18.675850,321,1.4545454545454546,1.3703703703703705,-40,-300,400.0
230000.0,2,1.0,770,6450,1.0,4,6,770,0.0,1948,780,6063,27095 days 16:47:18.675850,283,2.0,0.0,-10,387,770.0
3400000.0,3,4.5,5230,17826,2.0,3,1,3740,1490.0,2005,3670,17826,6275 days 16:47:18.675850,174,0.6666666666666666,2.51006711409396,1560,0,2250.0
954500.0,3,2.25,2440,9689,1.0,4,8,1830,610.0,1974,2730,9689,17598 days 16:47:18.675850,098,1.3333333333333333,3.0,-290,0,1220.0
622000.0,3,1.5,1650,3150,1.5,4,8,1650,0.0,1929,1650,4500,34034 days 16:47:18.675850,075,2.0,0.0,0,-1350,1650.0
90000.0,1,1.0,780,4000,1.0,3,5,780,0.0,1905,1150,4000,42800 days 16:47:18.675850,062,1.0,0.0,-370,0,780.0
342000.0,3,3.0,1260,1634,3.0,3,8,1260,0.0,1998,1260,1135,8832 days 16:47:18.675850,302,1.0,0.0,0,499,1260.0
305000.0,4,2.5,2320,4683,2.0,3,7,2320,0.0,2007,2230,5750,5545 days 16:47:18.675850,210,1.6,0.0,90,-1067,2320.0
259900.0,4,2.75,1560,8820,1.0,3,7,1060,500.0,1979,2140,7800,15772 days 16:47:18.675850,232,1.4545454545454546,2.12,-580,1020,560.0
420000.0,3,2.0,2330,6346,1.5,3,6,1600,730.0,1934,1380,8400,32208 days 16:47:18.675850,239,1.5,2.191780821917808,950,-2054,870.0
250000.0,2,1.0,1400,19570,1.5,3,6,1100,300.0,1929,2250,6500,34034 days 16:47:18.675850,063,2.0,3.6666666666666665,-850,13070,800.0
249950.0,3,1.5,1450,6875,1.0,4,7,1450,0.0,1961,1270,8000,22346 days 16:47:18.675850,082,2.0,0.0,180,-1125,1450.0
199000.0,2,1.0,1140,15120,1.0,4,6,990,150.0,1932,2320,11250,32939 days 16:47:18.675850,048,2.0,6.6,-1180,3870,840.0
355200.0,3,1.0,1120,7320,1.0,4,7,1120,0.0,1954,1410,6328,24903 days 16:47:18.675850,097,3.0,0.0,-290,992,1120.0
425000.0,3,1.5,1970,13709,1.0,4,7,1680,290.0,1955,2200,16536,24538 days 16:47:18.675850,252,2.0,5.793103448275862,-230,-2827,1390.0
379500.0,3,1.0,1110,7128,1.0,3,7,1110,0.0,1980,1510,7107,15407 days 16:47:18.675850,316,3.0,0.0,-400,21,1110.0
860000.0,4,2.5,3070,6923,2.0,3,9,3070,0.0,2009,2190,9218,4814 days 16:47:18.675850,231,1.6,0.0,880,-2295,3070.0
335000.0,3,2.5,1940,4927,2.0,3,8,1940,0.0,2004,2070,4892,6641 days 16:47:18.675850,132,1.2,0.0,-130,35,1940.0
865000.0,3,2.5,3050,12558,2.0,3,1,3050,0.0,1997,3543,12558,9197 days 16:47:18.675850,309,1.2,0.0,-493,0,3050.0
390000.0,3,1.0,1240,3600,1.5,3,7,1240,0.0,1902,1680,3600,43896 days 16:47:18.675850,098,3.0,0.0,-440,0,1240.0
569950.0,5,4.25,3380,7805,2.0,3,8,3380,0.0,2014,2790,7805,2988 days 16:47:18.675850,252,1.1764705882352942,0.0,590,0,3380.0
495500.0,3,2.5,3190,7828,2.0,3,9,3190,0.0,2006,2970,7828,5910 days 16:47:18.675850,036,1.2,0.0,220,0,3190.0
476500.0,4,1.75,1670,10200,1.0,3,7,1390,280.0,1953,1720,6860,25268 days 16:47:18.675850,345,2.2857142857142856,4.964285714285714,-50,3340,1110.0
261000.0,3,1.0,1660,11200,1.0,3,7,1660,0.0,1957,1380,10875,23807 days 16:47:18.675850,224,3.0,0.0,280,325,1660.0
375000.0,4,2.0,2070,9822,1.0,5,7,2070,0.0,1955,1300,9572,24538 days 16:47:18.675850,234,2.0,0.0,770,250,2070.0
550000.0,4,2.0,2070,9822,1.0,5,7,2070,0.0,1955,1300,9572,24538 days 16:47:18.675850,112,2.0,0.0,770,250,2070.0
230000.0,2,1.0,1430,4000,1.0,3,7,930,500.0,1949,1110,4000,26729 days 16:47:18.675850,204,2.0,1.86,320,0,430.0
606000.0,3,2.0,1980,7680,1.5,4,6,1070,910.0,1911,1330,8704,40609 days 16:47:18.675850,063,1.5,1.1758241758241759,650,-1024,160.0
368500.0,4,2.75,2500,26400,1.0,3,8,1780,720.0,1977,2180,31900,16502 days 16:47:18.675850,114,1.4545454545454546,2.4722222222222223,320,-5500,1060.0
275000.0,3,1.0,1230,171190,1.0,3,7,1230,0.0,1973,1550,15450,17963 days 16:47:18.675850,272,3.0,0.0,-320,155740,1230.0
342000.0,4,1.0,1390,9023,1.5,3,7,1390,0.0,1955,1760,9023,24538 days 16:47:18.675850,112,4.0,0.0,-370,0,1390.0
278100.0,4,1.75,2120,8520,1.0,3,7,1600,520.0,1978,2160,8400,16137 days 16:47:18.675850,086,2.2857142857142856,3.076923076923077,-40,120,1080.0
450000.0,4,2.75,1540,4840,1.0,4,7,850,690.0,1929,1180,4840,34034 days 16:47:18.675850,301,1.4545454545454546,1.2318840579710144,360,0,160.0
349950.0,4,2.5,2000,5006,2.0,3,7,2000,0.0,2005,2410,4889,6275 days 16:47:18.675850,237,1.6,0.0,-410,117,2000.0
425000.0,4,2.5,2400,6053,2.0,3,8,2400,0.0,2001,2460,6519,7736 days 16:47:18.675850,100,1.6,0.0,-60,-466,2400.0
435000.0,4,2.75,2110,8751,1.0,3,7,1510,600.0,1962,1660,10295,21981 days 16:47:18.675850,177,1.4545454545454546,2.5166666666666666,450,-1544,910.0
460000.0,4,2.5,2550,19017,1.0,4,7,1300,1250.0,1961,2080,21100,22346 days 16:47:18.675850,177,1.6,1.04,470,-2083,50.0
323000.0,4,1.75,1440,8114,1.0,4,7,1440,0.0,1963,1940,7208,21616 days 16:47:18.675850,356,2.2857142857142856,0.0,-500,906,1440.0
325000.0,2,1.0,810,6827,1.0,3,6,810,0.0,1944,990,6827,28556 days 16:47:18.675850,120,2.0,0.0,-180,0,810.0
480000.0,2,1.75,1170,4635,1.0,4,6,690,480.0,1924,1240,4120,35861 days 16:47:18.675850,225,1.1428571428571428,1.4375,-70,515,210.0
1330000.0,3,2.5,3590,8400,1.0,3,9,2950,640.0,1958,1620,7875,23442 days 16:47:18.675850,120,1.2,4.609375,1970,525,2310.0
210000.0,4,1.75,2090,6485,1.0,3,7,1280,810.0,1956,2190,9600,24173 days 16:47:18.675850,117,2.2857142857142856,1.5802469135802468,-100,-3115,470.0
920000.0,5,4.5,3820,5750,2.0,3,9,2830,990.0,2000,1750,5750,8102 days 16:47:18.675850,091,1.1111111111111112,2.8585858585858586,2070,0,1840.0
399000.0,3,1.0,1460,8290,1.0,3,8,1460,0.0,1959,1470,8290,23077 days 16:47:18.675850,336,3.0,0.0,-10,0,1460.0
631750.0,3,1.75,2360,4063,1.0,5,7,1180,1180.0,1940,1660,4063,30017 days 16:47:18.675850,230,1.7142857142857142,1.0,700,0,0.0
184000.0,3,1.0,1100,8680,1.0,3,6,1100,0.0,1962,1100,9220,21981 days 16:47:18.675850,085,3.0,0.0,0,-540,1100.0
333000.0,4,2.5,2100,7208,2.0,3,8,2100,0.0,1974,2060,7480,17598 days 16:47:18.675850,106,1.6,0.0,40,-272,2100.0
218000.0,2,2.0,1310,2841,2.0,3,6,1310,0.0,2004,1360,2550,6641 days 16:47:18.675850,171,1.0,0.0,-50,291,1310.0
258305.0,2,1.5,750,2964,1.0,5,5,750,0.0,1919,1350,3090,37687 days 16:47:18.675850,055,1.3333333333333333,0.0,-600,-126,750.0
775000.0,5,1.5,1720,5000,1.5,3,8,1720,0.0,1915,1720,5000,39148 days 16:47:18.675850,196,3.3333333333333335,0.0,0,0,1720.0
515000.0,3,2.5,3370,19585,2.0,3,7,3200,170.0,1951,1730,9430,25999 days 16:47:18.675850,162,1.2,18.823529411764707,1640,10155,3030.0
455000.0,2,1.5,1200,1259,2.0,3,8,1000,200.0,2015,1320,1852,2623 days 16:47:18.675850,175,1.3333333333333333,5.0,-120,-593,800.0
440000.0,3,2.5,1830,6807,2.5,5,7,1830,0.0,1954,1340,6807,24903 days 16:47:18.675850,049,1.2,0.0,490,0,1830.0
1440000.0,3,3.5,3870,3819,2.0,3,1,2760,1110.0,2002,2530,5500,7371 days 16:47:18.675850,170,0.8571428571428571,2.4864864864864864,1340,-1681,1650.0
850000.0,3,2.25,2220,3707,2.0,4,8,1620,600.0,1919,2030,4850,37687 days 16:47:18.675850,195,1.3333333333333333,2.7,190,-1143,1020.0
480000.0,3,1.75,2920,21375,1.0,3,8,1850,1070.0,1961,1540,8482,22346 days 16:47:18.675850,121,1.7142857142857142,1.7289719626168225,1380,12893,780.0
420000.0,5,2.75,2540,27007,1.0,3,8,1520,1020.0,1980,1800,26572,15407 days 16:47:18.675850,330,1.8181818181818181,1.4901960784313726,740,435,500.0
1200000.0,3,3.0,2350,1620,2.0,3,9,1560,790.0,2001,2000,4380,7736 days 16:47:18.675850,022,1.0,1.9746835443037976,350,-2760,770.0
454000.0,4,2.25,2630,39000,2.0,3,9,2630,0.0,1979,2270,66647,15772 days 16:47:18.675850,164,1.7777777777777777,0.0,360,-27647,2630.0
1850000.0,4,2.5,4120,14866,1.0,3,8,2070,2050.0,1965,3620,19729,20885 days 16:47:18.675850,107,1.6,1.0097560975609756,500,-4863,20.0
499000.0,4,2.25,2440,5000,2.0,3,7,2440,0.0,2007,2440,5212,5545 days 16:47:18.675850,125,1.7777777777777777,0.0,0,-212,2440.0
590000.0,5,3.0,3480,6625,2.0,3,8,3480,0.0,2012,2800,9400,3719 days 16:47:18.675850,049,1.6666666666666667,0.0,680,-2775,3480.0
385000.0,3,3.5,1900,4805,2.0,3,8,1560,340.0,1999,1360,4800,8467 days 16:47:18.675850,211,0.8571428571428571,4.588235294117647,540,5,1220.0
1250000.0,4,3.25,3160,10043,2.0,3,9,3160,0.0,2011,3450,10043,4084 days 16:47:18.675850,267,1.2307692307692308,0.0,-290,0,3160.0
202200.0,2,1.75,1330,2159,1.0,4,8,1330,0.0,1979,1220,3679,15772 days 16:47:18.675850,267,1.1428571428571428,0.0,110,-1520,1330.0
450000.0,3,2.25,1420,13468,1.0,3,7,960,460.0,1976,1480,10980,16868 days 16:47:18.675850,070,1.3333333333333333,2.0869565217391304,-60,2488,500.0
435000.0,3,2.0,2570,233481,1.5,4,8,2570,0.0,1986,2280,157687,13215 days 16:47:18.675850,128,1.5,0.0,290,75794,2570.0
550000.0,2,1.0,1270,43560,1.0,4,5,1270,0.0,1908,1870,6960,41705 days 16:47:18.675850,035,2.0,0.0,-600,36600,1270.0
361000.0,3,2.25,2470,5650,1.0,3,7,1550,920.0,1973,1660,5650,17963 days 16:47:18.675850,124,1.3333333333333333,1.684782608695652,810,0,630.0
760000.0,4,2.25,2590,12600,2.0,3,9,2590,0.0,1979,2620,11050,15772 days 16:47:18.675850,020,1.7777777777777777,0.0,-30,1550,2590.0
902000.0,4,2.5,3030,8507,2.0,3,9,3030,0.0,2003,2570,8830,7006 days 16:47:18.675850,167,1.6,0.0,460,-323,3030.0
505000.0,3,1.75,1240,4550,1.5,4,7,1240,0.0,1951,2110,5700,25999 days 16:47:18.675850,101,1.7142857142857142,0.0,-870,-1150,1240.0
200000.0,3,1.0,1040,8925,1.0,4,6,1040,0.0,1961,1040,8925,22346 days 16:47:18.675850,056,3.0,0.0,0,0,1040.0
260000.0,5,2.25,2320,6375,1.0,4,7,1270,1050.0,1967,1760,7600,20155 days 16:47:18.675850,035,2.2222222222222223,1.2095238095238094,560,-1225,220.0
287500.0,3,2.25,2030,8690,1.0,4,8,1360,670.0,1986,1720,8800,13215 days 16:47:18.675850,033,1.3333333333333333,2.029850746268657,310,-110,690.0
450000.0,3,1.5,1390,10530,1.0,3,7,1390,0.0,1961,1750,10530,22346 days 16:47:18.675850,097,2.0,0.0,-360,0,1390.0
825000.0,2,1.75,2050,4000,1.5,3,8,2050,0.0,1979,1940,4000,15772 days 16:47:18.675850,030,1.1428571428571428,0.0,110,0,2050.0
1480000.0,4,3.0,3050,6179,2.0,4,9,2330,720.0,1926,3020,6505,35130 days 16:47:18.675850,239,1.3333333333333333,3.236111111111111,30,-326,1610.0
319950.0,2,1.0,1240,5500,1.5,3,6,1240,0.0,1921,1520,5500,36956 days 16:47:18.675850,056,2.0,0.0,-280,0,1240.0
682000.0,4,2.5,3030,30000,2.0,4,9,3030,0.0,1981,2600,34932,15041 days 16:47:18.675850,240,1.6,0.0,430,-4932,3030.0
560000.0,3,1.75,1930,6000,1.0,3,8,1130,800.0,1956,1870,6000,24173 days 16:47:18.675850,126,1.7142857142857142,1.4125,60,0,330.0
350000.0,3,1.75,1490,10344,1.0,3,7,1490,0.0,1985,1450,8632,13580 days 16:47:18.675850,364,1.7142857142857142,0.0,40,1712,1490.0
270000.0,3,2.0,1510,10215,1.0,4,7,1510,0.0,1995,1370,8902,9928 days 16:47:18.675850,301,1.5,0.0,140,1313,1510.0
284000.0,3,1.75,1320,35100,1.0,3,7,1320,0.0,1990,1660,35100,11754 days 16:47:18.675850,064,1.7142857142857142,0.0,-340,0,1320.0
308000.0,4,2.5,2330,4606,2.0,3,8,2330,0.0,2004,2330,5783,6641 days 16:47:18.675850,195,1.6,0.0,0,-1177,2330.0
450000.0,4,2.0,2240,7725,1.0,5,7,1120,1120.0,1956,1340,6300,24173 days 16:47:18.675850,149,2.0,1.0,900,1425,0.0
540000.0,4,2.5,2050,34222,2.0,4,8,2050,0.0,1989,2240,51400,12119 days 16:47:18.675850,169,1.6,0.0,-190,-17178,2050.0
380000.0,4,1.5,1680,11123,1.0,3,7,1130,550.0,1959,1770,10103,23077 days 16:47:18.675850,161,2.6666666666666665,2.0545454545454547,-90,1020,580.0
522500.0,4,2.75,2200,122403,1.5,3,7,2200,0.0,1971,1710,74487,18694 days 16:47:18.675850,055,1.4545454545454546,0.0,490,47916,2200.0
118000.0,1,1.0,670,7957,1.0,4,6,670,0.0,1978,1600,7957,16137 days 16:47:18.675850,294,1.0,0.0,-930,0,670.0
280400.0,4,1.75,1730,7210,1.0,4,7,1010,720.0,1968,1620,7210,19790 days 16:47:18.675850,113,2.2857142857142856,1.4027777777777777,110,0,290.0
720000.0,3,3.25,3410,25741,2.0,4,8,3410,0.0,1993,1660,25865,10658 days 16:47:18.675850,253,0.9230769230769231,0.0,1750,-124,3410.0
787000.0,3,1.75,1330,7500,1.0,3,8,1330,0.0,1961,1690,7800,22346 days 16:47:18.675850,125,1.7142857142857142,0.0,-360,-300,1330.0
537000.0,4,2.5,1990,2660,2.0,3,8,1990,0.0,2012,1990,2665,3719 days 16:47:18.675850,089,1.6,0.0,0,-5,1990.0
650000.0,2,1.5,1900,4450,1.0,5,7,1500,400.0,1916,2130,5000,38783 days 16:47:18.675850,307,1.3333333333333333,3.75,-230,-550,1100.0
154200.0,4,1.0,1310,8640,1.0,3,6,910,400.0,1948,1310,8640,27095 days 16:47:18.675850,006,4.0,2.275,0,0,510.0
238000.0,4,2.5,1690,7260,1.0,3,7,1080,610.0,1979,1690,7700,15772 days 16:47:18.675850,015,1.6,1.7704918032786885,0,-440,470.0
285650.0,3,1.0,1040,8199,1.0,3,7,1040,0.0,1953,1420,8200,25268 days 16:47:18.675850,216,3.0,0.0,-380,-1,1040.0
485500.0,2,1.5,1340,1286,2.0,3,8,1190,150.0,2006,1460,1245,5910 days 16:47:18.675850,219,1.3333333333333333,7.933333333333334,-120,41,1040.0
315000.0,2,1.0,1120,7350,1.0,3,7,1120,0.0,1942,1320,7545,29286 days 16:47:18.675850,026,2.0,0.0,-200,-195,1120.0
4670000.0,5,6.75,9640,13068,1.0,3,1,4820,4820.0,1983,3270,10454,14311 days 16:47:18.675850,168,0.7407407407407407,1.0,6370,2614,0.0
627000.0,3,2.0,2310,10525,2.0,5,7,2310,0.0,1965,1430,10523,20885 days 16:47:18.675850,321,1.5,0.0,880,2,2310.0
525000.0,3,2.5,2190,34528,2.0,3,8,2190,0.0,1994,2460,37901,10293 days 16:47:18.675850,100,1.2,0.0,-270,-3373,2190.0
526000.0,3,3.25,1220,1281,2.0,3,8,930,290.0,2014,1303,3810,2988 days 16:47:18.675850,262,0.9230769230769231,3.206896551724138,-83,-2529,640.0
480000.0,3,1.5,1200,3060,1.0,4,7,1060,140.0,1910,1410,3060,40974 days 16:47:18.675850,086,2.0,7.571428571428571,-210,0,920.0
970000.0,3,3.5,3840,53696,2.0,3,9,3840,0.0,1996,3810,35181,9563 days 16:47:18.675850,281,0.8571428571428571,0.0,30,18515,3840.0
640000.0,4,2.5,2460,9973,1.0,4,8,1560,900.0,1965,1830,7200,20885 days 16:47:18.675850,223,1.6,1.7333333333333334,630,2773,660.0
279000.0,3,2.5,1630,7950,1.0,3,8,1320,310.0,1985,1650,7952,13580 days 16:47:18.675850,178,1.2,4.258064516129032,-20,-2,1010.0
303000.0,2,2.0,970,9750,1.0,5,6,970,0.0,1940,1850,9000,30017 days 16:47:18.675850,191,1.0,0.0,-880,750,970.0
336500.0,4,1.75,1760,7268,1.0,4,7,1080,680.0,1979,1830,8786,15772 days 16:47:18.675850,084,2.2857142857142856,1.588235294117647,-70,-1518,400.0
163250.0,2,1.0,770,8150,1.0,3,6,770,0.0,1951,1140,8550,25999 days 16:47:18.675850,317,2.0,0.0,-370,-400,770.0
444950.0,3,1.0,1760,6927,1.0,3,7,1050,710.0,1962,2060,9120,21981 days 16:47:18.675850,049,3.0,1.4788732394366197,-300,-2193,340.0
285000.0,2,1.0,990,2446,2.0,3,7,990,0.0,1998,1260,2805,8832 days 16:47:18.675850,213,2.0,0.0,-270,-359,990.0
370000.0,2,1.0,1250,4960,1.0,3,7,940,310.0,1938,2030,7440,30747 days 16:47:18.675850,076,2.0,3.032258064516129,-780,-2480,630.0
330000.0,3,2.25,1440,5150,2.0,3,7,1440,0.0,1997,1530,5238,9197 days 16:47:18.675850,349,1.3333333333333333,0.0,-90,-88,1440.0
395000.0,2,2.0,1960,4018,1.0,5,7,980,980.0,1950,1240,4641,26364 days 16:47:18.675850,232,1.0,1.0,720,-623,0.0
440000.0,6,3.0,2510,5310,1.0,4,7,1460,1050.0,1944,1390,5407,28556 days 16:47:18.675850,106,2.0,1.3904761904761904,1120,-97,410.0
625000.0,4,2.75,2920,6605,2.0,3,8,2920,0.0,2012,3030,6605,3719 days 16:47:18.675850,123,1.4545454545454546,0.0,-110,0,2920.0
435000.0,3,2.5,1730,46638,2.0,3,8,1730,0.0,1991,1750,35508,11389 days 16:47:18.675850,272,1.2,0.0,-20,11130,1730.0
299950.0,3,2.5,1570,2577,2.0,3,7,1570,0.0,2005,1970,2952,6275 days 16:47:18.675850,322,1.2,0.0,-400,-375,1570.0
560000.0,2,1.75,970,4233,1.0,4,7,970,0.0,1944,1340,4233,28556 days 16:47:18.675850,272,1.1428571428571428,0.0,-370,0,970.0
380000.0,4,3.0,2800,9764,2.0,3,8,2800,0.0,2002,3610,8194,7371 days 16:47:18.675850,140,1.3333333333333333,0.0,-810,1570,2800.0
333000.0,4,2.0,1580,7800,2.0,2,6,1580,0.0,1906,1190,4440,42435 days 16:47:18.675850,139,2.0,0.0,390,3360,1580.0
499000.0,2,1.0,1220,3000,1.0,3,7,920,300.0,1926,1270,3000,35130 days 16:47:18.675850,161,2.0,3.066666666666667,-50,0,620.0
386000.0,3,1.5,1550,8000,1.0,3,6,1330,220.0,1980,1150,5150,15407 days 16:47:18.675850,055,2.0,6.045454545454546,400,2850,1110.0
320600.0,3,2.0,1220,7620,1.0,3,6,720,500.0,1947,1640,7620,27460 days 16:47:18.675850,265,1.5,1.44,-420,0,220.0
285000.0,2,2.0,1651,18200,1.0,3,6,1651,0.0,1946,1510,89595,27825 days 16:47:18.675850,161,1.0,0.0,141,-71395,1651.0
450000.0,7,4.0,3150,7800,2.0,3,8,3150,0.0,2013,1880,6000,3353 days 16:47:18.675850,252,1.75,0.0,1270,1800,3150.0
175000.0,2,1.0,800,7150,1.0,3,5,800,0.0,1933,1220,8019,32573 days 16:47:18.675850,352,2.0,0.0,-420,-869,800.0
544800.0,5,2.75,3190,5857,2.0,3,9,3190,0.0,2004,3100,5857,6641 days 16:47:18.675850,111,1.8181818181818181,0.0,90,0,3190.0
220000.0,3,1.75,1720,7587,1.0,4,7,1140,580.0,1981,1120,7287,15041 days 16:47:18.675850,021,1.7142857142857142,1.9655172413793103,600,300,560.0
374000.0,2,2.25,1100,1695,2.0,3,9,1100,0.0,2009,1100,3082,4814 days 16:47:18.675850,248,0.8888888888888888,0.0,0,-1387,1100.0
200000.0,3,2.0,1010,7896,1.0,3,7,1010,0.0,1984,1540,7896,13946 days 16:47:18.675850,058,1.5,0.0,-530,0,1010.0
259950.0,3,2.0,1010,7896,1.0,3,7,1010,0.0,1984,1540,7896,13946 days 16:47:18.675850,126,1.5,0.0,-530,0,1010.0
255000.0,4,2.75,1760,9222,1.0,3,7,1140,620.0,1971,1800,9222,18694 days 16:47:18.675850,203,1.4545454545454546,1.8387096774193548,-40,0,520.0
447000.0,3,1.75,1400,6750,1.0,3,7,1040,360.0,1975,1860,7480,17233 days 16:47:18.675850,082,1.7142857142857142,2.888888888888889,-460,-730,680.0
287000.0,3,2.5,1820,8722,1.5,3,7,1820,0.0,1926,1480,12285,35130 days 16:47:18.675850,078,1.2,0.0,340,-3563,1820.0
344950.0,3,2.0,1470,6950,1.0,5,6,1470,0.0,1932,1660,5065,32939 days 16:47:18.675850,273,1.5,0.0,-190,1885,1470.0
212000.0,2,1.0,770,7000,1.0,3,6,770,0.0,1921,1100,8777,36956 days 16:47:18.675850,283,2.0,0.0,-330,-1777,770.0
425000.0,5,2.75,1340,11583,1.0,3,7,1190,150.0,1962,1950,10514,21981 days 16:47:18.675850,204,1.8181818181818181,7.933333333333334,-610,1069,1040.0
170000.0,1,1.0,480,4560,1.0,3,5,480,0.0,1922,890,4803,36591 days 16:47:18.675850,247,1.0,0.0,-410,-243,480.0
565000.0,3,1.0,1260,4080,1.5,4,7,1260,0.0,1928,1130,3876,34400 days 16:47:18.675850,043,3.0,0.0,130,204,1260.0
234000.0,2,1.0,870,11100,1.0,3,6,870,0.0,1940,1370,10404,30017 days 16:47:18.675850,174,2.0,0.0,-500,696,870.0
1510000.0,3,2.5,4010,12105,1.0,5,1,2600,1410.0,1983,4010,15081,14311 days 16:47:18.675850,282,1.2,1.8439716312056738,0,-2976,1190.0
345000.0,3,2.5,2340,8414,1.0,3,7,1280,1060.0,1993,2340,7268,10658 days 16:47:18.675850,026,1.2,1.2075471698113207,0,1146,220.0
415000.0,3,2.75,1770,3172,2.0,3,8,1770,0.0,2009,1760,2891,4814 days 16:47:18.675850,117,1.0909090909090908,0.0,10,281,1770.0
760000.0,5,1.75,2660,10637,1.5,5,7,1670,990.0,1922,1570,6825,36591 days 16:47:18.675850,283,2.857142857142857,1.6868686868686869,1090,3812,680.0
484000.0,5,2.5,3600,20001,2.0,4,9,3600,0.0,1976,2860,21780,16868 days 16:47:18.675850,057,2.0,0.0,740,-1779,3600.0
360000.0,2,1.75,1230,1107,2.0,3,8,1230,0.0,2006,1380,1107,5910 days 16:47:18.675850,269,1.1428571428571428,0.0,-150,0,1230.0
875000.0,3,2.75,3270,39586,1.5,3,1,3270,0.0,1988,3480,35998,12485 days 16:47:18.675850,055,1.0909090909090908,0.0,-210,3588,3270.0
930000.0,3,2.5,3100,20553,1.0,3,1,3100,0.0,1954,3000,22302,24903 days 16:47:18.675850,134,1.2,0.0,100,-1749,3100.0
250000.0,3,2.0,1900,6660,1.0,5,7,950,950.0,1966,1690,8111,20520 days 16:47:18.675850,136,1.5,1.0,210,-1451,0.0
394000.0,2,2.0,1750,2731,2.0,3,8,1750,0.0,2012,1650,2731,3719 days 16:47:18.675850,111,1.0,0.0,100,0,1750.0
865000.0,4,3.5,3380,11270,2.0,3,9,2160,1220.0,2007,2910,11214,5545 days 16:47:18.675850,022,1.1428571428571428,1.7704918032786885,470,56,940.0
477500.0,2,2.0,2090,6000,2.0,3,7,2090,0.0,1918,1600,5400,38052 days 16:47:18.675850,255,1.0,0.0,490,600,2090.0
1250000.0,4,2.75,4120,12500,1.0,4,8,2060,2060.0,1947,3680,5000,27460 days 16:47:18.675850,351,1.4545454545454546,1.0,440,7500,0.0
270000.0,3,1.75,1260,7500,1.0,3,6,840,420.0,1947,1340,7500,27460 days 16:47:18.675850,239,1.7142857142857142,2.0,-80,0,420.0
567000.0,3,2.25,1800,6875,1.0,4,8,1230,570.0,1974,1800,8749,17598 days 16:47:18.675850,118,1.3333333333333333,2.1578947368421053,0,-1874,660.0
635000.0,3,2.5,1960,7200,1.0,4,8,980,980.0,1940,1440,7200,30017 days 16:47:18.675850,153,1.2,1.0,520,0,0.0
1870000.0,6,2.75,4460,6952,2.5,4,1,3460,1000.0,1930,2750,4769,33669 days 16:47:18.675850,254,2.1818181818181817,3.46,1710,2183,2460.0
183000.0,3,1.75,1330,9200,1.0,4,7,1330,0.0,1973,1590,9200,17963 days 16:47:18.675850,161,1.7142857142857142,0.0,-260,0,1330.0
309933.0,3,1.75,1820,78408,1.0,3,6,1220,600.0,1950,1340,78408,26364 days 16:47:18.675850,119,1.7142857142857142,2.033333333333333,480,0,620.0
945800.0,4,2.75,3360,9100,1.0,4,8,1760,1600.0,1973,2620,8925,17963 days 16:47:18.675850,084,1.4545454545454546,1.1,740,175,160.0
503000.0,2,1.75,2860,59612,1.0,3,8,1510,1350.0,1948,2720,59612,27095 days 16:47:18.675850,142,1.1428571428571428,1.1185185185185185,140,0,160.0
220000.0,3,1.0,1460,10200,1.0,4,7,1460,0.0,1957,1460,8500,23807 days 16:47:18.675850,226,3.0,0.0,0,1700,1460.0
335000.0,3,1.75,1900,36769,1.0,3,8,1900,0.0,1987,1950,35847,12850 days 16:47:18.675850,091,1.7142857142857142,0.0,-50,922,1900.0
650000.0,3,2.25,1790,9927,1.0,4,7,1240,550.0,1969,2610,10700,19424 days 16:47:18.675850,112,1.3333333333333333,2.2545454545454544,-820,-773,690.0
511000.0,4,3.5,3100,7600,2.0,3,1,3100,0.0,2005,3350,7638,6275 days 16:47:18.675850,034,1.1428571428571428,0.0,-250,-38,3100.0
275000.0,2,1.0,900,57063,1.0,4,6,900,0.0,1938,1440,268765,30747 days 16:47:18.675850,351,2.0,0.0,-540,-211702,900.0
576250.0,2,1.75,1530,5000,2.0,4,7,1260,270.0,1989,1470,5000,12119 days 16:47:18.675850,093,1.1428571428571428,4.666666666666667,60,0,990.0
1450000.0,2,3.25,2070,3128,2.0,3,9,1760,310.0,1988,2740,3568,12485 days 16:47:18.675850,078,0.6153846153846154,5.67741935483871,-670,-440,1450.0
186000.0,3,2.0,1340,4320,1.0,3,5,920,420.0,1912,980,6480,40244 days 16:47:18.675850,170,1.5,2.1904761904761907,360,-2160,500.0
655100.0,1,1.0,1220,4160,1.0,3,7,1220,0.0,1922,1970,4200,36591 days 16:47:18.675850,125,1.0,0.0,-750,-40,1220.0
328000.0,4,2.5,2370,6500,2.0,3,9,2370,0.0,1998,2590,6137,8832 days 16:47:18.675850,125,1.6,0.0,-220,363,2370.0
441000.0,3,2.5,1890,11036,1.0,3,8,1460,430.0,1973,2040,7524,17963 days 16:47:18.675850,069,1.2,3.395348837209302,-150,3512,1030.0
370000.0,3,1.75,1480,7725,1.5,4,7,1480,0.0,1981,1720,8379,15041 days 16:47:18.675850,104,1.7142857142857142,0.0,-240,-654,1480.0
630000.0,2,1.0,1050,8382,1.0,3,7,1050,0.0,1959,2400,9525,23077 days 16:47:18.675850,103,2.0,0.0,-1350,-1143,1050.0
470500.0,4,2.25,2070,14000,1.0,3,7,1720,350.0,1958,1690,14444,23442 days 16:47:18.675850,104,1.7777777777777777,4.914285714285715,380,-444,1370.0
285950.0,2,1.0,1170,6000,1.0,3,6,1170,0.0,1948,1130,7500,27095 days 16:47:18.675850,103,2.0,0.0,40,-1500,1170.0
698000.0,3,1.5,1090,7200,1.0,4,7,1090,0.0,1958,2010,8982,23442 days 16:47:18.675850,083,2.0,0.0,-920,-1782,1090.0
268000.0,3,2.5,1650,6684,2.0,3,7,1650,0.0,1991,1850,7048,11389 days 16:47:18.675850,177,1.2,0.0,-200,-364,1650.0
1630000.0,4,3.75,4410,8112,3.0,3,1,3570,840.0,2003,2770,5750,7006 days 16:47:18.675850,043,1.0666666666666667,4.25,1640,2362,2730.0
355000.0,4,2.5,1780,15000,2.0,2,7,1780,0.0,1993,2005,9680,10658 days 16:47:18.675850,089,1.6,0.0,-225,5320,1780.0
299000.0,3,1.0,1550,8778,1.0,3,7,1250,300.0,1952,2120,7268,25634 days 16:47:18.675850,260,3.0,4.166666666666667,-570,1510,950.0
1000000.0,4,2.75,2290,6120,2.0,4,7,2170,120.0,1926,1910,4590,35130 days 16:47:18.675850,141,1.4545454545454546,18.083333333333332,380,1530,2050.0
275000.0,4,2.0,2220,8229,1.5,4,7,2220,0.0,1958,1660,8396,23442 days 16:47:18.675850,110,2.0,0.0,560,-167,2220.0
475000.0,3,1.75,1150,10240,1.0,3,6,1030,120.0,1918,1270,2566,38052 days 16:47:18.675850,123,1.7142857142857142,8.583333333333334,-120,7674,910.0
260000.0,4,2.5,2000,37045,2.0,3,8,2000,0.0,1989,2390,36868,12119 days 16:47:18.675850,174,1.6,0.0,-390,177,2000.0
416000.0,2,1.75,1270,7560,1.5,4,7,1270,0.0,1932,1480,7560,32939 days 16:47:18.675850,199,1.1428571428571428,0.0,-210,0,1270.0
495000.0,5,1.0,1810,11205,1.5,3,7,1810,0.0,1915,1860,7965,39148 days 16:47:18.675850,323,5.0,0.0,-50,3240,1810.0
357500.0,3,1.0,1450,8100,1.0,3,6,1450,0.0,1952,1450,7800,25634 days 16:47:18.675850,014,3.0,0.0,0,300,1450.0
459500.0,2,1.5,1170,1079,3.0,3,7,1170,0.0,2003,1170,1116,7006 days 16:47:18.675850,237,1.3333333333333333,0.0,0,-37,1170.0
258000.0,3,2.5,1730,6930,2.0,3,8,1730,0.0,1994,1780,6930,10293 days 16:47:18.675850,246,1.2,0.0,-50,0,1730.0
600000.0,3,2.25,2680,98445,1.0,5,8,2680,0.0,1962,2340,98445,21981 days 16:47:18.675850,101,1.3333333333333333,0.0,340,0,2680.0
665000.0,3,1.0,1260,24550,1.5,4,7,1260,0.0,1937,2500,12320,31112 days 16:47:18.675850,262,3.0,0.0,-1240,12230,1260.0
165000.0,3,1.5,1020,10152,1.0,5,6,1020,0.0,1959,1320,8892,23077 days 16:47:18.675850,276,2.0,0.0,-300,1260,1020.0
297000.0,5,2.5,1970,8605,2.0,4,7,1970,0.0,1994,1970,8460,10293 days 16:47:18.675850,138,2.0,0.0,0,145,1970.0
350000.0,2,1.0,830,5100,1.0,4,7,830,0.0,1942,1220,5100,29286 days 16:47:18.675850,296,2.0,0.0,-390,0,830.0
2450000.0,4,4.5,5030,11023,2.0,3,1,3250,1780.0,2008,3640,11490,5180 days 16:47:18.675850,133,0.8888888888888888,1.8258426966292134,1390,-467,1470.0
180000.0,2,1.0,800,9450,1.0,3,6,800,0.0,1958,1090,9450,23442 days 16:47:18.675850,133,2.0,0.0,-290,0,800.0
339950.0,3,1.75,1330,12092,1.0,4,6,720,610.0,1981,1770,11770,15041 days 16:47:18.675850,097,1.7142857142857142,1.180327868852459,-440,322,110.0
365000.0,3,1.0,1030,4700,1.0,3,7,1030,0.0,1952,1030,4700,25634 days 16:47:18.675850,027,3.0,0.0,0,0,1030.0
955000.0,4,4.25,5660,193593,2.0,3,1,4100,1560.0,2001,3620,207141,7736 days 16:47:18.675850,156,0.9411764705882353,2.628205128205128,2040,-13548,2540.0
732000.0,3,2.5,2330,1987,2.0,3,9,1410,920.0,2004,2640,5250,6641 days 16:47:18.675850,147,1.2,1.5326086956521738,-310,-3263,490.0
500000.0,3,1.75,1540,10800,1.0,5,6,770,770.0,1947,2020,10800,27460 days 16:47:18.675850,167,1.7142857142857142,1.0,-480,0,0.0
610000.0,6,2.75,2040,8560,1.0,4,7,1100,940.0,1961,2230,8560,22346 days 16:47:18.675850,044,2.1818181818181817,1.1702127659574468,-190,0,160.0
525000.0,3,2.0,1540,7800,1.0,3,8,1540,0.0,2004,1510,7800,6641 days 16:47:18.675850,155,1.5,0.0,30,0,1540.0
170000.0,4,1.0,1920,13787,1.0,4,7,1220,700.0,1966,1490,11200,20520 days 16:47:18.675850,168,4.0,1.7428571428571429,430,2587,520.0
300000.0,3,2.5,1870,3439,2.0,3,7,1870,0.0,2005,2190,4029,6275 days 16:47:18.675850,194,1.2,0.0,-320,-590,1870.0
389500.0,5,3.5,2960,12527,2.0,3,9,1940,1020.0,1986,2210,10952,13215 days 16:47:18.675850,302,1.4285714285714286,1.9019607843137254,750,1575,920.0
330000.0,3,1.5,1690,10250,1.0,4,7,1690,0.0,1955,1990,11084,24538 days 16:47:18.675850,050,2.0,0.0,-300,-834,1690.0
269950.0,3,2.25,1610,7187,2.0,3,7,1610,0.0,1988,1640,7194,12485 days 16:47:18.675850,318,1.3333333333333333,0.0,-30,-7,1610.0
107000.0,2,1.0,670,4720,1.0,4,6,670,0.0,1948,1480,4720,27095 days 16:47:18.675850,240,2.0,0.0,-810,0,670.0
249000.0,3,1.0,1752,14626,2.0,3,8,1752,0.0,2005,1800,9000,6275 days 16:47:18.675850,336,3.0,0.0,-48,5626,1752.0
442500.0,4,2.0,1540,5920,1.5,5,7,1540,0.0,1935,1630,6216,31843 days 16:47:18.675850,230,2.0,0.0,-90,-296,1540.0
579000.0,3,2.5,3160,286181,2.0,3,9,3160,0.0,2002,2110,94663,7371 days 16:47:18.675850,107,1.2,0.0,1050,191518,3160.0
203000.0,3,1.5,1370,7500,1.0,3,7,1080,290.0,1958,1400,7500,23442 days 16:47:18.675850,323,2.0,3.7241379310344827,-30,0,790.0
222900.0,2,1.0,860,5800,1.0,5,5,860,0.0,1942,900,6000,29286 days 16:47:18.675850,252,2.0,0.0,-40,-200,860.0
453000.0,2,1.5,1680,17400,1.5,3,7,1680,0.0,1991,1610,27600,11389 days 16:47:18.675850,099,1.3333333333333333,0.0,70,-10200,1680.0
190000.0,1,0.75,930,29258,1.0,3,6,930,0.0,1941,2000,18321,29651 days 16:47:18.675850,176,1.3333333333333333,0.0,-1070,10937,930.0
320000.0,4,1.75,1820,7381,1.0,5,7,1150,670.0,1962,1610,8462,21981 days 16:47:18.675850,096,2.2857142857142856,1.7164179104477613,210,-1081,480.0
733500.0,3,1.5,2120,4370,1.5,3,8,2120,0.0,1904,1960,5120,43166 days 16:47:18.675850,344,2.0,0.0,160,-750,2120.0
555000.0,4,2.25,3330,21785,2.0,3,9,3330,0.0,1994,3330,21796,10293 days 16:47:18.675850,049,1.7777777777777777,0.0,0,-11,3330.0
364950.0,3,2.25,2520,6170,2.0,3,7,1850,670.0,2003,2260,6967,7006 days 16:47:18.675850,349,1.3333333333333333,2.7611940298507465,260,-797,1180.0
490000.0,3,1.75,1560,9247,1.0,3,7,1160,400.0,1989,1690,8772,12119 days 16:47:18.675850,324,1.7142857142857142,2.9,-130,475,760.0
165000.0,2,1.0,640,7768,1.0,3,6,640,0.0,1942,840,7424,29286 days 16:47:18.675850,192,2.0,0.0,-200,344,640.0
506000.0,5,3.75,3880,8370,2.0,4,7,3880,0.0,2004,2160,4651,6641 days 16:47:18.675850,317,1.3333333333333333,0.0,1720,3719,3880.0
2190000.0,3,2.25,3360,7108,2.0,3,1,2770,590.0,1905,3450,8558,42800 days 16:47:18.675850,343,1.3333333333333333,4.694915254237288,-90,-1450,2180.0
754000.0,5,1.75,2350,7800,1.0,4,8,1510,840.0,1968,2220,8400,19790 days 16:47:18.675850,119,2.857142857142857,1.7976190476190477,130,-600,670.0
949950.0,5,2.5,2340,1989,2.0,3,8,2340,0.0,1959,2200,3230,23077 days 16:47:18.675850,107,2.0,0.0,140,-1241,2340.0
443600.0,3,2.5,1430,1056,3.0,3,8,1430,0.0,2003,1310,2135,7006 days 16:47:18.675850,234,1.2,0.0,120,-1079,1430.0
380600.0,3,2.5,1920,12244,2.0,3,7,1920,0.0,1998,1920,11859,8832 days 16:47:18.675850,226,1.2,0.0,0,385,1920.0
722800.0,3,3.25,4330,14600,2.0,3,1,3630,700.0,1985,3220,12672,13580 days 16:47:18.675850,026,0.9230769230769231,5.185714285714286,1110,1928,2930.0
342888.0,2,1.0,790,5150,1.0,4,6,790,0.0,1948,1460,5150,27095 days 16:47:18.675850,041,2.0,0.0,-670,0,790.0
555000.0,4,1.75,2350,5946,1.0,3,8,1350,1000.0,1957,2060,6000,23807 days 16:47:18.675850,259,2.2857142857142856,1.35,290,-54,350.0
613000.0,3,2.5,1350,3068,2.0,3,7,1350,0.0,1991,1900,4000,11389 days 16:47:18.675850,154,1.2,0.0,-550,-932,1350.0
480000.0,3,2.0,1470,10052,1.0,4,8,1470,0.0,1956,1480,9780,24173 days 16:47:18.675850,183,1.5,0.0,-10,272,1470.0
619500.0,6,1.5,1680,5202,1.5,2,7,1680,0.0,1911,1890,5500,40609 days 16:47:18.675850,075,4.0,0.0,-210,-298,1680.0
437000.0,4,2.5,1890,8505,1.0,3,8,1290,600.0,1980,1720,9600,15407 days 16:47:18.675850,175,1.6,2.15,170,-1095,690.0
621000.0,4,2.5,2030,9905,1.0,4,8,2030,0.0,1959,2130,10008,23077 days 16:47:18.675850,098,1.6,0.0,-100,-103,2030.0
810000.0,4,1.75,1760,4080,1.5,4,8,1760,0.0,1906,1760,6120,42435 days 16:47:18.675850,195,2.2857142857142856,0.0,0,-2040,1760.0
415000.0,3,2.25,1950,8868,1.0,3,7,1350,600.0,1964,1300,8880,21251 days 16:47:18.675850,147,1.3333333333333333,2.25,650,-12,750.0
250000.0,4,1.0,1440,7404,1.0,3,6,1080,360.0,1918,1620,7436,38052 days 16:47:18.675850,317,4.0,3.0,-180,-32,720.0
585000.0,3,1.5,2230,6000,1.0,3,8,1260,970.0,1968,2120,7200,19790 days 16:47:18.675850,103,2.0,1.2989690721649485,110,-1200,290.0
220000.0,3,1.0,1180,5002,1.5,3,7,1180,0.0,1946,1470,8410,27825 days 16:47:18.675850,148,3.0,0.0,-290,-3408,1180.0
580000.0,5,2.5,2500,11900,1.0,3,7,1400,1100.0,1963,2820,11900,21616 days 16:47:18.675850,112,2.0,1.2727272727272727,-320,0,300.0
1320000.0,3,2.75,2680,20104,1.0,5,9,1820,860.0,1964,3060,19837,21251 days 16:47:18.675850,206,1.0909090909090908,2.116279069767442,-380,267,960.0
675000.0,4,2.5,2040,9225,1.0,5,8,1610,430.0,1968,1730,9225,19790 days 16:47:18.675850,213,1.6,3.744186046511628,310,0,1180.0
695000.0,4,2.75,2660,7389,2.0,3,9,2660,0.0,2002,2820,7388,7371 days 16:47:18.675850,302,1.4545454545454546,0.0,-160,1,2660.0
915000.0,5,2.75,2580,7630,1.0,4,7,1730,850.0,1954,2040,7717,24903 days 16:47:18.675850,343,1.8181818181818181,2.0352941176470587,540,-87,880.0
375000.0,3,1.0,1000,6947,1.0,4,7,1000,0.0,1947,1000,6947,27460 days 16:47:18.675850,325,3.0,0.0,0,0,1000.0
500000.0,3,1.5,1330,1265,2.0,3,8,1140,190.0,2008,1330,1264,5180 days 16:47:18.675850,097,2.0,6.0,0,1,950.0
335000.0,2,2.0,1420,5185,1.0,3,7,1420,0.0,2004,2140,4890,6641 days 16:47:18.675850,360,1.0,0.0,-720,295,1420.0
170000.0,2,1.0,1280,21750,1.5,5,6,1280,0.0,1912,1520,21750,40244 days 16:47:18.675850,199,2.0,0.0,-240,0,1280.0
320900.0,5,2.5,2200,8500,1.0,4,7,1400,800.0,1971,1360,8855,18694 days 16:47:18.675850,119,2.0,1.75,840,-355,600.0
508000.0,3,1.75,1800,8462,1.0,3,8,1440,360.0,1978,2210,8436,16137 days 16:47:18.675850,065,1.7142857142857142,4.0,-410,26,1080.0
228950.0,3,1.75,1200,9085,1.0,4,7,1200,0.0,1968,1200,9085,19790 days 16:47:18.675850,189,1.7142857142857142,0.0,0,0,1200.0
433000.0,4,2.0,1840,4760,1.5,4,6,1080,760.0,1929,1170,5950,34034 days 16:47:18.675850,127,2.0,1.4210526315789473,670,-1190,320.0
267500.0,2,1.0,960,5150,1.0,5,6,960,0.0,1951,1010,5000,25999 days 16:47:18.675850,251,2.0,0.0,-50,150,960.0
910000.0,4,1.5,2890,9000,2.0,3,8,2090,800.0,1939,2550,8400,30382 days 16:47:18.675850,281,2.6666666666666665,2.6125,340,600,1290.0
370000.0,3,1.75,1290,10117,1.0,3,7,1290,0.0,1984,1770,11839,13946 days 16:47:18.675850,062,1.7142857142857142,0.0,-480,-1722,1290.0
320000.0,2,1.0,1140,3834,1.5,3,6,1140,0.0,1911,1190,5750,40609 days 16:47:18.675850,340,2.0,0.0,-50,-1916,1140.0
660000.0,3,1.75,1750,5200,1.0,4,8,1750,0.0,1956,2060,5200,24173 days 16:47:18.675850,274,1.7142857142857142,0.0,-310,0,1750.0
787888.0,4,2.25,2580,21115,2.0,4,9,2580,0.0,1977,2690,10165,16502 days 16:47:18.675850,238,1.7777777777777777,0.0,-110,10950,2580.0
329000.0,4,2.5,2650,5880,2.0,3,9,2650,0.0,2005,2610,6490,6275 days 16:47:18.675850,352,1.6,0.0,40,-610,2650.0
602000.0,2,1.0,1470,6398,1.0,4,7,970,500.0,1941,1950,6398,29651 days 16:47:18.675850,337,2.0,1.94,-480,0,470.0
375000.0,3,2.0,1640,9750,1.0,3,7,1640,0.0,1959,1340,9750,23077 days 16:47:18.675850,310,1.5,0.0,300,0,1640.0
212000.0,1,1.0,620,7620,1.0,3,6,620,0.0,1926,1160,7620,35130 days 16:47:18.675850,125,1.0,0.0,-540,0,620.0
224000.0,3,1.5,1440,8370,1.0,3,7,1440,0.0,1977,1440,8370,16502 days 16:47:18.675850,234,2.0,0.0,0,0,1440.0
315500.0,3,2.0,1160,10079,1.0,3,7,1160,0.0,1986,1130,10087,13215 days 16:47:18.675850,069,1.5,0.0,30,-8,1160.0
350000.0,2,1.0,1070,2880,1.0,3,7,1070,0.0,1902,2030,2880,43896 days 16:47:18.675850,028,2.0,0.0,-960,0,1070.0
389000.0,6,4.5,3560,14010,2.0,3,7,3560,0.0,1989,1710,11116,12119 days 16:47:18.675850,126,1.3333333333333333,0.0,1850,2894,3560.0
285000.0,3,1.75,1720,13104,1.0,4,7,1720,0.0,1962,1840,13104,21981 days 16:47:18.675850,194,1.7142857142857142,0.0,-120,0,1720.0
425000.0,3,1.75,1530,9800,1.0,5,8,1530,0.0,1958,1660,9800,23442 days 16:47:18.675850,335,1.7142857142857142,0.0,-130,0,1530.0
190000.0,3,1.75,1270,7875,1.0,4,7,1270,0.0,1980,1830,7210,15407 days 16:47:18.675850,068,1.7142857142857142,0.0,-560,665,1270.0
374000.0,3,1.75,1510,18439,1.0,3,7,1510,0.0,1971,1600,34326,18694 days 16:47:18.675850,125,1.7142857142857142,0.0,-90,-15887,1510.0
292000.0,2,1.0,880,5500,1.0,3,6,880,0.0,1904,1080,5500,43166 days 16:47:18.675850,219,2.0,0.0,-200,0,880.0
475000.0,5,1.75,2020,5100,1.5,5,7,1320,700.0,1911,1130,5100,40609 days 16:47:18.675850,131,2.857142857142857,1.8857142857142857,890,0,620.0
546500.0,3,2.5,1410,2675,1.0,3,7,820,590.0,1985,1410,4013,13580 days 16:47:18.675850,089,1.2,1.3898305084745763,0,-1338,230.0
82000.0,3,1.0,860,10426,1.0,3,6,860,0.0,1954,1140,11250,24903 days 16:47:18.675850,309,3.0,0.0,-280,-824,860.0
219900.0,3,1.0,860,10426,1.0,3,6,860,0.0,1954,1140,11250,24903 days 16:47:18.675850,098,3.0,0.0,-280,-824,860.0
440000.0,3,1.0,1210,5750,1.5,4,7,1210,0.0,1910,1160,5000,40974 days 16:47:18.675850,163,3.0,0.0,50,750,1210.0
400000.0,3,2.5,2090,32718,2.0,3,7,1550,540.0,1919,1200,192268,37687 days 16:47:18.675850,118,1.2,2.8703703703703702,890,-159550,1010.0
453000.0,3,1.75,1430,20193,1.0,3,7,1430,0.0,1955,2140,18364,24538 days 16:47:18.675850,321,1.7142857142857142,0.0,-710,1829,1430.0
330000.0,6,3.25,2120,6893,1.0,4,7,1060,1060.0,1983,1380,6986,14311 days 16:47:18.675850,224,1.8461538461538463,1.0,740,-93,0.0
359950.0,3,2.75,2540,8604,2.0,3,8,2540,0.0,1991,2260,7438,11389 days 16:47:18.675850,202,1.0909090909090908,0.0,280,1166,2540.0
616000.0,4,2.5,2490,12929,2.0,3,9,2490,0.0,1983,2440,12929,14311 days 16:47:18.675850,168,1.6,0.0,50,0,2490.0
245000.0,2,1.0,670,2356,1.0,5,6,670,0.0,1960,1220,1740,22712 days 16:47:18.675850,311,2.0,0.0,-550,616,670.0
296000.0,2,2.0,1320,2040,3.0,3,7,1320,0.0,1997,1430,2040,9197 days 16:47:18.675850,307,1.0,0.0,-110,0,1320.0
193000.0,2,1.0,950,9000,1.0,3,6,950,0.0,1924,1000,8280,35861 days 16:47:18.675850,310,2.0,0.0,-50,720,950.0
456000.0,3,2.0,1870,8442,1.5,5,7,1060,810.0,1927,1640,6174,34765 days 16:47:18.675850,240,1.5,1.308641975308642,230,2268,250.0
480000.0,4,1.75,1840,9250,1.0,4,7,980,860.0,1956,1520,9250,24173 days 16:47:18.675850,117,2.2857142857142856,1.1395348837209303,320,0,120.0
382000.0,3,3.25,1410,1253,3.0,3,8,1410,0.0,2005,1410,1253,6275 days 16:47:18.675850,129,0.9230769230769231,0.0,0,0,1410.0
650000.0,2,1.0,1050,2542,1.0,3,7,880,170.0,1904,1620,1809,43166 days 16:47:18.675850,179,2.0,5.176470588235294,-570,733,710.0
431750.0,2,2.0,1400,10052,1.0,3,8,1400,0.0,1957,1400,8785,23807 days 16:47:18.675850,329,1.0,0.0,0,1267,1400.0
419900.0,3,2.5,1630,1755,2.0,3,8,1320,310.0,1997,1920,14550,9197 days 16:47:18.675850,131,1.2,4.258064516129032,-290,-12795,1010.0
315000.0,3,2.0,1900,9513,1.0,3,8,1900,0.0,1995,1790,8028,9928 days 16:47:18.675850,363,1.5,0.0,110,1485,1900.0
597500.0,4,3.0,1890,35280,1.0,3,9,1510,380.0,1979,2730,34525,15772 days 16:47:18.675850,110,1.3333333333333333,3.973684210526316,-840,755,1130.0
615000.0,3,2.5,2980,43301,1.0,4,8,1930,1050.0,1978,2890,35915,16137 days 16:47:18.675850,065,1.2,1.838095238095238,90,7386,880.0
605000.0,4,3.25,2885,33671,2.0,4,8,2885,0.0,1984,1910,16000,13946 days 16:47:18.675850,304,1.2307692307692308,0.0,975,17671,2885.0
220000.0,3,2.5,1980,11900,2.0,3,8,1980,0.0,1990,2130,9933,11754 days 16:47:18.675850,091,1.2,0.0,-150,1967,1980.0
340000.0,4,2.5,3020,8750,1.0,3,8,1710,1310.0,1960,1900,8750,22712 days 16:47:18.675850,103,1.6,1.3053435114503817,1120,0,400.0
620000.0,4,2.5,2980,210395,2.0,3,9,2980,0.0,2001,2530,45596,7736 days 16:47:18.675850,288,1.6,0.0,450,164799,2980.0
602000.0,5,1.75,3290,11900,1.5,3,8,3290,0.0,1973,2210,8549,17963 days 16:47:18.675850,139,2.857142857142857,0.0,1080,3351,3290.0
575000.0,3,1.75,1580,11750,1.0,4,7,1180,400.0,1951,2150,11750,25999 days 16:47:18.675850,133,1.7142857142857142,2.95,-570,0,780.0
285000.0,3,2.5,2090,10834,1.0,4,8,1360,730.0,1987,1750,8595,12850 days 16:47:18.675850,122,1.2,1.8630136986301369,340,2239,630.0
306500.0,3,1.5,1100,8140,1.0,4,7,1100,0.0,1965,1430,7700,20885 days 16:47:18.675850,051,2.0,0.0,-330,440,1100.0
325000.0,3,2.5,1870,3480,2.0,3,7,1870,0.0,2002,2160,3480,7371 days 16:47:18.675850,002,1.2,0.0,-290,0,1870.0
623000.0,3,2.75,2390,21804,1.0,3,8,1450,940.0,1973,2390,10136,17963 days 16:47:18.675850,078,1.0909090909090908,1.5425531914893618,0,11668,510.0
256500.0,3,2.0,1320,8568,1.0,3,7,1320,0.0,1993,1600,8463,10658 days 16:47:18.675850,070,1.5,0.0,-280,105,1320.0
473000.0,5,3.5,3430,6872,2.0,3,1,2830,600.0,2002,3650,6600,7371 days 16:47:18.675850,321,1.4285714285714286,4.716666666666667,-220,272,2230.0
549000.0,3,2.5,2250,9235,2.0,3,8,2250,0.0,1985,2290,8187,13580 days 16:47:18.675850,302,1.2,0.0,-40,1048,2250.0
305000.0,3,1.0,1710,19115,1.0,3,6,1710,0.0,1986,1650,15144,13215 days 16:47:18.675850,076,3.0,0.0,60,3971,1710.0
317000.0,4,2.5,2160,8049,2.0,3,9,2160,0.0,1988,2490,8995,12485 days 16:47:18.675850,035,1.6,0.0,-330,-946,2160.0
450000.0,3,1.75,1400,13775,1.0,3,8,1400,0.0,1963,2200,10450,21616 days 16:47:18.675850,182,1.7142857142857142,0.0,-800,3325,1400.0
225000.0,2,2.5,1560,5333,1.0,3,5,780,780.0,1947,1010,4800,27460 days 16:47:18.675850,099,0.8,1.0,550,533,0.0
500000.0,5,2.0,2300,7897,2.5,4,8,2300,0.0,1956,2030,7902,24173 days 16:47:18.675850,043,2.5,0.0,270,-5,2300.0
207000.0,2,1.0,820,4860,1.0,5,6,820,0.0,1955,1240,6000,24538 days 16:47:18.675850,224,2.0,0.0,-420,-1140,820.0
474900.0,3,1.0,1630,8308,1.5,3,7,1630,0.0,1948,1170,8308,27095 days 16:47:18.675850,230,3.0,0.0,460,0,1630.0
515000.0,3,2.5,2010,7200,2.0,3,8,2010,0.0,1994,1970,7202,10293 days 16:47:18.675850,182,1.2,0.0,40,-2,2010.0
542000.0,4,1.0,1540,5000,1.5,4,7,1090,450.0,1922,1590,5000,36591 days 16:47:18.675850,043,4.0,2.422222222222222,-50,0,640.0
725000.0,4,2.75,2420,10962,1.0,3,8,1530,890.0,1977,2620,13200,16502 days 16:47:18.675850,156,1.4545454545454546,1.7191011235955056,-200,-2238,640.0
314950.0,3,2.5,1690,4533,2.0,3,7,1690,0.0,2003,1830,5175,7006 days 16:47:18.675850,068,1.2,0.0,-140,-642,1690.0
375000.0,3,2.0,1410,10078,1.0,4,6,1410,0.0,1983,2090,9202,14311 days 16:47:18.675850,310,1.5,0.0,-680,876,1410.0
500000.0,3,1.75,1640,47044,1.0,3,7,1640,0.0,1989,2280,200811,12119 days 16:47:18.675850,191,1.7142857142857142,0.0,-640,-153767,1640.0
689000.0,3,1.75,2200,9840,1.0,5,8,1500,700.0,1978,2410,9623,16137 days 16:47:18.675850,175,1.7142857142857142,2.142857142857143,-210,217,800.0
525000.0,3,2.25,1290,1182,2.0,3,8,1000,290.0,2006,1300,1169,5910 days 16:47:18.675850,343,1.3333333333333333,3.4482758620689653,-10,13,710.0
360000.0,3,1.5,1060,6232,1.0,4,7,1060,0.0,1968,1120,5379,19790 days 16:47:18.675850,124,2.0,0.0,-60,853,1060.0
425000.0,3,1.0,1240,5750,1.0,4,6,1240,0.0,1948,1240,5750,27095 days 16:47:18.675850,232,3.0,0.0,0,0,1240.0
239950.0,2,1.0,1280,5500,1.0,3,7,1280,0.0,1949,1270,5500,26729 days 16:47:18.675850,063,2.0,0.0,10,0,1280.0
577500.0,2,2.5,2330,3000,2.0,3,8,2330,0.0,1915,1760,4000,39148 days 16:47:18.675850,092,0.8,0.0,570,-1000,2330.0
615000.0,3,1.75,2360,7291,1.0,4,8,1360,1000.0,1948,1860,5499,27095 days 16:47:18.675850,122,1.7142857142857142,1.36,500,1792,360.0
516000.0,4,2.75,2210,10800,1.0,4,8,1170,1040.0,1997,2210,10800,9197 days 16:47:18.675850,239,1.4545454545454546,1.125,0,0,130.0
1220000.0,4,2.75,3670,15400,2.0,4,1,3670,0.0,1986,3370,13300,13215 days 16:47:18.675850,225,1.4545454545454546,0.0,300,2100,3670.0
1660000.0,4,3.5,3080,4815,2.0,3,1,2300,780.0,1937,2910,5350,31112 days 16:47:18.675850,147,1.1428571428571428,2.948717948717949,170,-535,1520.0
315000.0,2,1.0,770,6731,1.0,4,6,770,0.0,1943,1120,9212,28921 days 16:47:18.675850,121,2.0,0.0,-350,-2481,770.0
250000.0,4,2.0,2600,9000,1.0,3,8,1410,1190.0,1959,2600,7200,23077 days 16:47:18.675850,294,2.0,1.184873949579832,0,1800,220.0
250000.0,4,1.5,1220,4900,1.0,3,6,1220,0.0,1942,1410,3000,29286 days 16:47:18.675850,317,2.6666666666666665,0.0,-190,1900,1220.0
925000.0,4,2.5,2910,48351,1.0,4,8,1910,1000.0,1967,2760,43560,20155 days 16:47:18.675850,100,1.6,1.91,150,4791,910.0
358000.0,3,1.0,1150,4681,1.0,3,7,1150,0.0,1955,1150,6800,24538 days 16:47:18.675850,237,3.0,0.0,0,-2119,1150.0
262000.0,3,2.5,1700,6200,2.0,3,8,1700,0.0,1997,1720,6205,9197 days 16:47:18.675850,269,1.2,0.0,-20,-5,1700.0
500000.0,3,1.75,1220,7370,1.0,4,7,1220,0.0,1964,1580,8213,21251 days 16:47:18.675850,288,1.7142857142857142,0.0,-360,-843,1220.0
1300000.0,5,1.0,1670,6400,1.5,3,8,1670,0.0,1919,1910,2983,37687 days 16:47:18.675850,196,5.0,0.0,-240,3417,1670.0
500000.0,3,1.75,2420,65501,2.0,3,8,2420,0.0,1984,2970,19036,13946 days 16:47:18.675850,258,1.7142857142857142,0.0,-550,46465,2420.0
675000.0,3,2.25,2610,9002,2.0,3,9,2610,0.0,1988,2320,8306,12485 days 16:47:18.675850,153,1.3333333333333333,0.0,290,696,2610.0
235000.0,3,1.0,960,5030,1.0,3,7,960,0.0,1955,1460,5400,24538 days 16:47:18.675850,269,3.0,0.0,-500,-370,960.0
545000.0,3,1.0,960,5030,1.0,3,7,960,0.0,1955,1460,5400,24538 days 16:47:18.675850,077,3.0,0.0,-500,-370,960.0
350000.0,3,1.0,1010,9360,1.0,3,6,1010,0.0,1981,1470,9360,15041 days 16:47:18.675850,127,3.0,0.0,-460,0,1010.0
320000.0,2,2.25,1550,1827,2.0,3,8,1550,0.0,2008,1420,1826,5180 days 16:47:18.675850,329,0.8888888888888888,0.0,130,1,1550.0
452000.0,5,2.5,5067,13315,1.0,3,9,3154,1913.0,1968,2860,13957,19790 days 16:47:18.675850,077,2.0,1.6487192890747517,2207,-642,1241.0
875000.0,3,2.0,2350,6000,1.5,4,8,1990,360.0,1922,2010,5040,36591 days 16:47:18.675850,206,1.5,5.527777777777778,340,960,1630.0
325000.0,3,1.5,1310,2998,2.0,3,7,1310,0.0,1998,1310,2997,8832 days 16:47:18.675850,312,2.0,0.0,0,1,1310.0
319000.0,4,2.5,2510,7992,1.0,3,8,1610,900.0,1978,2030,7992,16137 days 16:47:18.675850,175,1.6,1.788888888888889,480,0,710.0
455000.0,3,1.75,890,3800,1.5,3,7,750,140.0,1926,1280,3800,35130 days 16:47:18.675850,021,1.7142857142857142,5.357142857142857,-390,0,610.0
330000.0,2,1.0,1129,3840,1.0,3,7,1129,0.0,1953,1300,3880,25268 days 16:47:18.675850,099,2.0,0.0,-171,-40,1129.0
510000.0,4,3.25,1980,9988,1.0,3,8,1340,640.0,1980,1980,8972,15407 days 16:47:18.675850,008,1.2307692307692308,2.09375,0,1016,700.0
532000.0,3,1.0,2360,5012,1.0,3,7,1560,800.0,1964,1690,4800,21251 days 16:47:18.675850,106,3.0,1.95,670,212,760.0
775000.0,3,2.5,2480,5007,2.0,3,8,1960,520.0,2014,1650,7806,2988 days 16:47:18.675850,020,1.2,3.769230769230769,830,-2799,1440.0
410000.0,3,1.75,2160,4000,1.0,3,7,1080,1080.0,1953,1260,3200,25268 days 16:47:18.675850,107,1.7142857142857142,1.0,900,800,0.0
205000.0,2,1.75,1740,5100,1.0,3,6,580,1160.0,1915,1440,5100,39148 days 16:47:18.675850,077,1.1428571428571428,0.5,300,0,-580.0
585000.0,4,2.5,2430,6766,2.0,3,8,2430,0.0,1999,1820,6772,8467 days 16:47:18.675850,346,1.6,0.0,610,-6,2430.0
255000.0,2,1.75,1950,8200,1.0,3,8,1950,0.0,1975,2370,8000,17233 days 16:47:18.675850,069,1.1428571428571428,0.0,-420,200,1950.0
415000.0,2,1.0,910,3750,1.0,3,7,910,0.0,1904,1160,4000,43166 days 16:47:18.675850,254,2.0,0.0,-250,-250,910.0
459000.0,4,2.0,2360,7080,1.0,5,6,1180,1180.0,1925,1340,7200,35495 days 16:47:18.675850,092,2.0,1.0,1020,-120,0.0
354000.0,3,1.0,1130,11250,1.0,3,7,1130,0.0,1965,1410,11250,20885 days 16:47:18.675850,345,3.0,0.0,-280,0,1130.0
782000.0,4,3.5,5270,53428,2.0,3,1,3440,1830.0,2004,2340,30904,6641 days 16:47:18.675850,189,1.1428571428571428,1.8797814207650274,2930,22524,1610.0
570000.0,3,1.5,1300,7287,1.0,4,7,1300,0.0,1965,1300,9129,20885 days 16:47:18.675850,124,2.0,0.0,0,-1842,1300.0
414500.0,3,1.0,1050,6002,1.0,3,7,840,210.0,1941,1180,6003,29651 days 16:47:18.675850,036,3.0,4.0,-130,-1,630.0
185000.0,4,1.0,1380,6700,1.0,3,7,1190,190.0,1928,1380,8292,34400 days 16:47:18.675850,218,4.0,6.2631578947368425,0,-1592,1000.0
262500.0,3,1.5,1610,10291,1.0,4,7,1610,0.0,1961,1410,7729,22346 days 16:47:18.675850,274,2.0,0.0,200,2562,1610.0
370000.0,4,2.75,3150,67518,1.0,4,9,2250,900.0,1965,2210,32391,20885 days 16:47:18.675850,142,1.4545454545454546,2.5,940,35127,1350.0
362500.0,3,1.0,1520,9507,1.0,3,7,1520,0.0,1954,1360,7219,24903 days 16:47:18.675850,005,3.0,0.0,160,2288,1520.0
536000.0,3,2.5,1990,7397,2.0,3,9,1990,0.0,1993,2210,7397,10658 days 16:47:18.675850,063,1.2,0.0,-220,0,1990.0
425000.0,5,2.0,2500,7804,1.5,3,7,1570,930.0,1921,1170,7676,36956 days 16:47:18.675850,111,2.5,1.6881720430107527,1330,128,640.0
435000.0,3,2.25,1890,7200,1.0,4,7,1230,660.0,1973,1970,8101,17963 days 16:47:18.675850,160,1.3333333333333333,1.8636363636363635,-80,-901,570.0
435000.0,5,2.0,1840,9240,1.0,4,7,1540,300.0,1942,1200,5250,29286 days 16:47:18.675850,125,2.5,5.133333333333334,640,3990,1240.0
400000.0,2,1.0,1220,6300,1.0,3,7,760,460.0,1942,1850,4886,29286 days 16:47:18.675850,071,2.0,1.6521739130434783,-630,1414,300.0
446000.0,2,1.5,1370,1221,2.0,3,8,1080,290.0,2008,1560,2081,5180 days 16:47:18.675850,177,1.3333333333333333,3.7241379310344827,-190,-860,790.0
1250000.0,3,2.5,2710,13120,1.0,3,1,2710,0.0,1959,3130,13566,23077 days 16:47:18.675850,026,1.2,0.0,-420,-446,2710.0
300000.0,3,2.25,1760,5421,2.0,3,7,1760,0.0,1991,1570,6000,11389 days 16:47:18.675850,324,1.3333333333333333,0.0,190,-579,1760.0
404500.0,2,1.0,800,5080,1.0,3,7,800,0.0,1938,1560,5110,30747 days 16:47:18.675850,218,2.0,0.0,-760,-30,800.0
910000.0,4,2.5,3530,49222,2.0,4,9,3530,0.0,1986,3750,49222,13215 days 16:47:18.675850,064,1.6,0.0,-220,0,3530.0
771000.0,3,2.25,1780,6120,1.5,4,9,1390,390.0,1927,1960,5568,34765 days 16:47:18.675850,133,1.3333333333333333,3.5641025641025643,-180,552,1000.0
335000.0,4,2.5,2610,4781,2.0,3,8,2610,0.0,2009,2583,4796,4814 days 16:47:18.675850,156,1.6,0.0,27,-15,2610.0
390000.0,3,1.75,1850,15170,1.0,3,7,1850,0.0,1965,1160,14175,20885 days 16:47:18.675850,216,1.7142857142857142,0.0,690,995,1850.0
288000.0,3,2.25,1560,9706,1.0,4,7,1560,0.0,1963,1510,9706,21616 days 16:47:18.675850,118,1.3333333333333333,0.0,50,0,1560.0
403000.0,3,1.75,1270,10790,1.0,3,7,1270,0.0,1956,1270,10790,24173 days 16:47:18.675850,287,1.7142857142857142,0.0,0,0,1270.0
510000.0,3,2.25,1420,1309,3.0,3,8,1420,0.0,2006,1500,1282,5910 days 16:47:18.675850,175,1.3333333333333333,0.0,-80,27,1420.0
751000.0,6,3.0,2880,6800,2.0,3,7,2880,0.0,1980,1640,4000,15407 days 16:47:18.675850,050,2.0,0.0,1240,2800,2880.0
408000.0,3,1.0,1420,8000,1.0,3,7,1420,0.0,1950,1780,8295,26364 days 16:47:18.675850,034,3.0,0.0,-360,-295,1420.0
1010000.0,3,1.0,1640,12855,1.5,5,6,1500,140.0,1920,2190,11262,37322 days 16:47:18.675850,182,3.0,10.714285714285714,-550,1593,1360.0
575000.0,3,2.0,1730,9030,1.0,4,7,1730,0.0,1956,1470,9030,24173 days 16:47:18.675850,114,1.5,0.0,260,0,1730.0
330000.0,3,1.75,1250,8100,1.0,3,7,1250,0.0,1951,1300,8175,25999 days 16:47:18.675850,107,1.7142857142857142,0.0,-50,-75,1250.0
565000.0,3,2.25,1520,1221,3.0,3,8,1520,0.0,2013,1550,4750,3353 days 16:47:18.675850,136,1.3333333333333333,0.0,-30,-3529,1520.0
456000.0,3,2.5,1820,2935,2.0,3,8,1820,0.0,1999,1820,2936,8467 days 16:47:18.675850,103,1.2,0.0,0,-1,1820.0
652500.0,4,2.5,2700,9122,2.0,3,9,2700,0.0,1990,2500,9122,11754 days 16:47:18.675850,166,1.6,0.0,200,0,2700.0
582000.0,3,1.75,1820,3140,2.0,5,8,1820,0.0,1949,2030,5499,26729 days 16:47:18.675850,365,1.7142857142857142,0.0,-210,-2359,1820.0
700000.0,4,2.5,2770,5686,2.0,3,9,2770,0.0,2004,2910,5000,6641 days 16:47:18.675850,176,1.6,0.0,-140,686,2770.0
235000.0,2,1.0,1270,9182,1.5,3,6,1270,0.0,1917,1760,9100,38417 days 16:47:18.675850,288,2.0,0.0,-490,82,1270.0
460000.0,3,1.75,1400,12155,1.0,4,7,1400,0.0,1977,2540,23522,16502 days 16:47:18.675850,212,1.7142857142857142,0.0,-1140,-11367,1400.0
475000.0,3,2.25,1820,8008,1.0,3,8,1240,580.0,1981,2030,8750,15041 days 16:47:18.675850,142,1.3333333333333333,2.1379310344827585,-210,-742,660.0
579000.0,2,2.0,1870,6275,1.0,3,8,1870,0.0,2003,1670,5200,7006 days 16:47:18.675850,160,1.0,0.0,200,1075,1870.0
507000.0,4,2.0,1360,2746,1.5,3,7,1360,0.0,1945,1960,2746,28190 days 16:47:18.675850,314,2.0,0.0,-600,0,1360.0
210000.0,3,2.5,1040,2643,2.0,3,7,720,320.0,2004,1540,5110,6641 days 16:47:18.675850,132,1.2,2.25,-500,-2467,400.0
359500.0,4,2.75,2140,10316,2.0,3,8,2140,0.0,1993,1920,11337,10658 days 16:47:18.675850,181,1.4545454545454546,0.0,220,-1021,2140.0
248000.0,3,1.75,1330,9831,1.0,3,7,1330,0.0,1987,1330,7500,12850 days 16:47:18.675850,311,1.7142857142857142,0.0,0,2331,1330.0
239300.0,3,1.0,1070,5750,1.0,3,7,1070,0.0,1952,1420,6500,25634 days 16:47:18.675850,295,3.0,0.0,-350,-750,1070.0
315000.0,3,2.25,1370,1533,3.0,3,8,1370,0.0,2009,1370,1125,4814 days 16:47:18.675850,350,1.3333333333333333,0.0,0,408,1370.0
970000.0,4,3.0,3510,12410,2.0,4,9,3510,0.0,1976,3000,13209,16868 days 16:47:18.675850,057,1.3333333333333333,0.0,510,-799,3510.0
510000.0,3,1.5,1730,6240,1.0,3,8,1000,730.0,1954,1620,6240,24903 days 16:47:18.675850,076,2.0,1.36986301369863,110,0,270.0
418000.0,4,1.5,1550,9176,1.0,3,7,1000,550.0,1956,1730,8539,24173 days 16:47:18.675850,172,2.6666666666666665,1.8181818181818181,-180,637,450.0
699000.0,4,2.5,3280,27441,2.0,3,9,3280,0.0,1996,3200,26960,9563 days 16:47:18.675850,163,1.6,0.0,80,481,3280.0
871000.0,4,2.5,2150,8536,1.0,4,8,1400,750.0,1967,2800,9500,20155 days 16:47:18.675850,080,1.6,1.8666666666666667,-650,-964,650.0
515000.0,3,1.75,1580,9147,1.0,4,7,1210,370.0,1967,2600,23564,20155 days 16:47:18.675850,127,1.7142857142857142,3.27027027027027,-1020,-14417,840.0
400000.0,3,1.0,1460,43000,1.0,3,7,1460,0.0,1952,2250,20023,25634 days 16:47:18.675850,223,3.0,0.0,-790,22977,1460.0
445000.0,3,1.75,1410,5100,1.0,4,7,1110,300.0,1954,1600,7800,24903 days 16:47:18.675850,343,1.7142857142857142,3.7,-190,-2700,810.0
1110000.0,4,2.75,3090,6600,1.0,3,9,1800,1290.0,1956,2380,5000,24173 days 16:47:18.675850,056,1.4545454545454546,1.3953488372093024,710,1600,510.0
212000.0,3,1.5,1690,9600,1.0,3,7,1210,480.0,1976,1450,9647,16868 days 16:47:18.675850,300,2.0,2.5208333333333335,240,-47,730.0
710000.0,4,2.5,2870,11304,2.0,3,9,2870,0.0,1980,2690,9940,15407 days 16:47:18.675850,012,1.6,0.0,180,1364,2870.0
225800.0,4,1.0,1100,7110,1.0,4,7,880,220.0,1907,1150,7110,42070 days 16:47:18.675850,090,4.0,4.0,-50,0,660.0
520000.0,3,1.75,2310,36665,1.0,3,8,1580,730.0,1983,2000,14000,14311 days 16:47:18.675850,356,1.7142857142857142,2.164383561643836,310,22665,850.0
1300000.0,5,3.75,3490,15246,1.0,4,1,1940,1550.0,1968,3410,15682,19790 days 16:47:18.675850,128,1.3333333333333333,1.2516129032258065,80,-436,390.0
248000.0,4,2.0,2080,13510,1.0,3,7,1040,1040.0,1950,2010,11625,26364 days 16:47:18.675850,170,2.0,1.0,70,1885,0.0
556000.0,4,2.5,2230,7200,1.0,4,7,1220,1010.0,1957,1920,7200,23807 days 16:47:18.675850,289,1.6,1.2079207920792079,310,0,210.0
319950.0,5,1.75,1710,11900,1.0,3,7,1070,640.0,1958,1030,10360,23442 days 16:47:18.675850,132,2.857142857142857,1.671875,680,1540,430.0
320000.0,4,2.75,1640,3000,1.0,3,7,1000,640.0,1984,1150,4545,13946 days 16:47:18.675850,090,1.4545454545454546,1.5625,490,-1545,360.0
245000.0,3,2.5,1600,2788,2.0,4,7,1600,0.0,1992,1720,3605,11024 days 16:47:18.675850,189,1.2,0.0,-120,-817,1600.0
700000.0,3,2.5,2850,36585,2.0,3,1,2850,0.0,1987,3340,35671,12850 days 16:47:18.675850,034,1.2,0.0,-490,914,2850.0
628000.0,5,2.75,2600,8160,2.0,3,8,2600,0.0,2015,1600,8160,2623 days 16:47:18.675850,071,1.8181818181818181,0.0,1000,0,2600.0
640000.0,3,2.0,1380,4800,1.0,3,7,1380,0.0,1948,1740,5640,27095 days 16:47:18.675850,168,1.5,0.0,-360,-840,1380.0
420000.0,4,1.75,1320,4978,1.0,4,7,940,380.0,1942,1260,4693,29286 days 16:47:18.675850,118,2.2857142857142856,2.473684210526316,60,285,560.0
349950.0,3,2.5,1420,1162,3.0,3,8,1420,0.0,2002,1430,1560,7371 days 16:47:18.675850,281,1.2,0.0,-10,-398,1420.0
307999.0,4,2.75,2420,8438,2.0,3,8,2420,0.0,1996,2420,8580,9563 days 16:47:18.675850,195,1.4545454545454546,0.0,0,-142,2420.0
749950.0,4,2.75,2600,6050,2.0,5,8,1960,640.0,1949,1990,6050,26729 days 16:47:18.675850,127,1.4545454545454546,3.0625,610,0,1320.0
290000.0,2,1.0,840,3844,1.0,4,6,840,0.0,1919,1040,3844,37687 days 16:47:18.675850,192,2.0,0.0,-200,0,840.0
235000.0,3,1.75,1420,7920,1.0,4,7,1420,0.0,1962,1420,7920,21981 days 16:47:18.675850,193,1.7142857142857142,0.0,0,0,1420.0
225000.0,3,1.0,1790,6120,1.0,3,6,1790,0.0,1937,830,6120,31112 days 16:47:18.675850,246,3.0,0.0,960,0,1790.0
302100.0,3,1.0,1790,6120,1.0,3,6,1790,0.0,1937,830,6120,31112 days 16:47:18.675850,114,3.0,0.0,960,0,1790.0
520000.0,2,1.0,1340,6380,1.0,3,7,890,450.0,1939,1380,6380,30382 days 16:47:18.675850,043,2.0,1.9777777777777779,-40,0,440.0
285000.0,2,1.0,1010,7200,1.0,3,7,1010,0.0,1975,1890,9248,17233 days 16:47:18.675850,177,2.0,0.0,-880,-2048,1010.0
525000.0,3,2.0,1640,15258,1.0,3,8,1640,0.0,1981,1640,16345,15041 days 16:47:18.675850,233,1.5,0.0,0,-1087,1640.0
374900.0,5,2.75,2980,8500,1.0,3,8,1540,1440.0,1982,2310,8500,14676 days 16:47:18.675850,078,1.8181818181818181,1.0694444444444444,670,0,100.0
377500.0,3,2.0,1370,7200,1.0,3,7,1130,240.0,1926,1300,7208,35130 days 16:47:18.675850,279,1.5,4.708333333333333,70,-8,890.0
587450.0,3,2.25,2190,8775,1.5,4,8,2190,0.0,1927,1910,8145,34765 days 16:47:18.675850,117,1.3333333333333333,0.0,280,630,2190.0
245000.0,3,2.25,1530,12000,1.0,3,7,1070,460.0,1979,2140,13636,15772 days 16:47:18.675850,021,1.3333333333333333,2.3260869565217392,-610,-1636,610.0
200000.0,3,2.0,1290,5757,1.0,3,7,1290,0.0,1994,1580,6798,10293 days 16:47:18.675850,210,1.5,0.0,-290,-1041,1290.0
2140000.0,4,3.75,5150,453895,2.0,3,1,4360,790.0,1997,2500,215186,9197 days 16:47:18.675850,329,1.0666666666666667,5.518987341772152,2650,238709,3570.0
607000.0,3,2.5,2470,9226,2.0,3,9,2470,0.0,1991,2820,11013,11389 days 16:47:18.675850,313,1.2,0.0,-350,-1787,2470.0
1250000.0,1,1.25,1810,5070,1.5,4,8,1230,580.0,1967,2280,5070,20155 days 16:47:18.675850,104,0.8,2.1206896551724137,-470,0,650.0
549950.0,4,2.5,2230,14694,1.0,4,7,1180,1050.0,1981,1470,13458,15041 days 16:47:18.675850,069,1.6,1.1238095238095238,760,1236,130.0
250000.0,3,3.0,2300,7701,1.0,3,7,2300,0.0,1960,1570,8116,22712 days 16:47:18.675850,322,1.0,0.0,730,-415,2300.0
525000.0,3,2.5,2030,6970,2.0,4,8,2030,0.0,1991,2000,6140,11389 days 16:47:18.675850,129,1.2,0.0,30,830,2030.0
440000.0,3,1.75,2000,9900,1.0,4,8,1480,520.0,1957,2310,10200,23807 days 16:47:18.675850,175,1.7142857142857142,2.8461538461538463,-310,-300,960.0
425000.0,3,2.75,3610,107386,1.5,3,8,3130,480.0,1918,2630,42126,38052 days 16:47:18.675850,072,1.0909090909090908,6.520833333333333,980,65260,2650.0
739900.0,5,2.5,3290,5029,2.0,3,8,3290,0.0,2004,2990,6441,6641 days 16:47:18.675850,182,2.0,0.0,300,-1412,3290.0
315000.0,3,2.0,1300,3731,1.0,3,7,900,400.0,1993,1300,3731,10658 days 16:47:18.675850,148,1.5,2.25,0,0,500.0
340000.0,5,1.0,1880,3774,1.5,3,6,1360,520.0,1917,1420,2550,38417 days 16:47:18.675850,062,5.0,2.6153846153846154,460,1224,840.0
366000.0,4,2.75,2170,9743,2.0,3,7,2170,0.0,1995,1670,7734,9928 days 16:47:18.675850,121,1.4545454545454546,0.0,500,2009,2170.0
315000.0,3,1.75,1680,7250,1.0,3,7,930,750.0,1952,1340,7250,25634 days 16:47:18.675850,294,1.7142857142857142,1.24,340,0,180.0
299000.0,3,1.5,1190,9135,1.0,4,7,1190,0.0,1959,1520,9146,23077 days 16:47:18.675850,300,2.0,0.0,-330,-11,1190.0
350000.0,2,1.0,940,5000,1.0,3,7,940,0.0,1950,1800,7400,26364 days 16:47:18.675850,317,2.0,0.0,-860,-2400,940.0
340000.0,2,1.75,1010,1461,1.0,3,7,670,340.0,2003,1500,2499,7006 days 16:47:18.675850,309,1.1428571428571428,1.9705882352941178,-490,-1038,330.0
460000.0,3,1.75,1290,8580,1.0,4,7,1290,0.0,1962,1840,8580,21981 days 16:47:18.675850,364,1.7142857142857142,0.0,-550,0,1290.0
224000.0,3,1.5,1480,10588,1.0,3,7,1480,0.0,1957,1370,10588,23807 days 16:47:18.675850,212,2.0,0.0,110,0,1480.0
140000.0,2,1.0,900,6400,1.0,2,6,900,0.0,1940,1350,6405,30017 days 16:47:18.675850,223,2.0,0.0,-450,-5,900.0
246000.0,4,2.0,1400,7632,1.5,5,6,1400,0.0,1930,1400,7632,33669 days 16:47:18.675850,286,2.0,0.0,0,0,1400.0
330000.0,3,2.5,2040,14071,2.0,3,7,2040,0.0,1995,1890,14040,9928 days 16:47:18.675850,027,1.2,0.0,150,31,2040.0
306000.0,3,1.0,1450,7200,1.0,3,7,1010,440.0,1969,1500,6767,19424 days 16:47:18.675850,190,3.0,2.2954545454545454,-50,433,570.0
324950.0,3,1.0,1210,7440,1.0,3,7,1210,0.0,1949,1120,7440,26729 days 16:47:18.675850,155,3.0,0.0,90,0,1210.0
345000.0,2,1.5,1800,26615,1.0,5,7,1240,560.0,1987,2010,26337,12850 days 16:47:18.675850,164,1.3333333333333333,2.2142857142857144,-210,278,680.0
207000.0,3,1.0,1490,8995,1.0,4,7,1490,0.0,1954,1490,9000,24903 days 16:47:18.675850,128,3.0,0.0,0,-5,1490.0
238000.0,3,1.0,1240,5700,1.5,5,6,1240,0.0,1953,1140,5700,25268 days 16:47:18.675850,239,3.0,0.0,100,0,1240.0
695000.0,3,2.0,2632,18743,2.0,3,1,2632,0.0,2000,1970,14171,8102 days 16:47:18.675850,091,1.5,0.0,662,4572,2632.0
649950.0,3,2.5,2150,15304,2.0,4,9,2150,0.0,1979,2540,10507,15772 days 16:47:18.675850,254,1.2,0.0,-390,4797,2150.0
515000.0,3,2.75,1710,9448,1.0,3,7,1010,700.0,1947,1960,8951,27460 days 16:47:18.675850,104,1.0909090909090908,1.4428571428571428,-250,497,310.0
452000.0,3,2.5,1530,5032,2.0,3,7,1530,0.0,1998,1450,2136,8832 days 16:47:18.675850,274,1.2,0.0,80,2896,1530.0
236000.0,4,2.5,1630,3060,2.0,3,7,1630,0.0,2003,1270,4590,7006 days 16:47:18.675850,303,1.6,0.0,360,-1530,1630.0
1290000.0,4,3.5,4080,14450,2.0,3,1,3210,870.0,1998,4080,12114,8832 days 16:47:18.675850,211,1.1428571428571428,3.689655172413793,0,2336,2340.0
563000.0,3,2.75,2340,16500,1.0,4,8,1500,840.0,1972,2210,15251,18329 days 16:47:18.675850,161,1.0909090909090908,1.7857142857142858,130,1249,660.0
410988.0,3,1.75,1000,14061,1.0,4,7,1000,0.0,1967,1260,12635,20155 days 16:47:18.675850,092,1.7142857142857142,0.0,-260,1426,1000.0
1200000.0,4,2.5,3180,13118,2.0,4,1,3180,0.0,1986,3070,12861,13215 days 16:47:18.675850,294,1.6,0.0,110,257,3180.0
340000.0,4,2.5,2170,19785,2.0,3,8,2170,0.0,1992,2280,8616,11024 days 16:47:18.675850,078,1.6,0.0,-110,11169,2170.0
808100.0,4,3.25,3020,13457,1.0,5,9,3020,0.0,1956,2120,7553,24173 days 16:47:18.675850,311,1.2307692307692308,0.0,900,5904,3020.0
236000.0,3,1.75,1330,6301,1.0,3,7,1330,0.0,1998,1330,6144,8832 days 16:47:18.675850,160,1.7142857142857142,0.0,0,157,1330.0
330000.0,4,1.75,1720,8300,1.0,4,8,1720,0.0,1965,1840,8300,20885 days 16:47:18.675850,133,2.2857142857142856,0.0,-120,0,1720.0
799990.0,4,3.5,2540,5808,2.0,5,8,1820,720.0,1910,1520,5461,40974 days 16:47:18.675850,027,1.1428571428571428,2.5277777777777777,1020,347,1100.0
343000.0,3,1.0,1410,18600,1.0,5,7,1410,0.0,1960,1610,24941,22712 days 16:47:18.675850,107,3.0,0.0,-200,-6341,1410.0
332000.0,3,2.5,1530,9406,1.0,3,7,1270,260.0,1993,1700,7682,10658 days 16:47:18.675850,168,1.2,4.884615384615385,-170,1724,1010.0
945000.0,5,3.5,4380,14925,2.0,3,1,4380,0.0,2003,4310,14633,7006 days 16:47:18.675850,091,1.4285714285714286,0.0,70,292,4380.0
239950.0,3,1.0,1140,8366,1.0,5,6,1140,0.0,1943,960,7200,28921 days 16:47:18.675850,168,3.0,0.0,180,1166,1140.0
674000.0,5,1.75,2110,5000,1.5,4,7,1250,860.0,1946,1720,5000,27825 days 16:47:18.675850,062,2.857142857142857,1.4534883720930232,390,0,390.0
200000.0,3,1.0,1050,5000,1.0,4,6,1050,0.0,1967,1050,5200,20155 days 16:47:18.675850,140,3.0,0.0,0,-200,1050.0
453000.0,3,1.75,1600,7232,1.0,3,8,1600,0.0,1966,1970,8120,20520 days 16:47:18.675850,064,1.7142857142857142,0.0,-370,-888,1600.0
330000.0,3,1.75,1430,8865,1.0,3,7,1430,0.0,1950,1250,8154,26364 days 16:47:18.675850,165,1.7142857142857142,0.0,180,711,1430.0
285000.0,4,2.5,1996,4547,2.0,3,7,1996,0.0,2009,2180,5127,4814 days 16:47:18.675850,106,1.6,0.0,-184,-580,1996.0
338000.0,4,1.75,1530,8152,1.0,5,6,910,620.0,1948,1310,8152,27095 days 16:47:18.675850,310,2.2857142857142856,1.467741935483871,220,0,290.0
264950.0,2,1.0,1000,6000,1.0,3,6,1000,0.0,1951,1250,6000,25999 days 16:47:18.675850,114,2.0,0.0,-250,0,1000.0
880000.0,4,2.0,2530,10800,1.0,5,8,1350,1180.0,1954,2960,12150,24903 days 16:47:18.675850,070,2.0,1.1440677966101696,-430,-1350,170.0
209500.0,3,1.5,970,5488,1.0,3,7,970,0.0,1976,1040,5488,16868 days 16:47:18.675850,096,2.0,0.0,-70,0,970.0
380000.0,4,2.5,2400,9398,1.0,4,7,1310,1090.0,1958,1330,8249,23442 days 16:47:18.675850,115,1.6,1.201834862385321,1070,1149,220.0
336500.0,3,2.0,1830,12891,1.0,3,7,1830,0.0,1994,2320,8709,10293 days 16:47:18.675850,351,1.5,0.0,-490,4182,1830.0
360000.0,3,2.25,2130,8466,1.0,3,7,1290,840.0,1983,2250,9682,14311 days 16:47:18.675850,195,1.3333333333333333,1.5357142857142858,-120,-1216,450.0
911100.0,4,3.25,3330,33826,2.0,5,8,3330,0.0,1924,2580,28707,35861 days 16:47:18.675850,233,1.2307692307692308,0.0,750,5119,3330.0
249900.0,2,1.0,560,7560,1.0,3,6,560,0.0,1944,990,7560,28556 days 16:47:18.675850,328,2.0,0.0,-430,0,560.0
175000.0,4,1.0,1210,6250,1.0,3,7,1210,0.0,1962,1210,8291,21981 days 16:47:18.675850,266,4.0,0.0,0,-2041,1210.0
549950.0,3,2.5,2380,2500,3.0,3,9,2380,0.0,1988,2270,5000,12485 days 16:47:18.675850,317,1.2,0.0,110,-2500,2380.0
225000.0,3,1.75,1370,10866,1.0,4,6,1370,0.0,1945,1580,14250,28190 days 16:47:18.675850,294,1.7142857142857142,0.0,-210,-3384,1370.0
270000.0,3,1.75,1370,10866,1.0,4,6,1370,0.0,1945,1580,14250,28190 days 16:47:18.675850,356,1.7142857142857142,0.0,-210,-3384,1370.0
400000.0,3,2.25,1740,11040,2.0,3,8,1740,0.0,1980,1720,11778,15407 days 16:47:18.675850,231,1.3333333333333333,0.0,20,-738,1740.0
299800.0,2,1.0,790,5240,1.0,4,6,790,0.0,1925,1430,5320,35495 days 16:47:18.675850,141,2.0,0.0,-640,-80,790.0
555000.0,3,2.5,2480,8676,2.0,4,8,2480,0.0,1989,2540,9496,12119 days 16:47:18.675850,218,1.2,0.0,-60,-820,2480.0
230000.0,3,2.5,1920,9180,2.0,3,8,1920,0.0,1988,1930,7252,12485 days 16:47:18.675850,127,1.2,0.0,-10,1928,1920.0
360000.0,4,2.5,2750,6259,2.0,3,9,2750,0.0,2002,2810,6824,7371 days 16:47:18.675850,344,1.6,0.0,-60,-565,2750.0
415000.0,2,1.0,880,3200,1.0,3,7,880,0.0,1910,1880,6000,40974 days 16:47:18.675850,246,2.0,0.0,-1000,-2800,880.0
355000.0,4,1.75,2160,8000,1.0,4,9,1660,500.0,1976,2350,8200,16868 days 16:47:18.675850,230,2.2857142857142856,3.32,-190,-200,1160.0
635000.0,4,2.5,2570,27972,2.0,3,8,2570,0.0,1997,2500,29761,9197 days 16:47:18.675850,082,1.6,0.0,70,-1789,2570.0
353000.0,5,2.75,2130,5000,1.0,5,7,1100,1030.0,1978,1340,6837,16137 days 16:47:18.675850,336,1.8181818181818181,1.0679611650485437,790,-1837,70.0
999000.0,7,4.0,3150,34830,1.0,3,9,3150,0.0,1957,2390,12054,23807 days 16:47:18.675850,148,1.75,0.0,760,22776,3150.0
265000.0,3,1.5,1780,10196,1.0,4,7,1270,510.0,1967,1320,7875,20155 days 16:47:18.675850,112,2.0,2.4901960784313726,460,2321,760.0
250000.0,4,1.75,1910,8250,1.0,4,7,1910,0.0,1959,1500,8250,23077 days 16:47:18.675850,085,2.2857142857142856,0.0,410,0,1910.0
225000.0,2,1.0,1170,7142,1.0,3,7,1170,0.0,1951,1170,7615,25999 days 16:47:18.675850,232,2.0,0.0,0,-473,1170.0
553000.0,2,1.0,900,5000,1.0,3,7,900,0.0,1944,1280,5000,28556 days 16:47:18.675850,123,2.0,0.0,-380,0,900.0
565000.0,5,2.5,2650,11455,1.0,3,7,1400,1250.0,1961,1960,9880,22346 days 16:47:18.675850,155,2.0,1.12,690,1575,150.0
312000.0,2,1.0,1170,5150,1.0,3,6,980,190.0,1907,1660,5150,42070 days 16:47:18.675850,230,2.0,5.157894736842105,-490,0,790.0
475000.0,3,2.5,2630,185130,2.0,3,9,2630,0.0,1991,2630,210394,11389 days 16:47:18.675850,203,1.2,0.0,0,-25264,2630.0
320000.0,4,2.75,2150,9163,1.0,3,8,1340,810.0,1992,2260,7750,11024 days 16:47:18.675850,310,1.4545454545454546,1.654320987654321,-110,1413,530.0
453000.0,3,2.0,1430,9583,1.0,4,7,1430,0.0,1964,1890,11100,21251 days 16:47:18.675850,237,1.5,0.0,-460,-1517,1430.0
320000.0,3,1.0,960,6180,1.0,4,6,960,0.0,1910,1250,4120,40974 days 16:47:18.675850,084,3.0,0.0,-290,2060,960.0
610000.0,4,2.75,2640,8400,1.0,3,8,1440,1200.0,1947,2610,6000,27460 days 16:47:18.675850,022,1.4545454545454546,1.2,30,2400,240.0
385000.0,3,1.5,1490,9630,1.0,4,8,1490,0.0,1959,1960,10469,23077 days 16:47:18.675850,140,2.0,0.0,-470,-839,1490.0
215000.0,3,1.75,1210,8075,1.0,4,6,1210,0.0,1983,1310,8025,14311 days 16:47:18.675850,148,1.7142857142857142,0.0,-100,50,1210.0
215000.0,4,1.5,1860,5040,1.5,5,8,1860,0.0,1920,1680,5800,37322 days 16:47:18.675850,190,2.6666666666666665,0.0,180,-760,1860.0
415000.0,3,2.5,1980,4274,2.0,3,7,1980,0.0,2003,2000,4394,7006 days 16:47:18.675850,364,1.2,0.0,-20,-120,1980.0
350000.0,1,1.0,900,6380,1.0,3,6,900,0.0,1947,1830,6380,27460 days 16:47:18.675850,226,1.0,0.0,-930,0,900.0
395000.0,1,1.0,900,6380,1.0,3,6,900,0.0,1947,1830,6380,27460 days 16:47:18.675850,118,1.0,0.0,-930,0,900.0
898000.0,2,1.75,1490,9874,1.0,4,7,1490,0.0,1963,2280,9869,21616 days 16:47:18.675850,314,1.1428571428571428,0.0,-790,5,1490.0
480000.0,3,2.5,2980,7338,2.0,3,8,2980,0.0,2006,3010,5267,5910 days 16:47:18.675850,352,1.2,0.0,-30,2071,2980.0
1240000.0,3,2.5,2660,1973,3.0,3,9,1870,790.0,2007,1640,1369,5545 days 16:47:18.675850,314,1.2,2.367088607594937,1020,604,1080.0
599000.0,4,2.5,2790,230868,2.0,3,8,2790,0.0,1989,1590,217800,12119 days 16:47:18.675850,162,1.6,0.0,1200,13068,2790.0
770000.0,4,3.0,2800,9127,2.0,3,9,2800,0.0,1999,2780,8165,8467 days 16:47:18.675850,128,1.3333333333333333,0.0,20,962,2800.0
1210000.0,3,2.25,1590,8520,2.0,4,8,1590,0.0,1980,2470,12005,15407 days 16:47:18.675850,072,1.3333333333333333,0.0,-880,-3485,1590.0
1590000.0,4,2.25,3240,11131,1.0,4,9,2080,1160.0,1953,2300,12150,25268 days 16:47:18.675850,016,1.7777777777777777,1.793103448275862,940,-1019,920.0
880000.0,3,2.0,2130,35169,1.0,4,8,2130,0.0,1989,2860,43560,12119 days 16:47:18.675850,146,1.5,0.0,-730,-8391,2130.0
332000.0,3,2.0,1510,7884,1.0,3,6,1510,0.0,1942,1050,7620,29286 days 16:47:18.675850,171,1.5,0.0,460,264,1510.0
445000.0,3,1.75,1750,7200,1.0,3,7,1750,0.0,1966,1810,7590,20520 days 16:47:18.675850,310,1.7142857142857142,0.0,-60,-390,1750.0
849000.0,4,2.75,4010,87555,2.0,3,1,4010,0.0,2004,2451,209523,6641 days 16:47:18.675850,237,1.4545454545454546,0.0,1559,-121968,4010.0
752000.0,4,1.5,1650,2970,1.5,3,7,1650,0.0,1903,1670,2970,43531 days 16:47:18.675850,345,2.6666666666666665,0.0,-20,0,1650.0
450000.0,9,7.5,4050,6504,2.0,3,7,4050,0.0,1996,1448,3866,9563 days 16:47:18.675850,223,1.2,0.0,2602,2638,4050.0
420000.0,3,1.0,1320,5500,1.0,3,7,1320,0.0,1955,1480,5250,24538 days 16:47:18.675850,261,3.0,0.0,-160,250,1320.0
330000.0,4,2.5,2310,6320,2.0,3,8,2310,0.0,1997,1850,6181,9197 days 16:47:18.675850,076,1.6,0.0,460,139,2310.0
409000.0,3,1.75,1440,9065,1.0,4,8,1440,0.0,1972,1990,8812,18329 days 16:47:18.675850,337,1.7142857142857142,0.0,-550,253,1440.0
350000.0,5,1.75,2330,14322,1.0,4,7,1180,1150.0,1968,1690,10010,19790 days 16:47:18.675850,178,2.857142857142857,1.0260869565217392,640,4312,30.0
570000.0,4,2.5,2430,44001,1.0,3,8,2430,0.0,1994,2200,46924,10293 days 16:47:18.675850,105,1.6,0.0,230,-2923,2430.0
315000.0,3,1.0,1390,8333,1.0,3,7,1390,0.0,1982,1320,7090,14676 days 16:47:18.675850,259,3.0,0.0,70,1243,1390.0
224000.0,2,1.0,1150,15000,1.0,3,6,1060,90.0,1930,1350,15000,33669 days 16:47:18.675850,279,2.0,11.777777777777779,-200,0,970.0
293550.0,4,1.75,2120,9706,1.0,3,7,1370,750.0,1965,1730,11337,20885 days 16:47:18.675850,279,2.2857142857142856,1.8266666666666667,390,-1631,620.0
350000.0,4,2.75,2300,3175,1.5,3,6,1340,960.0,1966,1260,3175,20520 days 16:47:18.675850,276,1.4545454545454546,1.3958333333333333,1040,0,380.0
1110000.0,4,2.5,3320,9380,2.0,3,1,3320,0.0,1988,2870,11779,12485 days 16:47:18.675850,259,1.6,0.0,450,-2399,3320.0
616500.0,3,2.5,3580,118047,1.0,3,9,3240,340.0,1992,3240,123275,11024 days 16:47:18.675850,216,1.2,9.529411764705882,340,-5228,2900.0
506400.0,3,2.5,2100,9040,1.0,3,8,1700,400.0,1989,2430,8809,12119 days 16:47:18.675850,323,1.2,4.25,-330,231,1300.0
324000.0,3,2.25,1550,4411,2.0,3,7,1550,0.0,2001,1620,4621,7736 days 16:47:18.675850,356,1.3333333333333333,0.0,-70,-210,1550.0
169000.0,3,1.5,1570,6450,1.5,4,6,1570,0.0,1931,1400,6450,33304 days 16:47:18.675850,217,2.0,0.0,170,0,1570.0
595000.0,3,2.0,1480,5000,1.0,4,7,750,730.0,1928,1250,4000,34400 days 16:47:18.675850,149,1.5,1.0273972602739727,230,1000,20.0
299900.0,3,2.5,2720,6014,2.0,3,7,2720,0.0,2002,2760,6537,7371 days 16:47:18.675850,141,1.2,0.0,-40,-523,2720.0
332000.0,3,2.25,2270,8876,1.0,3,7,1380,890.0,1977,2150,7455,16502 days 16:47:18.675850,149,1.3333333333333333,1.550561797752809,120,1421,490.0
432000.0,4,1.75,2410,8400,1.0,3,7,1600,810.0,1978,1850,8400,16137 days 16:47:18.675850,293,2.2857142857142856,1.9753086419753085,560,0,790.0
510000.0,4,2.75,2730,9112,1.0,3,9,1740,990.0,1996,3050,10454,9563 days 16:47:18.675850,275,1.4545454545454546,1.7575757575757576,-320,-1342,750.0
270000.0,3,2.5,1540,7739,2.0,4,7,1540,0.0,1986,1720,7200,13215 days 16:47:18.675850,121,1.2,0.0,-180,539,1540.0
750000.0,5,2.5,3120,15593,2.0,3,1,3120,0.0,1986,3390,17003,13215 days 16:47:18.675850,089,2.0,0.0,-270,-1410,3120.0
509250.0,2,1.5,1480,3120,1.0,3,7,930,550.0,1914,1000,3780,39513 days 16:47:18.675850,287,1.3333333333333333,1.690909090909091,480,-660,380.0
189000.0,3,1.0,860,5200,1.0,5,6,860,0.0,1969,1010,5200,19424 days 16:47:18.675850,050,3.0,0.0,-150,0,860.0
726500.0,4,2.5,2180,3893,2.0,3,8,2180,0.0,1999,1710,4550,8467 days 16:47:18.675850,342,1.6,0.0,470,-657,2180.0
287000.0,3,2.0,1300,11374,1.5,5,7,1300,0.0,1933,1480,9670,32573 days 16:47:18.675850,170,1.5,0.0,-180,1704,1300.0
679000.0,4,3.5,3420,49223,2.0,3,9,3420,0.0,2004,3580,49223,6641 days 16:47:18.675850,260,1.1428571428571428,0.0,-160,0,3420.0
498000.0,4,2.5,2300,22445,2.0,4,8,2300,0.0,1992,2640,21886,11024 days 16:47:18.675850,117,1.6,0.0,-340,559,2300.0
448000.0,4,1.75,2560,8270,1.0,3,7,1480,1080.0,1979,2320,8450,15772 days 16:47:18.675850,280,2.2857142857142856,1.3703703703703705,240,-180,400.0
535000.0,2,1.0,1040,5527,1.0,3,7,1040,0.0,1951,2080,7020,25999 days 16:47:18.675850,147,2.0,0.0,-1040,-1493,1040.0
560000.0,4,3.0,3080,9601,2.0,3,1,3080,0.0,1990,3200,9375,11754 days 16:47:18.675850,016,1.3333333333333333,0.0,-120,226,3080.0
437850.0,4,2.25,2670,14255,1.0,4,8,1610,1060.0,1975,2470,10290,17233 days 16:47:18.675850,275,1.7777777777777777,1.5188679245283019,200,3965,550.0
435000.0,4,2.75,3270,50994,2.0,4,8,2720,550.0,1983,2780,36036,14311 days 16:47:18.675850,157,1.4545454545454546,4.945454545454545,490,14958,2170.0
510000.0,4,2.5,2610,8031,2.0,3,8,2610,0.0,1998,2320,8031,8832 days 16:47:18.675850,170,1.6,0.0,290,0,2610.0
520000.0,3,2.5,2460,54885,2.0,4,8,2460,0.0,1980,2770,21407,15407 days 16:47:18.675850,126,1.2,0.0,-310,33478,2460.0
509000.0,2,1.5,1930,3521,2.0,3,8,1930,0.0,1989,1840,3576,12119 days 16:47:18.675850,184,1.3333333333333333,0.0,90,-55,1930.0
575000.0,3,1.0,1220,5652,1.0,3,6,1220,0.0,1905,1490,2467,42800 days 16:47:18.675850,096,3.0,0.0,-270,3185,1220.0
795000.0,3,2.0,2420,17859,1.0,5,9,1500,920.0,1979,2955,17859,15772 days 16:47:18.675850,163,1.5,1.6304347826086956,-535,0,580.0
285000.0,3,2.5,1870,4060,2.0,3,7,1870,0.0,2005,2190,4060,6275 days 16:47:18.675850,162,1.2,0.0,-320,0,1870.0
955000.0,3,2.25,3020,43560,2.0,3,1,2720,300.0,1969,3910,43560,19424 days 16:47:18.675850,153,1.3333333333333333,9.066666666666666,-890,0,2420.0
775000.0,4,2.5,2880,8400,2.0,3,8,2050,830.0,1955,2880,7440,24538 days 16:47:18.675850,195,1.6,2.4698795180722892,0,960,1220.0
400000.0,4,3.0,1810,5012,2.0,4,7,1810,0.0,1997,1670,5161,9197 days 16:47:18.676848,279,1.3333333333333333,0.0,140,-149,1810.0
570000.0,4,2.5,2590,8483,2.0,3,9,2590,0.0,1991,2660,8717,11389 days 16:47:18.676848,182,1.6,0.0,-70,-234,2590.0
955990.0,5,3.25,3830,6507,2.0,3,9,3830,0.0,2014,3950,6723,2988 days 16:47:18.676848,293,1.5384615384615385,0.0,-120,-216,3830.0
1150000.0,3,2.25,3250,34848,1.0,3,1,2260,990.0,2006,2770,21512,5910 days 16:47:18.676848,272,1.3333333333333333,2.282828282828283,480,13336,1270.0
459950.0,4,2.0,2760,21465,1.0,4,9,2120,640.0,1979,2550,13144,15772 days 16:47:18.676848,104,2.0,3.3125,210,8321,1480.0
245000.0,2,1.75,1220,8382,1.0,3,6,1220,0.0,1942,1100,8382,29286 days 16:47:18.676848,050,1.1428571428571428,0.0,120,0,1220.0
281000.0,3,1.5,1280,974,3.0,3,7,1280,0.0,2003,1420,1422,7006 days 16:47:18.676848,251,2.0,0.0,-140,-448,1280.0
205000.0,3,0.75,770,7000,1.0,3,4,770,0.0,1942,950,10500,29286 days 16:47:18.676848,295,4.0,0.0,-180,-3500,770.0
290000.0,3,1.75,1520,15090,1.0,4,7,1520,0.0,1968,1580,18618,19790 days 16:47:18.676848,162,1.7142857142857142,0.0,-60,-3528,1520.0
635000.0,4,2.5,2080,11176,1.0,5,8,2080,0.0,1954,1390,7928,24903 days 16:47:18.676848,057,1.6,0.0,690,3248,2080.0
310000.0,1,1.0,570,6000,1.0,2,5,570,0.0,1918,1530,6000,38052 days 16:47:18.676848,246,1.0,0.0,-960,0,570.0
470000.0,4,2.0,1500,3659,1.0,3,7,830,670.0,1906,1560,3706,42435 days 16:47:18.676848,014,2.0,1.2388059701492538,-60,-47,160.0
600000.0,2,2.5,2510,14878,2.0,3,1,2510,0.0,1990,3080,13594,11754 days 16:47:18.676848,182,0.8,0.0,-570,1284,2510.0
279000.0,4,2.0,1980,10051,1.0,3,7,1980,0.0,1969,1520,10125,19424 days 16:47:18.676848,351,2.0,0.0,460,-74,1980.0
538500.0,3,3.5,2500,4270,2.0,3,8,2500,0.0,2000,2420,4205,8102 days 16:47:18.676848,216,0.8571428571428571,0.0,80,65,2500.0
594950.0,4,2.5,2720,10006,2.0,3,9,2720,0.0,1989,2720,10759,12119 days 16:47:18.676848,190,1.6,0.0,0,-753,2720.0
533050.0,2,1.0,910,295772,1.0,3,5,910,0.0,1953,2050,48351,25268 days 16:47:18.676848,220,2.0,0.0,-1140,247421,910.0
510000.0,3,1.75,1480,7040,1.0,3,7,1480,0.0,1974,2040,7810,17598 days 16:47:18.676848,157,1.7142857142857142,0.0,-560,-770,1480.0
360000.0,4,2.25,2470,8686,1.0,4,7,1270,1200.0,1974,1900,7350,17598 days 16:47:18.676848,272,1.7777777777777777,1.0583333333333333,570,1336,70.0
435000.0,2,1.0,1650,5106,1.0,3,7,1090,560.0,1960,1300,6947,22712 days 16:47:18.676848,202,2.0,1.9464285714285714,350,-1841,530.0
559000.0,3,1.75,1700,6500,1.0,3,8,1700,0.0,1967,1880,6000,20155 days 16:47:18.676848,083,1.7142857142857142,0.0,-180,500,1700.0
645000.0,2,1.5,1995,115670,1.5,4,8,1995,0.0,1991,2142,29375,11389 days 16:47:18.676848,239,1.3333333333333333,0.0,-147,86295,1995.0
340000.0,2,1.0,1280,9690,1.0,4,6,640,640.0,1919,1630,15884,37687 days 16:47:18.676848,301,2.0,1.0,-350,-6194,0.0
565000.0,4,2.5,2980,10459,2.0,3,9,2980,0.0,2001,2920,7700,7736 days 16:47:18.676848,071,1.6,0.0,60,2759,2980.0
575700.0,3,1.75,1730,6130,1.0,3,7,1480,250.0,1941,1730,6131,29651 days 16:47:18.676848,044,1.7142857142857142,5.92,0,-1,1230.0
1010000.0,3,3.25,2420,1923,2.0,3,1,1840,580.0,2006,1840,2890,5910 days 16:47:18.676848,168,0.9230769230769231,3.1724137931034484,580,-967,1260.0
540500.0,3,2.0,2800,185130,1.0,3,8,2320,480.0,1996,2200,72055,9563 days 16:47:18.676848,191,1.5,4.833333333333333,600,113075,1840.0
265000.0,5,4.0,1400,8580,1.0,5,7,900,500.0,1954,1220,8832,24903 days 16:47:18.676848,230,1.25,1.8,180,-252,400.0
699950.0,4,2.0,2070,7830,1.0,5,7,1180,890.0,1941,2390,7830,29651 days 16:47:18.676848,223,2.0,1.3258426966292134,-320,0,290.0
355000.0,1,1.75,750,20339,1.0,4,4,550,200.0,1946,2020,23958,27825 days 16:47:18.676848,162,0.5714285714285714,2.75,-1270,-3619,350.0
381000.0,3,1.5,1460,11407,1.0,3,7,1460,0.0,1954,1470,11407,24903 days 16:47:18.676848,162,2.0,0.0,-10,0,1460.0
564000.0,5,2.25,2140,8700,1.0,3,8,1220,920.0,1962,1720,6670,21981 days 16:47:18.676848,104,2.2222222222222223,1.326086956521739,420,2030,300.0
114975.0,2,1.0,740,6250,1.0,3,6,740,0.0,1942,980,6957,29286 days 16:47:18.676848,191,2.0,0.0,-240,-707,740.0
325000.0,1,0.75,410,8636,1.0,2,4,410,0.0,1953,1190,8636,25268 days 16:47:18.676848,030,1.3333333333333333,0.0,-780,0,410.0
299990.0,2,1.0,1570,125452,1.0,4,7,1570,0.0,1953,1660,46119,25268 days 16:47:18.676848,300,2.0,0.0,-90,79333,1570.0
751000.0,5,2.75,2860,5280,2.0,3,9,2860,0.0,2006,3150,6442,5910 days 16:47:18.676848,133,1.8181818181818181,0.0,-290,-1162,2860.0
425000.0,3,2.25,1400,6970,2.0,3,8,1400,0.0,1984,1800,8140,13946 days 16:47:18.676848,365,1.3333333333333333,0.0,-400,-1170,1400.0
665000.0,3,1.75,2700,5040,1.0,3,8,1560,1140.0,1947,3010,5000,27460 days 16:47:18.676848,014,1.7142857142857142,1.368421052631579,-310,40,420.0
833450.0,5,4.0,4460,269345,2.0,3,9,3330,1130.0,1996,2670,115434,9563 days 16:47:18.676848,084,1.25,2.9469026548672566,1790,153911,2200.0
575000.0,7,1.5,2670,11250,1.5,4,8,2320,350.0,1948,2030,9000,27095 days 16:47:18.676848,301,4.666666666666667,6.628571428571429,640,2250,1970.0
190000.0,3,1.75,1520,9600,1.0,4,7,1520,0.0,1967,1590,10183,20155 days 16:47:18.676848,329,1.7142857142857142,0.0,-70,-583,1520.0
314950.0,3,1.75,1520,9600,1.0,4,7,1520,0.0,1967,1590,10183,20155 days 16:47:18.676848,054,1.7142857142857142,0.0,-70,-583,1520.0
601150.0,2,2.0,1660,5200,1.0,5,7,1120,540.0,1906,1260,5160,42435 days 16:47:18.676848,337,1.0,2.074074074074074,400,40,580.0
315000.0,2,1.0,860,8308,1.0,3,7,860,0.0,1948,1200,8308,27095 days 16:47:18.676848,346,2.0,0.0,-340,0,860.0
545000.0,2,1.5,2340,13380,1.0,4,7,1280,1060.0,1954,1490,8100,24903 days 16:47:18.676848,092,1.3333333333333333,1.2075471698113207,850,5280,220.0
565000.0,4,2.25,2110,10698,2.0,4,8,2110,0.0,1979,2220,8252,15772 days 16:47:18.676848,139,1.7777777777777777,0.0,-110,2446,2110.0
175000.0,3,1.0,1010,7034,1.0,3,7,1010,0.0,1954,1440,10994,24903 days 16:47:18.676848,126,3.0,0.0,-430,-3960,1010.0
530000.0,3,2.0,2330,26571,2.5,3,8,2330,0.0,1987,2030,20037,12850 days 16:47:18.676848,177,1.5,0.0,300,6534,2330.0
4490000.0,4,3.0,6430,27517,2.0,3,1,6430,0.0,2001,3720,14592,7736 days 16:47:18.676848,169,1.3333333333333333,0.0,2710,12925,6430.0
430000.0,3,1.75,1610,7900,1.0,4,8,1310,300.0,1960,2210,7700,22712 days 16:47:18.676848,280,1.7142857142857142,4.366666666666666,-600,200,1010.0
225000.0,3,1.75,1460,8372,1.0,4,7,1460,0.0,1981,1220,7803,15041 days 16:47:18.676848,303,1.7142857142857142,0.0,240,569,1460.0
312000.0,5,4.0,2900,9779,2.0,4,7,1950,950.0,1937,1360,8000,31112 days 16:47:18.676848,198,1.25,2.0526315789473686,1540,1779,1000.0
380000.0,3,1.0,1260,7980,1.0,3,7,1260,0.0,1951,1760,7606,25999 days 16:47:18.676848,061,3.0,0.0,-500,374,1260.0
222200.0,2,1.0,1210,10000,1.0,3,7,1210,0.0,1953,1620,10959,25268 days 16:47:18.676848,107,2.0,0.0,-410,-959,1210.0
1440000.0,5,3.5,3420,8000,2.0,3,1,3420,0.0,2006,1900,8000,5910 days 16:47:18.676848,335,1.4285714285714286,0.0,1520,0,3420.0
329950.0,4,2.5,2120,4558,2.0,3,7,2120,0.0,2002,2370,5506,7371 days 16:47:18.676848,183,1.6,0.0,-250,-948,2120.0
995000.0,3,2.5,2460,10300,1.0,3,1,2460,0.0,1992,2410,5250,11024 days 16:47:18.676848,266,1.2,0.0,50,5050,2460.0
929950.0,3,3.5,3790,10829,2.0,3,1,3790,0.0,1993,3620,10989,10658 days 16:47:18.676848,195,0.8571428571428571,0.0,170,-160,3790.0
692000.0,4,2.5,2350,9779,1.0,3,1,2350,0.0,1987,2700,10441,12850 days 16:47:18.676848,086,1.6,0.0,-350,-662,2350.0
402000.0,2,1.0,620,2475,1.0,5,6,620,0.0,1911,1290,2475,40609 days 16:47:18.676848,177,2.0,0.0,-670,0,620.0
510000.0,3,1.75,1920,43560,1.0,4,7,1340,580.0,1962,2540,58806,21981 days 16:47:18.676848,255,1.7142857142857142,2.310344827586207,-620,-15246,760.0
249000.0,3,1.0,1050,8498,1.0,4,7,1050,0.0,1959,1050,8498,23077 days 16:47:18.676848,170,3.0,0.0,0,0,1050.0
244900.0,3,1.5,1360,9980,1.0,4,7,1360,0.0,1966,1360,9750,20520 days 16:47:18.676848,336,2.0,0.0,0,230,1360.0
552500.0,4,1.0,1560,7980,1.0,4,7,1170,390.0,1939,1570,7980,30382 days 16:47:18.676848,090,4.0,3.0,-10,0,780.0
760000.0,4,2.5,3300,165528,2.0,3,8,3300,0.0,1984,3030,144696,13946 days 16:47:18.676848,181,1.6,0.0,270,20832,3300.0
440000.0,2,2.75,1100,1088,2.0,3,7,750,350.0,2006,2090,4125,5910 days 16:47:18.676848,300,0.7272727272727273,2.142857142857143,-990,-3037,400.0
286000.0,3,1.75,1770,9000,1.0,3,7,1090,680.0,1954,1520,21141,24903 days 16:47:18.676848,213,1.7142857142857142,1.6029411764705883,250,-12141,410.0
260000.0,3,1.0,1200,4592,1.0,3,6,800,400.0,1950,940,4440,26364 days 16:47:18.676848,248,3.0,2.0,260,152,400.0
355000.0,2,2.25,1330,10838,2.0,3,8,1330,0.0,1985,1390,10310,13580 days 16:47:18.676848,178,0.8888888888888888,0.0,-60,528,1330.0
318000.0,3,1.75,1570,12506,1.0,4,8,1570,0.0,1959,2120,13243,23077 days 16:47:18.676848,030,1.7142857142857142,0.0,-550,-737,1570.0
255000.0,2,1.0,1610,19965,1.0,3,7,1610,0.0,1952,2100,28400,25634 days 16:47:18.676848,238,2.0,0.0,-490,-8435,1610.0
139000.0,3,1.0,1100,17334,1.0,3,7,1100,0.0,1978,1530,18694,16137 days 16:47:18.676848,134,3.0,0.0,-430,-1360,1100.0
588000.0,3,1.5,1780,4200,1.5,4,8,1780,0.0,1916,1380,3333,38783 days 16:47:18.676848,259,2.0,0.0,400,867,1780.0
975000.0,3,2.5,3050,7410,1.5,5,8,1950,1100.0,1950,1890,5814,26364 days 16:47:18.676848,196,1.2,1.7727272727272727,1160,1596,850.0
402000.0,3,2.0,1540,1827,2.0,3,8,1540,0.0,2005,1540,1827,6275 days 16:47:18.676848,143,1.5,0.0,0,0,1540.0
245000.0,3,1.0,1380,9875,1.0,3,7,1380,0.0,1959,1200,6250,23077 days 16:47:18.676848,121,3.0,0.0,180,3625,1380.0
445000.0,3,1.75,1890,32340,1.5,3,8,1890,0.0,1976,1890,40180,16868 days 16:47:18.676848,167,1.7142857142857142,0.0,0,-7840,1890.0
195000.0,3,1.75,1570,8459,1.0,3,7,1570,0.0,1991,1650,8844,11389 days 16:47:18.676848,145,1.7142857142857142,0.0,-80,-385,1570.0
385000.0,5,2.0,2540,11750,1.0,3,7,1480,1060.0,1962,2000,12000,21981 days 16:47:18.676848,012,2.5,1.3962264150943395,540,-250,420.0
450000.0,3,1.5,1520,7903,1.0,4,7,1000,520.0,1955,1520,9830,24538 days 16:47:18.676848,197,2.0,1.9230769230769231,0,-1927,480.0
1090000.0,4,2.5,2780,6837,2.0,3,9,2780,0.0,2004,1160,6837,6641 days 16:47:18.676848,301,1.6,0.0,1620,0,2780.0
396675.0,2,1.0,1730,6375,2.0,4,6,1730,0.0,1945,1180,6250,28190 days 16:47:18.676848,140,2.0,0.0,550,125,1730.0
242000.0,5,2.25,2340,7494,1.0,3,7,1170,1170.0,1951,1650,10125,25999 days 16:47:18.676848,275,2.2222222222222223,1.0,690,-2631,0.0
380000.0,3,1.75,1300,12378,1.0,4,6,1300,0.0,1943,1300,11596,28921 days 16:47:18.676848,304,1.7142857142857142,0.0,0,782,1300.0
496000.0,2,1.0,1420,4635,2.0,4,7,1420,0.0,1941,1810,4635,29651 days 16:47:18.676848,337,2.0,0.0,-390,0,1420.0
399950.0,3,2.5,1470,4488,2.0,5,7,1470,0.0,1980,1400,4441,15407 days 16:47:18.676848,342,1.2,0.0,70,47,1470.0
895000.0,4,2.5,2850,8526,2.0,3,9,2850,0.0,1998,2440,7072,8832 days 16:47:18.676848,063,1.6,0.0,410,1454,2850.0
270000.0,3,1.5,1610,8375,2.0,3,7,1610,0.0,1927,1610,9107,34765 days 16:47:18.676848,245,2.0,0.0,0,-732,1610.0
349900.0,3,2.0,2420,38781,1.0,5,7,1210,1210.0,1949,2650,88426,26729 days 16:47:18.676848,174,1.5,1.0,-230,-49645,0.0
454280.0,3,2.5,1470,1741,2.0,3,8,1170,300.0,2004,1470,1583,6641 days 16:47:18.676848,124,1.2,3.9,0,158,870.0
390000.0,3,2.5,1410,26375,1.0,3,6,1410,0.0,1992,1410,12474,11024 days 16:47:18.676848,132,1.2,0.0,0,13901,1410.0
275000.0,3,1.75,1840,14005,1.0,3,8,1840,0.0,1983,2170,7992,14311 days 16:47:18.676848,015,1.7142857142857142,0.0,-330,6013,1840.0
300000.0,4,2.5,2450,8932,2.0,3,8,2450,0.0,1990,2410,8775,11754 days 16:47:18.676848,119,1.6,0.0,40,157,2450.0
700000.0,3,1.75,1500,6000,1.0,5,7,850,650.0,1940,1700,6000,30017 days 16:47:18.676848,128,1.7142857142857142,1.3076923076923077,-200,0,200.0
520000.0,3,1.75,2080,6609,1.0,3,7,1280,800.0,1950,1680,6270,26364 days 16:47:18.676848,352,1.7142857142857142,1.6,400,339,480.0
715000.0,3,2.5,2770,39529,2.0,3,9,2770,0.0,1987,3010,35435,12850 days 16:47:18.676848,092,1.2,0.0,-240,4094,2770.0
404000.0,3,2.5,2370,4324,2.0,3,8,2370,0.0,2006,2370,4348,5910 days 16:47:18.676848,110,1.2,0.0,0,-24,2370.0
490500.0,3,2.0,3000,21883,2.0,3,7,1970,1030.0,1998,2280,14025,8832 days 16:47:18.676848,269,1.5,1.912621359223301,720,7858,940.0
1490000.0,6,2.75,4430,6440,2.0,3,1,2680,1750.0,1964,3530,7314,21251 days 16:47:18.676848,126,2.1818181818181817,1.5314285714285714,900,-874,930.0
557800.0,4,1.75,1550,6000,1.0,5,7,1550,0.0,1944,1550,6000,28556 days 16:47:18.676848,099,2.2857142857142856,0.0,0,0,1550.0
571000.0,4,2.25,2290,9900,1.0,4,8,1550,740.0,1959,2320,9900,23077 days 16:47:18.676848,103,1.7777777777777777,2.0945945945945947,-30,0,810.0
410000.0,4,2.5,2560,4020,2.0,3,9,2560,0.0,2006,3010,4916,5910 days 16:47:18.676848,189,1.6,0.0,-450,-896,2560.0
225000.0,3,1.5,1240,5506,1.0,4,7,1240,0.0,1971,1670,5589,18694 days 16:47:18.676848,072,2.0,0.0,-430,-83,1240.0
700000.0,4,2.5,2590,4498,2.0,3,9,2590,0.0,2004,2660,5238,6641 days 16:47:18.676848,197,1.6,0.0,-70,-740,2590.0
500000.0,3,1.0,1370,3500,1.5,3,7,1370,0.0,1905,1590,4500,42800 days 16:47:18.676848,040,3.0,0.0,-220,-1000,1370.0
536500.0,2,2.0,1360,1860,1.0,4,7,680,680.0,1925,1440,5000,35495 days 16:47:18.676848,118,1.0,1.0,-80,-3140,0.0
330000.0,3,2.5,2060,25046,1.0,4,8,1600,460.0,1980,2050,21255,15407 days 16:47:18.676848,100,1.2,3.4782608695652173,10,3791,1140.0
249950.0,3,1.75,1120,15210,1.0,5,7,1120,0.0,1976,1710,8470,16868 days 16:47:18.676848,042,1.7142857142857142,0.0,-590,6740,1120.0
249000.0,4,1.75,1630,8410,1.5,5,7,1630,0.0,1943,1390,8410,28921 days 16:47:18.676848,288,2.2857142857142856,0.0,240,0,1630.0
249000.0,3,1.75,1590,7535,1.5,5,6,1590,0.0,1909,1110,6000,41339 days 16:47:18.676848,098,1.7142857142857142,0.0,480,1535,1590.0
780000.0,4,1.75,2480,9195,1.0,3,7,1390,1090.0,1950,2440,9195,26364 days 16:47:18.676848,128,2.2857142857142856,1.275229357798165,40,0,300.0
1200000.0,4,2.5,2700,4275,2.0,3,9,2700,0.0,2004,1810,4500,6641 days 16:47:18.676848,186,1.6,0.0,890,-225,2700.0
434500.0,3,1.75,1930,7210,1.0,3,7,1110,820.0,1975,1870,7877,17233 days 16:47:18.676848,258,1.7142857142857142,1.353658536585366,60,-667,290.0
590000.0,4,2.0,2490,339332,1.0,3,8,2490,0.0,2002,1910,129373,7371 days 16:47:18.676848,283,2.0,0.0,580,209959,2490.0
417200.0,2,1.0,1000,4000,1.0,3,6,1000,0.0,1910,1490,5000,40974 days 16:47:18.676848,050,2.0,0.0,-490,-1000,1000.0
649990.0,4,2.25,2130,11900,2.0,3,9,2130,0.0,1976,2590,11900,16868 days 16:47:18.676848,267,1.7777777777777777,0.0,-460,0,2130.0
506000.0,2,1.0,1060,3588,1.0,4,7,960,100.0,1926,1570,3741,35130 days 16:47:18.676848,336,2.0,9.6,-510,-153,860.0
348000.0,3,2.5,1730,4004,2.0,3,7,1730,0.0,1999,1730,5523,8467 days 16:47:18.676848,111,1.2,0.0,0,-1519,1730.0
301000.0,4,2.5,2810,6146,2.0,3,9,2810,0.0,1998,2810,6180,8832 days 16:47:18.676848,209,1.6,0.0,0,-34,2810.0
427550.0,2,1.0,880,4000,1.0,3,7,880,0.0,1940,1150,4000,30017 days 16:47:18.676848,189,2.0,0.0,-270,0,880.0
361000.0,3,1.0,1040,6720,1.5,3,7,1040,0.0,1951,1880,11407,25999 days 16:47:18.676848,121,3.0,0.0,-840,-4687,1040.0
460000.0,2,2.5,1830,8107,1.0,5,7,930,900.0,1946,1260,6960,27825 days 16:47:18.676848,233,0.8,1.0333333333333334,570,1147,30.0
958000.0,4,3.5,1800,6400,2.0,3,8,1800,0.0,1984,1700,4736,13946 days 16:47:18.676848,191,1.1428571428571428,0.0,100,1664,1800.0
445000.0,5,1.75,2460,6846,1.5,5,7,1340,1120.0,1911,1410,4800,40609 days 16:47:18.676848,163,2.857142857142857,1.1964285714285714,1050,2046,220.0
373000.0,3,2.5,1670,3565,2.0,3,7,1670,0.0,1999,1510,3770,8467 days 16:47:18.676848,139,1.2,0.0,160,-205,1670.0
525000.0,4,2.25,2660,7957,1.0,4,8,1750,910.0,1977,1890,8250,16502 days 16:47:18.676848,104,1.7777777777777777,1.9230769230769231,770,-293,840.0
364988.0,3,2.5,2850,12593,2.0,3,9,2850,0.0,1997,2850,9435,9197 days 16:47:18.676848,238,1.2,0.0,0,3158,2850.0
324000.0,2,1.0,820,8370,1.0,4,7,820,0.0,1941,1410,8370,29651 days 16:47:18.676848,226,2.0,0.0,-590,0,820.0
625000.0,4,3.0,2350,5627,1.0,5,8,1490,860.0,1960,2020,5627,22712 days 16:47:18.676848,064,1.3333333333333333,1.7325581395348837,330,0,630.0
237500.0,3,1.75,1480,7830,1.0,3,7,1480,0.0,1980,1130,7553,15407 days 16:47:18.676848,251,1.7142857142857142,0.0,350,277,1480.0
429300.0,6,2.25,2930,15949,1.0,4,8,1730,1200.0,1965,1730,8550,20885 days 16:47:18.676848,218,2.6666666666666665,1.4416666666666667,1200,7399,530.0
155000.0,3,1.0,1250,6250,1.0,2,7,1030,220.0,1949,1130,6250,26729 days 16:47:18.676848,149,3.0,4.681818181818182,120,0,810.0
614000.0,4,2.75,2760,8160,1.5,4,8,1780,980.0,1940,2720,8160,30017 days 16:47:18.676848,054,1.4545454545454546,1.816326530612245,40,0,800.0
650000.0,3,2.5,2380,3332,2.0,3,9,2380,0.0,2014,2590,4382,2988 days 16:47:18.676848,090,1.2,0.0,-210,-1050,2380.0
625000.0,3,2.0,1730,12219,1.0,4,7,1730,0.0,1986,2470,13594,13215 days 16:47:18.676848,202,1.5,0.0,-740,-1375,1730.0
587100.0,3,2.25,1670,6414,1.0,4,8,1670,0.0,1961,2130,7035,22346 days 16:47:18.676848,084,1.3333333333333333,0.0,-460,-621,1670.0
380000.0,4,2.5,2150,37647,2.0,3,8,2150,0.0,1991,2410,42193,11389 days 16:47:18.676848,168,1.6,0.0,-260,-4546,2150.0
479500.0,2,1.0,930,5760,1.0,3,6,730,200.0,1917,1970,5760,38417 days 16:47:18.676848,125,2.0,3.65,-1040,0,530.0
382888.0,1,1.0,620,2380,1.0,3,6,620,0.0,1900,980,3570,44626 days 16:47:18.676848,076,1.0,0.0,-360,-1190,620.0
540000.0,4,4.25,1960,3565,2.0,3,7,1960,0.0,1940,1920,5750,30017 days 16:47:18.676848,147,0.9411764705882353,0.0,40,-2185,1960.0
691000.0,4,2.75,2550,8632,1.0,3,8,1700,850.0,1972,2550,9534,18329 days 16:47:18.676848,141,1.4545454545454546,2.0,0,-902,850.0
760500.0,3,2.0,1990,3990,1.0,5,7,1130,860.0,1912,1710,4000,40244 days 16:47:18.676848,155,1.5,1.313953488372093,280,-10,270.0
685000.0,4,2.5,3550,10968,2.0,3,9,3550,0.0,2006,3550,8583,5910 days 16:47:18.676848,120,1.6,0.0,0,2385,3550.0
199129.0,3,1.0,860,33664,1.0,4,6,860,0.0,1955,1290,18287,24538 days 16:47:18.676848,272,3.0,0.0,-430,15377,860.0
335000.0,3,3.0,2031,7702,2.0,3,9,2031,0.0,1988,2390,7700,12485 days 16:47:18.676848,205,1.0,0.0,-359,2,2031.0
305100.0,3,2.0,1590,35988,1.0,4,8,1590,0.0,1974,2780,23789,17598 days 16:47:18.676848,160,1.5,0.0,-1190,12199,1590.0
830000.0,4,2.25,3010,12202,1.0,4,9,3010,0.0,1959,2480,10143,23077 days 16:47:18.676848,084,1.7777777777777777,0.0,530,2059,3010.0
810000.0,3,2.5,2610,8481,2.0,3,1,2610,0.0,1993,3140,10008,10658 days 16:47:18.676848,028,1.2,0.0,-530,-1527,2610.0
500000.0,3,2.25,1440,15661,1.0,3,8,1180,260.0,1988,1440,13963,12485 days 16:47:18.676848,013,1.3333333333333333,4.538461538461538,0,1698,920.0
490000.0,3,1.75,1920,5405,1.0,4,7,960,960.0,1947,1190,5405,27460 days 16:47:18.676848,150,1.7142857142857142,1.0,730,0,0.0
490000.0,2,1.75,1670,4200,2.0,3,7,1670,0.0,1912,1340,2875,40244 days 16:47:18.676848,301,1.1428571428571428,0.0,330,1325,1670.0
272000.0,4,1.75,1390,10660,1.0,4,7,1030,360.0,1960,1800,11960,22712 days 16:47:18.676848,261,2.2857142857142856,2.861111111111111,-410,-1300,670.0
280000.0,3,2.25,2140,7200,2.0,4,7,2140,0.0,1979,1890,7455,15772 days 16:47:18.676848,253,1.3333333333333333,0.0,250,-255,2140.0
233000.0,3,1.0,1250,6180,1.5,3,7,1250,0.0,1955,1490,6180,24538 days 16:47:18.676848,176,3.0,0.0,-240,0,1250.0
275000.0,3,1.0,1080,6000,1.0,4,7,1080,0.0,1952,1200,7210,25634 days 16:47:18.676848,174,3.0,0.0,-120,-1210,1080.0
375000.0,3,3.25,2760,6420,2.0,3,9,2110,650.0,1991,2030,7725,11389 days 16:47:18.676848,209,0.9230769230769231,3.246153846153846,730,-1305,1460.0
445000.0,3,2.75,2180,3703,2.0,3,8,2180,0.0,2004,2190,3963,6641 days 16:47:18.676848,238,1.0909090909090908,0.0,-10,-260,2180.0
437500.0,3,2.5,1260,1125,3.0,3,8,1260,0.0,2002,1360,1250,7371 days 16:47:18.676848,262,1.2,0.0,-100,-125,1260.0
426250.0,4,1.0,1610,6000,1.5,4,7,1510,100.0,1905,1430,6000,42800 days 16:47:18.676848,131,4.0,15.1,180,0,1410.0
358000.0,3,1.5,2450,12497,1.0,4,7,2450,0.0,1967,1560,11700,20155 days 16:47:18.676848,177,2.0,0.0,890,797,2450.0
1180000.0,4,3.5,4150,49503,2.0,3,1,4150,0.0,2003,3330,60137,7006 days 16:47:18.676848,296,1.1428571428571428,0.0,820,-10634,4150.0
305000.0,2,1.0,960,8276,1.0,3,5,960,0.0,1939,1620,6000,30382 days 16:47:18.676848,120,2.0,0.0,-660,2276,960.0
415000.0,2,1.75,1340,4664,1.0,3,8,1340,0.0,2004,1350,4236,6641 days 16:47:18.676848,150,1.1428571428571428,0.0,-10,428,1340.0
520000.0,11,3.0,3000,4960,2.0,3,7,2400,600.0,1918,1420,4960,38052 days 16:47:18.676848,233,3.6666666666666665,4.0,1580,0,1800.0
733000.0,4,3.5,3080,5974,2.0,3,9,3080,0.0,2003,2950,5425,7006 days 16:47:18.676848,286,1.1428571428571428,0.0,130,549,3080.0
411500.0,3,1.0,1130,8159,1.0,4,7,1130,0.0,1954,1570,8162,24903 days 16:47:18.676848,068,3.0,0.0,-440,-3,1130.0
540000.0,3,1.75,2280,16671,1.5,4,6,1760,520.0,1909,1850,9351,41339 days 16:47:18.676848,262,1.7142857142857142,3.3846153846153846,430,7320,1240.0
270500.0,3,1.5,1952,8613,1.0,4,7,1652,300.0,1960,1400,8712,22712 days 16:47:18.676848,055,2.0,5.506666666666667,552,-99,1352.0
422250.0,2,1.5,1280,1256,2.0,3,8,1200,80.0,1998,1390,1256,8832 days 16:47:18.676848,100,1.3333333333333333,15.0,-110,0,1120.0
655000.0,5,3.25,3690,12353,2.0,5,9,3690,0.0,1977,2290,9082,16502 days 16:47:18.676848,136,1.5384615384615385,0.0,1400,3271,3690.0
1200000.0,5,3.25,4610,10576,2.0,3,1,3310,1300.0,2006,4042,8321,5910 days 16:47:18.676848,219,1.5384615384615385,2.546153846153846,568,2255,2010.0
550000.0,3,2.5,2920,169448,2.5,3,9,2920,0.0,1990,2360,326097,11754 days 16:47:18.676848,216,1.2,0.0,560,-156649,2920.0
460000.0,2,2.25,1230,929,2.0,3,8,1020,210.0,2004,1270,1370,6641 days 16:47:18.676848,126,0.8888888888888888,4.857142857142857,-40,-441,810.0
159075.0,4,1.5,1580,6200,1.0,3,6,790,790.0,1944,1320,6499,28556 days 16:47:18.676848,298,2.6666666666666665,1.0,260,-299,0.0
470000.0,2,1.0,1220,4000,1.5,4,6,1220,0.0,1908,1580,4000,41705 days 16:47:18.676848,343,2.0,0.0,-360,0,1220.0
235000.0,2,1.0,1020,7920,1.0,3,6,1020,0.0,1939,1530,6900,30382 days 16:47:18.676848,189,2.0,0.0,-510,1020,1020.0
309950.0,2,1.5,1510,9843,1.0,4,7,1510,0.0,1961,1590,9368,22346 days 16:47:18.676848,261,1.3333333333333333,0.0,-80,475,1510.0
433000.0,4,1.75,1830,9600,1.0,4,7,1010,820.0,1966,1910,11100,20520 days 16:47:18.676848,143,2.2857142857142856,1.2317073170731707,-80,-1500,190.0
895000.0,3,2.5,2750,10000,1.0,3,8,1650,1100.0,1967,2490,10000,20155 days 16:47:18.676848,034,1.2,1.5,260,0,550.0
291000.0,3,1.5,1860,60960,1.0,4,7,1140,720.0,1967,2170,82764,20155 days 16:47:18.676848,171,2.0,1.5833333333333333,-310,-21804,420.0
835000.0,3,2.5,2720,13124,2.0,3,9,2720,0.0,1988,2760,16200,12485 days 16:47:18.676848,040,1.2,0.0,-40,-3076,2720.0
640000.0,2,1.0,1360,5000,1.0,3,7,1200,160.0,1936,1540,4000,31478 days 16:47:18.676848,009,2.0,7.5,-180,1000,1040.0
438000.0,3,2.25,2340,14279,1.0,3,8,1340,1000.0,1965,2340,13600,20885 days 16:47:18.676848,026,1.3333333333333333,1.34,0,679,340.0
325000.0,4,2.5,2090,7434,1.0,3,7,1090,1000.0,1993,1260,8404,10658 days 16:47:18.676848,068,1.6,1.09,830,-970,90.0
380000.0,4,1.75,2260,7200,1.5,5,7,1360,900.0,1924,1410,7465,35861 days 16:47:18.676848,026,2.2857142857142856,1.511111111111111,850,-265,460.0
510000.0,2,1.0,1390,5544,1.0,3,7,930,460.0,1947,1710,6200,27460 days 16:47:18.676848,317,2.0,2.0217391304347827,-320,-656,470.0
380000.0,4,2.5,2300,7707,2.0,3,8,2300,0.0,2004,2320,6035,6641 days 16:47:18.676848,224,1.6,0.0,-20,1672,2300.0
825000.0,4,2.5,2810,9800,1.0,4,8,1710,1100.0,1973,2800,9800,17963 days 16:47:18.676848,167,1.6,1.5545454545454545,10,0,610.0
880000.0,4,3.25,4060,52707,2.0,4,9,4060,0.0,1996,3100,50755,9563 days 16:47:18.676848,269,1.2307692307692308,0.0,960,1952,4060.0
1800000.0,3,3.0,2790,13295,2.0,4,1,2370,420.0,1933,3140,11949,32573 days 16:47:18.676848,065,1.0,5.642857142857143,-350,1346,1950.0
790000.0,3,1.0,1290,6380,1.5,3,7,1290,0.0,1930,1630,6380,33669 days 16:47:18.676848,007,3.0,0.0,-340,0,1290.0
287000.0,2,1.5,720,4346,1.0,4,6,720,0.0,1942,790,4346,29286 days 16:47:18.676848,346,1.3333333333333333,0.0,-70,0,720.0
509000.0,3,3.0,2130,5000,1.5,3,7,1570,560.0,1913,1638,4500,39878 days 16:47:18.676848,255,1.0,2.8035714285714284,492,500,1010.0
270000.0,3,2.25,1750,8400,1.0,3,7,1350,400.0,1965,2020,9110,20885 days 16:47:18.676848,251,1.3333333333333333,3.375,-270,-710,950.0
210000.0,3,2.0,960,9380,1.0,3,6,960,0.0,1949,1460,9240,26729 days 16:47:18.676848,189,1.5,0.0,-500,140,960.0
415000.0,3,1.0,1570,11752,1.5,5,8,1570,0.0,1930,2010,8291,33669 days 16:47:18.676848,328,3.0,0.0,-440,3461,1570.0
550000.0,3,2.5,3070,14400,1.0,5,9,1720,1350.0,1985,2020,18211,13580 days 16:47:18.676848,339,1.2,1.2740740740740741,1050,-3811,370.0
1250000.0,4,2.5,2920,5500,1.0,3,1,2030,890.0,1957,3790,5500,23807 days 16:47:18.676848,190,1.6,2.2808988764044944,-870,0,1140.0
499950.0,3,1.0,1870,4984,1.0,3,7,1120,750.0,1955,1650,5750,24538 days 16:47:18.676848,213,3.0,1.4933333333333334,220,-766,370.0
659000.0,3,1.5,1540,5040,2.0,3,8,1540,0.0,1907,1590,3600,42070 days 16:47:18.676848,248,2.0,0.0,-50,1440,1540.0
265000.0,2,1.5,1440,22081,2.0,3,7,1440,0.0,1990,1440,19544,11754 days 16:47:18.676848,061,1.3333333333333333,0.0,0,2537,1440.0
492000.0,4,3.75,2810,10840,2.0,4,8,2070,740.0,1994,2370,11248,10293 days 16:47:18.676848,156,1.0666666666666667,2.7972972972972974,440,-408,1330.0
715000.0,4,2.5,2450,7700,1.0,3,8,1250,1200.0,1958,2450,8000,23442 days 16:47:18.676848,225,1.6,1.0416666666666667,0,-300,50.0
175000.0,2,1.0,1330,28270,1.5,3,6,1330,0.0,1925,1210,6926,35495 days 16:47:18.676848,072,2.0,0.0,120,21344,1330.0
975000.0,4,3.5,3130,52322,2.0,3,9,2430,700.0,2011,3200,5820,4084 days 16:47:18.676848,332,1.1428571428571428,3.4714285714285715,-70,46502,1730.0
306950.0,1,1.0,730,5005,1.0,4,5,730,0.0,1945,1630,5667,28190 days 16:47:18.676848,282,1.0,0.0,-900,-662,730.0
367500.0,3,1.0,1270,8792,1.0,5,7,1270,0.0,1969,1780,8792,19424 days 16:47:18.676848,009,3.0,0.0,-510,0,1270.0
699950.0,3,3.25,2230,5460,1.0,4,8,1430,800.0,1977,2070,5600,16502 days 16:47:18.676848,084,0.9230769230769231,1.7875,160,-140,630.0
1000000.0,3,3.0,2880,3750,2.0,3,9,2220,660.0,1909,1910,4000,41339 days 16:47:18.676848,106,1.0,3.3636363636363638,970,-250,1560.0
285000.0,4,2.5,2434,4400,2.0,3,8,2434,0.0,2007,2434,4400,5545 days 16:47:18.676848,289,1.6,0.0,0,0,2434.0
215000.0,2,1.5,1120,1312,2.0,3,7,1000,120.0,2004,1560,1314,6641 days 16:47:18.676848,014,1.3333333333333333,8.333333333333334,-440,-2,880.0
1050000.0,4,2.5,4080,11054,2.0,3,1,4080,0.0,2001,3520,11914,7736 days 16:47:18.676848,065,1.6,0.0,560,-860,4080.0
1370000.0,4,2.75,3720,9450,1.0,5,1,1960,1760.0,1962,2900,8605,21981 days 16:47:18.676848,129,1.4545454545454546,1.1136363636363635,820,845,200.0
235000.0,3,1.0,1430,7599,1.5,4,6,1010,420.0,1930,1290,10320,33669 days 16:47:18.676848,091,3.0,2.4047619047619047,140,-2721,590.0
604000.0,3,2.0,1560,2589,1.0,3,7,790,770.0,1923,1450,3893,36226 days 16:47:18.676848,106,1.5,1.025974025974026,110,-1304,20.0
750000.0,3,1.75,1700,8400,1.0,3,8,1460,240.0,1947,2010,7000,27460 days 16:47:18.676848,150,1.7142857142857142,6.083333333333333,-310,1400,1220.0
800000.0,4,2.25,2510,9963,1.0,4,9,2200,310.0,1967,3110,9963,20155 days 16:47:18.676848,328,1.7777777777777777,7.096774193548387,-600,0,1890.0
580000.0,5,2.0,2600,3750,1.5,4,6,1400,1200.0,1914,1700,3750,39513 days 16:47:18.676848,007,2.5,1.1666666666666667,900,0,200.0
350000.0,1,1.0,790,4590,1.0,3,6,790,0.0,1911,1070,4590,40609 days 16:47:18.676848,338,1.0,0.0,-280,0,790.0
353750.0,4,2.0,1710,7490,2.0,3,7,1320,390.0,1956,1880,7704,24173 days 16:47:18.676848,350,2.0,3.3846153846153846,-170,-214,930.0
1100000.0,5,2.75,2660,8737,1.0,5,8,1470,1190.0,1969,3280,8783,19424 days 16:47:18.676848,155,1.8181818181818181,1.2352941176470589,-620,-46,280.0
465000.0,4,2.0,1470,10291,1.0,4,7,1470,0.0,1963,1460,9601,21616 days 16:47:18.676848,040,2.0,0.0,10,690,1470.0
568000.0,3,2.0,2350,5080,1.5,3,8,1780,570.0,1929,1700,5080,34034 days 16:47:18.676848,127,1.5,3.1228070175438596,650,0,1210.0
1010000.0,5,2.0,2440,3080,2.0,4,8,2440,0.0,1910,1640,3077,40974 days 16:47:18.676848,310,2.5,0.0,800,3,2440.0
213500.0,3,1.5,1150,11571,1.0,3,7,1150,0.0,1961,1630,11571,22346 days 16:47:18.676848,259,2.0,0.0,-480,0,1150.0
250000.0,3,2.5,1510,10384,1.0,2,7,1030,480.0,1976,1490,10000,16868 days 16:47:18.676848,156,1.2,2.1458333333333335,20,384,550.0
357000.0,2,1.0,870,4600,1.0,4,7,870,0.0,1942,930,4600,29286 days 16:47:18.676848,184,2.0,0.0,-60,0,870.0
425000.0,2,2.0,1280,4095,2.0,4,8,1280,0.0,1918,1470,5500,38052 days 16:47:18.676848,269,1.0,0.0,-190,-1405,1280.0
571000.0,3,2.5,2600,7465,2.0,3,9,2600,0.0,1988,2660,7683,12485 days 16:47:18.676848,162,1.2,0.0,-60,-218,2600.0
588000.0,3,2.25,2030,7350,1.0,4,7,1190,840.0,1977,1950,7350,16502 days 16:47:18.676848,139,1.3333333333333333,1.4166666666666667,80,0,350.0
275000.0,4,1.5,1930,15531,2.0,3,7,1930,0.0,1979,1580,7800,15772 days 16:47:18.676848,143,2.6666666666666665,0.0,350,7731,1930.0
565000.0,3,2.75,3210,15939,2.0,3,1,3210,0.0,1998,2870,15939,8832 days 16:47:18.676848,056,1.0909090909090908,0.0,340,0,3210.0
460000.0,3,1.75,1970,9135,1.0,4,7,1370,600.0,1961,1880,9650,22346 days 16:47:18.676848,078,1.7142857142857142,2.283333333333333,90,-515,770.0
603500.0,4,2.5,4060,9734,1.0,3,9,2150,1910.0,1977,2750,10370,16502 days 16:47:18.676848,155,1.6,1.12565445026178,1310,-636,240.0
490600.0,3,2.5,3316,11447,2.0,3,9,3316,0.0,1986,3000,11447,13215 days 16:47:18.676848,184,1.2,0.0,316,0,3316.0
1010000.0,2,2.0,1460,9052,1.0,5,6,1460,0.0,1900,2554,7834,44626 days 16:47:18.676848,175,1.0,0.0,-1094,1218,1460.0
500000.0,4,2.0,2100,12620,1.0,4,7,2100,0.0,1972,1720,7840,18329 days 16:47:18.676848,239,2.0,0.0,380,4780,2100.0
249000.0,4,2.25,1830,6136,2.0,3,7,1830,0.0,1990,1830,7664,11754 days 16:47:18.676848,176,1.7777777777777777,0.0,0,-1528,1830.0
235000.0,3,2.0,1530,8700,1.0,4,7,1530,0.0,1970,1960,7600,19059 days 16:47:18.676848,154,1.5,0.0,-430,1100,1530.0
410000.0,4,2.0,1490,13736,1.0,4,6,1490,0.0,1942,2040,7200,29286 days 16:47:18.676848,021,2.0,0.0,-550,6536,1490.0
370000.0,2,1.0,860,6050,1.0,3,7,860,0.0,1952,1130,6050,25634 days 16:47:18.676848,182,2.0,0.0,-270,0,860.0
360000.0,5,2.5,2130,7111,1.0,3,7,1330,800.0,1968,1840,7592,19790 days 16:47:18.676848,259,2.0,1.6625,290,-481,530.0
1410000.0,5,2.25,3580,16789,2.0,5,9,3580,0.0,1966,3390,17000,20520 days 16:47:18.676848,339,2.2222222222222223,0.0,190,-211,3580.0
298000.0,4,2.5,2420,3825,2.0,3,8,2420,0.0,2003,1880,4250,7006 days 16:47:18.676848,325,1.6,0.0,540,-425,2420.0
485000.0,4,2.25,1900,7200,1.0,3,8,1370,530.0,1977,2030,8008,16502 days 16:47:18.676848,189,1.7777777777777777,2.5849056603773586,-130,-808,840.0
400000.0,3,1.75,1330,9143,1.0,3,7,1330,0.0,1960,1950,10384,22712 days 16:47:18.676848,238,1.7142857142857142,0.0,-620,-1241,1330.0
580000.0,3,2.5,2150,4604,2.0,3,8,2150,0.0,2003,2280,4253,7006 days 16:47:18.676848,217,1.2,0.0,-130,351,2150.0
355000.0,2,2.5,1370,1140,2.0,3,8,1080,290.0,2009,1340,1050,4814 days 16:47:18.676848,219,0.8,3.7241379310344827,30,90,790.0
650000.0,3,2.5,2430,12997,2.0,3,9,2430,0.0,1992,2720,12500,11024 days 16:47:18.676848,202,1.2,0.0,-290,497,2430.0
261490.0,4,1.0,1640,8467,1.0,4,6,1220,420.0,1943,1060,7396,28921 days 16:47:18.676848,272,4.0,2.9047619047619047,580,1071,800.0
347000.0,3,1.0,1010,7200,1.0,3,7,1010,0.0,1968,1120,7200,19790 days 16:47:18.676848,197,3.0,0.0,-110,0,1010.0
485000.0,3,1.0,1500,4100,1.5,3,7,1370,130.0,1926,1500,4100,35130 days 16:47:18.676848,139,3.0,10.538461538461538,0,0,1240.0
601000.0,3,2.5,1740,1251,2.0,3,9,1180,560.0,2012,1740,1625,3719 days 16:47:18.676848,295,1.2,2.107142857142857,0,-374,620.0
380000.0,3,3.25,2090,51212,1.0,3,8,1510,580.0,1989,2690,40820,12119 days 16:47:18.676848,101,0.9230769230769231,2.603448275862069,-600,10392,930.0
565000.0,3,3.0,1850,12556,2.0,3,9,1850,0.0,1976,2390,12474,16868 days 16:47:18.676848,241,1.0,0.0,-540,82,1850.0
750000.0,3,2.5,2790,21043,2.0,3,9,2790,0.0,1993,2900,34589,10658 days 16:47:18.676848,082,1.2,0.0,-110,-13546,2790.0
291000.0,3,2.25,1480,7200,1.0,3,7,1190,290.0,1975,1830,7200,17233 days 16:47:18.676848,007,1.3333333333333333,4.103448275862069,-350,0,900.0
560000.0,3,2.5,2280,12498,2.0,4,9,2280,0.0,1987,2330,8844,12850 days 16:47:18.676848,309,1.2,0.0,-50,3654,2280.0
725000.0,4,2.25,3180,9600,2.0,3,1,3180,0.0,1984,2840,10739,13946 days 16:47:18.676848,084,1.7777777777777777,0.0,340,-1139,3180.0
539000.0,3,2.0,2350,209088,1.0,3,7,2350,0.0,1993,2300,209088,10658 days 16:47:18.676848,246,1.5,0.0,50,0,2350.0
470000.0,5,3.25,3910,7077,2.0,3,9,2710,1200.0,2000,2650,7077,8102 days 16:47:18.676848,203,1.5384615384615385,2.2583333333333333,1260,0,1510.0
264950.0,2,1.0,770,7434,1.0,3,6,770,0.0,1947,1060,7453,27460 days 16:47:18.676848,009,2.0,0.0,-290,-19,770.0
200000.0,4,1.5,1780,8000,2.0,4,6,1080,700.0,1900,1750,9147,44626 days 16:47:18.676848,056,2.6666666666666665,1.542857142857143,30,-1147,380.0
453500.0,5,2.5,2300,23345,1.0,5,7,1170,1130.0,1967,2280,23345,20155 days 16:47:18.676848,155,2.0,1.0353982300884956,20,0,40.0
811000.0,2,2.5,2510,17986,2.0,3,9,2510,0.0,1943,2440,8039,28921 days 16:47:18.676848,237,0.8,0.0,70,9947,2510.0
425000.0,3,3.25,1410,1350,3.0,3,8,1410,0.0,2005,1410,1253,6275 days 16:47:18.676848,259,0.9230769230769231,0.0,0,97,1410.0
1530000.0,4,2.25,4250,16940,1.0,4,9,2380,1870.0,1974,3460,17693,17598 days 16:47:18.676848,261,1.7777777777777777,1.2727272727272727,790,-753,510.0
562000.0,4,2.75,2560,83200,1.0,3,8,1860,700.0,1980,1990,38332,15407 days 16:47:18.676848,363,1.4545454545454546,2.657142857142857,570,44868,1160.0
281000.0,3,2.5,1760,7601,2.0,3,8,1760,0.0,1992,1920,6851,11024 days 16:47:18.676848,204,1.2,0.0,-160,750,1760.0
270000.0,3,2.25,2100,14027,2.0,3,8,2100,0.0,1979,2730,5999,15772 days 16:47:18.676848,289,1.3333333333333333,0.0,-630,8028,2100.0
205950.0,3,1.0,1490,8239,1.0,4,6,1490,0.0,1963,1200,8470,21616 days 16:47:18.676848,223,3.0,0.0,290,-231,1490.0
310000.0,2,1.0,870,5400,1.0,3,6,870,0.0,1950,990,5200,26364 days 16:47:18.676848,176,2.0,0.0,-120,200,870.0
350000.0,3,1.75,1260,1111,2.0,3,8,1260,0.0,2003,1410,1630,7006 days 16:47:18.676848,071,1.7142857142857142,0.0,-150,-519,1260.0
843500.0,4,2.0,2630,16475,2.0,4,8,2630,0.0,1953,2670,15001,25268 days 16:47:18.676848,152,2.0,0.0,-40,1474,2630.0
370000.0,4,2.0,1950,3757,1.0,4,6,1160,790.0,1908,1720,3757,41705 days 16:47:18.676848,128,2.0,1.4683544303797469,230,0,370.0
279000.0,4,2.0,2200,7700,1.0,3,7,1100,1100.0,1979,1790,7700,15772 days 16:47:18.676848,171,2.0,1.0,410,0,0.0
408000.0,3,1.75,1600,313672,1.0,4,7,1600,0.0,1960,1780,90860,22712 days 16:47:18.676848,002,1.7142857142857142,0.0,-180,222812,1600.0
392000.0,3,1.0,1230,9600,1.0,3,7,1230,0.0,1952,1510,6600,25634 days 16:47:18.676848,006,3.0,0.0,-280,3000,1230.0
455000.0,2,1.0,1030,5000,1.0,5,6,1030,0.0,1917,1550,5000,38417 days 16:47:18.676848,272,2.0,0.0,-520,0,1030.0
310000.0,2,1.5,1040,83199,1.0,4,7,870,170.0,1965,1760,75794,20885 days 16:47:18.676848,317,1.3333333333333333,5.117647058823529,-720,7405,700.0
323500.0,3,3.0,2240,11536,2.0,3,7,2240,0.0,1943,1650,8760,28921 days 16:47:18.676848,260,1.0,0.0,590,2776,2240.0
364500.0,3,1.0,1600,4489,1.0,3,6,800,800.0,1944,1640,6013,28556 days 16:47:18.676848,269,3.0,1.0,-40,-1524,0.0
280000.0,4,2.0,2190,14439,1.0,4,7,1180,1010.0,1977,2160,14439,16502 days 16:47:18.676848,129,2.0,1.1683168316831682,30,0,170.0
289900.0,3,1.75,1899,11325,2.0,3,7,1899,0.0,1943,2000,10454,28921 days 16:47:18.676848,349,1.7142857142857142,0.0,-101,871,1899.0
585000.0,3,1.0,1870,2807,1.5,4,7,1580,290.0,1927,1640,4500,34765 days 16:47:18.676848,164,3.0,5.448275862068965,230,-1693,1290.0
269000.0,3,2.5,1730,6653,1.0,4,7,1360,370.0,1990,1730,7061,11754 days 16:47:18.676848,259,1.2,3.675675675675676,0,-408,990.0
280000.0,3,2.25,1860,9210,2.0,3,7,1860,0.0,1994,1530,8091,10293 days 16:47:18.676848,220,1.3333333333333333,0.0,330,1119,1860.0
287000.0,3,1.75,1940,9000,1.0,3,7,1290,650.0,1965,1900,9120,20885 days 16:47:18.676848,099,1.7142857142857142,1.9846153846153847,40,-120,640.0
183000.0,2,1.0,670,5140,1.0,3,6,670,0.0,1926,850,5140,35130 days 16:47:18.676848,224,2.0,0.0,-180,0,670.0
309000.0,3,1.0,1820,8142,1.0,3,7,1040,780.0,1961,1820,8142,22346 days 16:47:18.676848,353,3.0,1.3333333333333333,0,0,260.0
920000.0,4,2.5,3810,13579,2.0,3,1,3810,0.0,2003,3310,9270,7006 days 16:47:18.676848,286,1.6,0.0,500,4309,3810.0
815241.0,5,2.25,2060,4800,2.5,3,8,2060,0.0,1907,1740,4800,42070 days 16:47:18.676848,272,2.2222222222222223,0.0,320,0,2060.0
405000.0,3,1.75,1520,7252,1.0,3,7,1140,380.0,1975,1910,7820,17233 days 16:47:18.676848,325,1.7142857142857142,3.0,-390,-568,760.0
525000.0,5,3.5,3450,19080,2.0,3,9,3450,0.0,2001,2570,17007,7736 days 16:47:18.676848,120,1.4285714285714286,0.0,880,2073,3450.0
150000.0,2,1.0,830,4045,1.0,3,6,830,0.0,1943,1100,4116,28921 days 16:47:18.676848,198,2.0,0.0,-270,-71,830.0
240000.0,4,1.75,1880,9600,1.0,5,7,1020,860.0,1946,1560,14400,27825 days 16:47:18.676848,268,2.2857142857142856,1.186046511627907,320,-4800,160.0
698000.0,4,2.25,2200,11250,1.5,5,7,1300,900.0,1920,2320,10814,37322 days 16:47:18.676848,122,1.7777777777777777,1.4444444444444444,-120,436,400.0
440000.0,3,2.0,1800,10950,1.0,4,8,1800,0.0,1982,2400,11300,14676 days 16:47:18.676848,068,1.5,0.0,-600,-350,1800.0
204000.0,3,1.0,1200,12500,1.5,3,6,1200,0.0,1936,1200,7500,31478 days 16:47:18.676848,104,3.0,0.0,0,5000,1200.0
875000.0,3,2.0,2220,6641,1.0,4,7,1220,1000.0,1947,1800,5900,27460 days 16:47:18.676848,136,1.5,1.22,420,741,220.0
650000.0,3,1.5,1380,4500,1.0,5,7,1380,0.0,1960,1590,9000,22712 days 16:47:18.676848,184,2.0,0.0,-210,-4500,1380.0
392500.0,3,1.0,1660,8839,1.0,4,7,1660,0.0,1947,1230,9236,27460 days 16:47:18.676848,098,3.0,0.0,430,-397,1660.0
400000.0,4,1.0,2320,4000,1.5,3,6,1310,1010.0,1921,1750,4000,36956 days 16:47:18.676848,290,4.0,1.297029702970297,570,0,300.0
653000.0,3,2.25,2800,17300,1.0,4,8,1420,1380.0,1971,2140,12650,18694 days 16:47:18.676848,118,1.3333333333333333,1.0289855072463767,660,4650,40.0
452000.0,4,1.0,1210,3760,1.5,3,6,1210,0.0,1900,1540,3800,44626 days 16:47:18.676848,140,4.0,0.0,-330,-40,1210.0
345000.0,4,2.5,2331,3826,2.0,3,8,2331,0.0,2007,2441,3826,5545 days 16:47:18.676848,126,1.6,0.0,-110,0,2331.0
350000.0,4,1.75,1820,6930,1.0,4,7,1320,500.0,1952,1820,6825,25634 days 16:47:18.676848,336,2.2857142857142856,2.64,0,105,820.0
650000.0,4,2.5,2860,5576,2.0,3,8,2860,0.0,2004,2290,10667,6641 days 16:47:18.676848,212,1.6,0.0,570,-5091,2860.0
525000.0,5,3.0,2750,3800,1.5,5,7,1750,1000.0,1926,1900,3800,35130 days 16:47:18.676848,147,1.6666666666666667,1.75,850,0,750.0
840000.0,5,3.0,2750,3800,1.5,5,7,1750,1000.0,1926,1900,3800,35130 days 16:47:18.676848,026,1.6666666666666667,1.75,850,0,750.0
1330000.0,3,2.5,2280,5000,2.0,4,9,2280,0.0,1926,2200,5000,35130 days 16:47:18.676848,328,1.2,0.0,80,0,2280.0
998000.0,5,3.5,3760,10207,2.0,3,1,3150,610.0,1969,3550,12118,19424 days 16:47:18.676848,051,1.4285714285714286,5.163934426229508,210,-1911,2540.0
1070000.0,3,3.0,2940,4622,2.0,4,9,2230,710.0,1988,1580,4000,12485 days 16:47:18.676848,161,1.0,3.140845070422535,1360,622,1520.0
1910000.0,4,3.0,4460,6833,2.0,3,1,3140,1320.0,1955,3130,7450,24538 days 16:47:18.676848,191,1.3333333333333333,2.378787878787879,1330,-617,1820.0
190500.0,3,1.5,1110,1150,2.0,3,8,940,170.0,2007,1380,1751,5545 days 16:47:18.676848,068,2.0,5.529411764705882,-270,-601,770.0
465000.0,3,2.25,2560,117176,1.0,4,9,1280,1280.0,1977,2760,57063,16502 days 16:47:18.676848,316,1.3333333333333333,1.0,-200,60113,0.0
370000.0,3,1.0,1060,7419,1.0,4,6,1060,0.0,1906,2190,5953,42435 days 16:47:18.676848,035,3.0,0.0,-1130,1466,1060.0
350000.0,3,1.75,1380,4590,1.0,2,7,930,450.0,1950,1320,4692,26364 days 16:47:18.676848,308,1.7142857142857142,2.066666666666667,60,-102,480.0
740000.0,3,1.75,1380,4590,1.0,2,7,930,450.0,1950,1320,4692,26364 days 16:47:18.676848,064,1.7142857142857142,2.066666666666667,60,-102,480.0
460000.0,3,1.75,2560,8400,1.0,3,7,1970,590.0,1959,1970,8400,23077 days 16:47:18.676848,280,1.7142857142857142,3.3389830508474576,590,0,1380.0
290000.0,3,1.0,1010,10800,1.0,4,7,1010,0.0,1972,1370,9500,18329 days 16:47:18.676848,238,3.0,0.0,-360,1300,1010.0
475000.0,3,1.5,1790,229125,2.0,3,7,1790,0.0,1987,1970,216928,12850 days 16:47:18.676848,261,2.0,0.0,-180,12197,1790.0
214000.0,3,2.5,1600,2231,2.0,3,7,1600,0.0,2003,1600,2962,7006 days 16:47:18.676848,269,1.2,0.0,0,-731,1600.0
455000.0,2,1.0,910,5759,1.0,3,6,910,0.0,1951,1520,7518,25999 days 16:47:18.676848,128,2.0,0.0,-610,-1759,910.0
275000.0,3,2.5,2497,4400,2.0,3,8,2497,0.0,2007,2434,4400,5545 days 16:47:18.676848,206,1.2,0.0,63,0,2497.0
305000.0,3,1.5,1800,12196,1.0,4,7,1800,0.0,1966,1490,11730,20520 days 16:47:18.676848,190,2.0,0.0,310,466,1800.0
449000.0,5,2.5,2570,61855,1.0,4,7,1470,1100.0,1981,1990,49658,15041 days 16:47:18.676848,099,2.0,1.3363636363636364,580,12197,370.0
366000.0,3,2.5,1320,4320,1.0,3,6,660,660.0,1918,1190,4200,38052 days 16:47:18.676848,294,1.2,1.0,130,120,0.0
348000.0,3,2.5,1670,5090,2.0,3,7,1670,0.0,2003,2560,4851,7006 days 16:47:18.676848,087,1.2,0.0,-890,239,1670.0
515000.0,4,2.5,2800,21370,2.0,3,8,2800,0.0,2003,1880,9336,7006 days 16:47:18.676848,337,1.6,0.0,920,12034,2800.0
950000.0,4,2.5,3360,11548,2.0,3,9,3360,0.0,1988,3400,14091,12485 days 16:47:18.676848,171,1.6,0.0,-40,-2543,3360.0
815000.0,3,2.5,2590,21494,2.0,4,8,2590,0.0,1991,2590,10720,11389 days 16:47:18.676848,211,1.2,0.0,0,10774,2590.0
199950.0,3,3.0,1530,2132,2.0,3,8,1530,0.0,1993,1530,3384,10658 days 16:47:18.676848,020,1.0,0.0,0,-1252,1530.0
386000.0,3,2.0,1330,8100,1.0,4,7,1330,0.0,1969,1590,8100,19424 days 16:47:18.676848,156,1.5,0.0,-260,0,1330.0
273000.0,3,2.25,2160,7964,2.0,3,8,2160,0.0,1991,2000,7964,11389 days 16:47:18.676848,002,1.3333333333333333,0.0,160,0,2160.0
284000.0,4,2.5,1830,6360,2.0,3,8,1830,0.0,1994,1830,6596,10293 days 16:47:18.676848,084,1.6,0.0,0,-236,1830.0
399950.0,3,1.0,1470,7930,1.0,3,7,1070,400.0,1950,1440,8100,26364 days 16:47:18.676848,238,3.0,2.675,30,-170,670.0
285000.0,3,1.75,1150,6423,1.0,3,5,590,560.0,1927,1150,8367,34765 days 16:47:18.676848,015,1.7142857142857142,1.0535714285714286,0,-1944,30.0
315000.0,3,2.5,1790,6452,2.0,3,7,1790,0.0,2004,1610,3600,6641 days 16:47:18.676848,093,1.2,0.0,180,2852,1790.0
250000.0,3,1.0,1700,7700,1.0,3,7,1120,580.0,1960,1700,8800,22712 days 16:47:18.676848,219,3.0,1.9310344827586208,0,-1100,540.0
290000.0,4,2.0,1630,7618,1.5,3,7,1630,0.0,1967,1320,8774,20155 days 16:47:18.676848,075,2.0,0.0,310,-1156,1630.0
725000.0,4,2.5,3420,30410,2.0,3,9,3420,0.0,1988,2940,45916,12485 days 16:47:18.676848,174,1.6,0.0,480,-15506,3420.0
410000.0,3,2.0,1650,9641,1.5,3,7,1650,0.0,1983,1940,6701,14311 days 16:47:18.676848,143,1.5,0.0,-290,2940,1650.0
855000.0,4,2.5,2810,52062,1.5,4,9,2810,0.0,1988,3330,49783,12485 days 16:47:18.676848,229,1.6,0.0,-520,2279,2810.0
399900.0,4,2.5,2710,8127,2.0,3,8,2710,0.0,1994,2520,8436,10293 days 16:47:18.676848,209,1.6,0.0,190,-309,2710.0
852600.0,4,2.5,3320,11901,2.0,5,9,2650,670.0,1977,2700,11114,16502 days 16:47:18.676848,162,1.6,3.955223880597015,620,787,1980.0
235000.0,2,1.0,720,6321,1.0,3,6,720,0.0,1940,920,5684,30017 days 16:47:18.676848,220,2.0,0.0,-200,637,720.0
230950.0,2,1.0,930,12724,1.0,4,6,930,0.0,1912,1240,21828,40244 days 16:47:18.676848,219,2.0,0.0,-310,-9104,930.0
230000.0,3,2.25,1490,8722,2.0,3,7,1490,0.0,1997,1510,8061,9197 days 16:47:18.676848,089,1.3333333333333333,0.0,-20,661,1490.0
404763.0,3,2.5,1690,1609,2.0,3,8,1150,540.0,2014,1690,1860,2988 days 16:47:18.676848,210,1.2,2.1296296296296298,0,-251,610.0
245000.0,3,2.5,1720,3407,2.0,3,7,1720,0.0,1992,1720,3407,11024 days 16:47:18.676848,266,1.2,0.0,0,0,1720.0
188000.0,3,1.5,1140,8500,1.0,4,7,1140,0.0,1964,1600,8500,21251 days 16:47:18.676848,029,2.0,0.0,-460,0,1140.0
626100.0,4,2.5,2280,7219,2.0,4,8,2280,0.0,1987,2240,7471,12850 days 16:47:18.676848,338,1.6,0.0,40,-252,2280.0
428750.0,3,1.0,1100,4080,1.0,4,7,900,200.0,1929,1170,4080,34034 days 16:47:18.676848,061,3.0,4.5,-70,0,700.0
522000.0,4,2.25,1800,8623,1.0,4,8,1360,440.0,1980,2370,8623,15407 days 16:47:18.676848,132,1.7777777777777777,3.090909090909091,-570,0,920.0
684000.0,4,2.5,2500,8434,2.0,4,8,2500,0.0,1988,1900,8131,12485 days 16:47:18.676848,070,1.6,0.0,600,303,2500.0
1070000.0,3,2.25,2950,7232,1.0,3,8,1520,1430.0,1983,2130,7140,14311 days 16:47:18.676848,110,1.3333333333333333,1.062937062937063,820,92,90.0
611206.0,1,1.0,1940,6300,1.0,3,8,1940,0.0,1963,2560,6300,21616 days 16:47:18.676848,125,1.0,0.0,-620,0,1940.0
350000.0,2,1.0,1280,5250,1.0,4,7,1140,140.0,1942,1050,5250,29286 days 16:47:18.676848,258,2.0,8.142857142857142,230,0,1000.0
894000.0,4,2.5,3800,22029,2.0,3,9,3800,0.0,1993,3170,24979,10658 days 16:47:18.676848,113,1.6,0.0,630,-2950,3800.0
420000.0,2,1.0,930,5368,1.0,4,7,930,0.0,1953,1770,6000,25268 days 16:47:18.676848,246,2.0,0.0,-840,-632,930.0
400000.0,5,2.0,1930,9747,1.0,4,7,1020,910.0,1962,2040,9370,21981 days 16:47:18.676848,149,2.5,1.120879120879121,-110,377,110.0
675000.0,3,3.0,2980,28000,1.0,3,1,1820,1160.0,1981,2570,28500,15041 days 16:47:18.676848,145,1.0,1.5689655172413792,410,-500,660.0
426000.0,4,2.5,2800,8494,2.0,3,8,2800,0.0,2004,3740,8494,6641 days 16:47:18.676848,140,1.6,0.0,-940,0,2800.0
750000.0,4,2.25,3190,11597,2.0,3,1,2300,890.0,1984,2990,10679,13946 days 16:47:18.676848,178,1.7777777777777777,2.5842696629213484,200,918,1410.0
368000.0,3,1.75,1710,10800,1.0,4,7,1710,0.0,1958,1890,10800,23442 days 16:47:18.676848,160,1.7142857142857142,0.0,-180,0,1710.0
342000.0,3,1.0,1980,6450,1.0,4,6,1120,860.0,1950,1180,5160,26364 days 16:47:18.676848,086,3.0,1.302325581395349,800,1290,260.0
700000.0,3,1.75,1910,4800,1.0,3,7,1080,830.0,1959,1750,4800,23077 days 16:47:18.676848,156,1.7142857142857142,1.3012048192771084,160,0,250.0
848750.0,6,3.75,3160,5000,2.0,3,8,3160,0.0,1989,1740,5000,12119 days 16:47:18.676848,203,1.6,0.0,1420,0,3160.0
720000.0,3,2.0,1590,5200,1.0,3,7,1320,270.0,1939,1620,5150,30382 days 16:47:18.676848,062,1.5,4.888888888888889,-30,50,1050.0
525000.0,4,2.25,1890,8549,1.0,3,8,1890,0.0,1967,1940,7210,20155 days 16:47:18.676848,265,1.7777777777777777,0.0,-50,1339,1890.0
397900.0,3,2.75,2500,35245,1.0,3,7,1580,920.0,2000,2060,153766,8102 days 16:47:18.676848,083,1.0909090909090908,1.7173913043478262,440,-118521,660.0
405000.0,3,2.0,1740,18000,1.0,3,7,1230,510.0,1989,1740,11250,12119 days 16:47:18.676848,227,1.5,2.411764705882353,0,6750,720.0
392800.0,3,2.0,1080,11856,1.0,5,7,1080,0.0,1986,1220,9247,13215 days 16:47:18.676848,028,1.5,0.0,-140,2609,1080.0
394999.0,3,1.5,1730,7800,1.0,3,7,1330,400.0,1958,1780,8309,23442 days 16:47:18.677845,055,2.0,3.325,-50,-509,930.0
340000.0,3,2.5,2480,6112,2.0,3,7,2480,0.0,2004,3220,6727,6641 days 16:47:18.677845,170,1.2,0.0,-740,-615,2480.0
482500.0,3,2.25,1450,1445,2.0,3,7,980,470.0,2005,1510,1370,6275 days 16:47:18.677845,139,1.3333333333333333,2.0851063829787235,-60,75,510.0
812500.0,4,2.5,2750,10159,2.0,3,1,2750,0.0,1991,3160,10159,11389 days 16:47:18.677845,252,1.6,0.0,-410,0,2750.0
450000.0,3,2.5,2820,10208,1.0,4,8,1410,1410.0,1954,1540,10684,24903 days 16:47:18.677845,269,1.2,1.0,1280,-476,0.0
398000.0,3,1.75,1830,27468,1.0,3,7,1830,0.0,1954,1860,10180,24903 days 16:47:18.677845,308,1.7142857142857142,0.0,-30,17288,1830.0
1080000.0,2,3.25,1550,1767,3.0,3,8,1550,0.0,2006,2710,3444,5910 days 16:47:18.677845,127,0.6153846153846154,0.0,-1160,-1677,1550.0
540000.0,2,2.0,1640,3021,1.0,3,7,840,800.0,1959,1780,4500,23077 days 16:47:18.677845,287,1.0,1.05,-140,-1479,40.0
275000.0,4,2.0,1720,5472,1.0,3,6,860,860.0,1923,1720,5670,36226 days 16:47:18.677845,276,2.0,1.0,0,-198,0.0
780000.0,5,2.0,2880,12000,2.0,3,8,2880,0.0,1921,1720,5000,36956 days 16:47:18.677845,234,2.5,0.0,1160,7000,2880.0
225000.0,3,1.5,1220,8345,1.5,3,7,1220,0.0,1931,1880,10169,33304 days 16:47:18.677845,205,2.0,0.0,-660,-1824,1220.0
503045.0,3,3.0,1560,2250,2.0,3,9,1560,0.0,2009,1610,4500,4814 days 16:47:18.677845,203,1.0,0.0,-50,-2250,1560.0
249000.0,2,2.0,1090,1357,2.0,3,7,1090,0.0,1990,1078,1318,11754 days 16:47:18.677845,255,1.0,0.0,12,39,1090.0
569950.0,4,1.0,1140,5940,1.0,3,7,1140,0.0,1916,1630,4000,38783 days 16:47:18.677845,191,4.0,0.0,-490,1940,1140.0
450000.0,2,2.25,1040,1377,2.0,3,8,1040,0.0,2003,1264,1892,7006 days 16:47:18.677845,026,0.8888888888888888,0.0,-224,-515,1040.0
1100000.0,4,2.0,2580,6000,1.0,5,9,1300,1280.0,1950,2300,6200,26364 days 16:47:18.677845,154,2.0,1.015625,280,-200,20.0
700000.0,4,2.5,2310,3570,1.5,3,7,1490,820.0,1927,1580,3060,34765 days 16:47:18.677845,150,1.6,1.8170731707317074,730,510,670.0
454000.0,3,2.5,1590,4094,2.0,3,7,1590,0.0,1991,1940,3924,11389 days 16:47:18.677845,231,1.2,0.0,-350,170,1590.0
555000.0,3,1.75,1270,9170,1.0,3,7,1270,0.0,1969,1700,8500,19424 days 16:47:18.677845,119,1.7142857142857142,0.0,-430,670,1270.0
214000.0,3,1.5,1240,5200,1.0,5,6,1240,0.0,1970,1060,5200,19059 days 16:47:18.677845,006,2.0,0.0,180,0,1240.0
590000.0,3,2.5,2210,8622,2.0,3,8,2210,0.0,1988,2340,7192,12485 days 16:47:18.677845,220,1.2,0.0,-130,1430,2210.0
459900.0,3,1.75,2340,51836,1.5,3,8,1510,830.0,1978,2060,77536,16137 days 16:47:18.677845,223,1.7142857142857142,1.819277108433735,280,-25700,680.0
390000.0,3,1.75,1430,9857,1.0,4,7,1140,290.0,1980,1310,9880,15407 days 16:47:18.677845,132,1.7142857142857142,3.9310344827586206,120,-23,850.0
970500.0,3,2.75,2470,10125,2.0,3,8,2470,0.0,1960,2290,10125,22712 days 16:47:18.677845,171,1.0909090909090908,0.0,180,0,2470.0
790000.0,3,2.5,2390,15084,2.0,3,8,2390,0.0,2000,1850,17494,8102 days 16:47:18.677845,111,1.2,0.0,540,-2410,2390.0
320000.0,3,1.0,1120,10576,1.0,4,7,1120,0.0,1969,1300,10000,19424 days 16:47:18.677845,188,3.0,0.0,-180,576,1120.0
552500.0,3,2.25,2700,4025,2.0,4,8,1760,940.0,1907,1580,4025,42070 days 16:47:18.677845,204,1.3333333333333333,1.872340425531915,1120,0,820.0
1050000.0,3,3.0,3490,4500,2.5,3,9,3170,320.0,1924,2840,4050,35861 days 16:47:18.677845,323,1.0,9.90625,650,450,2850.0
230000.0,3,1.0,1640,7187,1.0,3,7,1640,0.0,1966,1340,8346,20520 days 16:47:18.677845,266,3.0,0.0,300,-1159,1640.0
680000.0,3,1.75,1620,5500,1.0,3,7,1110,510.0,1950,2100,6500,26364 days 16:47:18.677845,210,1.7142857142857142,2.176470588235294,-480,-1000,600.0
985000.0,3,1.75,1670,5400,2.0,5,8,1670,0.0,1912,2100,5400,40244 days 16:47:18.677845,153,1.7142857142857142,0.0,-430,0,1670.0
375000.0,4,2.5,1870,7471,2.0,3,8,1870,0.0,1990,2020,8912,11754 days 16:47:18.677845,174,1.6,0.0,-150,-1441,1870.0
431000.0,2,1.5,1300,4000,1.5,4,6,1300,0.0,1900,1480,4000,44626 days 16:47:18.677845,112,1.3333333333333333,0.0,-180,0,1300.0
463000.0,3,2.5,2190,17108,2.0,3,8,2190,0.0,1991,2400,14040,11389 days 16:47:18.677845,252,1.2,0.0,-210,3068,2190.0
350000.0,3,1.75,1320,10500,1.0,3,7,1320,0.0,1966,1310,10500,20520 days 16:47:18.677845,279,1.7142857142857142,0.0,10,0,1320.0
485000.0,3,1.0,1250,7200,1.0,3,7,1250,0.0,1964,1430,7400,21251 days 16:47:18.677845,104,3.0,0.0,-180,-200,1250.0
603500.0,3,1.75,2140,7280,1.0,3,7,1070,1070.0,1910,2280,8400,40974 days 16:47:18.677845,086,1.7142857142857142,1.0,-140,-1120,0.0
860000.0,5,1.75,2510,6000,1.5,5,8,2010,500.0,1920,2240,5000,37322 days 16:47:18.677845,231,2.857142857142857,4.02,270,1000,1510.0
259875.0,5,2.5,2200,6250,2.0,3,7,2200,0.0,1996,1850,6091,9563 days 16:47:18.677845,065,2.0,0.0,350,159,2200.0
685000.0,4,2.5,2170,8680,1.0,3,7,1220,950.0,1959,2010,8680,23077 days 16:47:18.677845,197,1.6,1.2842105263157895,160,0,270.0
382500.0,4,2.5,2980,8786,2.0,3,8,2980,0.0,2003,2980,6718,7006 days 16:47:18.677845,273,1.6,0.0,0,2068,2980.0
490000.0,3,1.0,1180,2250,1.5,3,7,1180,0.0,1902,1320,5100,43896 days 16:47:18.677845,060,3.0,0.0,-140,-2850,1180.0
229000.0,3,2.0,1540,6000,1.0,4,6,1540,0.0,1953,1490,8213,25268 days 16:47:18.677845,026,1.5,0.0,50,-2213,1540.0
430000.0,3,2.0,1540,6000,1.0,4,6,1540,0.0,1953,1490,8213,25268 days 16:47:18.677845,125,1.5,0.0,50,-2213,1540.0
580000.0,5,2.5,3110,15783,1.0,3,8,1720,1390.0,1974,2550,12220,17598 days 16:47:18.677845,230,2.0,1.2374100719424461,560,3563,330.0
510000.0,3,1.75,1370,6700,1.0,3,8,1370,0.0,1940,1180,6694,30017 days 16:47:18.677845,317,1.7142857142857142,0.0,190,6,1370.0
489990.0,5,2.25,2440,20828,1.5,4,8,2440,0.0,1975,2670,14472,17233 days 16:47:18.677845,128,2.2222222222222223,0.0,-230,6356,2440.0
440000.0,3,2.25,1760,1800,2.0,3,7,1330,430.0,1983,1150,4575,14311 days 16:47:18.677845,259,1.3333333333333333,3.0930232558139537,610,-2775,900.0
479950.0,3,2.5,2810,4984,1.0,3,9,1750,1060.0,2006,2810,5711,5910 days 16:47:18.677845,118,1.2,1.650943396226415,0,-727,690.0
806000.0,4,2.5,2500,206474,1.0,3,1,2500,0.0,1997,3680,208652,9197 days 16:47:18.677845,174,1.6,0.0,-1180,-2178,2500.0
875000.0,4,2.5,3220,22588,2.0,3,1,3220,0.0,1996,3220,22922,9563 days 16:47:18.677845,175,1.6,0.0,0,-334,3220.0
710800.0,3,2.5,2880,36820,2.0,3,1,2880,0.0,1992,3190,36820,11024 days 16:47:18.677845,254,1.2,0.0,-310,0,2880.0
565000.0,3,2.5,2700,6037,2.0,3,8,2700,0.0,2004,2740,6054,6641 days 16:47:18.677845,041,1.2,0.0,-40,-17,2700.0
359999.0,5,3.0,2680,9624,2.0,3,7,1870,810.0,1995,1860,9921,9928 days 16:47:18.677845,054,1.6666666666666667,2.308641975308642,820,-297,1060.0
625000.0,3,1.75,1780,4500,1.0,4,7,920,860.0,1922,1360,4000,36591 days 16:47:18.677845,023,1.7142857142857142,1.069767441860465,420,500,60.0
349950.0,3,2.5,2240,7565,2.0,3,8,2240,0.0,1999,2190,8254,8467 days 16:47:18.677845,255,1.2,0.0,50,-689,2240.0
415000.0,4,2.0,1610,9600,1.0,5,7,1610,0.0,1967,1450,9600,20155 days 16:47:18.677845,168,2.0,0.0,160,0,1610.0
435000.0,2,2.0,1440,1170,2.0,3,9,960,480.0,2004,1440,1350,6641 days 16:47:18.677845,309,1.0,2.0,0,-180,480.0
225000.0,3,1.75,1550,9060,2.0,3,7,1550,0.0,1948,1080,7620,27095 days 16:47:18.677845,325,1.7142857142857142,0.0,470,1440,1550.0
770000.0,3,1.75,1720,5000,1.0,3,9,1720,0.0,1954,2120,4188,24903 days 16:47:18.677845,132,1.7142857142857142,0.0,-400,812,1720.0
340000.0,3,1.75,1740,10800,1.0,3,7,1740,0.0,1959,1810,7735,23077 days 16:47:18.677845,006,1.7142857142857142,0.0,-70,3065,1740.0
965000.0,5,2.75,3280,12673,1.0,4,9,2050,1230.0,1981,3060,12847,15041 days 16:47:18.677845,071,1.8181818181818181,1.6666666666666667,220,-174,820.0
667000.0,3,2.75,2216,31215,1.0,3,9,2216,0.0,1968,2216,30048,19790 days 16:47:18.677845,013,1.0909090909090908,0.0,0,1167,2216.0
250000.0,1,1.0,1100,4373,1.0,2,6,820,280.0,1947,1100,7500,27460 days 16:47:18.677845,127,1.0,2.9285714285714284,0,-3127,540.0
397990.0,3,1.0,1180,11862,1.0,4,7,1180,0.0,1948,1540,8100,27095 days 16:47:18.677845,163,3.0,0.0,-360,3762,1180.0
535000.0,3,1.75,2020,10031,1.0,5,7,1370,650.0,1952,1500,8456,25634 days 16:47:18.677845,261,1.7142857142857142,2.1076923076923078,520,1575,720.0
265950.0,3,1.5,1150,8450,1.0,4,6,1150,0.0,1951,1160,6800,25999 days 16:47:18.677845,176,2.0,0.0,-10,1650,1150.0
258000.0,3,1.75,2090,7461,1.0,3,6,1200,890.0,1986,1420,7462,13215 days 16:47:18.677845,280,1.7142857142857142,1.348314606741573,670,-1,310.0
505500.0,3,2.5,1300,1187,3.0,3,8,1300,0.0,2005,1320,1194,6275 days 16:47:18.677845,336,1.2,0.0,-20,-7,1300.0
455000.0,5,2.5,2240,7770,1.0,3,7,1340,900.0,1978,1820,7770,16137 days 16:47:18.677845,126,2.0,1.488888888888889,420,0,440.0
1350000.0,5,3.25,3540,5971,1.0,3,1,2000,1540.0,2005,2820,6029,6275 days 16:47:18.677845,304,1.5384615384615385,1.2987012987012987,720,-58,460.0
600000.0,4,2.25,2840,31720,1.0,3,8,1780,1060.0,1958,2290,29577,23442 days 16:47:18.677845,009,1.7777777777777777,1.679245283018868,550,2143,720.0
329800.0,4,2.5,2080,7047,2.0,3,8,2080,0.0,1996,2580,7227,9563 days 16:47:18.677845,036,1.6,0.0,-500,-180,2080.0
222000.0,2,1.0,1550,38449,1.0,3,6,1550,0.0,1947,1188,25875,27460 days 16:47:18.677845,111,2.0,0.0,362,12574,1550.0
450000.0,4,2.5,1900,9240,1.0,3,7,1900,0.0,1962,2040,8052,21981 days 16:47:18.677845,095,1.6,0.0,-140,1188,1900.0
952000.0,3,3.5,2760,4500,2.0,3,9,2120,640.0,2004,1950,6000,6641 days 16:47:18.677845,352,0.8571428571428571,3.3125,810,-1500,1480.0
625000.0,4,2.0,1410,4480,1.5,3,8,1410,0.0,1927,1240,3400,34765 days 16:47:18.677845,204,2.0,0.0,170,1080,1410.0
226800.0,2,1.0,1240,11393,1.0,4,7,1240,0.0,1960,1660,11393,22712 days 16:47:18.677845,071,2.0,0.0,-420,0,1240.0
1210000.0,5,4.25,4420,13497,2.0,3,1,3510,910.0,2000,4220,12015,8102 days 16:47:18.677845,346,1.1764705882352942,3.857142857142857,200,1482,2600.0
350000.0,4,2.75,3390,16153,1.0,4,7,1970,1420.0,1961,2530,8495,22346 days 16:47:18.677845,276,1.4545454545454546,1.3873239436619718,860,7658,550.0
395000.0,3,1.75,1400,8640,1.0,3,7,1400,0.0,1962,1630,8640,21981 days 16:47:18.677845,071,1.7142857142857142,0.0,-230,0,1400.0
285000.0,5,3.0,2110,5260,2.0,3,7,1670,440.0,2002,2110,5260,7371 days 16:47:18.677845,262,1.6666666666666667,3.7954545454545454,0,0,1230.0
553000.0,3,1.0,1310,18135,1.0,3,7,1310,0.0,1948,2150,18135,27095 days 16:47:18.677845,007,3.0,0.0,-840,0,1310.0
254000.0,3,1.0,1270,16800,1.0,4,7,1270,0.0,1957,1700,10200,23807 days 16:47:18.677845,125,3.0,0.0,-430,6600,1270.0
348140.0,2,1.5,2060,10880,1.0,3,6,1190,870.0,1924,1430,8781,35861 days 16:47:18.677845,238,1.3333333333333333,1.367816091954023,630,2099,320.0
354950.0,4,2.75,2530,7350,1.0,5,8,1280,1250.0,1977,2280,7350,16502 days 16:47:18.677845,177,1.4545454545454546,1.024,250,0,30.0
706000.0,3,2.75,1900,6400,1.0,5,7,1410,490.0,1942,1350,6400,29286 days 16:47:18.677845,163,1.0909090909090908,2.877551020408163,550,0,920.0
427500.0,3,1.5,1900,43186,1.5,4,7,1300,600.0,1971,2080,108028,18694 days 16:47:18.677845,338,2.0,2.1666666666666665,-180,-64842,700.0
439000.0,5,3.5,2880,10000,2.0,3,8,1980,900.0,1991,2120,9535,11389 days 16:47:18.677845,048,1.4285714285714286,2.2,760,465,1080.0
545000.0,4,2.5,2820,25995,2.0,3,9,2820,0.0,1998,3330,27653,8832 days 16:47:18.677845,321,1.6,0.0,-510,-1658,2820.0
842000.0,3,1.0,1620,4774,1.5,3,7,1620,0.0,1920,1880,4560,37322 days 16:47:18.677845,290,3.0,0.0,-260,214,1620.0
685000.0,4,2.5,3320,38043,2.0,3,9,3320,0.0,1997,3170,42621,9197 days 16:47:18.677845,344,1.6,0.0,150,-4578,3320.0
665000.0,4,3.5,3770,47480,2.0,3,9,3770,0.0,2003,3380,42689,7006 days 16:47:18.677845,246,1.1428571428571428,0.0,390,4791,3770.0
255000.0,2,1.0,1200,9000,1.0,5,6,1200,0.0,1917,1660,9000,38417 days 16:47:18.677845,160,2.0,0.0,-460,0,1200.0
565000.0,5,2.25,2130,4360,1.0,3,8,1240,890.0,1959,1830,5000,23077 days 16:47:18.677845,365,2.2222222222222223,1.3932584269662922,300,-640,350.0
274000.0,5,1.75,1950,8720,1.0,3,7,1050,900.0,1962,1660,8030,21981 days 16:47:18.677845,056,2.857142857142857,1.1666666666666667,290,690,150.0
260000.0,3,2.0,1920,8075,1.0,4,7,1510,410.0,1969,1920,7826,19424 days 16:47:18.677845,129,1.5,3.682926829268293,0,249,1100.0
581000.0,4,2.0,2510,13695,1.0,4,7,1280,1230.0,1961,1220,12500,22346 days 16:47:18.677845,127,2.0,1.0406504065040652,1290,1195,50.0
625000.0,3,1.5,1990,5978,1.5,4,7,1990,0.0,1926,2100,6221,35130 days 16:47:18.677845,206,2.0,0.0,-110,-243,1990.0
220000.0,3,1.0,1230,9720,1.0,5,7,1230,0.0,1969,1230,9720,19424 days 16:47:18.677845,363,3.0,0.0,0,0,1230.0
765000.0,3,2.25,3190,324086,2.0,3,9,3190,0.0,1982,3190,217800,14676 days 16:47:18.677845,301,1.3333333333333333,0.0,0,106286,3190.0
1330000.0,6,4.25,5720,10213,2.0,3,1,4170,1550.0,2004,4300,10224,6641 days 16:47:18.677845,191,1.411764705882353,2.6903225806451614,1420,-11,2620.0
700000.0,8,2.5,2280,3000,1.5,3,7,1210,1070.0,1911,1610,3000,40609 days 16:47:18.677845,077,3.2,1.1308411214953271,670,0,140.0
351000.0,4,1.0,1550,7260,1.0,4,6,1550,0.0,1959,1210,7260,23077 days 16:47:18.677845,267,4.0,0.0,340,0,1550.0
413565.0,3,2.5,1690,1613,2.0,3,8,1150,540.0,2014,1690,1619,2988 days 16:47:18.677845,217,1.2,2.1296296296296298,0,-6,610.0
363000.0,3,3.25,1651,1779,2.0,3,8,1341,310.0,2008,1650,2908,5180 days 16:47:18.677845,163,0.9230769230769231,4.325806451612904,1,-1129,1031.0
679000.0,4,1.75,2260,41236,1.0,4,8,1690,570.0,1962,3080,30240,21981 days 16:47:18.677845,094,2.2857142857142856,2.9649122807017543,-820,10996,1120.0
473000.0,2,1.75,1510,4555,1.0,3,8,1510,0.0,2005,1640,4500,6275 days 16:47:18.677845,253,1.1428571428571428,0.0,-130,55,1510.0
585888.0,3,2.0,1490,7431,1.0,4,7,1490,0.0,1966,1700,7725,20520 days 16:47:18.677845,111,1.5,0.0,-210,-294,1490.0
405000.0,4,2.5,2220,4652,2.0,3,7,2220,0.0,2001,1840,4500,7736 days 16:47:18.677845,177,1.6,0.0,380,152,2220.0
650000.0,3,1.75,2800,19386,1.0,3,8,1400,1400.0,1965,3270,31450,20885 days 16:47:18.677845,016,1.7142857142857142,1.0,-470,-12064,0.0
415000.0,4,2.5,2210,213008,1.0,4,7,1210,1000.0,1975,2270,52707,17233 days 16:47:18.677845,055,1.6,1.21,-60,160301,210.0
575000.0,3,2.0,2150,3880,1.0,3,8,1080,1070.0,1951,2130,4000,25999 days 16:47:18.677845,356,1.5,1.0093457943925233,20,-120,10.0
220000.0,3,2.25,1400,7205,1.0,3,7,1140,260.0,1985,1970,7252,13580 days 16:47:18.677845,198,1.3333333333333333,4.384615384615385,-570,-47,880.0
610000.0,4,3.0,2450,10117,1.0,5,8,1580,870.0,1967,2530,10125,20155 days 16:47:18.677845,126,1.3333333333333333,1.8160919540229885,-80,-8,710.0
499950.0,3,1.0,980,6380,1.0,3,7,760,220.0,1941,1390,6380,29651 days 16:47:18.677845,132,3.0,3.4545454545454546,-410,0,540.0
883000.0,4,2.5,2800,6874,2.0,3,9,2170,630.0,1990,1430,6240,11754 days 16:47:18.677845,062,1.6,3.4444444444444446,1370,634,1540.0
436000.0,2,1.0,1240,8100,1.5,3,7,1240,0.0,1925,2790,8100,35495 days 16:47:18.677845,296,2.0,0.0,-1550,0,1240.0
320000.0,3,2.5,1610,1356,2.0,3,8,1240,370.0,2007,1270,1314,5545 days 16:47:18.677845,347,1.2,3.3513513513513513,340,42,870.0
425000.0,3,1.75,1510,44000,1.0,3,7,1240,270.0,1989,2290,36242,12119 days 16:47:18.677845,150,1.7142857142857142,4.592592592592593,-780,7758,970.0
204700.0,4,2.0,1670,9987,1.0,3,7,1670,0.0,1967,1640,7280,20155 days 16:47:18.677845,135,2.0,0.0,30,2707,1670.0
384000.0,6,3.0,2320,4502,1.0,4,7,1200,1120.0,1987,1160,5628,12850 days 16:47:18.677845,198,2.0,1.0714285714285714,1160,-1126,80.0
314000.0,3,2.75,1900,8200,2.0,4,7,1900,0.0,1984,1620,8200,13946 days 16:47:18.677845,013,1.0909090909090908,0.0,280,0,1900.0
535000.0,3,2.5,2390,6263,2.0,3,9,2390,0.0,2003,2390,11761,7006 days 16:47:18.677845,120,1.2,0.0,0,-5498,2390.0
568000.0,4,1.75,2110,265716,1.0,4,8,2110,0.0,1979,2110,110597,15772 days 16:47:18.677845,177,2.2857142857142856,0.0,0,155119,2110.0
426000.0,4,1.5,1470,5850,1.0,4,7,810,660.0,1973,1290,7300,17963 days 16:47:18.677845,121,2.6666666666666665,1.2272727272727273,180,-1450,150.0
675000.0,4,2.75,2670,6780,2.0,5,8,1630,1040.0,1908,2400,5989,41705 days 16:47:18.677845,343,1.4545454545454546,1.5673076923076923,270,791,590.0
380000.0,4,2.5,2540,6365,2.0,3,8,1870,670.0,2000,2290,5942,8102 days 16:47:18.677845,164,1.6,2.791044776119403,250,423,1200.0
685000.0,3,2.5,3450,8000,3.0,4,8,2970,480.0,1927,1880,6135,34765 days 16:47:18.677845,204,1.2,6.1875,1570,1865,2490.0
429000.0,3,2.0,1700,52826,1.0,3,7,1700,0.0,1991,2480,114728,11389 days 16:47:18.677845,231,1.5,0.0,-780,-61902,1700.0
799000.0,4,1.5,1810,6583,1.0,3,7,1500,310.0,1968,860,8670,19790 days 16:47:18.677845,111,2.6666666666666665,4.838709677419355,950,-2087,1190.0
318500.0,5,1.75,1550,6986,1.0,3,7,1030,520.0,1978,1550,6986,16137 days 16:47:18.677845,263,2.857142857142857,1.9807692307692308,0,0,510.0
420000.0,3,1.5,2080,5000,1.0,3,7,1300,780.0,1963,1860,5000,21616 days 16:47:18.677845,055,2.0,1.6666666666666667,220,0,520.0
570000.0,2,1.0,1100,4000,1.0,3,7,1100,0.0,1906,1590,4000,42435 days 16:47:18.677845,352,2.0,0.0,-490,0,1100.0
1050000.0,4,2.75,3950,12840,2.0,5,8,3950,0.0,1960,2350,12507,22712 days 16:47:18.677845,225,1.4545454545454546,0.0,1600,333,3950.0
333000.0,3,1.0,1250,8450,1.0,4,7,1250,0.0,1954,1350,9300,24903 days 16:47:18.677845,260,3.0,0.0,-100,-850,1250.0
660000.0,3,2.5,2290,2798,3.0,4,9,2290,0.0,1953,2260,5000,25268 days 16:47:18.677845,154,1.2,0.0,30,-2202,2290.0
350000.0,6,4.5,3500,8504,2.0,3,7,3500,0.0,1980,1550,8460,15407 days 16:47:18.677845,260,1.3333333333333333,0.0,1950,44,3500.0
399990.0,5,2.75,1690,4000,1.0,5,7,970,720.0,1943,1240,4000,28921 days 16:47:18.677845,344,1.8181818181818181,1.3472222222222223,450,0,250.0
860000.0,5,3.25,4500,9648,2.0,4,8,3000,1500.0,1968,2780,21132,19790 days 16:47:18.677845,176,1.5384615384615385,2.0,1720,-11484,1500.0
216180.0,2,1.0,1120,7797,1.0,3,6,1120,0.0,1948,2180,7200,27095 days 16:47:18.677845,294,2.0,0.0,-1060,597,1120.0
300000.0,4,2.25,1740,9613,2.0,5,8,1740,0.0,1989,1680,9769,12119 days 16:47:18.677845,258,1.7777777777777777,0.0,60,-156,1740.0
145000.0,3,1.0,1010,11880,1.0,3,7,1010,0.0,1960,1150,9435,22712 days 16:47:18.677845,287,3.0,0.0,-140,2445,1010.0
255000.0,3,1.0,1010,11880,1.0,3,7,1010,0.0,1960,1150,9435,22712 days 16:47:18.677845,064,3.0,0.0,-140,2445,1010.0
250000.0,3,1.75,1200,24805,1.0,3,6,1200,0.0,1984,2150,4339,13946 days 16:47:18.677845,183,1.7142857142857142,0.0,-950,20466,1200.0
245000.0,3,1.0,1020,8625,1.0,3,7,1020,0.0,1978,1290,9440,16137 days 16:47:18.677845,302,3.0,0.0,-270,-815,1020.0
445000.0,3,1.75,1850,7056,2.5,4,8,1850,0.0,1979,1970,7056,15772 days 16:47:18.677845,287,1.7142857142857142,0.0,-120,0,1850.0
562000.0,3,1.5,1830,8000,1.0,4,7,1830,0.0,1957,1310,7500,23807 days 16:47:18.677845,134,2.0,0.0,520,500,1830.0
501000.0,4,1.0,2070,7519,1.0,3,7,1160,910.0,1963,1730,7519,21616 days 16:47:18.677845,125,4.0,1.2747252747252746,340,0,250.0
862500.0,4,2.75,3280,24440,2.0,3,1,3280,0.0,1996,3490,25138,9563 days 16:47:18.677845,136,1.4545454545454546,0.0,-210,-698,3280.0
1090000.0,5,2.5,2340,6000,2.0,4,1,2340,0.0,1922,2350,6000,36591 days 16:47:18.677845,162,2.0,0.0,-10,0,2340.0
575000.0,5,3.0,3690,49709,1.0,3,9,2690,1000.0,1960,2590,8691,22712 days 16:47:18.677845,177,1.6666666666666667,2.69,1100,41018,1690.0
250000.0,1,1.0,720,123710,1.0,4,6,720,0.0,1935,1860,297514,31843 days 16:47:18.677845,364,1.0,0.0,-1140,-173804,720.0
310000.0,7,1.5,2660,15111,1.5,4,7,2660,0.0,1962,1710,15429,21981 days 16:47:18.677845,126,4.666666666666667,0.0,950,-318,2660.0
1400000.0,5,3.25,4300,9270,2.0,3,1,2910,1390.0,1957,2780,6610,23807 days 16:47:18.677845,282,1.5384615384615385,2.093525179856115,1520,2660,1520.0
284850.0,3,1.5,1590,8256,1.0,3,7,1090,500.0,1969,1950,7840,19424 days 16:47:18.677845,350,2.0,2.18,-360,416,590.0
570000.0,4,2.5,2590,7910,2.0,3,9,2590,0.0,2003,2110,11761,7006 days 16:47:18.677845,050,1.6,0.0,480,-3851,2590.0
304000.0,3,1.75,1720,6000,1.0,3,7,1000,720.0,1954,1690,6000,24903 days 16:47:18.677845,276,1.7142857142857142,1.3888888888888888,30,0,280.0
560000.0,4,2.5,1790,9787,1.0,4,8,1240,550.0,1983,1790,9787,14311 days 16:47:18.677845,350,1.6,2.2545454545454544,0,0,690.0
325000.0,3,1.0,1590,8160,1.0,3,7,1090,500.0,1954,1540,10500,24903 days 16:47:18.677845,238,3.0,2.18,50,-2340,590.0
305000.0,4,2.25,2580,8820,1.0,4,9,1620,960.0,1967,2140,8400,20155 days 16:47:18.677845,110,1.7777777777777777,1.6875,440,420,660.0
320000.0,5,1.0,1740,27350,1.0,4,5,1740,0.0,1958,2760,10749,23442 days 16:47:18.677845,245,5.0,0.0,-1020,16601,1740.0
455000.0,5,2.25,3470,28212,1.5,4,8,2790,680.0,1978,2020,28177,16137 days 16:47:18.677845,248,2.2222222222222223,4.102941176470588,1450,35,2110.0
383001.0,3,1.0,1180,7210,1.0,4,7,1180,0.0,1963,1700,7210,21616 days 16:47:18.677845,247,3.0,0.0,-520,0,1180.0
545000.0,3,1.75,1700,51649,1.5,5,6,1700,0.0,1931,1100,39504,33304 days 16:47:18.677845,156,1.7142857142857142,0.0,600,12145,1700.0
487500.0,2,1.0,1190,5000,1.0,3,7,1190,0.0,1925,1600,5000,35495 days 16:47:18.677845,098,2.0,0.0,-410,0,1190.0
345000.0,5,2.5,2450,6994,2.0,3,8,2450,0.0,2002,1940,6035,7371 days 16:47:18.677845,183,2.0,0.0,510,959,2450.0
583000.0,6,2.75,2630,16411,1.0,4,8,1650,980.0,1974,2250,12255,17598 days 16:47:18.677845,155,2.1818181818181817,1.683673469387755,380,4156,670.0
534950.0,3,2.25,2130,12286,2.0,3,8,2130,0.0,1977,2130,10158,16502 days 16:47:18.677845,224,1.3333333333333333,0.0,0,2128,2130.0
403504.0,4,1.0,1060,5750,1.0,3,6,950,110.0,1904,1790,5857,43166 days 16:47:18.677845,224,4.0,8.636363636363637,-730,-107,840.0
500000.0,3,1.75,1480,6120,1.5,3,7,1480,0.0,1946,1480,6120,27825 days 16:47:18.677845,117,1.7142857142857142,0.0,0,0,1480.0
319502.0,3,1.75,1610,38707,1.0,3,7,1610,0.0,1990,1930,45151,11754 days 16:47:18.677845,055,1.7142857142857142,0.0,-320,-6444,1610.0
525000.0,4,2.75,2440,5080,2.0,3,8,1750,690.0,1960,1920,6375,22712 days 16:47:18.677845,316,1.4545454545454546,2.536231884057971,520,-1295,1060.0
563000.0,4,3.0,3100,15480,2.0,3,8,2400,700.0,1996,2000,42500,9563 days 16:47:18.677845,126,1.3333333333333333,3.4285714285714284,1100,-27020,1700.0
898500.0,4,2.75,2890,5000,1.5,3,8,1990,900.0,1911,1080,3750,40609 days 16:47:18.677845,216,1.4545454545454546,2.2111111111111112,1810,1250,1090.0
651000.0,3,2.5,3240,108366,2.0,4,1,3240,0.0,1991,2090,108366,11389 days 16:47:18.677845,127,1.2,0.0,1150,0,3240.0
450000.0,4,2.75,2900,6400,2.0,3,7,2040,860.0,1911,1340,6144,40609 days 16:47:18.677845,335,1.4545454545454546,2.372093023255814,1560,256,1180.0
665000.0,4,2.25,2650,8149,1.0,4,8,1610,1040.0,1975,2290,8019,17233 days 16:47:18.677845,080,1.7777777777777777,1.5480769230769231,360,130,570.0
825000.0,4,2.5,2560,4000,2.0,5,8,1610,950.0,1929,1760,4000,34034 days 16:47:18.677845,306,1.6,1.694736842105263,800,0,660.0
200000.0,3,1.0,1150,4800,1.5,4,6,1150,0.0,1938,1310,9510,30747 days 16:47:18.677845,176,3.0,0.0,-160,-4710,1150.0
295000.0,3,2.0,1760,6092,1.0,3,7,1760,0.0,1998,2590,6255,8832 days 16:47:18.677845,247,1.5,0.0,-830,-163,1760.0
748000.0,4,2.5,3220,8379,2.0,3,1,3220,0.0,2004,2720,7635,6641 days 16:47:18.677845,349,1.6,0.0,500,744,3220.0
580000.0,3,2.5,3200,18750,1.0,2,9,2660,540.0,1967,3200,22475,20155 days 16:47:18.677845,195,1.2,4.925925925925926,0,-3725,2120.0
275000.0,3,1.0,1250,10744,1.0,3,6,1250,0.0,1942,1500,10710,29286 days 16:47:18.677845,043,3.0,0.0,-250,34,1250.0
196000.0,3,1.0,1000,8470,1.0,4,6,1000,0.0,1963,1020,8470,21616 days 16:47:18.677845,085,3.0,0.0,-20,0,1000.0
235750.0,2,1.0,740,11250,1.0,2,6,740,0.0,1938,1390,11250,30747 days 16:47:18.677845,142,2.0,0.0,-650,0,740.0
315000.0,3,2.25,2170,8480,1.0,3,8,2170,0.0,1965,2080,8452,20885 days 16:47:18.677845,082,1.3333333333333333,0.0,90,28,2170.0
338000.0,4,2.5,2370,10631,2.0,3,8,2370,0.0,1999,2200,8297,8467 days 16:47:18.677845,237,1.6,0.0,170,2334,2370.0
353000.0,4,2.5,2300,4249,2.0,3,8,2300,0.0,2006,2390,4385,5910 days 16:47:18.677845,021,1.6,0.0,-90,-136,2300.0
235000.0,3,1.75,1400,6300,1.0,3,7,1400,0.0,1998,1400,8490,8832 days 16:47:18.677845,178,1.7142857142857142,0.0,0,-2190,1400.0
569999.0,3,2.5,3080,13880,2.0,3,9,3080,0.0,1990,2780,15318,11754 days 16:47:18.677845,079,1.2,0.0,300,-1438,3080.0
505000.0,4,2.25,2350,12540,2.0,3,8,2350,0.0,1968,2090,7964,19790 days 16:47:18.677845,261,1.7777777777777777,0.0,260,4576,2350.0
1230000.0,4,3.0,2660,4600,1.5,3,8,1820,840.0,1906,2350,4600,42435 days 16:47:18.677845,065,1.3333333333333333,2.1666666666666665,310,0,980.0
299000.0,2,1.75,1250,34395,1.0,4,7,1250,0.0,1950,1910,26042,26364 days 16:47:18.677845,134,1.1428571428571428,0.0,-660,8353,1250.0
240000.0,3,2.0,1100,6360,1.0,3,7,1100,0.0,1991,1620,6360,11389 days 16:47:18.677845,289,1.5,0.0,-520,0,1100.0
1960000.0,3,1.75,3330,12566,1.0,4,8,1940,1390.0,1960,3730,16560,22712 days 16:47:18.677845,044,1.7142857142857142,1.39568345323741,-400,-3994,550.0
1270000.0,4,3.25,3640,3604,2.0,5,9,1960,1680.0,1913,1940,4600,39878 days 16:47:18.677845,254,1.2307692307692308,1.1666666666666667,1700,-996,280.0
405000.0,2,1.75,1350,2653,2.0,3,7,1350,0.0,1986,1370,4115,13215 days 16:47:18.677845,104,1.1428571428571428,0.0,-20,-1462,1350.0
304000.0,4,2.0,1310,8454,1.0,4,7,1310,0.0,1953,1320,8274,25268 days 16:47:18.677845,175,2.0,0.0,-10,180,1310.0
272000.0,4,2.25,1800,5555,2.0,3,7,1800,0.0,2003,1810,5669,7006 days 16:47:18.677845,283,1.7777777777777777,0.0,-10,-114,1800.0
412000.0,2,1.0,1260,3960,1.0,3,6,690,570.0,1925,1250,3960,35495 days 16:47:18.677845,171,2.0,1.2105263157894737,10,0,120.0
698000.0,4,2.5,2990,7231,2.0,3,9,2990,0.0,2001,3160,8339,7736 days 16:47:18.677845,199,1.6,0.0,-170,-1108,2990.0
400000.0,2,1.0,1140,5100,1.0,3,7,1140,0.0,1942,1230,5100,29286 days 16:47:18.677845,160,2.0,0.0,-90,0,1140.0
305000.0,3,2.5,2100,6825,2.0,3,8,2100,0.0,1994,2180,7614,10293 days 16:47:18.677845,324,1.2,0.0,-80,-789,2100.0
585000.0,4,2.0,2400,12753,1.0,4,7,2400,0.0,1962,1830,12060,21981 days 16:47:18.677845,253,2.0,0.0,570,693,2400.0
190000.0,2,1.5,1400,9031,1.0,3,7,960,440.0,1982,1450,7658,14676 days 16:47:18.677845,224,1.3333333333333333,2.1818181818181817,-50,1373,520.0
760000.0,4,2.5,2990,12788,2.0,3,1,2990,0.0,1988,3250,12212,12485 days 16:47:18.677845,201,1.6,0.0,-260,576,2990.0
570000.0,3,1.75,1930,36210,1.0,3,8,1930,0.0,1977,1930,35060,16502 days 16:47:18.677845,147,1.7142857142857142,0.0,0,1150,1930.0
144000.0,3,1.0,980,6800,1.0,3,6,980,0.0,1946,1140,9975,27825 days 16:47:18.677845,310,3.0,0.0,-160,-3175,980.0
139000.0,2,1.0,690,5280,1.0,4,5,690,0.0,1942,1140,4860,29286 days 16:47:18.677845,175,2.0,0.0,-450,420,690.0
525000.0,4,1.5,1430,6380,1.5,4,7,1130,300.0,1945,1570,6380,28190 days 16:47:18.677845,323,2.6666666666666665,3.7666666666666666,-140,0,830.0
293000.0,1,1.0,1110,5421,1.0,3,6,1110,0.0,1935,1230,8100,31843 days 16:47:18.677845,197,1.0,0.0,-120,-2679,1110.0
267100.0,2,2.5,1250,1580,2.0,3,7,1030,220.0,2005,1250,1361,6275 days 16:47:18.677845,117,0.8,4.681818181818182,0,219,810.0
1500000.0,4,3.25,3470,5222,2.0,3,1,2830,640.0,2005,3090,6758,6275 days 16:47:18.677845,111,1.2307692307692308,4.421875,380,-1536,2190.0
240000.0,3,2.25,1500,15334,2.0,4,7,1500,0.0,1992,1530,8102,11024 days 16:47:18.677845,301,1.3333333333333333,0.0,-30,7232,1500.0
975000.0,3,2.5,2530,7000,2.5,3,9,2530,0.0,1915,2380,7000,39148 days 16:47:18.677845,099,1.2,0.0,150,0,2530.0
279950.0,5,1.75,2150,7171,1.0,4,7,1460,690.0,1970,1710,7300,19059 days 16:47:18.677845,169,2.857142857142857,2.1159420289855073,440,-129,770.0
405000.0,3,1.75,1260,7373,1.0,4,7,1260,0.0,1979,1360,7373,15772 days 16:47:18.677845,027,1.7142857142857142,0.0,-100,0,1260.0
400000.0,3,2.5,2740,83199,2.0,3,9,2740,0.0,1973,2500,29269,17963 days 16:47:18.677845,136,1.2,0.0,240,53930,2740.0
225000.0,3,1.0,960,6500,1.0,4,5,960,0.0,1954,1150,6500,24903 days 16:47:18.677845,328,3.0,0.0,-190,0,960.0
250000.0,3,1.0,1520,7800,1.0,4,7,1120,400.0,1967,1740,8000,20155 days 16:47:18.677845,363,3.0,2.8,-220,-200,720.0
272950.0,3,2.25,1570,9096,1.0,4,7,1180,390.0,1991,1570,8418,11389 days 16:47:18.677845,090,1.3333333333333333,3.0256410256410255,0,678,790.0
625000.0,5,1.0,3240,5324,2.0,3,9,3240,0.0,2007,3240,6036,5545 days 16:47:18.677845,203,5.0,0.0,0,-712,3240.0
670000.0,3,1.75,1280,2147,1.5,4,7,1280,0.0,1910,2010,2640,40974 days 16:47:18.677845,199,1.7142857142857142,0.0,-730,-493,1280.0
1070000.0,3,2.5,2130,3545,3.0,5,9,2130,0.0,1990,1970,3464,11754 days 16:47:18.677845,091,1.2,0.0,160,81,2130.0
540000.0,3,1.75,1970,8200,1.0,5,8,1420,550.0,1963,2140,8000,21616 days 16:47:18.677845,169,1.7142857142857142,2.581818181818182,-170,200,870.0
525000.0,3,2.5,2990,6725,2.0,3,9,2990,0.0,2003,2790,6725,7006 days 16:47:18.677845,309,1.2,0.0,200,0,2990.0
425000.0,2,1.0,1160,17700,1.0,3,7,1160,0.0,1947,1440,9000,27460 days 16:47:18.677845,062,2.0,0.0,-280,8700,1160.0
465500.0,3,1.75,1890,7004,1.0,3,7,1290,600.0,1965,1440,5378,20885 days 16:47:18.677845,153,1.7142857142857142,2.15,450,1626,690.0
443500.0,3,2.5,2170,5866,2.0,3,7,2170,0.0,2006,2440,5798,5910 days 16:47:18.677845,198,1.2,0.0,-270,68,2170.0
350000.0,4,2.25,1570,499571,1.0,4,7,1570,0.0,1972,1700,181708,18329 days 16:47:18.677845,337,1.7777777777777777,0.0,-130,317863,1570.0
205000.0,3,2.25,1250,952,3.0,3,8,1250,0.0,2008,1250,1030,5180 days 16:47:18.677845,051,1.3333333333333333,0.0,0,-78,1250.0
315000.0,4,2.5,1940,10200,1.0,4,8,1140,800.0,1977,1920,12600,16502 days 16:47:18.677845,177,1.6,1.425,20,-2400,340.0
470000.0,3,2.5,2150,8221,2.0,3,8,2150,0.0,1992,2490,7951,11024 days 16:47:18.677845,174,1.2,0.0,-340,270,2150.0
1100000.0,4,2.25,3310,8540,1.0,4,9,1660,1650.0,1973,3450,9566,17963 days 16:47:18.677845,210,1.7777777777777777,1.006060606060606,-140,-1026,10.0
340000.0,3,1.75,3400,46382,1.0,3,7,2050,1350.0,1979,2320,20624,15772 days 16:47:18.677845,324,1.7142857142857142,1.5185185185185186,1080,25758,700.0
310000.0,4,2.5,2660,12672,1.0,4,8,1740,920.0,1960,2280,12477,22712 days 16:47:18.677845,169,1.6,1.891304347826087,380,195,820.0
305000.0,3,1.0,950,13475,1.0,3,7,950,0.0,1950,1240,8910,26364 days 16:47:18.677845,153,3.0,0.0,-290,4565,950.0
307150.0,3,1.5,1480,6752,1.0,4,7,1480,0.0,1959,1450,8023,23077 days 16:47:18.677845,191,2.0,0.0,30,-1271,1480.0
729032.0,4,2.5,2840,12866,1.0,4,9,1780,1060.0,1977,2840,13209,16502 days 16:47:18.677845,182,1.6,1.679245283018868,0,-343,720.0
750000.0,5,2.5,3240,9960,1.0,3,8,2020,1220.0,1958,2730,10400,23442 days 16:47:18.677845,062,2.0,1.6557377049180328,510,-440,800.0
289000.0,4,2.5,1961,3207,2.0,3,7,1961,0.0,2006,1961,3401,5910 days 16:47:18.677845,034,1.6,0.0,0,-194,1961.0
480000.0,3,1.0,1100,5700,1.0,3,7,1100,0.0,1950,1560,6588,26364 days 16:47:18.677845,105,3.0,0.0,-460,-888,1100.0
529000.0,3,1.75,1500,7367,1.0,3,8,1500,0.0,1974,1920,7579,17598 days 16:47:18.677845,050,1.7142857142857142,0.0,-420,-212,1500.0
585000.0,3,1.75,1480,4800,2.0,4,7,1140,340.0,1944,1810,4800,28556 days 16:47:18.677845,209,1.7142857142857142,3.3529411764705883,-330,0,800.0
704000.0,4,2.75,2510,12500,1.0,5,8,2050,460.0,1976,2200,12088,16868 days 16:47:18.677845,268,1.4545454545454546,4.456521739130435,310,412,1590.0
607000.0,4,2.0,1490,4054,1.5,5,7,1490,0.0,1926,1510,3889,35130 days 16:47:18.677845,063,2.0,0.0,-20,165,1490.0
580000.0,3,2.25,2190,8188,2.0,3,8,1810,380.0,1978,2190,8374,16137 days 16:47:18.677845,069,1.3333333333333333,4.7631578947368425,0,-186,1430.0
875000.0,5,2.5,2530,8564,2.0,4,8,2530,0.0,1976,2480,8714,16868 days 16:47:18.677845,217,2.0,0.0,50,-150,2530.0
610000.0,4,2.5,2440,9350,1.0,4,8,1560,880.0,1976,2260,8500,16868 days 16:47:18.677845,288,1.6,1.7727272727272727,180,850,680.0
230000.0,3,0.75,1040,15000,1.0,3,6,1040,0.0,1941,1410,19000,29651 days 16:47:18.677845,209,4.0,0.0,-370,-4000,1040.0
510000.0,4,2.25,2450,62290,2.0,3,8,2450,0.0,1976,2450,41181,16868 days 16:47:18.677845,159,1.7777777777777777,0.0,0,21109,2450.0
733000.0,4,2.5,2210,5002,1.0,3,7,1370,840.0,1977,1970,4920,16502 days 16:47:18.677845,064,1.6,1.630952380952381,240,82,530.0
169100.0,3,2.0,1050,18304,1.0,4,7,1050,0.0,1953,1690,15675,25268 days 16:47:18.677845,226,1.5,0.0,-640,2629,1050.0
250000.0,3,2.0,1050,18304,1.0,4,7,1050,0.0,1953,1690,15675,25268 days 16:47:18.677845,126,1.5,0.0,-640,2629,1050.0
500000.0,4,2.25,2730,35100,2.0,3,8,2730,0.0,1977,2730,36677,16502 days 16:47:18.677845,307,1.7777777777777777,0.0,0,-1577,2730.0
700000.0,2,1.0,1620,9855,1.0,3,8,1320,300.0,1948,1820,7700,27095 days 16:47:18.677845,280,2.0,4.4,-200,2155,1020.0
379000.0,4,2.75,2410,5225,2.0,3,8,2410,0.0,2001,2300,5378,7736 days 16:47:18.677845,356,1.4545454545454546,0.0,110,-153,2410.0
650000.0,4,2.5,3420,222156,2.0,3,9,3420,0.0,2002,3340,222156,7371 days 16:47:18.677845,196,1.6,0.0,80,0,3420.0
412133.0,2,1.0,920,4400,1.0,3,7,920,0.0,1948,1560,4600,27095 days 16:47:18.677845,323,2.0,0.0,-640,-200,920.0
480000.0,4,2.25,2330,14190,1.0,3,8,1740,590.0,1962,2330,14190,21981 days 16:47:18.677845,092,1.7777777777777777,2.9491525423728815,0,0,1150.0
650000.0,3,1.75,1940,10245,1.0,3,7,1940,0.0,1957,2720,11448,23807 days 16:47:18.677845,352,1.7142857142857142,0.0,-780,-1203,1940.0
505000.0,2,2.5,1900,5065,2.0,3,8,1900,0.0,2005,1350,4664,6275 days 16:47:18.677845,089,0.8,0.0,550,401,1900.0
931088.0,4,2.5,3510,17400,1.0,4,9,1930,1580.0,1957,2730,12120,23807 days 16:47:18.677845,125,1.6,1.2215189873417722,780,5280,350.0
570000.0,4,1.75,1860,7700,1.0,4,8,1860,0.0,1964,1860,7700,21251 days 16:47:18.677845,269,2.2857142857142856,0.0,0,0,1860.0
475000.0,3,1.0,1380,4635,1.0,4,6,1380,0.0,1919,1790,4635,37687 days 16:47:18.677845,225,3.0,0.0,-410,0,1380.0
240000.0,6,1.75,2210,8594,1.0,3,7,1310,900.0,1959,1850,8594,23077 days 16:47:18.677845,217,3.4285714285714284,1.4555555555555555,360,0,410.0
462000.0,4,2.5,2640,47480,1.0,4,8,1590,1050.0,1979,2390,67415,15772 days 16:47:18.677845,014,1.6,1.5142857142857142,250,-19935,540.0
1120000.0,3,2.5,4530,22873,2.0,5,8,3220,1310.0,1912,3100,18210,40244 days 16:47:18.677845,041,1.2,2.4580152671755724,1430,4663,1910.0
243000.0,3,1.0,1500,6600,1.0,2,6,1500,0.0,1970,1730,6600,19059 days 16:47:18.677845,259,3.0,0.0,-230,0,1500.0
660000.0,4,2.25,2010,15375,1.0,4,8,2010,0.0,1957,1930,15375,23807 days 16:47:18.677845,042,1.7777777777777777,0.0,80,0,2010.0
1190000.0,2,1.75,2080,8112,1.0,4,8,1040,1040.0,1939,2030,8408,30382 days 16:47:18.677845,286,1.1428571428571428,1.0,50,-296,0.0
1680000.0,4,4.25,5584,68257,2.0,3,1,5584,0.0,1998,5030,101901,8832 days 16:47:18.677845,144,0.9411764705882353,0.0,554,-33644,5584.0
6890000.0,6,7.75,9890,31374,2.0,3,1,8860,1030.0,2001,4540,42730,7736 days 16:47:18.677845,262,0.7741935483870968,8.601941747572816,5350,-11356,7830.0
368000.0,3,2.5,2080,4307,2.0,3,7,2080,0.0,2004,2080,4947,6641 days 16:47:18.677845,253,1.2,0.0,0,-640,2080.0
811500.0,5,4.25,3970,4500,2.0,3,9,2860,1110.0,2004,3480,4500,6641 days 16:47:18.677845,324,1.1764705882352942,2.5765765765765765,490,0,1750.0
275000.0,2,1.0,770,8149,1.0,5,6,770,0.0,1948,770,8150,27095 days 16:47:18.677845,155,2.0,0.0,0,-1,770.0
650000.0,4,2.5,2500,6005,2.0,3,9,2500,0.0,2001,2680,7200,7736 days 16:47:18.677845,272,1.6,0.0,-180,-1195,2500.0
485000.0,3,2.0,2410,50654,1.5,3,7,2410,0.0,1995,1900,36300,9928 days 16:47:18.677845,050,1.5,0.0,510,14354,2410.0
425000.0,3,2.5,1340,10018,1.0,4,7,1340,0.0,1976,2520,13068,16868 days 16:47:18.677845,227,1.2,0.0,-1180,-3050,1340.0
530000.0,3,2.5,2640,13775,1.0,3,8,1550,1090.0,1978,2120,12432,16137 days 16:47:18.677845,344,1.2,1.4220183486238531,520,1343,460.0
657000.0,4,1.75,2740,8520,1.0,3,8,1370,1370.0,1954,2740,9286,24903 days 16:47:18.677845,142,2.2857142857142856,1.0,0,-766,0.0
315000.0,4,2.75,1580,3770,1.0,3,7,1080,500.0,2002,1740,3800,7371 days 16:47:18.677845,365,1.4545454545454546,2.16,-160,-30,580.0
273000.0,4,1.5,2180,22870,1.0,4,6,1280,900.0,1954,2420,22614,24903 days 16:47:18.677845,133,2.6666666666666665,1.4222222222222223,-240,256,380.0
550000.0,3,2.75,1960,13252,1.0,5,8,1240,720.0,1975,2040,9866,17233 days 16:47:18.677845,258,1.0909090909090908,1.7222222222222223,-80,3386,520.0
347000.0,2,2.25,1560,1705,2.0,3,8,1270,290.0,2006,1560,1758,5910 days 16:47:18.677845,349,0.8888888888888888,4.379310344827586,0,-53,980.0
525000.0,5,2.75,2440,8000,1.0,4,7,1240,1200.0,1972,1780,8391,18329 days 16:47:18.677845,157,1.8181818181818181,1.0333333333333334,660,-391,40.0
490000.0,3,1.5,990,1343,2.0,3,8,840,150.0,2007,1350,2521,5545 days 16:47:18.677845,268,2.0,5.6,-360,-1178,690.0
500000.0,3,2.25,2210,7916,2.0,3,8,2210,0.0,1978,1450,7955,16137 days 16:47:18.677845,363,1.3333333333333333,0.0,760,-39,2210.0
585000.0,3,2.75,3080,7282,2.0,3,9,3080,0.0,2008,3080,7274,5180 days 16:47:18.677845,028,1.0909090909090908,0.0,0,8,3080.0
926500.0,4,2.75,2900,17802,1.0,3,9,1750,1150.0,1981,2900,15720,15041 days 16:47:18.677845,310,1.4545454545454546,1.5217391304347827,0,2082,600.0
465000.0,1,1.0,1020,3200,1.0,3,7,1020,0.0,1927,1670,3480,34765 days 16:47:18.677845,297,1.0,0.0,-650,-280,1020.0
200000.0,4,2.0,1900,8160,1.0,3,7,1900,0.0,1975,1280,6532,17233 days 16:47:18.677845,086,2.0,0.0,620,1628,1900.0
1680000.0,6,4.75,5770,16747,2.0,3,1,4500,1270.0,1998,4470,14571,8832 days 16:47:18.677845,026,1.263157894736842,3.543307086614173,1300,2176,3230.0
220500.0,2,1.0,990,57499,1.0,2,6,990,0.0,1949,2090,27442,26729 days 16:47:18.677845,266,2.0,0.0,-1100,30057,990.0
329000.0,2,1.0,990,57499,1.0,2,6,990,0.0,1949,2090,27442,26729 days 16:47:18.677845,124,2.0,0.0,-1100,30057,990.0
715000.0,3,4.0,2080,2250,3.0,3,8,2080,0.0,1997,2080,2250,9197 days 16:47:18.677845,184,0.75,0.0,0,0,2080.0
780000.0,3,4.0,2080,2250,3.0,3,8,2080,0.0,1997,2080,2250,9197 days 16:47:18.677845,114,0.75,0.0,0,0,2080.0
410000.0,2,1.0,1480,4080,1.0,3,7,1050,430.0,1949,1310,4080,26729 days 16:47:18.677845,230,2.0,2.441860465116279,170,0,620.0
778100.0,2,1.0,1480,4080,1.0,3,7,1050,430.0,1949,1310,4080,26729 days 16:47:18.677845,126,2.0,2.441860465116279,170,0,620.0
406000.0,3,1.0,1090,11292,1.0,4,7,1090,0.0,1952,1570,8198,25634 days 16:47:18.677845,089,3.0,0.0,-480,3094,1090.0
665000.0,4,2.5,2800,5900,1.0,3,8,1660,1140.0,1963,2580,5900,21616 days 16:47:18.677845,125,1.6,1.456140350877193,220,0,520.0
305000.0,2,1.0,1000,8212,1.0,4,7,1000,0.0,1947,1620,8214,27460 days 16:47:18.677845,329,2.0,0.0,-620,-2,1000.0
265000.0,3,2.5,1640,7668,2.0,3,7,1640,0.0,1991,1850,7200,11389 days 16:47:18.677845,234,1.2,0.0,-210,468,1640.0
485000.0,4,1.0,1620,4080,1.5,3,7,1620,0.0,1923,1760,4080,36226 days 16:47:18.677845,275,4.0,0.0,-140,0,1620.0
510000.0,2,1.5,1860,5100,1.0,3,7,1060,800.0,1940,1710,5100,30017 days 16:47:18.677845,111,1.3333333333333333,1.325,150,0,260.0
195000.0,2,1.0,1080,3899,1.0,4,8,1080,0.0,1972,1090,3899,18329 days 16:47:18.677845,141,2.0,0.0,-10,0,1080.0
432500.0,3,1.75,1980,5100,1.0,3,7,1270,710.0,1965,1400,5100,20885 days 16:47:18.677845,148,1.7142857142857142,1.7887323943661972,580,0,560.0
490000.0,3,1.75,1510,8433,1.0,4,7,1220,290.0,1967,1950,8199,20155 days 16:47:18.677845,344,1.7142857142857142,4.206896551724138,-440,234,930.0
270000.0,3,2.5,1690,7165,2.0,4,7,1690,0.0,1992,1410,8590,11024 days 16:47:18.677845,192,1.2,0.0,280,-1425,1690.0
370000.0,2,1.5,1010,2102,2.0,3,7,1010,0.0,1984,1480,2632,13946 days 16:47:18.677845,238,1.3333333333333333,0.0,-470,-530,1010.0
327500.0,3,2.5,2090,12027,2.0,3,8,2090,0.0,1991,2090,12666,11389 days 16:47:18.677845,349,1.2,0.0,0,-639,2090.0
826000.0,2,1.0,1060,6120,1.0,3,7,1060,0.0,1908,1730,4080,41705 days 16:47:18.677845,082,2.0,0.0,-670,2040,1060.0
510000.0,3,1.75,1750,7020,2.0,3,7,1750,0.0,1934,1170,9546,32208 days 16:47:18.677845,182,1.7142857142857142,0.0,580,-2526,1750.0
587750.0,2,1.0,890,4730,1.0,3,7,890,0.0,1941,1330,5904,29651 days 16:47:18.677845,070,2.0,0.0,-440,-1174,890.0
449228.0,5,2.5,3020,24750,1.0,3,8,1650,1370.0,1965,2930,16062,20885 days 16:47:18.677845,086,2.0,1.2043795620437956,90,8688,280.0
565000.0,3,2.5,2030,217805,1.0,3,9,2030,0.0,1999,1870,109468,8467 days 16:47:18.677845,245,1.2,0.0,160,108337,2030.0
660000.0,4,2.5,3170,186436,2.0,3,9,3170,0.0,2000,3250,215186,8102 days 16:47:18.677845,114,1.6,0.0,-80,-28750,3170.0
400000.0,5,2.75,2470,19200,1.0,5,8,1250,1220.0,1977,2140,35140,16502 days 16:47:18.677845,337,1.8181818181818181,1.0245901639344261,330,-15940,30.0
612500.0,4,2.0,2060,5000,1.0,3,7,1030,1030.0,1949,1280,5000,26729 days 16:47:18.677845,126,2.0,1.0,780,0,0.0
560000.0,4,1.75,2120,6250,1.0,5,7,1060,1060.0,1917,1410,6250,38417 days 16:47:18.677845,072,2.2857142857142856,1.0,710,0,0.0
727000.0,3,2.25,2180,4200,1.5,5,8,1520,660.0,1939,1850,4200,30382 days 16:47:18.677845,246,1.3333333333333333,2.303030303030303,330,0,860.0
224000.0,4,3.0,2300,7609,2.0,4,7,2300,0.0,1976,940,5937,16868 days 16:47:18.677845,113,1.3333333333333333,0.0,1360,1672,2300.0
1080000.0,4,2.5,4200,35267,2.0,3,1,4200,0.0,1990,3540,22234,11754 days 16:47:18.677845,290,1.6,0.0,660,13033,4200.0
439000.0,3,2.25,1480,7565,1.0,3,7,1220,260.0,1977,1660,7565,16502 days 16:47:18.677845,113,1.3333333333333333,4.6923076923076925,-180,0,960.0
335000.0,3,1.5,2240,87625,1.5,2,7,1480,760.0,1980,1920,110206,15407 days 16:47:18.677845,128,2.0,1.9473684210526316,320,-22581,720.0
779000.0,4,1.5,2740,4912,1.0,4,8,1370,1370.0,1937,2160,5006,31112 days 16:47:18.677845,289,2.6666666666666665,1.0,580,-94,0.0
452000.0,5,1.75,1830,47916,1.5,3,6,1830,0.0,1948,2010,13135,27095 days 16:47:18.677845,211,2.857142857142857,0.0,-180,34781,1830.0
775000.0,4,3.0,2000,5304,1.5,4,7,2000,0.0,1947,1670,5304,27460 days 16:47:18.677845,086,1.3333333333333333,0.0,330,0,2000.0
235000.0,3,1.75,1380,8362,1.0,3,7,1380,0.0,1967,1380,8800,20155 days 16:47:18.677845,259,1.7142857142857142,0.0,0,-438,1380.0
370000.0,3,1.75,1620,37913,2.0,4,7,1620,0.0,1953,2190,21518,25268 days 16:47:18.677845,301,1.7142857142857142,0.0,-570,16395,1620.0
790000.0,4,3.0,3180,12070,2.0,4,9,3180,0.0,1976,3110,12600,16868 days 16:47:18.677845,318,1.3333333333333333,0.0,70,-530,3180.0
903000.0,2,1.5,1140,7800,1.0,4,6,1140,0.0,1947,2020,7800,27460 days 16:47:18.677845,335,1.3333333333333333,0.0,-880,0,1140.0
209950.0,3,1.0,970,9583,1.0,4,6,970,0.0,1967,970,7875,20155 days 16:47:18.677845,178,3.0,0.0,0,1708,970.0
309000.0,3,2.5,1780,7859,2.0,3,7,1780,0.0,1988,1670,6618,12485 days 16:47:18.677845,239,1.2,0.0,110,1241,1780.0
440000.0,3,1.75,2240,8153,1.0,3,7,1120,1120.0,1948,1710,8100,27095 days 16:47:18.677845,160,1.7142857142857142,1.0,530,53,0.0
571500.0,4,2.25,2810,25990,2.0,3,8,1860,950.0,1959,2020,16140,23077 days 16:47:18.677845,279,1.7777777777777777,1.9578947368421054,790,9850,910.0
514000.0,2,1.0,920,4000,1.0,4,7,920,0.0,1906,1300,4000,42435 days 16:47:18.677845,227,2.0,0.0,-380,0,920.0
323000.0,3,1.75,1830,12500,1.0,3,7,1200,630.0,1947,1830,7300,27460 days 16:47:18.677845,209,1.7142857142857142,1.9047619047619047,0,5200,570.0
290000.0,2,1.75,1560,7575,1.0,3,8,1560,0.0,2002,2050,9000,7371 days 16:47:18.677845,307,1.1428571428571428,0.0,-490,-1425,1560.0
2580000.0,4,4.25,5540,15408,2.0,3,1,4280,1260.0,2006,3570,14750,5910 days 16:47:18.677845,339,0.9411764705882353,3.3968253968253967,1970,658,3020.0
1360000.0,3,2.0,2310,21318,1.0,3,1,2310,0.0,1979,2950,21814,15772 days 16:47:18.677845,282,1.5,0.0,-640,-496,2310.0
960000.0,4,2.5,3430,43560,1.5,5,1,3430,0.0,1979,3700,44431,15772 days 16:47:18.677845,296,1.6,0.0,-270,-871,3430.0
720000.0,5,2.5,2900,9525,2.0,3,9,2900,0.0,1989,2910,11854,12119 days 16:47:18.677845,307,2.0,0.0,-10,-2329,2900.0
218000.0,3,1.75,1850,7684,1.0,3,8,1320,530.0,1979,1940,7630,15772 days 16:47:18.677845,126,1.7142857142857142,2.490566037735849,-90,54,790.0
334950.0,4,2.5,2190,7000,2.0,3,8,2190,0.0,1997,2040,7700,9197 days 16:47:18.677845,357,1.6,0.0,150,-700,2190.0
605000.0,4,2.25,2510,31584,2.0,4,9,2510,0.0,1979,2510,39221,15772 days 16:47:18.677845,210,1.7777777777777777,0.0,0,-7637,2510.0
825000.0,4,3.25,3200,4477,2.0,3,9,2390,810.0,2006,1830,4920,5910 days 16:47:18.677845,351,1.2307692307692308,2.950617283950617,1370,-443,1580.0
268500.0,4,1.75,1670,8000,1.0,4,8,1670,0.0,1974,1720,8000,17598 days 16:47:18.677845,224,2.2857142857142856,0.0,-50,0,1670.0
230000.0,3,1.75,1010,9600,1.0,5,7,1010,0.0,1969,1320,9600,19424 days 16:47:18.677845,178,1.7142857142857142,0.0,-310,0,1010.0
1340000.0,4,4.0,5050,202554,2.0,3,1,3260,1790.0,2000,3370,213444,8102 days 16:47:18.677845,325,1.0,1.8212290502793296,1680,-10890,1470.0
245500.0,2,1.5,1430,9782,1.0,3,7,1430,0.0,1955,1430,9828,24538 days 16:47:18.677845,091,1.3333333333333333,0.0,0,-46,1430.0
440000.0,3,2.25,1880,7989,1.0,3,7,1280,600.0,1982,1820,7414,14676 days 16:47:18.677845,210,1.3333333333333333,2.1333333333333333,60,575,680.0
571500.0,4,2.75,2180,5799,2.0,4,8,2180,0.0,1993,2060,6061,10658 days 16:47:18.677845,280,1.4545454545454546,0.0,120,-262,2180.0
182500.0,3,2.25,1830,4744,2.0,3,7,1830,0.0,1997,1670,8001,9197 days 16:47:18.677845,117,1.3333333333333333,0.0,160,-3257,1830.0
217000.0,2,1.0,970,5600,1.0,3,6,970,0.0,1951,1020,5600,25999 days 16:47:18.677845,301,2.0,0.0,-50,0,970.0
501000.0,2,1.0,1010,4320,1.0,5,7,1010,0.0,1924,1680,4320,35861 days 16:47:18.677845,144,2.0,0.0,-670,0,1010.0
339950.0,3,2.5,2140,7641,1.0,3,8,1290,850.0,1979,2090,8000,15772 days 16:47:18.677845,300,1.2,1.5176470588235293,50,-359,440.0
340000.0,3,1.75,2230,10403,1.0,3,8,1630,600.0,1968,1730,9450,19790 days 16:47:18.677845,021,1.7142857142857142,2.716666666666667,500,953,1030.0
582500.0,2,1.0,1140,23779,1.5,3,6,1140,0.0,1966,2940,8417,20520 days 16:47:18.677845,035,2.0,0.0,-1800,15362,1140.0
298800.0,2,1.0,860,8189,1.0,3,6,860,0.0,1948,1180,8189,27095 days 16:47:18.677845,237,2.0,0.0,-320,0,860.0
317500.0,6,1.75,2540,8400,1.0,3,8,1340,1200.0,1977,1900,7695,16502 days 16:47:18.677845,071,3.4285714285714284,1.1166666666666667,640,705,140.0
598000.0,4,2.5,2420,5118,1.5,5,7,1550,870.0,1926,1740,5750,35130 days 16:47:18.677845,092,1.6,1.7816091954022988,680,-632,680.0
375000.0,2,2.25,1640,2240,2.0,3,8,1640,0.0,1980,1640,2240,15407 days 16:47:18.677845,120,0.8888888888888888,0.0,0,0,1640.0
465000.0,4,2.25,2550,7650,2.0,4,9,2550,0.0,1996,2550,7650,9563 days 16:47:18.677845,016,1.7777777777777777,0.0,0,0,2550.0
551870.0,3,2.5,2507,18400,2.0,3,8,2507,0.0,2006,1520,14709,5910 days 16:47:18.677845,056,1.2,0.0,987,3691,2507.0
295000.0,3,2.5,1920,7229,2.0,3,8,1920,0.0,1993,2310,8009,10658 days 16:47:18.677845,128,1.2,0.0,-390,-780,1920.0
263500.0,4,1.75,2210,6375,1.0,3,8,1640,570.0,1977,2070,7210,16502 days 16:47:18.677845,267,2.2857142857142856,2.8771929824561404,140,-835,1070.0
1100000.0,4,4.0,3530,8400,2.0,5,8,2630,900.0,1958,2340,8216,23442 days 16:47:18.677845,167,1.0,2.922222222222222,1190,184,1730.0
300000.0,2,1.0,1100,4010,1.5,5,6,1100,0.0,1920,980,4501,37322 days 16:47:18.677845,316,2.0,0.0,120,-491,1100.0
780000.0,4,1.0,3390,4500,1.5,3,8,2190,1200.0,1924,2030,4872,35861 days 16:47:18.677845,203,4.0,1.825,1360,-372,990.0
325000.0,3,1.5,1590,7936,1.0,3,7,1590,0.0,1956,1590,7936,24173 days 16:47:18.677845,086,2.0,0.0,0,0,1590.0
370000.0,2,1.0,820,6550,1.0,3,7,820,0.0,1949,1640,6550,26729 days 16:47:18.677845,219,2.0,0.0,-820,0,820.0
715000.0,4,2.5,2370,10000,1.0,5,8,1660,710.0,1974,2480,9875,17598 days 16:47:18.677845,206,1.6,2.3380281690140845,-110,125,950.0
356000.0,4,2.0,1600,12500,1.0,5,7,1600,0.0,1938,1260,8306,30747 days 16:47:18.677845,016,2.0,0.0,340,4194,1600.0
329950.0,4,1.75,1740,7208,1.5,3,8,1740,0.0,1976,1680,7350,16868 days 16:47:18.677845,083,2.2857142857142856,0.0,60,-142,1740.0
490000.0,3,2.25,1470,2500,2.0,3,8,1080,390.0,1984,1640,4300,13946 days 16:47:18.677845,174,1.3333333333333333,2.769230769230769,-170,-1800,690.0
429000.0,3,3.25,1410,1246,3.0,3,8,1410,0.0,2005,1410,1253,6275 days 16:47:18.677845,161,0.9230769230769231,0.0,0,-7,1410.0
510000.0,4,2.5,1620,8125,2.0,4,7,1620,0.0,1983,1480,8120,14311 days 16:47:18.677845,090,1.6,0.0,140,5,1620.0
550000.0,3,2.5,2360,4080,2.0,3,7,2360,0.0,2003,2290,4080,7006 days 16:47:18.677845,267,1.2,0.0,70,0,2360.0
467500.0,3,1.0,1830,6453,1.0,4,7,1830,0.0,1956,1670,8012,24173 days 16:47:18.677845,005,3.0,0.0,160,-1559,1830.0
615000.0,5,2.0,2130,4180,1.5,5,7,1270,860.0,1926,1710,4180,35130 days 16:47:18.677845,174,2.5,1.4767441860465116,420,0,410.0
325000.0,2,1.0,990,15120,1.0,4,6,990,0.0,1953,1300,11500,25268 days 16:47:18.677845,286,2.0,0.0,-310,3620,990.0
219950.0,2,1.0,1010,4120,2.0,3,6,1010,0.0,1907,1200,4120,42070 days 16:47:18.677845,220,2.0,0.0,-190,0,1010.0
950000.0,3,1.0,1720,9830,1.0,4,7,1720,0.0,1946,3200,8923,27825 days 16:47:18.677845,103,3.0,0.0,-1480,907,1720.0
925000.0,3,1.0,1630,3200,1.5,4,8,1630,0.0,1912,1710,3600,40244 days 16:47:18.677845,265,3.0,0.0,-80,-400,1630.0
251200.0,4,1.5,1310,8250,1.0,3,7,1060,250.0,1953,1260,8255,25268 days 16:47:18.677845,139,2.6666666666666665,4.24,50,-5,810.0
215000.0,3,1.5,1610,5304,1.0,4,6,1610,0.0,1968,1060,5304,19790 days 16:47:18.677845,261,2.0,0.0,550,0,1610.0
245000.0,3,2.0,1850,8208,1.0,4,7,1180,670.0,1970,1790,8174,19059 days 16:47:18.677845,217,1.5,1.7611940298507462,60,34,510.0
349950.0,4,1.5,1420,6720,1.5,3,7,1420,0.0,1925,1560,5600,35495 days 16:47:18.677845,317,2.6666666666666665,0.0,-140,1120,1420.0
1570000.0,5,4.5,5220,67319,2.0,3,1,5220,0.0,2001,4190,40609,7736 days 16:47:18.677845,322,1.1111111111111112,0.0,1030,26710,5220.0
600000.0,2,1.0,1410,4500,1.0,3,7,1020,390.0,1939,1300,4500,30382 days 16:47:18.677845,128,2.0,2.6153846153846154,110,0,630.0
405000.0,2,1.5,1170,1274,3.0,3,8,1170,0.0,2001,1290,1308,7736 days 16:47:18.677845,275,1.3333333333333333,0.0,-120,-34,1170.0
625000.0,3,2.5,1860,10027,2.0,3,8,1860,0.0,1993,1530,9204,10658 days 16:47:18.677845,336,1.2,0.0,330,823,1860.0
430000.0,4,1.0,1620,37075,1.5,3,7,1620,0.0,1943,2190,87117,28921 days 16:47:18.677845,198,4.0,0.0,-570,-50042,1620.0
533000.0,3,3.0,1280,1085,3.0,3,8,1280,0.0,2004,1300,1310,6641 days 16:47:18.677845,119,1.0,0.0,-20,-225,1280.0
1050000.0,4,2.5,2750,9949,2.0,3,1,2750,0.0,1999,2750,9860,8467 days 16:47:18.677845,209,1.6,0.0,0,89,2750.0
230000.0,3,1.75,1420,3000,1.0,3,5,710,710.0,1931,1960,5000,33304 days 16:47:18.677845,297,1.7142857142857142,1.0,-540,-2000,0.0
275000.0,4,1.75,2000,8700,1.0,5,7,1010,990.0,1975,1490,7350,17233 days 16:47:18.677845,248,2.2857142857142856,1.02020202020202,510,1350,20.0
403000.0,2,1.0,1100,3598,1.0,4,7,1100,0.0,1926,1240,3598,35130 days 16:47:18.677845,161,2.0,0.0,-140,0,1100.0
550388.0,3,3.0,1720,70567,1.0,5,7,1720,0.0,1966,2740,70567,20520 days 16:47:18.677845,253,1.0,0.0,-1020,0,1720.0
415500.0,3,1.5,1240,12400,1.0,3,7,1240,0.0,1958,1640,9600,23442 days 16:47:18.677845,265,2.0,0.0,-400,2800,1240.0
913000.0,3,1.75,2170,4000,1.0,4,7,1110,1060.0,1925,1890,4000,35495 days 16:47:18.677845,110,1.7142857142857142,1.0471698113207548,280,0,50.0
334998.0,2,1.0,1800,5182,1.0,3,6,900,900.0,1942,1570,5876,29286 days 16:47:18.677845,072,2.0,1.0,230,-694,0.0
201500.0,3,1.0,1160,8320,1.0,4,7,1160,0.0,1959,1480,7800,23077 days 16:47:18.677845,129,3.0,0.0,-320,520,1160.0
820000.0,3,2.5,3030,46538,2.0,3,1,3030,0.0,1997,3370,51450,9197 days 16:47:18.677845,086,1.2,0.0,-340,-4912,3030.0
371000.0,3,1.0,890,7200,1.0,3,7,890,0.0,1951,1630,7455,25999 days 16:47:18.677845,162,3.0,0.0,-740,-255,890.0
229950.0,4,2.5,2150,7670,1.0,5,7,1240,910.0,1976,1610,7350,16868 days 16:47:18.677845,295,1.6,1.3626373626373627,540,320,330.0
344900.0,4,2.5,2150,7670,1.0,5,7,1240,910.0,1976,1610,7350,16868 days 16:47:18.677845,112,1.6,1.3626373626373627,540,320,330.0
840000.0,3,2.5,2060,9715,2.0,3,8,2060,0.0,1924,1240,7072,35861 days 16:47:18.677845,232,1.2,0.0,820,2643,2060.0
285000.0,3,1.5,1380,12196,1.0,4,7,1380,0.0,1967,1600,10720,20155 days 16:47:18.677845,259,2.0,0.0,-220,1476,1380.0
475000.0,4,2.25,1800,7200,1.0,3,7,1230,570.0,1979,2260,7498,15772 days 16:47:18.677845,085,1.7777777777777777,2.1578947368421053,-460,-298,660.0
420000.0,2,1.0,1460,7832,1.0,3,6,1460,0.0,1924,1460,7632,35861 days 16:47:18.677845,062,2.0,0.0,0,200,1460.0
685000.0,3,2.0,2210,5000,1.5,3,7,1710,500.0,1909,1920,5000,41339 days 16:47:18.677845,303,1.5,3.42,290,0,1210.0
879000.0,4,3.0,3590,89640,2.0,3,1,3590,0.0,2005,2790,54014,6275 days 16:47:18.677845,202,1.3333333333333333,0.0,800,35626,3590.0
197200.0,3,1.0,1140,8775,1.0,3,6,990,150.0,1942,1300,8775,29286 days 16:47:18.677845,020,3.0,6.6,-160,0,840.0
529950.0,3,1.0,1240,5000,1.5,5,7,1240,0.0,1909,1240,4900,41339 days 16:47:18.677845,184,3.0,0.0,0,100,1240.0
1090000.0,4,2.5,4340,141570,2.5,3,1,4340,0.0,1992,2720,97138,11024 days 16:47:18.677845,125,1.6,0.0,1620,44432,4340.0
792000.0,3,1.5,1570,1050,2.0,3,8,1570,0.0,1915,2070,3600,39148 days 16:47:18.677845,140,2.0,0.0,-500,-2550,1570.0
262000.0,3,2.5,1680,10300,2.0,4,7,1680,0.0,1994,1680,9849,10293 days 16:47:18.677845,232,1.2,0.0,0,451,1680.0
353900.0,3,1.75,1560,5760,1.0,5,6,780,780.0,1927,1320,7680,34765 days 16:47:18.677845,280,1.7142857142857142,1.0,240,-1920,0.0
380000.0,1,1.5,1200,44866,1.5,3,7,1200,0.0,1983,1480,67082,14311 days 16:47:18.677845,230,0.6666666666666666,0.0,-280,-22216,1200.0
305000.0,3,2.5,1690,5175,2.0,3,7,1690,0.0,2002,1830,5175,7371 days 16:47:18.677845,086,1.2,0.0,-140,0,1690.0
440000.0,4,2.0,2310,5004,1.0,3,7,1430,880.0,1994,1630,5060,10293 days 16:47:18.677845,110,2.0,1.625,680,-56,550.0
1010000.0,4,3.5,2650,3060,2.0,3,9,2060,590.0,2001,1470,3060,7736 days 16:47:18.677845,168,1.1428571428571428,3.4915254237288136,1180,0,1470.0
549900.0,5,3.0,3610,7555,2.0,3,8,3610,0.0,2003,3610,7979,7006 days 16:47:18.677845,262,1.6666666666666667,0.0,0,-424,3610.0
270000.0,3,2.25,1760,8287,1.0,3,7,1160,600.0,1986,1290,9587,13215 days 16:47:18.677845,238,1.3333333333333333,1.9333333333333333,470,-1300,560.0
430000.0,3,1.0,940,12521,1.5,4,7,940,0.0,1949,1920,9046,26729 days 16:47:18.677845,089,3.0,0.0,-980,3475,940.0
1930000.0,5,4.25,4830,8050,2.5,4,1,3710,1120.0,1914,4470,9194,39513 days 16:47:18.677845,181,1.1764705882352942,3.3125,360,-1144,2590.0
790500.0,4,2.75,3350,5416,2.0,3,9,3350,0.0,2014,3625,5637,2988 days 16:47:18.677845,225,1.4545454545454546,0.0,-275,-221,3350.0
447450.0,3,2.25,1570,7200,2.0,3,8,1570,0.0,1991,1620,7318,11389 days 16:47:18.677845,290,1.3333333333333333,0.0,-50,-118,1570.0
375000.0,3,2.0,2240,5200,1.0,3,7,1630,610.0,1954,1470,3775,24903 days 16:47:18.677845,040,1.5,2.6721311475409837,770,1425,1020.0
565000.0,4,2.0,1950,9940,1.0,4,7,1950,0.0,1963,1920,9270,21616 days 16:47:18.677845,037,2.0,0.0,30,670,1950.0
400000.0,2,1.0,1010,3916,1.0,4,6,810,200.0,1918,1580,3888,38052 days 16:47:18.677845,113,2.0,4.05,-570,28,610.0
246000.0,3,1.5,1630,10200,1.0,4,8,1300,330.0,1976,1960,6700,16868 days 16:47:18.677845,051,2.0,3.9393939393939394,-330,3500,970.0
329922.0,3,1.75,1420,6289,1.0,3,7,1100,320.0,1967,1460,7402,20155 days 16:47:18.677845,302,1.7142857142857142,3.4375,-40,-1113,780.0
1250000.0,5,3.25,3950,44431,1.0,3,1,2100,1850.0,1969,3860,45870,19424 days 16:47:18.677845,104,1.5384615384615385,1.135135135135135,90,-1439,250.0
375000.0,3,1.0,1210,7425,1.0,4,6,1210,0.0,1910,1260,7425,40974 days 16:47:18.677845,110,3.0,0.0,-50,0,1210.0
385000.0,3,1.75,1890,9920,1.0,3,7,1230,660.0,1944,1380,9086,28556 days 16:47:18.677845,128,1.7142857142857142,1.8636363636363635,510,834,570.0
591500.0,4,2.5,1690,4080,1.5,4,7,1140,550.0,1912,1600,4590,40244 days 16:47:18.677845,246,1.6,2.0727272727272728,90,-510,590.0
255000.0,4,2.0,2560,12155,1.0,4,7,1350,1210.0,1960,1790,11906,22712 days 16:47:18.677845,261,2.0,1.115702479338843,770,249,140.0
275000.0,3,1.5,1350,7800,1.0,3,7,1350,0.0,1959,1510,8040,23077 days 16:47:18.677845,075,2.0,0.0,-160,-240,1350.0
800000.0,4,2.75,3120,5000,2.0,3,9,3120,0.0,2010,3200,5000,4449 days 16:47:18.677845,363,1.4545454545454546,0.0,-80,0,3120.0
327000.0,2,1.0,1140,7435,1.0,3,7,1140,0.0,1952,1320,9385,25634 days 16:47:18.677845,115,2.0,0.0,-180,-1950,1140.0
355000.0,4,1.5,2230,11536,1.0,4,7,1220,1010.0,1954,2170,12465,24903 days 16:47:18.677845,364,2.6666666666666665,1.2079207920792079,60,-929,210.0
310000.0,2,1.0,1050,8220,1.0,4,6,780,270.0,1947,1340,7651,27460 days 16:47:18.677845,276,2.0,2.888888888888889,-290,569,510.0
869000.0,5,3.25,4180,49222,2.0,4,8,2880,1300.0,1979,3170,8029,15772 days 16:47:18.677845,139,1.5384615384615385,2.2153846153846155,1010,41193,1580.0
272000.0,3,2.0,1200,5700,1.0,5,7,1200,0.0,1942,1190,6384,29286 days 16:47:18.677845,220,1.5,0.0,10,-684,1200.0
665000.0,5,2.25,3320,60984,2.0,3,9,3320,0.0,2000,1580,55322,8102 days 16:47:18.677845,192,2.2222222222222223,0.0,1740,5662,3320.0
225000.0,3,2.5,1590,8449,2.0,3,7,1590,0.0,1989,1750,7172,12119 days 16:47:18.677845,321,1.2,0.0,-160,1277,1590.0
375000.0,3,2.5,2750,37096,2.0,3,9,2750,0.0,1989,2700,40091,12119 days 16:47:18.677845,360,1.2,0.0,50,-2995,2750.0
375500.0,3,1.5,1530,7200,1.0,3,8,1530,0.0,1975,2150,7216,17233 days 16:47:18.677845,161,2.0,0.0,-620,-16,1530.0
550000.0,3,1.75,1570,6500,1.0,3,7,920,650.0,1948,1570,5750,27095 days 16:47:18.677845,092,1.7142857142857142,1.4153846153846155,0,750,270.0
248000.0,3,1.0,1470,7680,1.0,3,7,1220,250.0,1946,1470,6784,27825 days 16:47:18.677845,261,3.0,4.88,0,896,970.0
546940.0,3,1.0,1470,7680,1.0,3,7,1220,250.0,1946,1470,6784,27825 days 16:47:18.677845,126,3.0,4.88,0,896,970.0
680000.0,4,3.0,3150,6175,2.0,3,9,3150,0.0,2001,3150,6986,7736 days 16:47:18.677845,245,1.3333333333333333,0.0,0,-811,3150.0
350000.0,4,2.5,2380,6124,2.0,3,8,2380,0.0,1997,2170,6097,9197 days 16:47:18.677845,199,1.6,0.0,210,27,2380.0
593000.0,2,2.5,2000,2500,3.0,3,8,1810,190.0,1994,1970,5650,10293 days 16:47:18.677845,084,0.8,9.526315789473685,30,-3150,1620.0
390000.0,2,1.0,1140,8147,1.0,3,7,1140,0.0,1958,1260,8148,23442 days 16:47:18.677845,078,2.0,0.0,-120,-1,1140.0
297000.0,3,1.0,1340,18000,1.0,4,7,1340,0.0,1924,1660,196591,35861 days 16:47:18.677845,280,3.0,0.0,-320,-178591,1340.0
355000.0,2,1.0,1450,9150,1.0,4,7,1450,0.0,1965,1440,10636,20885 days 16:47:18.677845,064,2.0,0.0,10,-1486,1450.0
309900.0,3,2.5,2020,26670,2.0,3,7,2020,0.0,1987,1680,10939,12850 days 16:47:18.677845,226,1.2,0.0,340,15731,2020.0
257000.0,3,2.25,1810,12000,2.0,3,7,1810,0.0,1992,1720,9916,11024 days 16:47:18.677845,267,1.3333333333333333,0.0,90,2084,1810.0
1700000.0,4,3.0,3600,9687,2.0,4,9,3600,0.0,1959,2620,10400,23077 days 16:47:18.677845,238,1.3333333333333333,0.0,980,-713,3600.0
300000.0,3,2.0,1260,2550,2.0,3,7,1260,0.0,1987,1590,3825,12850 days 16:47:18.677845,013,1.5,0.0,-330,-1275,1260.0
900000.0,8,4.0,4020,7500,1.0,3,8,2010,2010.0,1968,1560,3737,19790 days 16:47:18.677845,289,2.0,1.0,2460,3763,0.0
695000.0,4,3.0,3150,9130,2.0,3,9,3150,0.0,2001,2970,6228,7736 days 16:47:18.677845,135,1.3333333333333333,0.0,180,2902,3150.0
213400.0,4,2.5,1680,6655,2.0,3,7,1680,0.0,2001,1680,6982,7736 days 16:47:18.677845,352,1.6,0.0,0,-327,1680.0
425000.0,2,1.0,1320,8830,1.0,3,7,1020,300.0,1939,1620,8531,30382 days 16:47:18.677845,190,2.0,3.4,-300,299,720.0
420000.0,3,3.0,2700,47050,2.0,4,9,1570,1130.0,1986,2260,45901,13215 days 16:47:18.677845,223,1.0,1.3893805309734513,440,1149,440.0
411000.0,1,1.0,1080,5000,1.5,3,7,1080,0.0,1948,1620,4000,27095 days 16:47:18.677845,040,1.0,0.0,-540,1000,1080.0
762500.0,4,2.25,3130,41382,2.0,3,9,3130,0.0,1986,3130,54886,13215 days 16:47:18.677845,040,1.7777777777777777,0.0,0,-13504,3130.0
569950.0,5,4.5,4850,40902,2.0,3,1,4850,0.0,2001,1640,13503,7736 days 16:47:18.677845,147,1.1111111111111112,0.0,3210,27399,4850.0
258000.0,4,1.0,1220,8500,1.5,5,6,1220,0.0,1916,1460,8500,38783 days 16:47:18.677845,114,4.0,0.0,-240,0,1220.0
499000.0,3,2.25,1780,3665,2.0,3,8,1780,0.0,2004,1770,3669,6641 days 16:47:18.677845,055,1.3333333333333333,0.0,10,-4,1780.0
310000.0,3,1.0,1250,10723,1.0,4,7,1250,0.0,1961,1520,10723,22346 days 16:47:18.677845,131,3.0,0.0,-270,0,1250.0
398500.0,2,2.5,1780,1311,3.0,3,8,1350,430.0,2005,1390,1227,6275 days 16:47:18.677845,307,0.8,3.13953488372093,390,84,920.0
250600.0,4,2.5,1930,8660,1.0,3,7,1120,810.0,1981,1830,9591,15041 days 16:47:18.677845,164,1.6,1.382716049382716,100,-931,310.0
352000.0,4,2.5,2470,6116,1.0,3,7,1420,1050.0,1985,1670,7627,13580 days 16:47:18.677845,224,1.6,1.3523809523809525,800,-1511,370.0
600000.0,2,1.0,1180,2160,1.0,3,7,940,240.0,1909,2700,5400,41339 days 16:47:18.677845,196,2.0,3.9166666666666665,-1520,-3240,700.0
645000.0,3,1.0,2270,4182,1.0,4,7,1170,1100.0,1946,1860,4080,27825 days 16:47:18.677845,083,3.0,1.0636363636363637,410,102,70.0
291500.0,4,2.5,1770,5000,2.0,3,7,1770,0.0,2004,2080,5100,6641 days 16:47:18.677845,205,1.6,0.0,-310,-100,1770.0
350000.0,4,1.75,2250,13515,1.0,4,8,2150,100.0,1940,2150,12508,30017 days 16:47:18.677845,128,2.2857142857142856,21.5,100,1007,2050.0
279000.0,3,2.5,1540,7280,1.0,3,7,1080,460.0,1974,1220,6440,17598 days 16:47:18.677845,262,1.2,2.347826086956522,320,840,620.0
320000.0,2,1.0,820,5400,1.0,3,6,820,0.0,1940,1370,5632,30017 days 16:47:18.677845,063,2.0,0.0,-550,-232,820.0
495000.0,2,2.0,1580,5203,1.0,3,8,1580,0.0,2004,1560,4770,6641 days 16:47:18.677845,069,1.0,0.0,20,433,1580.0
490000.0,4,2.5,2430,42646,1.0,3,7,1450,980.0,1989,2000,38159,12119 days 16:47:18.677845,240,1.6,1.4795918367346939,430,4487,470.0
770000.0,5,1.5,2160,5000,1.5,4,8,2160,0.0,1926,1450,4265,35130 days 16:47:18.677845,198,3.3333333333333335,0.0,710,735,2160.0
215000.0,3,1.75,1770,29004,1.0,3,8,1770,0.0,1959,2300,24534,23077 days 16:47:18.677845,190,1.7142857142857142,0.0,-530,4470,1770.0
665000.0,3,3.5,3580,95832,1.5,3,9,3580,0.0,2005,2880,60548,6275 days 16:47:18.677845,089,0.8571428571428571,0.0,700,35284,3580.0
423500.0,3,2.25,1890,7498,1.0,3,7,1190,700.0,1987,1660,8100,12850 days 16:47:18.677845,231,1.3333333333333333,1.7,230,-602,490.0
850000.0,3,3.0,1910,4800,1.5,3,9,1910,0.0,1900,1280,1310,44626 days 16:47:18.677845,282,1.0,0.0,630,3490,1910.0
155000.0,2,1.0,910,6232,1.0,3,6,910,0.0,1943,1070,6232,28921 days 16:47:18.677845,133,2.0,0.0,-160,0,910.0
505000.0,3,2.25,1460,7210,1.0,3,7,1460,0.0,1963,1850,7519,21616 days 16:47:18.677845,103,1.3333333333333333,0.0,-390,-309,1460.0
780000.0,3,3.5,3310,5558,2.0,3,9,3310,0.0,2005,3310,5270,6275 days 16:47:18.677845,058,0.8571428571428571,0.0,0,288,3310.0
165000.0,3,1.5,1630,22764,1.0,3,7,1630,0.0,1970,1620,17859,19059 days 16:47:18.677845,237,2.0,0.0,10,4905,1630.0
707000.0,2,2.5,2130,5001,1.0,5,8,1330,800.0,1972,1750,6000,18329 days 16:47:18.677845,240,0.8,1.6625,380,-999,530.0
497000.0,3,2.5,1220,1475,3.0,3,8,1220,0.0,2000,1220,1546,8102 days 16:47:18.677845,121,1.2,0.0,0,-71,1220.0
349170.0,4,1.75,1670,8856,1.0,3,7,1070,600.0,1955,1660,8088,24538 days 16:47:18.677845,309,2.2857142857142856,1.7833333333333334,10,768,470.0
287000.0,4,1.5,1300,10050,1.5,3,7,1300,0.0,1963,1730,10050,21616 days 16:47:18.677845,002,2.6666666666666665,0.0,-430,0,1300.0
2380000.0,4,2.5,3220,20251,1.0,3,1,3220,0.0,1969,4200,22114,19424 days 16:47:18.677845,323,1.6,0.0,-980,-1863,3220.0
645000.0,4,2.5,2430,14400,1.0,5,8,1670,760.0,1963,2140,9048,21616 days 16:47:18.677845,153,1.6,2.1973684210526314,290,5352,910.0
238000.0,5,2.25,2240,9652,2.0,3,7,2240,0.0,1990,2180,11644,11754 days 16:47:18.677845,289,2.2222222222222223,0.0,60,-1992,2240.0
328000.0,5,2.25,2240,9652,2.0,3,7,2240,0.0,1990,2180,11644,11754 days 16:47:18.677845,044,2.2222222222222223,0.0,60,-1992,2240.0
365000.0,2,1.5,790,1123,2.0,3,8,700,90.0,2003,1370,1281,7006 days 16:47:18.677845,307,1.3333333333333333,7.777777777777778,-580,-158,610.0
380000.0,3,1.0,1380,8147,1.0,4,7,1380,0.0,1948,1360,8147,27095 days 16:47:18.677845,076,3.0,0.0,20,0,1380.0
525000.0,4,1.5,1680,10500,2.0,3,7,1680,0.0,1962,1830,10264,21981 days 16:47:18.677845,069,2.6666666666666665,0.0,-150,236,1680.0
402000.0,4,2.25,2000,3672,2.0,5,7,1650,350.0,1926,2000,5100,35130 days 16:47:18.677845,176,1.7777777777777777,4.714285714285714,0,-1428,1300.0
308000.0,2,1.0,1680,9250,1.0,3,7,860,820.0,1969,1590,9542,19424 days 16:47:18.677845,114,2.0,1.048780487804878,90,-292,40.0
405000.0,3,2.5,1960,6997,2.0,3,7,1960,0.0,2006,2320,5178,5910 days 16:47:18.677845,282,1.2,0.0,-360,1819,1960.0
808000.0,3,1.75,2590,32380,1.0,3,8,2590,0.0,1951,2340,28456,25999 days 16:47:18.677845,266,1.7142857142857142,0.0,250,3924,2590.0
875000.0,4,3.5,3790,6874,2.5,3,9,3790,0.0,2010,3370,6535,4449 days 16:47:18.677845,041,1.1428571428571428,0.0,420,339,3790.0
860000.0,3,2.5,2370,55321,3.0,4,8,2370,0.0,1982,2590,41553,14676 days 16:47:18.677845,078,1.2,0.0,-220,13768,2370.0
367500.0,4,2.25,1930,7925,1.0,3,8,1300,630.0,1960,1930,7200,22712 days 16:47:18.677845,223,1.7777777777777777,2.0634920634920637,0,725,670.0
604000.0,6,3.5,2580,13572,1.0,3,8,1290,1290.0,1987,2020,11656,12850 days 16:47:18.677845,217,1.7142857142857142,1.0,560,1916,0.0
230000.0,2,0.75,890,19703,1.0,3,6,890,0.0,1934,1270,9800,32208 days 16:47:18.677845,035,2.6666666666666665,0.0,-380,9903,890.0
435000.0,4,2.75,2160,8148,1.0,3,7,1410,750.0,1978,2060,8100,16137 days 16:47:18.677845,351,1.4545454545454546,1.88,100,48,660.0
525000.0,4,1.75,1570,16697,1.0,3,7,1030,540.0,1981,1560,9698,15041 days 16:47:18.677845,077,2.2857142857142856,1.9074074074074074,10,6999,490.0
280000.0,2,1.5,1480,15641,1.0,4,7,1480,0.0,1940,1520,7525,30017 days 16:47:18.677845,154,1.3333333333333333,0.0,-40,8116,1480.0
490000.0,2,1.5,1480,15641,1.0,4,7,1480,0.0,1940,1520,7525,30017 days 16:47:18.677845,036,1.3333333333333333,0.0,-40,8116,1480.0
265000.0,4,1.75,1430,5490,1.0,5,6,1430,0.0,1942,1030,5900,29286 days 16:47:18.677845,082,2.2857142857142856,0.0,400,-410,1430.0
645000.0,4,2.25,2720,18295,1.0,4,8,2000,720.0,1979,2720,18295,15772 days 16:47:18.677845,245,1.7777777777777777,2.7777777777777777,0,0,1280.0
390000.0,3,2.25,2420,31497,1.0,4,8,1750,670.0,1964,2040,30472,21251 days 16:47:18.677845,117,1.3333333333333333,2.611940298507463,380,1025,1080.0
267500.0,3,2.5,1400,7629,1.0,3,7,1120,280.0,1988,1530,7688,12485 days 16:47:18.677845,107,1.2,4.0,-130,-59,840.0
1280000.0,4,3.5,5844,10766,2.0,3,1,5844,0.0,2007,3413,10766,5545 days 16:47:18.677845,351,1.1428571428571428,0.0,2431,0,5844.0
404000.0,4,1.75,1840,10720,1.0,3,7,960,880.0,1958,1840,9044,23442 days 16:47:18.677845,126,2.2857142857142856,1.0909090909090908,0,1676,80.0
380000.0,3,2.25,2530,12042,2.0,3,8,2530,0.0,1989,2480,10172,12119 days 16:47:18.677845,119,1.3333333333333333,0.0,50,1870,2530.0
812500.0,4,2.75,2810,10300,1.0,4,9,1810,1000.0,1978,2710,9900,16137 days 16:47:18.677845,220,1.4545454545454546,1.81,100,400,810.0
265000.0,3,1.0,1020,8610,1.0,5,7,1020,0.0,1959,1070,5940,23077 days 16:47:18.677845,184,3.0,0.0,-50,2670,1020.0
480000.0,5,2.75,2550,7725,1.0,5,8,1390,1160.0,1967,2450,7725,20155 days 16:47:18.677845,190,1.8181818181818181,1.1982758620689655,100,0,230.0
264000.0,1,1.0,710,4725,1.0,3,6,710,0.0,1939,900,5250,30382 days 16:47:18.677845,259,1.0,0.0,-190,-525,710.0
1350000.0,5,3.0,5530,38816,1.5,3,1,5530,0.0,1969,3800,44417,19424 days 16:47:18.677845,113,1.6666666666666667,0.0,1730,-5601,5530.0
550000.0,4,1.75,2150,9000,1.0,4,7,1110,1040.0,1966,2040,9000,20520 days 16:47:18.677845,190,2.2857142857142856,1.0673076923076923,110,0,70.0
615000.0,2,1.5,880,2400,1.5,3,7,880,0.0,1929,1220,4440,34034 days 16:47:18.677845,124,1.3333333333333333,0.0,-340,-2040,880.0
464000.0,3,1.75,1630,28600,1.0,3,8,1630,0.0,1967,2260,26000,20155 days 16:47:18.677845,139,1.7142857142857142,0.0,-630,2600,1630.0
365000.0,3,1.0,1380,30940,2.0,3,8,1380,0.0,1976,2350,32500,16868 days 16:47:18.677845,197,3.0,0.0,-970,-1560,1380.0
490000.0,4,2.25,2800,10800,1.0,3,8,1680,1120.0,1977,2260,9800,16502 days 16:47:18.677845,196,1.7777777777777777,1.5,540,1000,560.0
282613.0,2,1.0,830,6017,1.0,4,6,830,0.0,1954,1340,6040,24903 days 16:47:18.677845,136,2.0,0.0,-510,-23,830.0
675000.0,3,2.25,2770,15886,2.0,3,1,2770,0.0,1982,3290,15886,14676 days 16:47:18.677845,296,1.3333333333333333,0.0,-520,0,2770.0
575550.0,4,2.5,2060,7475,1.0,3,8,1440,620.0,1985,2280,8396,13580 days 16:47:18.677845,138,1.6,2.3225806451612905,-220,-921,820.0
259900.0,3,2.0,1490,7770,1.0,4,7,1490,0.0,1990,1540,7366,11754 days 16:47:18.677845,140,1.5,0.0,-50,404,1490.0
450000.0,4,2.25,2120,8267,2.0,3,8,2120,0.0,1996,2150,7746,9563 days 16:47:18.677845,343,1.7777777777777777,0.0,-30,521,2120.0
487500.0,4,2.5,2810,6296,2.0,3,9,2810,0.0,2013,2850,6140,3353 days 16:47:18.677845,210,1.6,0.0,-40,156,2810.0
275000.0,4,2.25,2400,17842,2.0,4,7,2400,0.0,1973,1610,12100,17963 days 16:47:18.677845,028,1.7777777777777777,0.0,790,5742,2400.0
305000.0,3,2.5,2460,5027,2.0,3,8,2460,0.0,2002,2740,5000,7371 days 16:47:18.677845,223,1.2,0.0,-280,27,2460.0
395000.0,3,1.75,2030,217800,1.0,4,8,2030,0.0,1977,2570,216057,16502 days 16:47:18.677845,283,1.7142857142857142,0.0,-540,1743,2030.0
215000.0,3,1.0,880,7648,1.0,4,6,880,0.0,1940,1020,7566,30017 days 16:47:18.677845,112,3.0,0.0,-140,82,880.0
410000.0,3,2.0,1320,6000,1.5,4,7,1320,0.0,1920,1620,4000,37322 days 16:47:18.677845,189,1.5,0.0,-300,2000,1320.0
440000.0,4,2.5,2160,7826,1.0,4,7,1390,770.0,1976,2190,9900,16868 days 16:47:18.677845,177,1.6,1.8051948051948052,-30,-2074,620.0
1160000.0,4,3.5,4190,15724,2.0,3,1,4190,0.0,1994,3300,10113,10293 days 16:47:18.677845,241,1.1428571428571428,0.0,890,5611,4190.0
500000.0,4,2.0,2280,7200,1.0,4,7,2280,0.0,1956,1100,7620,24173 days 16:47:18.677845,329,2.0,0.0,1180,-420,2280.0
961000.0,5,2.75,2590,6120,2.0,3,8,2590,0.0,1909,1390,3060,41339 days 16:47:18.677845,324,1.8181818181818181,0.0,1200,3060,2590.0
825000.0,4,2.25,2770,9340,2.0,4,9,2770,0.0,1979,3010,9340,15772 days 16:47:18.677845,205,1.7777777777777777,0.0,-240,0,2770.0
734000.0,3,1.75,2145,3840,1.5,5,8,2145,0.0,1910,1140,3840,40974 days 16:47:18.677845,307,1.7142857142857142,0.0,1005,0,2145.0
490000.0,4,4.25,4480,5715,2.0,3,7,3680,800.0,2003,2190,6070,7006 days 16:47:18.677845,275,0.9411764705882353,4.6,2290,-355,2880.0
175000.0,4,2.5,1780,6000,2.0,3,7,1780,0.0,1991,1630,6000,11389 days 16:47:18.677845,183,1.6,0.0,150,0,1780.0
190000.0,1,1.0,720,4800,1.0,3,6,720,0.0,1914,1240,4860,39513 days 16:47:18.677845,169,1.0,0.0,-520,-60,720.0
305000.0,4,2.25,2050,12581,2.0,4,7,2050,0.0,1978,1620,7400,16137 days 16:47:18.677845,224,1.7777777777777777,0.0,430,5181,2050.0
1300000.0,3,1.0,2040,7936,1.0,5,8,1680,360.0,1940,2300,10080,30017 days 16:47:18.677845,075,3.0,4.666666666666667,-260,-2144,1320.0
417000.0,2,1.0,920,6600,1.0,3,6,920,0.0,1919,1510,5944,37687 days 16:47:18.677845,160,2.0,0.0,-590,656,920.0
275000.0,2,1.0,680,4190,1.0,2,5,680,0.0,1906,1070,4175,42435 days 16:47:18.677845,317,2.0,0.0,-390,15,680.0
661000.0,3,2.5,1940,8196,2.0,3,8,1940,0.0,1991,2070,8514,11389 days 16:47:18.677845,344,1.2,0.0,-130,-318,1940.0
435000.0,4,2.75,2230,9640,1.0,3,8,1320,910.0,1998,2100,9600,8832 days 16:47:18.677845,189,1.4545454545454546,1.4505494505494505,130,40,410.0
788000.0,5,2.25,2910,9454,1.0,3,8,1910,1000.0,1972,2400,10690,18329 days 16:47:18.677845,296,2.2222222222222223,1.91,510,-1236,910.0
1800000.0,5,3.25,5270,17232,2.0,3,1,4010,1260.0,1977,3550,13917,16502 days 16:47:18.677845,161,1.5384615384615385,3.1825396825396823,1720,3315,2750.0
570000.0,2,1.0,1790,3760,1.5,4,8,1490,300.0,1912,1458,3760,40244 days 16:47:18.677845,293,2.0,4.966666666666667,332,0,1190.0
1540000.0,5,3.25,2920,6960,2.0,3,9,2120,800.0,1953,2470,6735,25268 days 16:47:18.677845,127,1.5384615384615385,2.65,450,225,1320.0
400000.0,2,1.0,840,5510,1.0,3,7,840,0.0,1955,1630,5510,24538 days 16:47:18.677845,125,2.0,0.0,-790,0,840.0
247000.0,3,1.75,1820,8740,1.0,4,8,1820,0.0,1987,2210,8320,12850 days 16:47:18.677845,290,1.7142857142857142,0.0,-390,420,1820.0
453000.0,3,1.75,1550,7200,1.0,3,7,1100,450.0,1949,1560,7440,26729 days 16:47:18.677845,063,1.7142857142857142,2.4444444444444446,-10,-240,650.0
235000.0,2,1.0,1270,3008,1.0,4,6,650,620.0,1923,1270,1514,36226 days 16:47:18.677845,128,2.0,1.0483870967741935,0,1494,30.0
675000.0,4,1.75,2460,5750,1.5,5,7,1620,840.0,1919,1760,4830,37687 days 16:47:18.677845,111,2.2857142857142856,1.9285714285714286,700,920,780.0
516200.0,3,2.0,2110,5150,1.0,5,6,1080,1030.0,1919,1170,5107,37687 days 16:47:18.677845,161,1.5,1.0485436893203883,940,43,50.0
650000.0,1,1.0,920,91476,1.5,3,6,920,0.0,1996,1746,91476,9563 days 16:47:18.677845,195,1.0,0.0,-826,0,920.0
257100.0,3,1.5,1500,10227,1.0,4,7,1000,500.0,1945,1490,7670,28190 days 16:47:18.677845,350,2.0,2.0,10,2557,500.0
457000.0,2,2.0,1440,9985,1.0,3,8,1440,0.0,2006,1510,4560,5910 days 16:47:18.677845,089,1.0,0.0,-70,5425,1440.0
540000.0,3,1.75,1610,3478,1.5,4,7,1060,550.0,1929,1610,3478,34034 days 16:47:18.677845,321,1.7142857142857142,1.9272727272727272,0,0,510.0
268000.0,3,1.75,1970,10270,1.0,4,8,1970,0.0,1966,1970,8400,20520 days 16:47:18.677845,154,1.7142857142857142,0.0,0,1870,1970.0
300000.0,3,1.0,1150,7314,1.0,3,7,1150,0.0,1960,1350,7350,22712 days 16:47:18.677845,189,3.0,0.0,-200,-36,1150.0
380000.0,2,2.5,2110,114127,1.0,4,8,1590,520.0,1975,1960,11250,17233 days 16:47:18.677845,252,0.8,3.0576923076923075,150,102877,1070.0
725000.0,3,2.5,3580,54450,1.5,3,9,3580,0.0,1990,3090,35943,11754 days 16:47:18.677845,178,1.2,0.0,490,18507,3580.0
249000.0,3,1.0,1000,19204,1.0,3,7,1000,0.0,1968,2450,25927,19790 days 16:47:18.677845,174,3.0,0.0,-1450,-6723,1000.0
274000.0,5,1.0,1680,9383,1.0,3,7,1400,280.0,1929,1680,9458,34034 days 16:47:18.677845,217,5.0,5.0,0,-75,1120.0
1780000.0,4,3.25,3950,10912,2.0,3,1,3950,0.0,2003,3000,10998,7006 days 16:47:18.677845,119,1.2307692307692308,0.0,950,-86,3950.0
396500.0,3,1.75,2390,7149,1.0,3,8,1350,1040.0,1955,1710,7402,24538 days 16:47:18.677845,174,1.7142857142857142,1.2980769230769231,680,-253,310.0
460000.0,2,1.5,1820,7800,1.0,4,7,1240,580.0,1956,1400,7800,24173 days 16:47:18.677845,323,1.3333333333333333,2.1379310344827585,420,0,660.0
277000.0,3,1.0,1100,8536,1.0,4,7,1100,0.0,1957,1570,8040,23807 days 16:47:18.677845,167,3.0,0.0,-470,496,1100.0
449500.0,6,4.0,2280,5275,1.0,3,7,1270,1010.0,1998,1760,6642,8832 days 16:47:18.677845,308,1.5,1.2574257425742574,520,-1367,260.0
785950.0,4,3.0,2530,4560,1.5,3,7,1540,990.0,1925,1640,4560,35495 days 16:47:18.677845,246,1.3333333333333333,1.5555555555555556,890,0,550.0
545000.0,3,2.5,1940,9775,1.0,3,8,1440,500.0,1975,2830,9775,17233 days 16:47:18.677845,167,1.2,2.88,-890,0,940.0
244000.0,3,2.0,1360,9688,1.0,4,7,1360,0.0,1983,1390,9685,14311 days 16:47:18.677845,356,1.5,0.0,-30,3,1360.0
165000.0,3,2.5,1660,2415,2.0,3,7,1660,0.0,1983,1740,2624,14311 days 16:47:18.677845,234,1.2,0.0,-80,-209,1660.0
435000.0,2,1.0,800,5000,1.0,3,7,800,0.0,1906,1410,5000,42435 days 16:47:18.677845,160,2.0,0.0,-610,0,800.0
642000.0,3,2.5,2670,10082,1.0,3,1,2670,0.0,1987,2740,10854,12850 days 16:47:18.677845,150,1.2,0.0,-70,-772,2670.0
340000.0,3,2.5,1720,4120,2.0,3,7,1720,0.0,1999,1720,5544,8467 days 16:47:18.677845,099,1.2,0.0,0,-1424,1720.0
730000.0,4,2.5,3550,35689,2.0,4,9,3550,0.0,1991,3350,35711,11389 days 16:47:18.677845,203,1.6,0.0,200,-22,3550.0
563250.0,3,1.75,1370,2800,1.0,5,7,800,570.0,1982,2270,3773,14676 days 16:47:18.677845,023,1.7142857142857142,1.4035087719298245,-900,-973,230.0
675000.0,5,2.5,2820,67518,2.0,3,8,2820,0.0,1979,2820,48351,15772 days 16:47:18.677845,122,2.0,0.0,0,19167,2820.0
620000.0,3,1.5,1620,6630,1.0,3,8,1280,340.0,1954,1880,5100,24903 days 16:47:18.677845,132,2.0,3.764705882352941,-260,1530,940.0
275000.0,2,2.0,1290,9041,1.0,3,7,950,340.0,1956,1290,5000,24173 days 16:47:18.677845,344,1.0,2.7941176470588234,0,4041,610.0
270000.0,3,1.0,1830,8209,1.0,3,7,1830,0.0,1942,2150,12000,29286 days 16:47:18.677845,132,3.0,0.0,-320,-3791,1830.0
325000.0,4,2.5,2040,5472,2.0,3,8,2040,0.0,2003,2420,5782,7006 days 16:47:18.677845,105,1.6,0.0,-380,-310,2040.0
476100.0,4,2.5,1850,1836,2.0,3,7,1600,250.0,2005,1770,2236,6275 days 16:47:18.677845,276,1.6,6.4,80,-400,1350.0
700000.0,2,1.0,1300,12000,1.0,4,8,1300,0.0,1959,2420,15000,23077 days 16:47:18.677845,293,2.0,0.0,-1120,-3000,1300.0
220000.0,4,2.0,1620,5200,1.5,4,7,1620,0.0,1978,1500,5200,16137 days 16:47:18.677845,269,2.0,0.0,120,0,1620.0
236000.0,3,1.75,1560,10919,1.0,3,7,1560,0.0,1975,1730,10919,17233 days 16:47:18.677845,318,1.7142857142857142,0.0,-170,0,1560.0
790000.0,3,2.5,2600,4750,1.0,4,9,1700,900.0,1951,2380,4750,25999 days 16:47:18.677845,122,1.2,1.8888888888888888,220,0,800.0
350000.0,3,1.0,2010,6000,1.0,3,7,1210,800.0,1967,2460,6000,20155 days 16:47:18.677845,232,3.0,1.5125,-450,0,410.0
283200.0,4,2.5,1982,6406,2.0,3,8,1982,0.0,2004,2340,6501,6641 days 16:47:18.677845,147,1.6,0.0,-358,-95,1982.0
273000.0,3,1.0,1500,6250,1.0,3,6,890,610.0,1945,1210,6250,28190 days 16:47:18.677845,288,3.0,1.459016393442623,290,0,280.0
599000.0,5,2.25,2460,8710,1.0,4,8,1330,1130.0,1976,2460,8870,16868 days 16:47:18.677845,349,2.2222222222222223,1.176991150442478,0,-160,200.0
460000.0,4,2.5,2680,11998,1.0,3,8,1510,1170.0,1960,2680,12746,22712 days 16:47:18.677845,113,1.6,1.2905982905982907,0,-748,340.0
1160000.0,4,4.25,5860,52889,2.0,4,1,4910,950.0,1996,3320,39066,9563 days 16:47:18.677845,129,0.9411764705882353,5.168421052631579,2540,13823,3960.0
385000.0,4,1.75,1720,8750,1.0,3,7,860,860.0,1971,1790,8750,18694 days 16:47:18.677845,161,2.2857142857142856,1.0,-70,0,0.0
264250.0,3,1.0,1420,7420,1.5,3,6,1420,0.0,1944,1290,6600,28556 days 16:47:18.677845,253,3.0,0.0,130,820,1420.0
608000.0,3,2.5,1760,1472,3.0,3,8,1640,120.0,2006,1760,5400,5910 days 16:47:18.677845,302,1.2,13.666666666666666,0,-3928,1520.0
450000.0,3,2.5,2790,48994,2.0,4,9,2790,0.0,1984,2550,37834,13946 days 16:47:18.677845,258,1.2,0.0,240,11160,2790.0
1760000.0,3,2.0,2360,4800,2.0,3,9,2360,0.0,1909,2260,4800,41339 days 16:47:18.677845,184,1.5,0.0,100,0,2360.0
339950.0,5,2.0,1890,6050,2.0,4,7,1890,0.0,1944,1170,6050,28556 days 16:47:18.677845,318,2.5,0.0,720,0,1890.0
760000.0,6,3.75,3810,6150,2.0,4,8,3810,0.0,1977,1830,5125,16502 days 16:47:18.677845,100,1.6,0.0,1980,1025,3810.0
350000.0,2,1.0,1160,5395,1.0,3,7,860,300.0,1940,1664,5363,30017 days 16:47:18.677845,098,2.0,2.8666666666666667,-504,32,560.0
541500.0,3,1.75,2320,55847,1.0,4,8,2320,0.0,1960,2400,26112,22712 days 16:47:18.677845,111,1.7142857142857142,0.0,-80,29735,2320.0
730000.0,6,2.75,3280,16449,1.0,4,7,1910,1370.0,1963,2550,9532,21616 days 16:47:18.677845,086,2.1818181818181817,1.3941605839416058,730,6917,540.0
215000.0,3,1.0,980,5600,1.0,2,6,980,0.0,1949,1840,5302,26729 days 16:47:18.677845,119,3.0,0.0,-860,298,980.0
420000.0,3,2.0,1640,9972,1.0,4,7,1640,0.0,1977,1680,10165,16502 days 16:47:18.677845,135,1.5,0.0,-40,-193,1640.0
655000.0,4,2.25,2060,8470,1.0,3,8,1440,620.0,1983,2180,8978,14311 days 16:47:18.677845,150,1.7777777777777777,2.3225806451612905,-120,-508,820.0
240000.0,3,2.5,1500,10652,2.0,4,7,1500,0.0,1981,1610,7417,15041 days 16:47:18.677845,015,1.2,0.0,-110,3235,1500.0
730000.0,4,2.0,2360,6000,1.0,5,7,1260,1100.0,1939,1720,6000,30382 days 16:47:18.677845,153,2.0,1.1454545454545455,640,0,160.0
390000.0,4,1.5,1940,12100,1.0,3,7,1940,0.0,1962,1380,12100,21981 days 16:47:18.677845,286,2.6666666666666665,0.0,560,0,1940.0
473000.0,3,1.0,1280,10000,1.0,4,7,1280,0.0,1954,1240,10000,24903 days 16:47:18.677845,301,3.0,0.0,40,0,1280.0
698000.0,4,3.5,3630,5670,2.0,3,1,3630,0.0,1970,1620,5400,19059 days 16:47:18.677845,083,1.1428571428571428,0.0,2010,270,3630.0
511000.0,3,2.5,1820,4883,2.0,3,9,1820,0.0,2005,2720,5002,6275 days 16:47:18.677845,134,1.2,0.0,-900,-119,1820.0
358000.0,2,1.5,960,1808,2.0,3,7,960,0.0,1993,1290,1668,10658 days 16:47:18.677845,128,1.3333333333333333,0.0,-330,140,960.0
499990.0,3,1.75,1630,8400,1.0,4,7,1060,570.0,1955,1630,7245,24538 days 16:47:18.677845,100,1.7142857142857142,1.8596491228070176,0,1155,490.0
322000.0,4,2.25,1940,10200,1.0,3,7,1360,580.0,1960,1940,10200,22712 days 16:47:18.677845,072,1.7777777777777777,2.3448275862068964,0,0,780.0
201000.0,3,1.0,980,9682,1.0,3,7,980,0.0,1969,1580,9682,19424 days 16:47:18.677845,281,3.0,0.0,-600,0,980.0
765000.0,4,2.5,3140,16200,1.0,3,9,2570,570.0,1988,2530,13200,12485 days 16:47:18.677845,316,1.6,4.508771929824562,610,3000,2000.0
920000.0,4,2.75,2880,5750,1.5,5,9,1710,1170.0,1928,1640,5750,34400 days 16:47:18.677845,157,1.4545454545454546,1.4615384615384615,1240,0,540.0
360000.0,4,2.0,1650,7552,1.0,4,7,860,790.0,1977,1410,7199,16502 days 16:47:18.677845,105,2.0,1.0886075949367089,240,353,70.0
297300.0,3,1.75,1980,9220,2.0,3,8,1980,0.0,1987,2080,8305,12850 days 16:47:18.677845,127,1.7142857142857142,0.0,-100,915,1980.0
399000.0,3,1.0,860,9403,1.0,4,6,860,0.0,1942,2136,13009,29286 days 16:47:18.677845,268,3.0,0.0,-1276,-3606,860.0
400000.0,3,1.0,1430,10005,1.5,4,7,1430,0.0,1950,1720,8822,26364 days 16:47:18.677845,171,3.0,0.0,-290,1183,1430.0
230000.0,3,1.75,1260,10164,1.0,4,6,1260,0.0,1964,1190,10640,21251 days 16:47:18.677845,239,1.7142857142857142,0.0,70,-476,1260.0
290000.0,3,1.0,960,4560,1.0,4,7,960,0.0,1968,970,4800,19790 days 16:47:18.677845,051,3.0,0.0,-10,-240,960.0
323800.0,3,2.5,2060,7658,2.0,3,8,2060,0.0,2003,2250,7299,7006 days 16:47:18.677845,120,1.2,0.0,-190,359,2060.0
574500.0,4,1.5,1430,6380,1.5,4,9,1430,0.0,1930,1220,5112,33669 days 16:47:18.677845,293,2.6666666666666665,0.0,210,1268,1430.0
505000.0,3,2.25,1670,1596,2.0,3,8,1220,450.0,2002,1670,1596,7371 days 16:47:18.677845,142,1.3333333333333333,2.7111111111111112,0,0,770.0
372500.0,2,1.0,880,10950,1.0,4,7,880,0.0,1944,1450,7560,28556 days 16:47:18.677845,112,2.0,0.0,-570,3390,880.0
425000.0,3,1.5,1300,19163,1.0,3,7,1300,0.0,1964,1590,9744,21251 days 16:47:18.677845,182,2.0,0.0,-290,9419,1300.0
446250.0,3,2.5,2380,214315,1.5,3,9,2380,0.0,2000,2400,68824,8102 days 16:47:18.677845,106,1.2,0.0,-20,145491,2380.0
330000.0,2,0.75,520,6862,1.0,4,4,520,0.0,1924,1170,8756,35861 days 16:47:18.677845,226,2.6666666666666665,0.0,-650,-1894,520.0
608095.0,3,2.5,2680,17707,2.0,3,9,2680,0.0,1983,2840,21743,14311 days 16:47:18.677845,117,1.2,0.0,-160,-4036,2680.0
550000.0,3,2.5,2140,10136,1.0,3,8,1320,820.0,1958,1980,11200,23442 days 16:47:18.677845,025,1.2,1.6097560975609757,160,-1064,500.0
265000.0,4,2.5,1820,16103,2.0,3,7,1820,0.0,2004,2120,21277,6641 days 16:47:18.677845,240,1.6,0.0,-300,-5174,1820.0
399888.0,4,2.25,1820,8255,1.5,4,7,1320,500.0,1930,1550,7628,33669 days 16:47:18.677845,170,1.7777777777777777,2.64,270,627,820.0
430000.0,2,1.0,1050,2570,1.0,5,7,850,200.0,1927,1080,2800,34765 days 16:47:18.677845,178,2.0,4.25,-30,-230,650.0
554990.0,3,2.5,2100,6092,2.0,3,8,2100,0.0,2013,2250,8592,3353 days 16:47:18.677845,133,1.2,0.0,-150,-2500,2100.0
359950.0,3,2.5,2210,6280,2.0,3,8,2210,0.0,2003,2250,5972,7006 days 16:47:18.677845,311,1.2,0.0,-40,308,2210.0
405000.0,2,1.0,860,2599,1.0,4,6,860,0.0,1901,1300,3900,44261 days 16:47:18.677845,174,2.0,0.0,-440,-1301,860.0
280000.0,2,1.0,870,4025,1.0,3,7,870,0.0,1981,1370,3488,15041 days 16:47:18.677845,096,2.0,0.0,-500,537,870.0
479950.0,4,2.25,2570,11070,2.0,4,8,2570,0.0,1966,2210,9600,20520 days 16:47:18.677845,098,1.7777777777777777,0.0,360,1470,2570.0
575000.0,5,1.75,2980,53578,1.0,4,9,2230,750.0,1976,2860,75546,16868 days 16:47:18.677845,247,2.857142857142857,2.973333333333333,120,-21968,1480.0
392000.0,4,2.25,2360,7733,2.0,3,8,2360,0.0,1983,2160,7733,14311 days 16:47:18.677845,057,1.7777777777777777,0.0,200,0,2360.0
760500.0,4,2.25,2310,36136,2.0,4,9,2310,0.0,1977,3930,36136,16502 days 16:47:18.677845,056,1.7777777777777777,0.0,-1620,0,2310.0
435000.0,3,2.5,2300,9521,2.0,3,8,2300,0.0,2003,3020,10042,7006 days 16:47:18.677845,167,1.2,0.0,-720,-521,2300.0
1570000.0,4,2.75,2810,8570,2.0,3,1,2810,0.0,1993,2810,9621,10658 days 16:47:18.677845,231,1.4545454545454546,0.0,0,-1051,2810.0
261000.0,4,1.5,2040,10488,1.0,3,7,1190,850.0,1961,1960,10488,22346 days 16:47:18.677845,337,2.6666666666666665,1.4,80,0,340.0
1480000.0,3,2.25,3290,5000,2.0,3,9,2730,560.0,1939,2340,4000,30382 days 16:47:18.677845,127,1.3333333333333333,4.875,950,1000,2170.0
853800.0,7,4.0,2960,2665,2.0,3,9,1950,1010.0,1927,1970,4410,34765 days 16:47:18.677845,120,1.75,1.9306930693069306,990,-1745,940.0
657500.0,3,2.5,2670,10496,2.0,3,9,2670,0.0,1989,2490,8636,12119 days 16:47:18.677845,142,1.2,0.0,180,1860,2670.0
331950.0,4,2.5,2530,9933,2.0,3,8,2010,520.0,1990,2140,9933,11754 days 16:47:18.677845,124,1.6,3.8653846153846154,390,0,1490.0
514000.0,3,1.75,1720,5899,1.0,3,8,1220,500.0,1986,1900,6244,13215 days 16:47:18.677845,162,1.7142857142857142,2.44,-180,-345,720.0
496000.0,3,3.5,3090,27598,2.0,4,9,2020,1070.0,1995,2180,17085,9928 days 16:47:18.677845,255,0.8571428571428571,1.8878504672897196,910,10513,950.0
1090000.0,4,2.5,3930,21894,2.0,3,1,3930,0.0,1987,3930,20000,12850 days 16:47:18.677845,049,1.6,0.0,0,1894,3930.0
195700.0,3,1.0,1120,5200,1.0,5,7,1120,0.0,1976,1690,5200,16868 days 16:47:18.677845,310,3.0,0.0,-570,0,1120.0
1400000.0,4,2.25,3960,8640,2.0,3,9,2630,1330.0,1925,3850,8640,35495 days 16:47:18.677845,210,1.7777777777777777,1.9774436090225564,110,0,1300.0
1180000.0,4,3.25,4060,20822,2.0,3,1,4060,0.0,1991,4170,23958,11389 days 16:47:18.677845,339,1.2307692307692308,0.0,-110,-3136,4060.0
643403.0,3,2.5,2350,9648,1.0,4,9,2350,0.0,1966,2320,10512,20520 days 16:47:18.677845,266,1.2,0.0,30,-864,2350.0
357000.0,4,2.5,2380,7066,2.0,4,7,2380,0.0,1997,2310,8127,9197 days 16:47:18.677845,132,1.6,0.0,70,-1061,2380.0
865000.0,3,1.75,1480,8163,1.0,3,7,1040,440.0,1953,2170,11124,25268 days 16:47:18.678841,098,1.7142857142857142,2.3636363636363638,-690,-2961,600.0
905000.0,3,2.5,2930,9280,2.0,4,1,2930,0.0,1988,2730,10090,12485 days 16:47:18.678841,322,1.2,0.0,200,-810,2930.0
265000.0,3,1.5,1290,7100,1.0,3,6,1290,0.0,1954,1300,7183,24903 days 16:47:18.678841,295,2.0,0.0,-10,-83,1290.0
535000.0,2,2.5,2730,7246,2.0,3,9,2730,0.0,1998,3220,7214,8832 days 16:47:18.678841,358,0.8,0.0,-490,32,2730.0
450000.0,3,1.0,1290,5440,1.0,4,6,790,500.0,1929,1220,5464,34034 days 16:47:18.678841,223,3.0,1.58,70,-24,290.0
460500.0,4,2.5,2170,7533,2.0,3,8,2170,0.0,1991,2170,8728,11389 days 16:47:18.678841,049,1.6,0.0,0,-1195,2170.0
315000.0,4,1.75,1850,8580,1.0,3,7,1140,710.0,1960,2210,9240,22712 days 16:47:18.678841,328,2.2857142857142856,1.6056338028169015,-360,-660,430.0
607500.0,4,2.5,2110,13939,1.0,3,8,1270,840.0,1978,2140,8882,16137 days 16:47:18.678841,044,1.6,1.5119047619047619,-30,5057,430.0
432000.0,2,1.0,960,3235,1.0,4,7,960,0.0,1916,1290,2069,38783 days 16:47:18.678841,026,2.0,0.0,-330,1166,960.0
1700000.0,3,4.0,3910,5350,2.0,5,1,2610,1300.0,1933,2890,5350,32573 days 16:47:18.678841,040,0.75,2.0076923076923077,1020,0,1310.0
479000.0,4,2.5,2590,6139,2.0,3,8,2590,0.0,2001,2410,6139,7736 days 16:47:18.678841,232,1.6,0.0,180,0,2590.0
475000.0,5,2.75,3080,6600,2.0,3,9,3080,0.0,2002,3080,6600,7371 days 16:47:18.678841,079,1.8181818181818181,0.0,0,0,3080.0
415000.0,3,1.0,1630,8146,1.0,3,7,1630,0.0,1952,1480,8146,25634 days 16:47:18.678841,323,3.0,0.0,150,0,1630.0
450000.0,2,1.0,910,5000,1.0,4,6,910,0.0,1914,1480,5000,39513 days 16:47:18.678841,238,2.0,0.0,-570,0,910.0
1140000.0,3,2.5,2780,33503,1.5,4,8,2110,670.0,1969,3150,15542,19424 days 16:47:18.678841,184,1.2,3.1492537313432836,-370,17961,1440.0
430000.0,5,3.0,3880,8432,2.0,3,7,3880,0.0,2004,2620,5623,6641 days 16:47:18.678841,258,1.6666666666666667,0.0,1260,2809,3880.0
296000.0,3,1.75,1360,10742,1.0,5,7,960,400.0,1971,1830,9000,18694 days 16:47:18.678841,246,1.7142857142857142,2.4,-470,1742,560.0
303000.0,4,2.25,2560,8927,1.0,3,7,1790,770.0,1976,1920,9669,16868 days 16:47:18.678841,192,1.7777777777777777,2.324675324675325,640,-742,1020.0
641000.0,4,2.5,2600,6015,2.0,3,8,2600,0.0,2004,2910,5305,6641 days 16:47:18.678841,294,1.6,0.0,-310,710,2600.0
280000.0,3,2.25,1220,5739,1.0,3,7,790,430.0,1984,1870,5739,13946 days 16:47:18.678841,041,1.3333333333333333,1.8372093023255813,-650,0,360.0
260750.0,3,2.0,1560,9635,1.0,3,7,1260,300.0,1966,1570,8276,20520 days 16:47:18.678841,217,1.5,4.2,-10,1359,960.0
601000.0,4,2.5,2080,5191,2.0,3,8,2080,0.0,2001,2170,5518,7736 days 16:47:18.678841,323,1.6,0.0,-90,-327,2080.0
255000.0,3,1.5,1490,6604,1.0,4,6,1490,0.0,1918,1330,6604,38052 days 16:47:18.678841,240,2.0,0.0,160,0,1490.0
555000.0,4,2.75,2020,10720,1.0,4,8,1420,600.0,1976,2190,10164,16868 days 16:47:18.678841,156,1.4545454545454546,2.3666666666666667,-170,556,820.0
865000.0,3,1.5,1530,10827,1.0,4,8,1530,0.0,1955,2050,10827,24538 days 16:47:18.678841,322,2.0,0.0,-520,0,1530.0
1390000.0,4,2.5,3450,17400,1.5,4,9,2180,1270.0,1964,3770,19530,21251 days 16:47:18.678841,265,1.6,1.7165354330708662,-320,-2130,910.0
315000.0,3,2.25,1400,31626,1.0,2,7,1140,260.0,1987,1680,35093,12850 days 16:47:18.678841,140,1.3333333333333333,4.384615384615385,-280,-3467,880.0
200000.0,2,1.0,1730,9610,1.0,3,7,1380,350.0,1962,1310,9812,21981 days 16:47:18.678841,157,2.0,3.942857142857143,420,-202,1030.0
357000.0,3,1.0,1370,6450,1.0,3,7,1370,0.0,1948,1550,6898,27095 days 16:47:18.678841,321,3.0,0.0,-180,-448,1370.0
390000.0,2,1.5,1050,934,2.0,3,8,960,90.0,2007,1470,1885,5545 days 16:47:18.678841,338,1.3333333333333333,10.666666666666666,-420,-951,870.0
462000.0,5,1.75,2840,10220,1.0,4,7,2210,630.0,1954,2000,9750,24903 days 16:47:18.678841,210,2.857142857142857,3.507936507936508,840,470,1580.0
174500.0,2,1.0,1010,5200,1.0,3,7,1010,0.0,1955,1580,7500,24538 days 16:47:18.678841,136,2.0,0.0,-570,-2300,1010.0
305000.0,2,1.0,1210,7140,1.5,3,6,1210,0.0,1921,1150,7376,36956 days 16:47:18.678841,041,2.0,0.0,60,-236,1210.0
449000.0,5,1.75,1720,14040,1.0,4,8,1150,570.0,1956,1750,7800,24173 days 16:47:18.678841,036,2.857142857142857,2.017543859649123,-30,6240,580.0
260000.0,3,2.0,2710,5000,2.0,3,6,2710,0.0,1951,850,5000,25999 days 16:47:18.678841,241,1.5,0.0,1860,0,2710.0
751000.0,4,2.5,3110,6142,2.0,3,9,3110,0.0,2004,3200,6826,6641 days 16:47:18.678841,132,1.6,0.0,-90,-684,3110.0
370037.0,2,1.0,1250,9270,1.0,4,7,1250,0.0,1948,1130,6800,27095 days 16:47:18.678841,091,2.0,0.0,120,2470,1250.0
229950.0,3,1.75,1900,8910,2.0,4,7,1900,0.0,1988,1610,8586,12485 days 16:47:18.678841,237,1.7142857142857142,0.0,290,324,1900.0
349000.0,3,1.75,1740,7682,1.0,3,8,1330,410.0,1978,2010,8820,16137 days 16:47:18.678841,112,1.7142857142857142,3.2439024390243905,-270,-1138,920.0
348000.0,4,2.5,2070,3808,2.0,3,8,2070,0.0,2003,1900,2992,7006 days 16:47:18.678841,020,1.6,0.0,170,816,2070.0
1220000.0,3,3.25,3030,5600,2.0,3,9,2220,810.0,1905,2040,6600,42800 days 16:47:18.678841,107,0.9230769230769231,2.740740740740741,990,-1000,1410.0
510000.0,4,3.0,3610,18948,2.0,3,1,3610,0.0,1993,3568,18948,10658 days 16:47:18.678841,002,1.3333333333333333,0.0,42,0,3610.0
265000.0,3,1.5,1520,6805,1.0,4,7,1040,480.0,1981,1440,7041,15041 days 16:47:18.678841,082,2.0,2.1666666666666665,80,-236,560.0
1250000.0,3,2.75,2780,4815,3.0,3,1,2780,0.0,1974,2820,5000,17598 days 16:47:18.678841,301,1.0909090909090908,0.0,-40,-185,2780.0
937500.0,4,4.0,5545,871200,2.0,3,1,3605,1940.0,2003,3420,871200,7006 days 16:47:18.678841,007,1.0,1.8582474226804124,2125,0,1665.0
485000.0,3,1.75,2590,8384,1.0,4,8,1590,1000.0,1971,2590,8800,18694 days 16:47:18.678841,217,1.7142857142857142,1.59,0,-416,590.0
489000.0,4,1.0,1150,5217,1.5,3,7,1150,0.0,1951,1220,5217,25999 days 16:47:18.678841,079,4.0,0.0,-70,0,1150.0
400000.0,2,1.0,920,5120,1.0,5,7,920,0.0,1952,1190,5120,25634 days 16:47:18.678841,022,2.0,0.0,-270,0,920.0
638000.0,3,2.5,2110,3600,2.0,3,9,2110,0.0,2005,2540,4384,6275 days 16:47:18.678841,167,1.2,0.0,-430,-784,2110.0
440000.0,3,1.75,1170,8740,1.0,4,7,1170,0.0,1968,1870,8448,19790 days 16:47:18.678841,170,1.7142857142857142,0.0,-700,292,1170.0
305000.0,6,2.0,1900,8240,1.0,2,7,1200,700.0,1964,1900,8240,21251 days 16:47:18.678841,176,3.0,1.7142857142857142,0,0,500.0
649950.0,6,2.0,1900,8240,1.0,2,7,1200,700.0,1964,1900,8240,21251 days 16:47:18.678841,078,3.0,1.7142857142857142,0,0,500.0
680000.0,4,2.5,3290,6012,2.0,3,9,3290,0.0,2005,3210,6005,6275 days 16:47:18.678841,044,1.6,0.0,80,7,3290.0
629000.0,4,2.5,2660,22050,2.0,3,9,2660,0.0,1996,3060,21111,9563 days 16:47:18.678841,195,1.6,0.0,-400,939,2660.0
669000.0,4,2.75,2700,35362,2.0,5,8,2700,0.0,1976,2810,35915,16868 days 16:47:18.678841,168,1.4545454545454546,0.0,-110,-553,2700.0
272000.0,3,2.5,1980,6608,2.0,3,8,1980,0.0,1994,2150,7495,10293 days 16:47:18.678841,220,1.2,0.0,-170,-887,1980.0
270000.0,4,2.25,2600,9900,1.0,3,7,1600,1000.0,1965,1770,11250,20885 days 16:47:18.678841,177,1.7777777777777777,1.6,830,-1350,600.0
215000.0,3,1.0,1280,9775,1.0,3,6,1280,0.0,1964,1230,8750,21251 days 16:47:18.678841,006,3.0,0.0,50,1025,1280.0
690000.0,3,1.5,1710,17707,1.0,4,7,1180,530.0,1947,2590,9508,27460 days 16:47:18.678841,092,2.0,2.2264150943396226,-880,8199,650.0
256000.0,4,1.75,1270,6825,1.0,3,7,1270,0.0,1950,1800,6930,26364 days 16:47:18.678841,064,2.2857142857142856,0.0,-530,-105,1270.0
255000.0,3,2.25,1890,7314,1.0,3,7,1100,790.0,1981,1520,7676,15041 days 16:47:18.678841,083,1.3333333333333333,1.3924050632911393,370,-362,310.0
550000.0,7,4.0,3440,8100,2.0,3,7,3440,0.0,1970,1420,1560,19059 days 16:47:18.678841,133,1.75,0.0,2020,6540,3440.0
410000.0,3,1.0,1190,5280,1.0,4,7,1190,0.0,1957,1280,5280,23807 days 16:47:18.678841,128,3.0,0.0,-90,0,1190.0
410000.0,2,1.0,1030,4366,1.0,3,7,1030,0.0,1912,1890,4499,40244 days 16:47:18.678841,310,2.0,0.0,-860,-133,1030.0
259000.0,3,1.75,1240,4000,1.0,3,7,1240,0.0,1986,1570,4586,13215 days 16:47:18.678841,197,1.7142857142857142,0.0,-330,-586,1240.0
292000.0,3,1.0,1730,21183,1.0,3,7,1030,700.0,1955,1610,13000,24538 days 16:47:18.678841,086,3.0,1.4714285714285715,120,8183,330.0
1650000.0,4,3.5,4610,12500,2.0,3,1,4610,0.0,2003,2340,11538,7006 days 16:47:18.678841,224,1.1428571428571428,0.0,2270,962,4610.0
518000.0,5,1.0,1590,5000,1.5,3,7,1190,400.0,1929,1590,5000,34034 days 16:47:18.678841,317,5.0,2.975,0,0,790.0
485000.0,3,2.5,1760,3097,2.0,3,8,1760,0.0,1992,1760,3285,11024 days 16:47:18.678841,064,1.2,0.0,0,-188,1760.0
259500.0,3,2.0,1330,35060,1.0,3,7,1330,0.0,1989,1660,35100,12119 days 16:47:18.678841,062,1.5,0.0,-330,-40,1330.0
354000.0,4,2.5,2340,5420,2.0,3,8,2340,0.0,2003,2420,6252,7006 days 16:47:18.678841,113,1.6,0.0,-80,-832,2340.0
999950.0,3,2.25,3740,22464,2.0,5,8,2330,1410.0,1966,2680,19564,20520 days 16:47:18.678841,082,1.3333333333333333,1.6524822695035462,1060,2900,920.0
464500.0,3,1.75,1150,10466,1.0,5,7,1150,0.0,1959,1350,10384,23077 days 16:47:18.678841,175,1.7142857142857142,0.0,-200,82,1150.0
300000.0,3,2.5,1750,4200,2.0,3,7,1750,0.0,2005,1890,4048,6275 days 16:47:18.678841,237,1.2,0.0,-140,152,1750.0
1080000.0,3,2.75,3890,7216,2.0,3,8,3260,630.0,1967,2490,9920,20155 days 16:47:18.678841,182,1.0909090909090908,5.174603174603175,1400,-2704,2630.0
309950.0,4,2.5,1770,6666,2.0,3,7,1770,0.0,1989,1780,6666,12119 days 16:47:18.678841,202,1.6,0.0,-10,0,1770.0
315000.0,3,1.0,1160,3700,1.5,3,7,1160,0.0,1909,1340,3750,41339 days 16:47:18.678841,260,3.0,0.0,-180,-50,1160.0
499950.0,3,1.0,1440,5580,1.5,3,7,1440,0.0,1908,2010,5580,41705 days 16:47:18.678841,205,3.0,0.0,-570,0,1440.0
780000.0,4,2.0,2600,4800,1.0,3,8,1400,1200.0,1953,2050,3505,25268 days 16:47:18.678841,188,2.0,1.1666666666666667,550,1295,200.0
885000.0,3,3.25,2640,16090,1.0,4,8,1960,680.0,1976,3690,15000,16868 days 16:47:18.678841,325,0.9230769230769231,2.8823529411764706,-1050,1090,1280.0
500000.0,2,1.0,1010,3885,1.5,4,7,1010,0.0,1906,1770,4200,42435 days 16:47:18.678841,127,2.0,0.0,-760,-315,1010.0
329000.0,3,2.0,1840,6755,1.0,3,8,1840,0.0,1989,1790,6459,12119 days 16:47:18.678841,353,1.5,0.0,50,296,1840.0
246000.0,4,1.75,1720,7455,1.0,4,7,1020,700.0,1963,1720,7700,21616 days 16:47:18.678841,301,2.2857142857142856,1.457142857142857,0,-245,320.0
405000.0,3,1.5,1280,9600,1.0,4,7,1280,0.0,1960,1510,10005,22712 days 16:47:18.678841,357,2.0,0.0,-230,-405,1280.0
349000.0,4,1.75,1700,7800,1.0,5,7,1120,580.0,1981,1560,7800,15041 days 16:47:18.678841,149,2.2857142857142856,1.9310344827586208,140,0,540.0
374950.0,4,2.5,1980,12062,2.0,3,8,1980,0.0,1992,2300,7902,11024 days 16:47:18.678841,082,1.6,0.0,-320,4160,1980.0
306000.0,3,2.0,1160,7217,1.0,3,7,1160,0.0,1969,1870,9104,19424 days 16:47:18.678841,210,1.5,0.0,-710,-1887,1160.0
416000.0,4,1.75,1980,7840,1.0,4,7,990,990.0,1961,1520,8400,22346 days 16:47:18.678841,217,2.2857142857142856,1.0,460,-560,0.0
560000.0,3,2.5,1960,12476,2.0,4,8,1960,0.0,1989,2450,12177,12119 days 16:47:18.678841,174,1.2,0.0,-490,299,1960.0
260000.0,3,1.5,1270,20700,1.0,2,7,1150,120.0,1948,1990,15000,27095 days 16:47:18.678841,168,2.0,9.583333333333334,-720,5700,1030.0
306500.0,3,2.25,2060,38377,1.0,4,8,1560,500.0,1978,2080,60513,16137 days 16:47:18.678841,136,1.3333333333333333,3.12,-20,-22136,1060.0
299950.0,3,1.75,1980,11274,1.0,4,7,1480,500.0,1968,1520,8010,19790 days 16:47:18.678841,345,1.7142857142857142,2.96,460,3264,980.0
265500.0,3,2.5,1450,8977,1.0,3,8,1450,0.0,1990,2410,8850,11754 days 16:47:18.678841,096,1.2,0.0,-960,127,1450.0
219000.0,3,1.5,1200,12000,1.0,3,7,1200,0.0,1986,1200,9405,13215 days 16:47:18.678841,224,2.0,0.0,0,2595,1200.0
365000.0,3,1.75,1830,17349,1.0,3,8,1230,600.0,1977,1840,11694,16502 days 16:47:18.678841,125,1.7142857142857142,2.05,-10,5655,630.0
499000.0,3,2.0,2090,42689,1.5,3,7,2090,0.0,1959,1890,18276,23077 days 16:47:18.678841,134,1.5,0.0,200,24413,2090.0
514950.0,3,2.25,1310,1264,3.0,3,8,1310,0.0,2014,1330,2183,2988 days 16:47:18.678841,121,1.3333333333333333,0.0,-20,-919,1310.0
875000.0,4,2.75,3790,10669,2.0,3,1,3790,0.0,1999,3750,11634,8467 days 16:47:18.678841,155,1.4545454545454546,0.0,40,-965,3790.0
831000.0,3,2.25,2240,8800,1.0,5,8,2240,0.0,1957,2240,8800,23807 days 16:47:18.678841,020,1.3333333333333333,0.0,0,0,2240.0
689900.0,4,3.25,2740,7266,2.0,3,9,2060,680.0,2003,3030,6546,7006 days 16:47:18.678841,135,1.2307692307692308,3.0294117647058822,-290,720,1380.0
315000.0,3,2.5,1660,10763,2.0,3,7,1660,0.0,1994,2010,7983,10293 days 16:47:18.678841,205,1.2,0.0,-350,2780,1660.0
336500.0,3,1.0,1480,7284,1.0,3,7,970,510.0,1963,2020,7920,21616 days 16:47:18.678841,175,3.0,1.9019607843137254,-540,-636,460.0
1100000.0,3,2.75,2640,4050,1.5,5,8,1750,890.0,1926,1920,3600,35130 days 16:47:18.678841,147,1.0909090909090908,1.9662921348314606,720,450,860.0
375000.0,6,2.0,1900,8057,1.0,4,7,1170,730.0,1959,2090,8626,23077 days 16:47:18.678841,216,3.0,1.6027397260273972,-190,-569,440.0
289275.0,3,2.0,2860,24046,1.0,3,9,1700,1160.0,1985,1460,13648,13580 days 16:47:18.678841,223,1.5,1.4655172413793103,1400,10398,540.0
455000.0,4,3.5,3440,6000,2.0,4,8,3440,0.0,2002,1660,7800,7371 days 16:47:18.678841,189,1.1428571428571428,0.0,1780,-1800,3440.0
505000.0,3,1.75,1640,10695,1.0,3,8,1640,0.0,1975,2790,9775,17233 days 16:47:18.678841,176,1.7142857142857142,0.0,-1150,920,1640.0
450000.0,3,1.0,1450,3350,1.5,4,7,1450,0.0,1919,1340,4255,37687 days 16:47:18.678841,211,3.0,0.0,110,-905,1450.0
567500.0,3,2.5,2300,7398,2.0,3,8,2300,0.0,2001,2580,6983,7736 days 16:47:18.678841,159,1.2,0.0,-280,415,2300.0
265000.0,3,1.5,1460,8505,1.0,4,7,1460,0.0,1955,1580,8505,24538 days 16:47:18.678841,279,2.0,0.0,-120,0,1460.0
340000.0,3,2.0,1570,14992,1.0,3,8,1570,0.0,2001,1640,15000,7736 days 16:47:18.678841,364,1.5,0.0,-70,-8,1570.0
375000.0,3,2.0,1540,8885,1.5,5,6,1540,0.0,1939,1730,5000,30382 days 16:47:18.678841,120,1.5,0.0,-190,3885,1540.0
920000.0,6,3.0,3300,4218,2.0,3,8,2200,1100.0,1970,1420,4218,19059 days 16:47:18.678841,360,2.0,2.0,1880,0,1100.0
850000.0,4,2.25,2130,11843,2.0,4,9,2130,0.0,1972,2380,11643,18329 days 16:47:18.678841,163,1.7777777777777777,0.0,-250,200,2130.0
202000.0,3,1.0,1010,9750,1.0,5,7,1010,0.0,1969,1230,9750,19424 days 16:47:18.678841,344,3.0,0.0,-220,0,1010.0
725000.0,4,3.0,2420,12000,1.0,3,9,2420,0.0,1984,3100,13020,13946 days 16:47:18.678841,272,1.3333333333333333,0.0,-680,-1020,2420.0
900000.0,3,3.25,3870,33980,2.0,3,1,3150,720.0,1991,3590,10750,11389 days 16:47:18.678841,037,0.9230769230769231,4.375,280,23230,2430.0
680200.0,2,1.5,1960,6000,1.0,3,8,1210,750.0,1951,2060,6000,25999 days 16:47:18.678841,037,1.3333333333333333,1.6133333333333333,-100,0,460.0
216500.0,3,1.0,1170,9000,1.0,4,6,1170,0.0,1918,1280,8160,38052 days 16:47:18.678841,104,3.0,0.0,-110,840,1170.0
325000.0,3,1.5,1890,7650,1.0,5,7,1890,0.0,1966,1510,7560,20520 days 16:47:18.678841,346,2.0,0.0,380,90,1890.0
675000.0,3,2.5,2250,4134,2.0,3,9,2250,0.0,2004,2390,4134,6641 days 16:47:18.678841,224,1.2,0.0,-140,0,2250.0
435000.0,2,0.75,750,16321,1.0,3,4,750,0.0,1936,3020,10625,31478 days 16:47:18.678841,132,2.6666666666666665,0.0,-2270,5696,750.0
263500.0,3,1.75,1610,14000,1.0,4,7,1050,560.0,1977,1550,10080,16502 days 16:47:18.678841,022,1.7142857142857142,1.875,60,3920,490.0
550000.0,4,2.25,2590,36256,2.0,3,8,2590,0.0,1978,2670,35657,16137 days 16:47:18.678841,127,1.7777777777777777,0.0,-80,599,2590.0
875000.0,3,2.5,2520,3750,2.0,4,9,2520,0.0,1995,2250,6200,9928 days 16:47:18.678841,112,1.2,0.0,270,-2450,2520.0
246600.0,4,1.0,1340,8400,1.0,5,7,1340,0.0,1966,1120,8400,20520 days 16:47:18.678841,101,4.0,0.0,220,0,1340.0
337000.0,3,2.25,1460,941,3.0,3,8,1460,0.0,2006,1490,1399,5910 days 16:47:18.678841,182,1.3333333333333333,0.0,-30,-458,1460.0
240000.0,3,1.75,1380,7500,1.0,3,7,1380,0.0,1988,1530,7500,12485 days 16:47:18.678841,315,1.7142857142857142,0.0,-150,0,1380.0
490000.0,3,1.75,1510,11120,1.0,4,8,1510,0.0,1984,2660,10800,13946 days 16:47:18.678841,253,1.7142857142857142,0.0,-1150,320,1510.0
510000.0,5,2.5,2510,83231,1.0,4,7,1260,1250.0,1975,2460,46431,17233 days 16:47:18.678841,218,2.0,1.008,50,36800,10.0
305000.0,3,1.0,910,8008,1.0,3,7,910,0.0,1971,1480,7404,18694 days 16:47:18.678841,066,3.0,0.0,-570,604,910.0
350000.0,3,2.5,1970,3655,2.0,3,7,1970,0.0,2003,1970,2952,7006 days 16:47:18.678841,093,1.2,0.0,0,703,1970.0
284200.0,3,1.75,1540,6632,1.0,3,7,1070,470.0,1959,2510,6618,23077 days 16:47:18.678841,055,1.7142857142857142,2.276595744680851,-970,14,600.0
357000.0,4,2.5,1980,9757,2.0,5,7,1980,0.0,1995,1610,6147,9928 days 16:47:18.678841,028,1.6,0.0,370,3610,1980.0
854000.0,4,2.75,3150,38865,1.0,3,1,2480,670.0,1986,3150,35880,13215 days 16:47:18.678841,168,1.4545454545454546,3.701492537313433,0,2985,1810.0
1180000.0,4,2.5,4700,49658,2.0,3,1,4700,0.0,1999,2870,49658,8467 days 16:47:18.678841,014,1.6,0.0,1830,0,4700.0
1000000.0,3,2.25,2300,15952,1.0,4,8,1150,1150.0,1963,2200,14284,21616 days 16:47:18.678841,281,1.3333333333333333,1.0,100,1668,0.0
616500.0,4,2.25,1880,3000,2.0,3,8,1760,120.0,1909,1880,3000,41339 days 16:47:18.678841,329,1.7777777777777777,14.666666666666666,0,0,1640.0
750000.0,4,2.75,2640,3750,2.0,5,7,1840,800.0,1911,1690,5000,40609 days 16:47:18.678841,329,1.4545454545454546,2.3,950,-1250,1040.0
650000.0,6,4.5,3900,9100,2.0,3,8,2870,1030.0,1979,2080,9216,15772 days 16:47:18.678841,280,1.3333333333333333,2.7864077669902914,1820,-116,1840.0
275000.0,4,2.25,2670,10050,1.0,4,8,1420,1250.0,1962,2190,10050,21981 days 16:47:18.678841,196,1.7777777777777777,1.136,480,0,170.0
540000.0,4,1.75,1840,4280,1.0,4,7,920,920.0,1918,1660,4280,38052 days 16:47:18.678841,276,2.2857142857142856,1.0,180,0,0.0
225000.0,3,1.0,1120,10665,1.0,4,6,1120,0.0,1961,1240,10639,22346 days 16:47:18.678841,226,3.0,0.0,-120,26,1120.0
845000.0,4,2.5,2970,9072,2.0,3,1,2970,0.0,1991,2740,8729,11389 days 16:47:18.678841,099,1.6,0.0,230,343,2970.0
490000.0,3,2.25,1410,7740,1.0,5,6,1410,0.0,1923,1220,7740,36226 days 16:47:18.678841,071,1.3333333333333333,0.0,190,0,1410.0
753000.0,4,2.5,3060,8167,2.0,3,9,3060,0.0,2005,2930,4800,6275 days 16:47:18.678841,343,1.6,0.0,130,3367,3060.0
124000.0,1,0.75,840,7203,1.5,3,6,840,0.0,1949,1560,8603,26729 days 16:47:18.678841,276,1.3333333333333333,0.0,-720,-1400,840.0
224000.0,1,0.75,840,7203,1.5,3,6,840,0.0,1949,1560,8603,26729 days 16:47:18.678841,114,1.3333333333333333,0.0,-720,-1400,840.0
485000.0,2,1.0,1130,3800,1.0,4,7,1130,0.0,1916,1470,3800,38783 days 16:47:18.678841,226,2.0,0.0,-340,0,1130.0
230000.0,4,1.75,1850,6000,1.0,4,6,1270,580.0,1944,1270,6600,28556 days 16:47:18.678841,175,2.2857142857142856,2.189655172413793,580,-600,690.0
372000.0,4,2.75,2330,14175,1.0,3,7,1800,530.0,1980,1480,10125,15407 days 16:47:18.678841,309,1.4545454545454546,3.3962264150943398,850,4050,1270.0
306000.0,4,2.5,1880,9426,2.0,4,7,1880,0.0,1990,1760,7040,11754 days 16:47:18.678841,127,1.6,0.0,120,2386,1880.0
905000.0,4,3.5,2980,3000,2.0,3,9,2340,640.0,2008,1810,4545,5180 days 16:47:18.678841,239,1.1428571428571428,3.65625,1170,-1545,1700.0
440000.0,4,1.0,1440,6678,1.0,3,7,1040,400.0,1950,1320,6678,26364 days 16:47:18.678841,085,4.0,2.6,120,0,640.0
280000.0,3,1.75,1630,10001,1.0,4,7,1100,530.0,1977,1630,10001,16502 days 16:47:18.678841,118,1.7142857142857142,2.0754716981132075,0,0,570.0
435000.0,3,2.5,1778,147823,2.0,3,7,1778,0.0,1999,2840,43676,8467 days 16:47:18.678841,210,1.2,0.0,-1062,104147,1778.0
425000.0,3,2.5,1930,4500,2.0,3,8,1930,0.0,1990,1770,4500,11754 days 16:47:18.678841,175,1.2,0.0,160,0,1930.0
204950.0,2,0.75,1130,11429,1.0,3,7,1130,0.0,1956,1550,10700,24173 days 16:47:18.678841,238,2.6666666666666665,0.0,-420,729,1130.0
670000.0,2,1.75,1650,7500,1.0,4,7,1000,650.0,1959,2530,9000,23077 days 16:47:18.678841,195,1.1428571428571428,1.5384615384615385,-880,-1500,350.0
475000.0,2,1.0,820,2723,1.0,3,7,820,0.0,1921,1370,3850,36956 days 16:47:18.678841,127,2.0,0.0,-550,-1127,820.0
352000.0,5,2.5,2900,6650,1.0,3,7,1450,1450.0,1964,1600,8246,21251 days 16:47:18.678841,079,2.0,1.0,1300,-1596,0.0
575000.0,4,1.75,2330,8800,1.0,4,7,1260,1070.0,1961,2270,8800,22346 days 16:47:18.678841,099,2.2857142857142856,1.1775700934579438,60,0,190.0
1730000.0,4,3.5,4440,20668,2.0,5,1,3240,1200.0,1965,4240,18650,20885 days 16:47:18.678841,330,1.1428571428571428,2.7,200,2018,2040.0
491000.0,3,2.0,1660,5070,2.0,3,8,1660,0.0,1950,2440,6664,26364 days 16:47:18.678841,286,1.5,0.0,-780,-1594,1660.0
750000.0,4,2.5,3020,7465,2.0,3,9,3020,0.0,2004,3100,5587,6641 days 16:47:18.678841,190,1.6,0.0,-80,1878,3020.0
830000.0,4,2.5,1850,50662,1.0,3,8,1430,420.0,1978,2090,10599,16137 days 16:47:18.678841,147,1.6,3.4047619047619047,-240,40063,1010.0
1140000.0,6,3.75,5960,20197,2.0,3,1,3900,2060.0,2005,3860,12800,6275 days 16:47:18.678841,009,1.6,1.8932038834951457,2100,7397,1840.0
137124.0,3,1.0,960,27442,1.0,4,6,960,0.0,1970,1100,29019,19059 days 16:47:18.678841,190,3.0,0.0,-140,-1577,960.0
225000.0,4,1.0,1150,6000,1.5,3,6,1150,0.0,1907,840,3030,42070 days 16:47:18.678841,225,4.0,0.0,310,2970,1150.0
732600.0,4,2.5,2130,7300,1.0,4,7,1230,900.0,1963,2130,7560,21616 days 16:47:18.678841,173,1.6,1.3666666666666667,0,-260,330.0
818000.0,4,2.25,2460,8001,2.0,4,8,2460,0.0,1984,2460,9126,13946 days 16:47:18.678841,075,1.7777777777777777,0.0,0,-1125,2460.0
431000.0,3,2.25,2360,14950,1.0,4,9,2360,0.0,1978,2720,14388,16137 days 16:47:18.678841,232,1.3333333333333333,0.0,-360,562,2360.0
650000.0,5,2.0,1910,4667,1.0,3,7,1010,900.0,1908,1230,2545,41705 days 16:47:18.678841,294,2.5,1.1222222222222222,680,2122,110.0
450000.0,2,2.0,1610,6160,2.0,4,8,1610,0.0,1977,1750,6305,16502 days 16:47:18.678841,100,1.0,0.0,-140,-145,1610.0
269000.0,4,1.0,1610,8401,1.0,3,7,1610,0.0,1958,1610,8401,23442 days 16:47:18.678841,234,4.0,0.0,0,0,1610.0
875000.0,3,1.0,1160,10732,1.0,3,7,1160,0.0,1953,2390,13656,25268 days 16:47:18.678841,365,3.0,0.0,-1230,-2924,1160.0
890000.0,4,2.25,2870,8393,1.0,4,8,1480,1390.0,1977,2930,9850,16502 days 16:47:18.678841,119,1.7777777777777777,1.064748201438849,-60,-1457,90.0
565000.0,4,2.5,2280,9725,2.0,3,8,2280,0.0,1986,2140,8780,13215 days 16:47:18.678841,282,1.6,0.0,140,945,2280.0
448175.0,2,2.0,1370,1339,2.0,4,8,1150,220.0,2006,1370,1339,5910 days 16:47:18.678841,072,1.0,5.2272727272727275,0,0,930.0
680000.0,5,3.0,2970,6500,2.0,3,9,2970,0.0,2000,2970,6588,8102 days 16:47:18.678841,254,1.6666666666666667,0.0,0,-88,2970.0
629000.0,3,1.75,1460,12367,2.0,4,8,1120,340.0,1970,1970,18893,19059 days 16:47:18.678841,037,1.7142857142857142,3.2941176470588234,-510,-6526,780.0
494000.0,3,3.5,1570,1486,2.5,3,8,1330,240.0,2000,1610,1486,8102 days 16:47:18.678841,112,0.8571428571428571,5.541666666666667,-40,0,1090.0
1100000.0,4,3.0,2880,5500,2.0,4,9,1920,960.0,1926,2110,5500,35130 days 16:47:18.678841,027,1.3333333333333333,2.0,770,0,960.0
450000.0,5,2.5,1900,9460,1.0,3,7,1190,710.0,1969,1940,8360,19424 days 16:47:18.678841,016,2.0,1.676056338028169,-40,1100,480.0
330000.0,3,1.75,2020,11050,1.0,4,8,1320,700.0,1969,1940,11050,19424 days 16:47:18.678841,303,1.7142857142857142,1.8857142857142857,80,0,620.0
960000.0,4,2.5,3110,11397,2.0,4,1,3110,0.0,1984,3110,11586,13946 days 16:47:18.678841,232,1.6,0.0,0,-189,3110.0
360000.0,4,2.5,2390,7056,2.0,3,9,2390,0.0,1990,2590,7801,11754 days 16:47:18.678841,358,1.6,0.0,-200,-745,2390.0
378000.0,3,2.5,2150,11672,2.0,3,8,2150,0.0,2004,2150,5450,6641 days 16:47:18.678841,222,1.2,0.0,0,6222,2150.0
499950.0,3,1.75,1340,6250,1.0,4,7,1090,250.0,1941,1550,1755,29651 days 16:47:18.678841,255,1.7142857142857142,4.36,-210,4495,840.0
450000.0,3,2.5,1990,12866,2.0,4,7,1990,0.0,1986,2310,8803,13215 days 16:47:18.678841,205,1.2,0.0,-320,4063,1990.0
523500.0,2,2.0,1600,5969,1.0,4,7,800,800.0,1950,1520,5969,26364 days 16:47:18.678841,237,1.0,1.0,80,0,0.0
600000.0,3,2.5,2680,43995,2.0,3,9,2680,0.0,1986,2520,37277,13215 days 16:47:18.678841,342,1.2,0.0,160,6718,2680.0
290000.0,3,2.5,2080,4828,2.0,3,8,2080,0.0,2002,2190,4620,7371 days 16:47:18.678841,153,1.2,0.0,-110,208,2080.0
176000.0,3,3.25,1340,5434,2.0,3,7,1340,0.0,1986,1670,6203,13215 days 16:47:18.678841,037,0.9230769230769231,0.0,-330,-769,1340.0
885000.0,3,2.0,2590,3750,1.5,5,7,1790,800.0,1904,2440,4000,43166 days 16:47:18.678841,261,1.5,2.2375,150,-250,990.0
483000.0,2,1.75,1240,3000,1.5,3,7,1240,0.0,1906,1800,4080,42435 days 16:47:18.678841,175,1.1428571428571428,0.0,-560,-1080,1240.0
240000.0,3,1.0,1310,7125,1.0,4,7,1310,0.0,1978,1650,7290,16137 days 16:47:18.678841,128,3.0,0.0,-340,-165,1310.0
720000.0,4,2.25,2530,5200,1.0,4,8,1530,1000.0,1957,2240,5200,23807 days 16:47:18.678841,268,1.7777777777777777,1.53,290,0,530.0
311000.0,4,2.5,1780,5822,2.0,3,7,1780,0.0,2001,1990,4092,7736 days 16:47:18.678841,309,1.6,0.0,-210,1730,1780.0
164950.0,3,1.75,1570,15330,1.0,3,7,1080,490.0,1956,1250,13330,24173 days 16:47:18.678841,177,1.7142857142857142,2.204081632653061,320,2000,590.0
371000.0,3,1.75,1570,15330,1.0,3,7,1080,490.0,1956,1250,13330,24173 days 16:47:18.678841,082,1.7142857142857142,2.204081632653061,320,2000,590.0
264500.0,3,1.75,1650,16200,1.0,3,7,1650,0.0,1976,1650,8680,16868 days 16:47:18.678841,023,1.7142857142857142,0.0,0,7520,1650.0
1740000.0,4,2.25,2920,6513,2.0,4,9,2260,660.0,1937,4510,9248,31112 days 16:47:18.678841,186,1.7777777777777777,3.4242424242424243,-1590,-2735,1600.0
503000.0,2,1.0,870,4280,1.0,4,6,870,0.0,1921,1750,4280,36956 days 16:47:18.678841,089,2.0,0.0,-880,0,870.0
738000.0,4,2.5,2830,5010,2.0,3,9,2170,660.0,2000,1880,5739,8102 days 16:47:18.678841,302,1.6,3.287878787878788,950,-729,1510.0
393000.0,2,1.0,980,3350,1.0,4,7,980,0.0,1925,1260,4000,35495 days 16:47:18.678841,266,2.0,0.0,-280,-650,980.0
280000.0,2,1.0,990,45528,1.0,4,7,990,0.0,1992,1730,45528,11024 days 16:47:18.678841,102,2.0,0.0,-740,0,990.0
260000.0,4,2.5,2360,9647,1.0,3,8,1530,830.0,1964,2580,9680,21251 days 16:47:18.678841,084,1.6,1.8433734939759037,-220,-33,700.0
505000.0,2,1.0,1000,4640,1.0,3,7,1000,0.0,1915,1940,5800,39148 days 16:47:18.678841,099,2.0,0.0,-940,-1160,1000.0
241000.0,3,1.5,1660,8000,1.0,4,7,1120,540.0,1976,1900,7500,16868 days 16:47:18.678841,005,2.0,2.074074074074074,-240,500,580.0
530000.0,3,1.75,1520,9605,1.0,3,7,1520,0.0,1975,2040,9900,17233 days 16:47:18.678841,075,1.7142857142857142,0.0,-520,-295,1520.0
713000.0,1,1.0,1180,4000,1.5,4,8,840,340.0,1910,1420,4000,40974 days 16:47:18.678841,224,1.0,2.4705882352941178,-240,0,500.0
487000.0,3,1.75,1770,10125,2.0,3,7,1770,0.0,1944,1680,9825,28556 days 16:47:18.678841,203,1.7142857142857142,0.0,90,300,1770.0
128000.0,2,1.0,980,5393,1.0,3,6,980,0.0,1969,980,5200,19424 days 16:47:18.678841,317,2.0,0.0,0,193,980.0
210500.0,3,1.0,1840,10178,1.0,3,7,1040,800.0,1960,2040,10660,22712 days 16:47:18.678841,317,3.0,1.3,-200,-482,240.0
420000.0,3,2.5,1810,7210,1.0,5,7,1210,600.0,1968,1770,7210,19790 days 16:47:18.678841,015,1.2,2.0166666666666666,40,0,610.0
679000.0,3,2.5,1780,4320,2.0,4,8,1780,0.0,1930,1690,4952,33669 days 16:47:18.678841,303,1.2,0.0,90,-632,1780.0
784950.0,4,2.75,2840,4227,3.0,3,9,2840,0.0,2014,2880,4227,2988 days 16:47:18.678841,352,1.4545454545454546,0.0,-40,0,2840.0
352000.0,4,2.5,2650,6366,2.0,3,9,2650,0.0,1998,2650,6200,8832 days 16:47:18.678841,323,1.6,0.0,0,166,2650.0
386000.0,3,1.5,1270,1318,2.0,3,7,1080,190.0,2004,1360,1488,6641 days 16:47:18.678841,162,2.0,5.684210526315789,-90,-170,890.0
335000.0,3,1.75,1260,17000,1.0,3,7,1260,0.0,1994,1540,7213,10293 days 16:47:18.678841,120,1.7142857142857142,0.0,-280,9787,1260.0
472500.0,3,2.0,1750,15500,1.0,3,7,1490,260.0,1982,2450,50094,14676 days 16:47:18.678841,153,1.5,5.730769230769231,-700,-34594,1230.0
599950.0,5,2.25,2680,13292,1.0,3,8,1340,1340.0,1976,2220,13181,16868 days 16:47:18.678841,307,2.2222222222222223,1.0,460,111,0.0
963990.0,4,3.25,3830,6765,2.0,3,9,3830,0.0,2014,3830,6507,2988 days 16:47:18.678841,205,1.2307692307692308,0.0,0,258,3830.0
735000.0,3,2.0,1610,3600,2.0,5,8,1610,0.0,1925,2540,6600,35495 days 16:47:18.678841,268,1.5,0.0,-930,-3000,1610.0
858450.0,3,4.25,3840,9751,2.0,3,1,3840,0.0,1998,3230,7189,8832 days 16:47:18.678841,076,0.7058823529411765,0.0,610,2562,3840.0
665000.0,5,2.75,2670,4000,2.0,4,7,1800,870.0,1914,2460,4000,39513 days 16:47:18.678841,127,1.8181818181818181,2.0689655172413794,210,0,930.0
290000.0,3,2.5,2000,7414,2.0,4,7,2000,0.0,1993,2000,7414,10658 days 16:47:18.678841,212,1.2,0.0,0,0,2000.0
250000.0,2,1.0,860,4320,1.0,3,7,860,0.0,1925,980,6000,35495 days 16:47:18.678841,103,2.0,0.0,-120,-1680,860.0
192500.0,3,1.75,1420,7205,1.0,3,7,1420,0.0,1986,1690,7405,13215 days 16:47:18.678841,281,1.7142857142857142,0.0,-270,-200,1420.0
350000.0,4,2.0,2060,13400,1.0,4,8,2060,0.0,1957,1950,10370,23807 days 16:47:18.678841,237,2.0,0.0,110,3030,2060.0
518000.0,4,2.5,2790,9910,2.0,3,8,2790,0.0,2003,2590,9910,7006 days 16:47:18.678841,078,1.6,0.0,200,0,2790.0
563000.0,4,1.0,1410,3376,1.5,5,7,1410,0.0,1911,1040,3600,40609 days 16:47:18.678841,182,4.0,0.0,370,-224,1410.0
375000.0,4,3.0,2420,9566,2.0,3,7,2420,0.0,2003,2420,9135,7006 days 16:47:18.678841,280,1.3333333333333333,0.0,0,431,2420.0
400000.0,3,2.5,1460,1319,3.0,3,8,1460,0.0,2002,1430,1530,7371 days 16:47:18.678841,058,1.2,0.0,30,-211,1460.0
240000.0,5,1.75,2460,16000,1.0,3,7,1230,1230.0,1957,1990,16000,23807 days 16:47:18.678841,302,2.857142857142857,1.0,470,0,0.0
317500.0,2,1.0,1000,5120,1.0,3,6,1000,0.0,1902,1940,4300,43896 days 16:47:18.678841,266,2.0,0.0,-940,820,1000.0
1320000.0,5,4.0,4420,36342,2.0,5,1,2740,1680.0,1982,3720,37034,14676 days 16:47:18.678841,044,1.25,1.630952380952381,700,-692,1060.0
234000.0,3,1.0,1240,239144,1.0,3,6,1240,0.0,1921,1990,109335,36956 days 16:47:18.678841,314,3.0,0.0,-750,129809,1240.0
645000.0,3,2.5,1740,13750,2.0,4,9,1740,0.0,1975,2540,14300,17233 days 16:47:18.678841,133,1.2,0.0,-800,-550,1740.0
649000.0,2,1.0,1280,4840,1.0,3,7,1200,80.0,1908,1860,5500,41705 days 16:47:18.678841,068,2.0,15.0,-580,-660,1120.0
605000.0,4,2.5,2520,3980,2.0,3,8,2520,0.0,2004,2580,3980,6641 days 16:47:18.678841,107,1.6,0.0,-60,0,2520.0
337900.0,3,3.5,1500,1471,3.0,3,7,1500,0.0,1999,1500,1445,8467 days 16:47:18.678841,233,0.8571428571428571,0.0,0,26,1500.0
535000.0,3,2.75,2490,3600,2.0,3,8,2290,200.0,1906,1880,3600,42435 days 16:47:18.678841,036,1.0909090909090908,11.45,610,0,2090.0
325000.0,4,1.0,1530,5684,1.0,3,7,1130,400.0,1957,1540,6095,23807 days 16:47:18.678841,265,4.0,2.825,-10,-411,730.0
429950.0,4,2.25,1740,10875,1.0,3,8,1740,0.0,1967,1680,10701,20155 days 16:47:18.678841,349,1.7777777777777777,0.0,60,174,1740.0
775000.0,3,2.5,3550,32807,2.0,3,9,3550,0.0,1989,3270,35001,12119 days 16:47:18.678841,106,1.2,0.0,280,-2194,3550.0
650000.0,2,1.0,1280,6000,1.0,3,7,1280,0.0,1965,2460,4800,20885 days 16:47:18.678841,212,2.0,0.0,-1180,1200,1280.0
1200000.0,4,2.25,2320,13114,2.0,5,8,2320,0.0,1967,2740,15000,20155 days 16:47:18.678841,121,1.7777777777777777,0.0,-420,-1886,2320.0
275000.0,2,1.0,1140,10404,1.0,3,5,1140,0.0,1935,2200,11550,31843 days 16:47:18.678841,253,2.0,0.0,-1060,-1146,1140.0
575000.0,4,3.5,3930,16970,2.0,3,9,3930,0.0,1997,2740,17219,9197 days 16:47:18.678841,210,1.1428571428571428,0.0,1190,-249,3930.0
540000.0,3,2.5,2370,16455,1.0,5,7,1640,730.0,1959,2170,15551,23077 days 16:47:18.678841,218,1.2,2.2465753424657535,200,904,910.0
640000.0,3,1.75,2340,4206,1.0,5,7,1170,1170.0,1917,1360,4725,38417 days 16:47:18.678841,156,1.7142857142857142,1.0,980,-519,0.0
275000.0,3,1.5,1240,9125,1.0,4,7,1240,0.0,1967,1670,9125,20155 days 16:47:18.678841,266,2.0,0.0,-430,0,1240.0
672800.0,4,2.5,2740,10533,2.0,3,9,2740,0.0,1997,2760,8603,9197 days 16:47:18.678841,205,1.6,0.0,-20,1930,2740.0
495000.0,4,2.25,1940,9144,1.0,4,7,1430,510.0,1956,1460,9437,24173 days 16:47:18.678841,147,1.7777777777777777,2.803921568627451,480,-293,920.0
820000.0,3,2.5,2950,35108,1.5,3,1,2950,0.0,1995,3810,35181,9928 days 16:47:18.678841,269,1.2,0.0,-860,-73,2950.0
475000.0,4,2.75,1980,11443,1.0,5,7,1980,0.0,1952,2080,15700,25634 days 16:47:18.678841,160,1.4545454545454546,0.0,-100,-4257,1980.0
1280000.0,4,2.0,2850,7861,1.0,4,1,1450,1400.0,1970,2810,8087,19059 days 16:47:18.678841,140,2.0,1.0357142857142858,40,-226,50.0
380000.0,3,1.0,1160,9375,1.0,3,7,1160,0.0,1967,1160,9650,20155 days 16:47:18.678841,119,3.0,0.0,0,-275,1160.0
397500.0,3,2.0,2130,8225,1.0,4,8,2130,0.0,1987,2580,8225,12850 days 16:47:18.678841,232,1.5,0.0,-450,0,2130.0
352000.0,5,2.5,2420,8560,1.0,3,7,1620,800.0,1978,2210,7040,16137 days 16:47:18.678841,127,2.0,2.025,210,1520,820.0
893880.0,6,2.5,2820,8600,1.0,5,8,1430,1390.0,1967,2070,8900,20155 days 16:47:18.678841,103,2.4,1.0287769784172662,750,-300,40.0
635000.0,5,3.25,3710,34200,2.0,3,8,2510,1200.0,1986,1720,23100,13215 days 16:47:18.678841,259,1.5384615384615385,2.091666666666667,1990,11100,1310.0
420000.0,3,2.25,1770,8165,2.0,3,7,1770,0.0,1977,1650,8165,16502 days 16:47:18.678841,127,1.3333333333333333,0.0,120,0,1770.0
503000.0,3,2.0,1260,2500,1.0,4,7,750,510.0,1987,1710,5000,12850 days 16:47:18.678841,080,1.5,1.4705882352941178,-450,-2500,240.0
689000.0,2,1.75,2330,10143,1.0,4,7,1220,1110.0,1953,2560,9750,25268 days 16:47:18.678841,252,1.1428571428571428,1.0990990990990992,-230,393,110.0
749500.0,4,2.75,2490,3840,1.5,4,7,1610,880.0,1922,1420,4000,36591 days 16:47:18.678841,245,1.4545454545454546,1.8295454545454546,1070,-160,730.0
1150000.0,6,3.75,4090,49542,2.0,3,9,3100,990.0,1984,2980,43357,13946 days 16:47:18.678841,279,1.6,3.1313131313131315,1110,6185,2110.0
563500.0,4,2.5,2800,12831,2.0,3,8,2800,0.0,2001,2810,10235,7736 days 16:47:18.678841,160,1.6,0.0,-10,2596,2800.0
480000.0,4,3.0,2440,9664,2.0,3,8,1890,550.0,1981,2380,9609,15041 days 16:47:18.678841,181,1.3333333333333333,3.4363636363636365,60,55,1340.0
374950.0,4,3.0,2540,8800,1.0,3,9,1620,920.0,1977,2540,8800,16502 days 16:47:18.678841,112,1.3333333333333333,1.7608695652173914,0,0,700.0
308950.0,3,2.5,1600,6250,2.0,3,7,1600,0.0,1995,1760,6110,9928 days 16:47:18.678841,100,1.2,0.0,-160,140,1600.0
445000.0,4,2.75,2680,16934,1.0,4,7,1340,1340.0,1958,1240,7000,23442 days 16:47:18.678841,260,1.4545454545454546,1.0,1440,9934,0.0
237200.0,3,1.5,1220,9000,1.0,4,7,1220,0.0,1968,1220,9472,19790 days 16:47:18.678841,111,2.0,0.0,0,-472,1220.0
453500.0,3,1.75,1550,7270,1.5,5,7,1550,0.0,1953,1050,7210,25268 days 16:47:18.678841,245,1.7142857142857142,0.0,500,60,1550.0
616500.0,3,2.0,2080,4549,1.0,5,7,1040,1040.0,1954,1620,4549,24903 days 16:47:18.678841,127,1.5,1.0,460,0,0.0
1250000.0,5,5.0,5000,32909,2.0,3,1,5000,0.0,2000,3030,12601,8102 days 16:47:18.678841,218,1.0,0.0,1970,20308,5000.0
396000.0,1,1.0,630,5150,1.0,4,5,630,0.0,1954,1390,5150,24903 days 16:47:18.678841,097,1.0,0.0,-760,0,630.0
210000.0,3,1.0,1070,8179,1.0,3,6,1070,0.0,1949,1050,8177,26729 days 16:47:18.678841,189,3.0,0.0,20,2,1070.0
539000.0,2,1.75,1900,5175,1.0,3,7,1200,700.0,1919,1370,5175,37687 days 16:47:18.678841,274,1.1428571428571428,1.7142857142857142,530,0,500.0
605000.0,3,2.5,2960,18600,2.0,3,8,2960,0.0,1979,2740,15681,15772 days 16:47:18.678841,237,1.2,0.0,220,2919,2960.0
437500.0,3,2.0,1490,4800,2.0,5,6,1490,0.0,1948,1500,4800,27095 days 16:47:18.678841,188,1.5,0.0,-10,0,1490.0
215000.0,3,1.5,1500,15000,1.0,3,7,1500,0.0,1952,1790,13905,25634 days 16:47:18.678841,197,2.0,0.0,-290,1095,1500.0
440000.0,4,2.5,2410,4780,2.0,3,7,2410,0.0,2000,2410,4025,8102 days 16:47:18.678841,169,1.6,0.0,0,755,2410.0
525000.0,3,1.0,2000,22500,1.0,3,7,1680,320.0,1939,2000,10000,30382 days 16:47:18.678841,321,3.0,5.25,0,12500,1360.0
319900.0,3,1.5,1140,20383,1.0,3,7,840,300.0,1985,1200,15625,13580 days 16:47:18.678841,233,2.0,2.8,-60,4758,540.0
335000.0,3,1.0,1120,9075,1.0,3,7,1120,0.0,1977,1120,9705,16502 days 16:47:18.678841,006,3.0,0.0,0,-630,1120.0
485000.0,3,2.25,2900,35273,2.0,3,9,2900,0.0,1986,2510,38487,13215 days 16:47:18.678841,311,1.3333333333333333,0.0,390,-3214,2900.0
359999.0,4,2.25,3220,7700,2.0,4,8,3220,0.0,1976,2570,7700,16868 days 16:47:18.678841,268,1.7777777777777777,0.0,650,0,3220.0
799000.0,5,2.75,2500,19783,1.0,4,8,2500,0.0,1959,1700,15375,23077 days 16:47:18.678841,219,1.8181818181818181,0.0,800,4408,2500.0
280000.0,3,2.25,1610,10454,1.0,3,7,1610,0.0,1977,1720,9583,16502 days 16:47:18.678841,255,1.3333333333333333,0.0,-110,871,1610.0
1050000.0,4,2.75,2250,3433,1.5,3,8,1500,750.0,1927,1970,3484,34765 days 16:47:18.678841,189,1.4545454545454546,2.0,280,-51,750.0
290000.0,1,2.0,1240,4800,2.0,3,6,1240,0.0,1910,1030,4800,40974 days 16:47:18.678841,323,0.5,0.0,210,0,1240.0
235000.0,2,2.25,1660,2748,2.0,3,7,1660,0.0,1995,1620,3167,9928 days 16:47:18.678841,351,0.8888888888888888,0.0,40,-419,1660.0
495000.0,3,1.75,2080,3000,1.0,4,7,1040,1040.0,1925,1000,3193,35495 days 16:47:18.678841,274,1.7142857142857142,1.0,1080,-193,0.0
290000.0,3,2.25,1880,7488,2.0,3,8,1880,0.0,1980,2180,7344,15407 days 16:47:18.678841,055,1.3333333333333333,0.0,-300,144,1880.0
230000.0,4,1.5,1050,9516,1.0,4,7,1050,0.0,1969,1390,9600,19424 days 16:47:18.678841,301,2.6666666666666665,0.0,-340,-84,1050.0
234000.0,3,1.75,1480,8475,1.0,4,7,1480,0.0,1968,1800,8800,19790 days 16:47:18.678841,051,1.7142857142857142,0.0,-320,-325,1480.0
597400.0,4,2.5,2420,4500,2.0,3,7,2420,0.0,2001,2280,4500,7736 days 16:47:18.678841,276,1.6,0.0,140,0,2420.0
370000.0,4,2.5,2190,17600,1.0,4,7,1110,1080.0,1966,1820,17600,20520 days 16:47:18.678841,217,1.6,1.0277777777777777,370,0,30.0
755000.0,4,2.5,2660,10452,2.0,3,9,2660,0.0,1993,2890,9025,10658 days 16:47:18.678841,139,1.6,0.0,-230,1427,2660.0
342000.0,3,2.5,2430,5715,2.0,3,7,2430,0.0,1999,3040,5702,8467 days 16:47:18.678841,093,1.2,0.0,-610,13,2430.0
497000.0,2,1.0,770,3325,1.0,3,7,770,0.0,1918,960,4800,38052 days 16:47:18.678841,209,2.0,0.0,-190,-1475,770.0
835000.0,3,1.0,3060,30166,1.0,5,8,3060,0.0,1959,1880,19602,23077 days 16:47:18.678841,119,3.0,0.0,1180,10564,3060.0
730000.0,4,2.75,2920,4500,2.0,3,9,2920,0.0,1999,2920,4505,8467 days 16:47:18.678841,288,1.4545454545454546,0.0,0,-5,2920.0
655000.0,3,1.0,1370,5250,1.0,3,7,1070,300.0,1939,2410,4200,30382 days 16:47:18.678841,274,3.0,3.566666666666667,-1040,1050,770.0
205000.0,3,2.5,1870,3118,2.0,3,8,1870,0.0,1993,1580,3601,10658 days 16:47:18.678841,324,1.2,0.0,290,-483,1870.0
632750.0,4,2.0,1800,4800,1.5,3,7,1800,0.0,1918,1950,4800,38052 days 16:47:18.678841,097,2.0,0.0,-150,0,1800.0
330000.0,5,3.0,2100,7715,1.0,3,7,1250,850.0,2013,2100,7959,3353 days 16:47:18.678841,132,1.6666666666666667,1.4705882352941178,0,-244,400.0
527500.0,5,2.25,2530,8250,2.0,4,7,2530,0.0,1961,2020,8250,22346 days 16:47:18.678841,280,2.2222222222222223,0.0,510,0,2530.0
716500.0,4,2.5,3290,6465,2.0,3,9,3290,0.0,2002,3100,5929,7371 days 16:47:18.678841,128,1.6,0.0,190,536,3290.0
388500.0,4,2.5,1890,5395,2.0,3,7,1890,0.0,2006,2060,5395,5910 days 16:47:18.678841,351,1.6,0.0,-170,0,1890.0
530000.0,3,1.75,1680,7770,1.0,4,7,1680,0.0,1967,1880,7770,20155 days 16:47:18.678841,247,1.7142857142857142,0.0,-200,0,1680.0
419000.0,3,2.5,2170,4517,2.0,3,8,2170,0.0,2002,2610,4770,7371 days 16:47:18.678841,008,1.2,0.0,-440,-253,2170.0
385000.0,3,1.75,1200,7360,1.0,4,7,1200,0.0,1978,1200,7500,16137 days 16:47:18.678841,068,1.7142857142857142,0.0,0,-140,1200.0
655000.0,4,2.5,2990,5669,2.0,3,8,2990,0.0,2003,3110,5058,7006 days 16:47:18.678841,148,1.6,0.0,-120,611,2990.0
1700000.0,4,2.75,3770,10900,2.0,5,9,3070,700.0,1924,3000,5000,35861 days 16:47:18.678841,182,1.4545454545454546,4.385714285714286,770,5900,2370.0
279000.0,2,1.0,1020,47044,1.0,5,7,1020,0.0,1904,1930,12139,43166 days 16:47:18.678841,269,2.0,0.0,-910,34905,1020.0
262000.0,3,1.5,1700,9579,1.0,4,7,1100,600.0,1962,1700,9628,21981 days 16:47:18.678841,040,2.0,1.8333333333333333,0,-49,500.0
533000.0,4,1.0,1550,4750,1.5,3,7,1550,0.0,1919,1320,4750,37687 days 16:47:18.678841,219,4.0,0.0,230,0,1550.0
640000.0,3,1.75,1680,8100,1.0,3,8,1680,0.0,1950,1880,7750,26364 days 16:47:18.678841,092,1.7142857142857142,0.0,-200,350,1680.0
285000.0,3,2.25,1680,35127,2.0,3,7,1680,0.0,1987,1820,35166,12850 days 16:47:18.678841,160,1.3333333333333333,0.0,-140,-39,1680.0
458400.0,4,2.5,1910,10300,1.0,3,8,1910,0.0,1921,1910,7750,36956 days 16:47:18.678841,189,1.6,0.0,0,2550,1910.0
620000.0,5,3.25,3160,10587,1.0,5,7,2190,970.0,1960,2200,7761,22712 days 16:47:18.678841,077,1.5384615384615385,2.2577319587628866,960,2826,1220.0
465000.0,3,1.5,2020,11358,1.0,4,6,1190,830.0,1956,2370,9520,24173 days 16:47:18.678841,132,2.0,1.4337349397590362,-350,1838,360.0
690000.0,4,3.75,3210,7054,2.0,4,8,3210,0.0,1985,2350,8020,13580 days 16:47:18.678841,216,1.0666666666666667,0.0,860,-966,3210.0
462500.0,3,2.25,2350,51400,1.0,3,7,1390,960.0,1977,2350,51400,16502 days 16:47:18.678841,233,1.3333333333333333,1.4479166666666667,0,0,430.0
369950.0,4,2.5,1910,10221,2.0,3,8,1910,0.0,1994,2210,8705,10293 days 16:47:18.678841,232,1.6,0.0,-300,1516,1910.0
124500.0,2,1.0,840,6480,1.0,4,5,840,0.0,1954,1100,7300,24903 days 16:47:18.678841,085,2.0,0.0,-260,-820,840.0
950000.0,4,2.25,2620,10920,1.0,3,9,2620,0.0,1965,2370,11907,20885 days 16:47:18.678841,218,1.7777777777777777,0.0,250,-987,2620.0
418000.0,4,1.5,1220,10580,1.0,3,7,1220,0.0,1965,1350,7800,20885 days 16:47:18.678841,167,2.6666666666666665,0.0,-130,2780,1220.0
160000.0,3,1.0,1060,8000,1.0,4,6,1060,0.0,1927,1060,4697,34765 days 16:47:18.678841,344,3.0,0.0,0,3303,1060.0
457000.0,4,2.5,2200,10800,1.0,3,8,1500,700.0,1964,2280,10800,21251 days 16:47:18.678841,105,1.6,2.142857142857143,-80,0,800.0
530000.0,2,1.75,2120,7680,1.0,5,6,1130,990.0,1948,1220,7680,27095 days 16:47:18.678841,029,1.1428571428571428,1.1414141414141414,900,0,140.0
385000.0,3,1.0,1250,7300,1.0,4,7,1250,0.0,1956,1540,7400,24173 days 16:47:18.678841,142,3.0,0.0,-290,-100,1250.0
491000.0,3,1.75,1440,7800,1.0,4,7,1440,0.0,1958,1440,7800,23442 days 16:47:18.678841,077,1.7142857142857142,0.0,0,0,1440.0
521000.0,4,2.25,1890,8034,1.0,4,8,1890,0.0,1967,1920,7210,20155 days 16:47:18.678841,232,1.7777777777777777,0.0,-30,824,1890.0
255000.0,3,1.0,1140,8528,1.0,5,7,1140,0.0,1967,1140,8112,20155 days 16:47:18.678841,100,3.0,0.0,0,416,1140.0
292050.0,5,3.0,2840,7199,1.0,3,7,1710,1130.0,2003,2210,10800,7006 days 16:47:18.678841,147,1.6666666666666667,1.5132743362831858,630,-3601,580.0
326000.0,6,3.0,1880,7200,1.0,4,7,1880,0.0,1966,1540,13022,20520 days 16:47:18.678841,140,2.0,0.0,340,-5822,1880.0
300000.0,2,1.0,750,5120,1.0,4,6,750,0.0,1941,930,7200,29651 days 16:47:18.678841,175,2.0,0.0,-180,-2080,750.0
291600.0,3,1.75,1630,7480,1.0,3,7,1330,300.0,1979,1940,7480,15772 days 16:47:18.678841,120,1.7142857142857142,4.433333333333334,-310,0,1030.0
435000.0,5,1.5,1720,12551,1.0,3,7,1720,0.0,1967,1560,12960,20155 days 16:47:18.678841,050,3.3333333333333335,0.0,160,-409,1720.0
465000.0,3,2.5,1600,1311,3.0,3,8,1600,0.0,2005,1390,1321,6275 days 16:47:18.678841,352,1.2,0.0,210,-10,1600.0
200000.0,3,2.25,1230,7420,1.5,5,7,1230,0.0,1913,1260,7556,39878 days 16:47:18.678841,171,1.3333333333333333,0.0,-30,-136,1230.0
238000.0,3,1.5,1610,6132,1.0,4,7,1090,520.0,1959,1650,6132,23077 days 16:47:18.678841,198,2.0,2.0961538461538463,-40,0,570.0
455000.0,4,2.5,1320,7000,1.0,4,7,1320,0.0,1956,1550,8610,24173 days 16:47:18.678841,307,1.6,0.0,-230,-1610,1320.0
808000.0,4,2.25,2190,4104,2.0,5,8,1410,780.0,1928,1990,3860,34400 days 16:47:18.678841,254,1.7777777777777777,1.8076923076923077,200,244,630.0
578500.0,3,1.0,1490,5700,1.5,3,7,1490,0.0,1916,2290,5700,38783 days 16:47:18.678841,351,3.0,0.0,-800,0,1490.0
390000.0,3,2.0,1463,868,3.0,3,7,1463,0.0,2003,1484,4320,7006 days 16:47:18.678841,156,1.5,0.0,-21,-3452,1463.0
517500.0,3,2.5,1800,3933,2.0,3,8,1800,0.0,1989,1800,4659,12119 days 16:47:18.678841,125,1.2,0.0,0,-726,1800.0
755000.0,4,2.75,2880,4000,1.5,3,9,2100,780.0,1912,2110,4000,40244 days 16:47:18.678841,177,1.4545454545454546,2.6923076923076925,770,0,1320.0
579500.0,3,1.75,1250,4120,1.0,4,7,980,270.0,1925,1250,4120,35495 days 16:47:18.678841,303,1.7142857142857142,3.6296296296296298,0,0,710.0
649950.0,3,2.75,1670,1350,3.0,3,9,1350,320.0,2014,1520,4800,2988 days 16:47:18.678841,272,1.0909090909090908,4.21875,150,-3450,1030.0
228000.0,4,1.75,2000,6120,1.0,3,7,1100,900.0,1965,1880,6120,20885 days 16:47:18.678841,128,2.2857142857142856,1.2222222222222223,120,0,200.0
665000.0,4,1.75,2280,3680,1.5,5,7,1470,810.0,1926,1850,3680,35130 days 16:47:18.678841,336,2.2857142857142856,1.8148148148148149,430,0,660.0
689000.0,4,2.5,2110,6069,2.0,3,9,2110,0.0,1999,2180,9000,8467 days 16:47:18.678841,084,1.6,0.0,-70,-2931,2110.0
560000.0,4,2.5,2520,11240,1.0,3,8,1440,1080.0,1977,2360,10345,16502 days 16:47:18.678841,295,1.6,1.3333333333333333,160,895,360.0
529000.0,3,1.0,1590,6420,1.0,3,7,1590,0.0,1944,1780,5900,28556 days 16:47:18.678841,149,3.0,0.0,-190,520,1590.0
375000.0,5,2.5,2100,14858,1.0,5,8,2100,0.0,1970,1980,11730,19059 days 16:47:18.678841,008,2.0,0.0,120,3128,2100.0
325000.0,4,2.75,2090,9240,1.0,4,6,2090,0.0,1949,1460,9240,26729 days 16:47:18.678841,266,1.4545454545454546,0.0,630,0,2090.0
583000.0,4,2.5,3390,10519,2.0,3,1,3390,0.0,1990,2830,10519,11754 days 16:47:18.678841,015,1.6,0.0,560,0,3390.0
330000.0,2,1.0,790,9784,1.0,3,6,790,0.0,1932,2350,10102,32939 days 16:47:18.678841,119,2.0,0.0,-1560,-318,790.0
262000.0,3,2.5,1970,8727,2.0,3,7,1970,0.0,1995,1670,9168,9928 days 16:47:18.678841,107,1.2,0.0,300,-441,1970.0
555000.0,4,2.5,2870,6776,2.0,3,8,2870,0.0,2004,2770,6658,6641 days 16:47:18.678841,072,1.6,0.0,100,118,2870.0
585000.0,2,1.0,1110,6000,1.0,3,7,1010,100.0,1951,1410,3500,25999 days 16:47:18.678841,061,2.0,10.1,-300,2500,910.0
425590.0,3,2.75,1940,3088,2.0,3,8,1770,170.0,2008,1410,2335,5180 days 16:47:18.678841,058,1.0909090909090908,10.411764705882353,530,753,1600.0
235000.0,2,1.0,720,4840,1.0,4,6,720,0.0,1947,1510,4840,27460 days 16:47:18.678841,154,2.0,0.0,-790,0,720.0
362362.0,2,1.0,710,4000,1.0,3,6,710,0.0,1909,960,4000,41339 days 16:47:18.678841,205,2.0,0.0,-250,0,710.0
252000.0,3,2.0,1370,7500,1.0,3,7,1370,0.0,1997,1420,7500,9197 days 16:47:18.678841,035,1.5,0.0,-50,0,1370.0
439000.0,4,2.5,2690,9551,2.0,3,9,2690,0.0,1992,2890,9121,11024 days 16:47:18.678841,358,1.6,0.0,-200,430,2690.0
465000.0,4,2.25,3360,10810,2.0,4,9,3360,0.0,1988,2590,10810,12485 days 16:47:18.678841,224,1.7777777777777777,0.0,770,0,3360.0
249900.0,4,2.0,1500,7854,1.5,3,7,1500,0.0,1983,1500,7334,14311 days 16:47:18.678841,276,2.0,0.0,0,520,1500.0
665000.0,2,2.5,2600,5000,1.0,5,8,1300,1300.0,1926,2260,5000,35130 days 16:47:18.678841,199,0.8,1.0,340,0,0.0
370000.0,3,1.75,1160,8774,1.0,3,7,1160,0.0,1972,1990,7908,18329 days 16:47:18.678841,287,1.7142857142857142,0.0,-830,866,1160.0
620000.0,2,1.0,1430,3000,1.5,3,7,1300,130.0,1929,1750,4000,34034 days 16:47:18.678841,163,2.0,10.0,-320,-1000,1170.0
375000.0,3,1.0,1870,7671,1.0,4,8,1720,150.0,1937,1460,7679,31112 days 16:47:18.678841,205,3.0,11.466666666666667,410,-8,1570.0
552625.0,4,2.0,2560,9390,1.0,5,8,1280,1280.0,1957,1830,8169,23807 days 16:47:18.678841,239,2.0,1.0,730,1221,0.0
315500.0,3,1.0,1160,10500,1.0,4,7,1160,0.0,1966,1520,10500,20520 days 16:47:18.678841,273,3.0,0.0,-360,0,1160.0
620000.0,2,1.75,1680,8187,1.0,4,8,1680,0.0,1983,2390,7801,14311 days 16:47:18.678841,262,1.1428571428571428,0.0,-710,386,1680.0
510000.0,4,2.5,2010,9075,1.0,4,8,1310,700.0,1959,1850,9220,23077 days 16:47:18.678841,329,1.6,1.8714285714285714,160,-145,610.0
652500.0,4,2.5,2540,38677,2.0,3,9,2540,0.0,1987,2560,36280,12850 days 16:47:18.678841,178,1.6,0.0,-20,2397,2540.0
574000.0,4,2.5,3240,22795,2.0,3,8,3240,0.0,1998,2570,29761,8832 days 16:47:18.678841,318,1.6,0.0,670,-6966,3240.0
430000.0,3,2.5,2670,12806,2.0,3,9,2670,0.0,2010,3010,7231,4449 days 16:47:18.678841,055,1.2,0.0,-340,5575,2670.0
390000.0,3,2.0,1080,7236,1.0,5,7,1080,0.0,1947,1120,8008,27460 days 16:47:18.678841,154,1.5,0.0,-40,-772,1080.0
466500.0,3,1.0,1430,3840,1.0,3,7,950,480.0,1945,1430,3840,28190 days 16:47:18.678841,156,3.0,1.9791666666666667,0,0,470.0
315000.0,2,2.25,1290,2436,2.0,3,7,1290,0.0,1984,1360,3088,13946 days 16:47:18.678841,301,0.8888888888888888,0.0,-70,-652,1290.0
220000.0,4,1.5,1240,9600,1.0,3,7,1240,0.0,1971,1240,9592,18694 days 16:47:18.678841,125,2.6666666666666665,0.0,0,8,1240.0
325000.0,3,1.75,1840,17286,1.0,4,7,1440,400.0,1978,1840,14541,16137 days 16:47:18.678841,065,1.7142857142857142,3.6,0,2745,1040.0
365000.0,3,1.0,1120,8443,1.0,3,7,1120,0.0,1953,1450,8433,25268 days 16:47:18.678841,118,3.0,0.0,-330,10,1120.0
356000.0,3,3.5,2100,12384,2.0,3,9,2100,0.0,1980,2400,7776,15407 days 16:47:18.678841,134,0.8571428571428571,0.0,-300,4608,2100.0
380000.0,4,1.75,2030,12518,1.0,3,8,1610,420.0,1950,1650,7872,26364 days 16:47:18.678841,266,2.2857142857142856,3.8333333333333335,380,4646,1190.0
579000.0,4,2.25,2030,8764,2.0,4,8,2030,0.0,1983,1950,8750,14311 days 16:47:18.678841,194,1.7777777777777777,0.0,80,14,2030.0
682000.0,2,1.0,890,5000,1.0,3,7,890,0.0,1943,1680,5000,28921 days 16:47:18.678841,121,2.0,0.0,-790,0,890.0
499000.0,3,1.75,1750,12325,1.0,4,7,1470,280.0,1968,1820,9750,19790 days 16:47:18.678841,167,1.7142857142857142,5.25,-70,2575,1190.0
333760.0,3,1.0,1300,5880,1.0,3,7,1300,0.0,1968,1300,7700,19790 days 16:47:18.678841,113,3.0,0.0,0,-1820,1300.0
745000.0,4,2.5,2650,18903,2.0,3,1,2650,0.0,1994,3270,18843,10293 days 16:47:18.678841,253,1.6,0.0,-620,60,2650.0
380000.0,3,1.75,1750,10870,1.0,5,7,1750,0.0,1968,1230,10868,19790 days 16:47:18.678841,203,1.7142857142857142,0.0,520,2,1750.0
435000.0,3,3.0,1440,1350,3.5,3,8,1440,0.0,2005,1440,1350,6275 days 16:47:18.678841,213,1.0,0.0,0,0,1440.0
520000.0,3,2.75,1700,3264,1.0,3,7,1060,640.0,1919,1880,4080,37687 days 16:47:18.678841,020,1.0909090909090908,1.65625,-180,-816,420.0
965000.0,4,2.5,3920,41206,2.0,4,1,3920,0.0,1988,3780,36562,12485 days 16:47:18.678841,117,1.6,0.0,140,4644,3920.0
270000.0,3,2.25,1470,16728,1.0,4,7,1350,120.0,1959,1540,9000,23077 days 16:47:18.678841,220,1.3333333333333333,11.25,-70,7728,1230.0
1100000.0,5,2.75,2520,4643,1.5,4,8,2120,400.0,1916,2100,4564,38783 days 16:47:18.678841,072,1.8181818181818181,5.3,420,79,1720.0
577500.0,3,1.75,2140,13286,1.0,4,8,1220,920.0,1964,2250,13286,21251 days 16:47:18.678841,281,1.7142857142857142,1.326086956521739,-110,0,300.0
650000.0,3,1.75,1550,5000,1.0,3,7,1250,300.0,1911,1110,5000,40609 days 16:47:18.678841,209,1.7142857142857142,4.166666666666667,440,0,950.0
1230000.0,4,2.5,3180,10319,2.0,4,1,3180,0.0,1986,3130,12120,13215 days 16:47:18.678841,339,1.6,0.0,50,-1801,3180.0
1900000.0,5,4.25,6510,16471,2.0,4,1,3250,3260.0,1980,4480,16471,15407 days 16:47:18.678841,255,1.1764705882352942,0.9969325153374233,2030,0,-10.0
475000.0,2,2.0,1440,3720,1.5,3,7,1440,0.0,1983,1490,4308,14311 days 16:47:18.678841,202,1.0,0.0,-50,-588,1440.0
200000.0,3,1.0,1150,10132,1.0,4,7,1150,0.0,1970,1180,8713,19059 days 16:47:18.678841,089,3.0,0.0,-30,1419,1150.0
397000.0,4,2.5,2320,11717,2.0,3,8,2320,0.0,1997,2320,9714,9197 days 16:47:18.678841,171,1.6,0.0,0,2003,2320.0
383610.0,3,2.0,1230,8450,1.0,3,7,1230,0.0,1989,2110,8536,12119 days 16:47:18.678841,050,1.5,0.0,-880,-86,1230.0
275000.0,4,2.5,2060,5742,2.0,3,7,2060,0.0,1999,1610,7298,8467 days 16:47:18.678841,209,1.6,0.0,450,-1556,2060.0
840000.0,3,2.0,2783,11177,2.0,3,8,2783,0.0,1910,1730,8018,40974 days 16:47:18.678841,190,1.5,0.0,1053,3159,2783.0
365000.0,4,2.5,2140,7350,2.0,3,8,2140,0.0,1985,2120,8395,13580 days 16:47:18.678841,261,1.6,0.0,20,-1045,2140.0
362000.0,3,2.75,1420,955,2.0,3,8,1160,260.0,2004,1420,955,6641 days 16:47:18.678841,247,1.0909090909090908,4.461538461538462,0,0,900.0
350000.0,3,1.75,2090,6258,1.0,3,7,1390,700.0,1956,1790,5793,24173 days 16:47:18.678841,305,1.7142857142857142,1.9857142857142858,300,465,690.0
200000.0,2,1.75,1320,13052,1.5,3,7,1320,0.0,1980,1320,13052,15407 days 16:47:18.678841,315,1.1428571428571428,0.0,0,0,1320.0
299000.0,4,2.5,2300,8100,1.0,4,8,1360,940.0,1979,1910,7630,15772 days 16:47:18.678841,126,1.6,1.446808510638298,390,470,420.0
555000.0,4,1.5,3050,82764,1.0,3,8,1650,1400.0,1966,2930,10074,20520 days 16:47:18.678841,280,2.6666666666666665,1.1785714285714286,120,72690,250.0
1330000.0,3,2.25,2960,8330,1.0,4,1,2260,700.0,1953,2960,8840,25268 days 16:47:18.678841,056,1.3333333333333333,3.2285714285714286,0,-510,1560.0
896000.0,5,2.75,2520,16100,1.0,4,8,1570,950.0,1960,2760,16988,22712 days 16:47:18.678841,181,1.8181818181818181,1.6526315789473685,-240,-888,620.0
324500.0,2,1.0,1300,6617,1.0,3,7,1300,0.0,1986,1820,7800,13215 days 16:47:18.678841,128,2.0,0.0,-520,-1183,1300.0
312500.0,3,1.0,1170,7350,1.0,4,7,1170,0.0,1960,1170,7350,22712 days 16:47:18.678841,005,3.0,0.0,0,0,1170.0
485000.0,4,3.25,1946,17786,2.0,4,7,1946,0.0,1990,1460,16661,11754 days 16:47:18.678841,104,1.2307692307692308,0.0,486,1125,1946.0
511000.0,2,1.0,1250,5413,1.0,4,7,1250,0.0,1923,1250,5413,36226 days 16:47:18.678841,293,2.0,0.0,0,0,1250.0
255000.0,3,1.75,1740,8800,1.0,3,7,1140,600.0,1978,1690,7920,16137 days 16:47:18.678841,119,1.7142857142857142,1.9,50,880,540.0
679975.0,4,2.5,3830,4644,2.0,3,8,2900,930.0,2004,3400,6163,6641 days 16:47:18.678841,107,1.6,3.118279569892473,430,-1519,1970.0
624800.0,3,2.0,2250,14274,1.0,4,8,1500,750.0,1964,2820,13813,21251 days 16:47:18.678841,190,1.5,2.0,-570,461,750.0
920000.0,3,2.75,2590,223027,2.0,3,9,2590,0.0,1983,3410,212137,14311 days 16:47:18.678841,324,1.0909090909090908,0.0,-820,10890,2590.0
1370000.0,3,2.5,2090,6000,1.5,4,9,2090,0.0,1928,2730,6000,34400 days 16:47:18.678841,150,1.2,0.0,-640,0,2090.0
510000.0,3,1.5,2400,10275,1.0,4,8,1540,860.0,1964,2380,10125,21251 days 16:47:18.678841,346,2.0,1.7906976744186047,20,150,680.0
289659.0,4,2.25,2260,7200,2.0,4,7,2260,0.0,1984,1720,7200,13946 days 16:47:18.678841,177,1.7777777777777777,0.0,540,0,2260.0
585000.0,4,2.5,2910,6250,2.0,3,8,2910,0.0,1999,2550,6250,8467 days 16:47:18.678841,114,1.6,0.0,360,0,2910.0
555000.0,5,3.0,3640,6930,2.0,3,8,3640,0.0,2004,3740,7182,6641 days 16:47:18.678841,177,1.6666666666666667,0.0,-100,-252,3640.0
940000.0,4,2.75,3770,24897,2.0,4,8,2550,1220.0,1964,2640,11502,21251 days 16:47:18.678841,072,1.4545454545454546,2.0901639344262297,1130,13395,1330.0
460000.0,3,2.0,1600,7350,1.0,4,7,1600,0.0,1979,1600,7200,15772 days 16:47:18.678841,252,1.5,0.0,0,150,1600.0
319000.0,3,2.5,2110,7434,2.0,4,7,2110,0.0,1978,2100,7749,16137 days 16:47:18.678841,325,1.2,0.0,10,-315,2110.0
250000.0,3,1.0,1100,7470,1.0,4,5,1100,0.0,1917,1280,7055,38417 days 16:47:18.678841,322,3.0,0.0,-180,415,1100.0
749950.0,4,2.5,2620,8312,2.0,3,9,2620,0.0,1990,2260,8515,11754 days 16:47:18.678841,016,1.6,0.0,360,-203,2620.0
458000.0,5,2.5,3090,23265,1.0,3,8,2990,100.0,1957,2560,18773,23807 days 16:47:18.678841,150,2.0,29.9,530,4492,2890.0
465000.0,3,2.5,1890,4808,2.0,3,8,1890,0.0,2000,2460,5348,8102 days 16:47:18.678841,092,1.2,0.0,-570,-540,1890.0
580000.0,3,1.75,1850,2797,1.0,3,8,1150,700.0,1977,1450,4599,16502 days 16:47:18.678841,103,1.7142857142857142,1.6428571428571428,400,-1802,450.0
700000.0,4,2.5,3100,36562,2.0,3,1,3100,0.0,1994,3080,39351,10293 days 16:47:18.678841,218,1.6,0.0,20,-2789,3100.0
350000.0,4,2.5,2506,7206,2.0,3,8,2506,0.0,2007,2441,7220,5545 days 16:47:18.678841,314,1.6,0.0,65,-14,2506.0
456000.0,4,1.0,1700,7689,1.0,3,7,1080,620.0,1977,1700,7333,16502 days 16:47:18.678841,248,4.0,1.7419354838709677,0,356,460.0
290000.0,3,2.0,1550,18958,1.5,3,7,1550,0.0,1983,1840,12826,14311 days 16:47:18.678841,049,1.5,0.0,-290,6132,1550.0
475000.0,4,2.75,2200,16288,1.0,3,7,1290,910.0,1980,2650,6620,15407 days 16:47:18.678841,192,1.4545454545454546,1.4175824175824177,-450,9668,380.0
285000.0,3,2.5,1890,3629,2.0,3,7,1890,0.0,2005,1980,4000,6275 days 16:47:18.678841,251,1.2,0.0,-90,-371,1890.0
309000.0,3,1.0,1140,6400,1.0,3,7,1140,0.0,1962,1340,6650,21981 days 16:47:18.678841,058,3.0,0.0,-200,-250,1140.0
860000.0,4,2.0,3740,32417,2.0,3,9,3740,0.0,2000,3180,32417,8102 days 16:47:18.678841,126,2.0,0.0,560,0,3740.0
219000.0,3,2.25,1940,6500,1.0,3,8,1440,500.0,1979,1880,8991,15772 days 16:47:18.678841,057,1.3333333333333333,2.88,60,-2491,940.0
546500.0,3,2.5,2130,7199,2.0,3,8,2130,0.0,1990,1890,7546,11754 days 16:47:18.678841,282,1.2,0.0,240,-347,2130.0
338000.0,2,1.0,1470,5566,1.0,4,7,770,700.0,1919,1410,5808,37687 days 16:47:18.678841,044,2.0,1.1,60,-242,70.0
505000.0,2,1.0,1070,8130,1.0,3,7,1070,0.0,1942,1360,7653,29286 days 16:47:18.678841,070,2.0,0.0,-290,477,1070.0
340000.0,4,1.75,1680,15084,1.0,4,7,840,840.0,1979,1800,15092,15772 days 16:47:18.678841,275,2.2857142857142856,1.0,-120,-8,0.0
678000.0,3,2.25,2730,10675,2.0,3,9,2730,0.0,1990,2770,10570,11754 days 16:47:18.678841,234,1.3333333333333333,0.0,-40,105,2730.0
800000.0,3,1.75,1890,10292,1.0,4,8,1890,0.0,1969,2630,10625,19424 days 16:47:18.678841,342,1.7142857142857142,0.0,-740,-333,1890.0
112000.0,1,1.0,1080,3230,1.0,3,6,1080,0.0,1963,1210,5760,21616 days 16:47:18.678841,206,1.0,0.0,-130,-2530,1080.0
252000.0,3,1.75,1440,16819,1.5,4,6,1440,0.0,1925,1560,12376,35495 days 16:47:18.678841,069,1.7142857142857142,0.0,-120,4443,1440.0
335000.0,4,2.75,2540,7210,1.0,4,7,1600,940.0,1979,1820,7766,15772 days 16:47:18.678841,155,1.4545454545454546,1.702127659574468,720,-556,660.0
610000.0,3,2.0,2300,13418,1.0,3,8,1430,870.0,1955,2140,9380,24538 days 16:47:18.678841,184,1.5,1.6436781609195403,160,4038,560.0
245000.0,3,2.0,1690,6790,1.0,3,7,1360,330.0,1979,1740,6790,15772 days 16:47:18.678841,301,1.5,4.121212121212121,-50,0,1030.0
493500.0,3,1.75,1800,16026,1.0,3,8,1390,410.0,1972,2210,13959,18329 days 16:47:18.678841,036,1.7142857142857142,3.3902439024390243,-410,2067,980.0
596500.0,4,2.25,1770,8505,2.0,3,8,1770,0.0,1986,1880,8939,13215 days 16:47:18.678841,007,1.7777777777777777,0.0,-110,-434,1770.0
245000.0,3,2.0,1190,4072,1.5,5,6,1190,0.0,1907,1680,5850,42070 days 16:47:18.678841,182,1.5,0.0,-490,-1778,1190.0
333500.0,3,1.75,1320,7200,1.0,4,7,1320,0.0,1977,1750,7260,16502 days 16:47:18.678841,300,1.7142857142857142,0.0,-430,-60,1320.0
373000.0,3,1.0,1290,8974,1.0,5,7,1290,0.0,1976,1540,7500,16868 days 16:47:18.678841,314,3.0,0.0,-250,1474,1290.0
759900.0,4,2.5,3000,5639,2.0,3,8,3000,0.0,2008,3000,4587,5180 days 16:47:18.678841,205,1.6,0.0,0,1052,3000.0
317000.0,3,2.25,1358,1204,3.0,3,7,1358,0.0,2007,1358,1196,5545 days 16:47:18.678841,238,1.3333333333333333,0.0,0,8,1358.0
670000.0,3,1.5,1220,4080,1.5,5,7,1220,0.0,1914,1320,4080,39513 days 16:47:18.678841,132,2.0,0.0,-100,0,1220.0
985000.0,2,2.5,2720,26761,2.0,3,7,2720,0.0,1990,1870,12396,11754 days 16:47:18.678841,310,0.8,0.0,850,14365,2720.0
310000.0,3,1.5,1060,6954,1.0,4,6,1060,0.0,1983,1560,6372,14311 days 16:47:18.678841,120,2.0,0.0,-500,582,1060.0
750000.0,4,2.5,3020,13122,2.0,3,9,2540,480.0,1997,3020,10873,9197 days 16:47:18.678841,288,1.6,5.291666666666667,0,2249,2060.0
408000.0,3,2.0,1640,3440,2.0,3,7,1640,0.0,1987,1070,3549,12850 days 16:47:18.678841,202,1.5,0.0,570,-109,1640.0
900000.0,5,3.75,3870,8225,2.0,3,1,3870,0.0,1998,3600,9361,8832 days 16:47:18.678841,168,1.3333333333333333,0.0,270,-1136,3870.0
460000.0,4,2.25,2860,15054,1.0,3,8,1460,1400.0,1957,1730,18525,23807 days 16:47:18.678841,023,1.7777777777777777,1.042857142857143,1130,-3471,60.0
339000.0,4,2.5,1740,6000,1.0,4,7,1740,0.0,1952,1190,6000,25634 days 16:47:18.678841,076,1.6,0.0,550,0,1740.0
660000.0,3,2.0,1140,6000,1.0,3,7,1140,0.0,1909,1260,4000,41339 days 16:47:18.678841,103,1.5,0.0,-120,2000,1140.0
449950.0,4,3.0,3290,10783,2.0,3,9,3290,0.0,1990,2810,10783,11754 days 16:47:18.678841,112,1.3333333333333333,0.0,480,0,3290.0
235000.0,3,1.0,1210,6000,1.0,3,7,1210,0.0,1930,1210,6000,33669 days 16:47:18.678841,237,3.0,0.0,0,0,1210.0
428000.0,2,2.0,1350,3900,1.0,3,8,1350,0.0,2003,1440,3900,7006 days 16:47:18.678841,127,1.0,0.0,-90,0,1350.0
445000.0,3,2.25,1990,7340,2.0,3,8,1990,0.0,1984,2180,11223,13946 days 16:47:18.678841,136,1.3333333333333333,0.0,-190,-3883,1990.0
462000.0,4,2.5,2060,6958,1.0,3,7,1220,840.0,1974,1760,7350,17598 days 16:47:18.678841,080,1.6,1.4523809523809523,300,-392,380.0
775000.0,3,1.0,1460,6198,1.5,4,7,1460,0.0,1916,2280,5160,38783 days 16:47:18.678841,126,3.0,0.0,-820,1038,1460.0
605000.0,4,1.75,2250,10108,1.0,4,8,2250,0.0,1967,2050,9750,20155 days 16:47:18.678841,335,2.2857142857142856,0.0,200,358,2250.0
193500.0,2,1.0,950,15996,1.0,4,7,950,0.0,1946,950,25510,27825 days 16:47:18.678841,289,2.0,0.0,0,-9514,950.0
389950.0,4,2.5,3140,8060,2.0,3,9,3140,0.0,1991,3000,8060,11389 days 16:47:18.678841,142,1.6,0.0,140,0,3140.0
790000.0,4,3.5,3560,6098,2.0,3,1,3560,0.0,2006,3660,6846,5910 days 16:47:18.678841,192,1.1428571428571428,0.0,-100,-748,3560.0
442000.0,2,1.0,1410,5000,1.0,4,7,940,470.0,1918,1450,5000,38052 days 16:47:18.678841,030,2.0,2.0,-40,0,470.0
890000.0,4,2.25,2770,13500,2.0,3,8,2770,0.0,1974,2300,13500,17598 days 16:47:18.678841,164,1.7777777777777777,0.0,470,0,2770.0
235000.0,3,1.0,1864,6978,1.0,4,7,1864,0.0,1958,990,8000,23442 days 16:47:18.678841,078,3.0,0.0,874,-1022,1864.0
495000.0,4,1.75,1930,6720,1.0,3,8,1130,800.0,1959,1850,6380,23077 days 16:47:18.678841,351,2.2857142857142856,1.4125,80,340,330.0
600000.0,4,2.5,3870,50965,2.0,3,1,3870,0.0,2007,2170,65843,5545 days 16:47:18.678841,005,1.6,0.0,1700,-14878,3870.0
1400000.0,3,2.0,2020,5500,1.5,3,1,1790,230.0,1937,2580,5500,31112 days 16:47:18.678841,169,1.5,7.782608695652174,-560,0,1560.0
251000.0,3,2.0,1300,8400,1.0,4,7,1300,0.0,1967,1300,7500,20155 days 16:47:18.678841,238,1.5,0.0,0,900,1300.0
471000.0,4,2.25,3410,57063,2.0,4,8,2410,1000.0,1978,2870,145490,16137 days 16:47:18.678841,085,1.7777777777777777,2.41,540,-88427,1410.0
597000.0,4,2.5,2370,41338,2.0,3,8,2370,0.0,1995,2340,46661,9928 days 16:47:18.678841,082,1.6,0.0,30,-5323,2370.0
804000.0,5,3.5,2770,9305,2.0,3,9,2770,0.0,1985,2520,9773,13580 days 16:47:18.678841,266,1.4285714285714286,0.0,250,-468,2770.0
357000.0,3,1.75,1250,17493,1.0,3,7,1250,0.0,1972,2180,19553,18329 days 16:47:18.678841,286,1.7142857142857142,0.0,-930,-2060,1250.0
419990.0,3,2.5,1690,1689,2.0,3,8,1150,540.0,2014,1540,1689,2988 days 16:47:18.678841,233,1.2,2.1296296296296298,150,0,610.0
725000.0,4,2.5,3040,35201,2.0,4,1,3040,0.0,1987,2990,35416,12850 days 16:47:18.678841,314,1.6,0.0,50,-215,3040.0
275000.0,3,2.5,2710,5733,2.0,3,7,2710,0.0,2003,2720,5733,7006 days 16:47:18.678841,040,1.2,0.0,-10,0,2710.0
510000.0,3,2.5,2300,27566,2.0,3,9,2300,0.0,1995,2480,16650,9928 days 16:47:18.678841,255,1.2,0.0,-180,10916,2300.0
330000.0,4,1.0,1360,13372,1.0,3,7,1360,0.0,1955,1540,10283,24538 days 16:47:18.678841,147,4.0,0.0,-180,3089,1360.0
270000.0,3,1.0,1500,5605,1.0,5,6,750,750.0,1942,1050,9100,29286 days 16:47:18.678841,230,3.0,1.0,450,-3495,0.0
495000.0,4,2.0,1610,4770,1.0,4,7,1230,380.0,1941,1180,6120,29651 days 16:47:18.678841,093,2.0,3.236842105263158,430,-1350,850.0
225000.0,4,1.75,1420,10300,2.0,3,7,1420,0.0,1950,1420,10300,26364 days 16:47:18.678841,065,2.2857142857142856,0.0,0,0,1420.0
716528.0,3,1.5,1750,5400,1.0,4,7,1050,700.0,1952,1750,5400,25634 days 16:47:18.678841,124,2.0,1.5,0,0,350.0
260000.0,3,2.5,1510,6095,2.0,4,7,1510,0.0,1991,1520,6000,11389 days 16:47:18.678841,287,1.2,0.0,-10,95,1510.0
471000.0,4,2.5,2330,9928,2.0,3,8,2330,0.0,1998,2430,8175,8832 days 16:47:18.678841,160,1.6,0.0,-100,1753,2330.0
690000.0,5,3.5,2690,4800,2.0,3,8,1930,760.0,1919,2080,4900,37687 days 16:47:18.678841,057,1.4285714285714286,2.539473684210526,610,-100,1170.0
505000.0,3,1.0,1020,5410,1.0,4,7,880,140.0,1928,1580,5376,34400 days 16:47:18.678841,207,3.0,6.285714285714286,-560,34,740.0
325000.0,3,1.0,1160,11799,1.0,3,7,1160,0.0,1966,1220,10500,20520 days 16:47:18.678841,351,3.0,0.0,-60,1299,1160.0
682000.0,4,2.25,2450,34092,2.0,4,8,2450,0.0,1980,2410,35378,15407 days 16:47:18.678841,309,1.7777777777777777,0.0,40,-1286,2450.0
605000.0,3,2.25,2010,10760,2.0,3,8,2010,0.0,1985,2240,9357,13580 days 16:47:18.678841,168,1.3333333333333333,0.0,-230,1403,2010.0
276200.0,2,1.75,1370,4495,1.0,4,8,1370,0.0,1975,1370,4686,17233 days 16:47:18.678841,125,1.1428571428571428,0.0,0,-191,1370.0
530000.0,3,1.0,1370,4040,1.5,3,7,1370,0.0,1906,1220,3030,42435 days 16:47:18.678841,205,3.0,0.0,150,1010,1370.0
245000.0,3,3.0,1990,9600,1.0,3,7,1440,550.0,1988,1670,9600,12485 days 16:47:18.678841,245,1.0,2.618181818181818,320,0,890.0
654950.0,4,2.5,2790,45902,2.0,3,9,2790,0.0,1987,2890,42421,12850 days 16:47:18.678841,154,1.6,0.0,-100,3481,2790.0
221900.0,2,1.0,780,6727,1.0,3,6,780,0.0,1939,1860,10124,30382 days 16:47:18.678841,288,2.0,0.0,-1080,-3397,780.0
466000.0,4,2.0,2240,4508,1.0,4,8,1340,900.0,1926,1930,5250,35130 days 16:47:18.678841,119,2.0,1.488888888888889,310,-742,440.0
383150.0,3,2.0,2210,6387,1.0,3,8,2210,0.0,2003,2570,6497,7006 days 16:47:18.678841,044,1.5,0.0,-360,-110,2210.0
657100.0,4,1.0,1390,4240,1.0,3,7,1050,340.0,1924,1810,4240,35861 days 16:47:18.678841,125,4.0,3.088235294117647,-420,0,710.0
539000.0,3,2.0,1800,43995,2.0,3,8,1800,0.0,1988,2290,51400,12485 days 16:47:18.678841,071,1.5,0.0,-490,-7405,1800.0
400000.0,6,3.0,3320,15600,1.0,4,8,1660,1660.0,1977,2330,15360,16502 days 16:47:18.678841,248,2.0,1.0,990,240,0.0
215000.0,4,2.5,1960,11600,1.0,5,6,980,980.0,1931,1160,7685,33304 days 16:47:18.678841,171,1.6,1.0,800,3915,0.0
489000.0,2,1.0,850,2850,1.0,4,7,850,0.0,1927,1450,4015,34765 days 16:47:18.678841,328,2.0,0.0,-600,-1165,850.0
649000.0,4,2.5,2980,12764,2.0,3,1,2980,0.0,1994,3080,9810,10293 days 16:47:18.678841,309,1.6,0.0,-100,2954,2980.0
700000.0,4,1.75,1980,10800,1.0,4,8,1320,660.0,1953,2310,10800,25268 days 16:47:18.678841,132,2.2857142857142856,2.0,-330,0,660.0
268500.0,2,1.0,790,8424,1.0,4,6,790,0.0,1953,1470,8424,25268 days 16:47:18.678841,140,2.0,0.0,-680,0,790.0
515000.0,3,2.5,1800,5001,2.0,3,7,1800,0.0,1996,2106,5618,9563 days 16:47:18.678841,161,1.2,0.0,-306,-617,1800.0
685000.0,4,2.0,2260,10800,1.0,3,9,2260,0.0,1978,2650,9900,16137 days 16:47:18.678841,054,2.0,0.0,-390,900,2260.0
305000.0,2,1.5,800,2142,2.0,3,7,800,0.0,2006,1320,2742,5910 days 16:47:18.678841,289,1.3333333333333333,0.0,-520,-600,800.0
950000.0,4,2.0,2490,4600,1.5,3,8,2090,400.0,1926,2910,5000,35130 days 16:47:18.678841,012,2.0,5.225,-420,-400,1690.0
292500.0,4,2.5,1610,4568,2.0,3,7,1610,0.0,2006,1834,4604,5910 days 16:47:18.678841,085,1.6,0.0,-224,-36,1610.0
270000.0,4,1.75,1850,7730,1.0,5,7,1100,750.0,1956,2260,8581,24173 days 16:47:18.678841,226,2.2857142857142856,1.4666666666666666,-410,-851,350.0
450000.0,4,1.75,1850,7730,1.0,5,7,1100,750.0,1956,2260,8581,24173 days 16:47:18.678841,338,2.2857142857142856,1.4666666666666666,-410,-851,350.0
535000.0,4,1.0,1920,6480,1.5,3,7,1920,0.0,1920,1600,6470,37322 days 16:47:18.678841,300,4.0,0.0,320,10,1920.0
550000.0,3,2.5,1740,3082,2.0,3,8,1740,0.0,2000,1910,3075,8102 days 16:47:18.678841,065,1.2,0.0,-170,7,1740.0
457500.0,3,2.25,1430,2003,2.0,3,8,980,450.0,1996,2210,4000,9563 days 16:47:18.678841,175,1.3333333333333333,2.1777777777777776,-780,-1997,530.0
136500.0,3,1.5,1420,8580,1.0,3,6,1420,0.0,1962,1200,8580,21981 days 16:47:18.678841,126,2.0,0.0,220,0,1420.0
224097.0,3,1.5,1420,8580,1.0,3,6,1420,0.0,1962,1200,8580,21981 days 16:47:18.678841,281,2.0,0.0,220,0,1420.0
254000.0,3,2.5,1560,10608,2.0,3,7,1560,0.0,1994,1360,10608,10293 days 16:47:18.678841,265,1.2,0.0,200,0,1560.0
335000.0,4,2.25,2030,13500,1.0,3,7,1230,800.0,1963,1830,13800,21616 days 16:47:18.678841,162,1.7777777777777777,1.5375,200,-300,430.0
594950.0,5,2.5,3280,6553,2.0,3,9,3280,0.0,2012,3360,7242,3719 days 16:47:18.678841,092,2.0,0.0,-80,-689,3280.0
350000.0,3,1.75,1360,18123,1.0,3,8,1360,0.0,1983,1570,16817,14311 days 16:47:18.678841,239,1.7142857142857142,0.0,-210,1306,1360.0
169950.0,3,1.0,1180,9832,1.0,3,7,1180,0.0,1970,1220,9894,19059 days 16:47:18.678841,259,3.0,0.0,-40,-62,1180.0
432500.0,3,2.5,1940,10800,1.0,3,8,1340,600.0,1979,2080,9600,15772 days 16:47:18.678841,279,1.2,2.2333333333333334,-140,1200,740.0
440000.0,2,1.75,1300,4000,2.0,3,7,1300,0.0,1948,1350,4013,27095 days 16:47:18.678841,140,1.1428571428571428,0.0,-50,-13,1300.0
233703.0,3,2.25,1650,3788,2.0,3,7,1650,0.0,1985,1510,3994,13580 days 16:47:18.678841,261,1.3333333333333333,0.0,140,-206,1650.0
310000.0,3,1.5,1140,3292,2.0,3,7,1140,0.0,1988,1150,3592,12485 days 16:47:18.678841,318,2.0,0.0,-10,-300,1140.0
735000.0,3,2.5,2540,6762,2.0,3,1,2540,0.0,1998,2870,6631,8832 days 16:47:18.678841,092,1.2,0.0,-330,131,2540.0
730000.0,4,2.75,3440,8150,2.0,3,1,3440,0.0,2014,2560,8315,2988 days 16:47:18.678841,351,1.4545454545454546,0.0,880,-165,3440.0
257000.0,3,1.75,1800,9000,1.0,3,7,1200,600.0,1961,980,6000,22346 days 16:47:18.678841,297,1.7142857142857142,2.0,820,3000,600.0
485000.0,2,2.25,1260,1240,3.0,3,8,1260,0.0,2004,1330,1300,6641 days 16:47:18.678841,139,0.8888888888888888,0.0,-70,-60,1260.0
899000.0,4,2.25,2370,6000,1.0,3,8,1440,930.0,1959,3280,8843,23077 days 16:47:18.678841,170,1.7777777777777777,1.5483870967741935,-910,-2843,510.0
279000.0,3,1.0,1520,8055,1.5,3,7,1520,0.0,1952,1560,8160,25634 days 16:47:18.678841,322,3.0,0.0,-40,-105,1520.0
225000.0,4,2.0,1750,7245,1.0,4,7,1050,700.0,1974,1640,7245,17598 days 16:47:18.678841,345,2.0,1.5,110,0,350.0
1360000.0,3,1.5,2680,4775,2.0,5,8,1880,800.0,1913,2280,5947,39878 days 16:47:18.678841,176,2.0,2.35,400,-1172,1080.0
355000.0,3,2.5,1590,4242,2.0,3,7,1590,0.0,2000,1590,3702,8102 days 16:47:18.678841,223,1.2,0.0,0,540,1590.0
382500.0,4,1.75,1560,8700,1.0,4,7,1560,0.0,1967,2080,8000,20155 days 16:47:18.678841,122,2.2857142857142856,0.0,-520,700,1560.0
324360.0,3,2.5,2000,9669,2.0,4,8,2000,0.0,1992,1930,9202,11024 days 16:47:18.678841,311,1.2,0.0,70,467,2000.0
315000.0,3,1.75,2380,10450,1.5,3,8,2380,0.0,1966,2320,8500,20520 days 16:47:18.678841,083,1.7142857142857142,0.0,60,1950,2380.0
426000.0,2,1.0,2230,11472,2.0,3,7,2230,0.0,1951,1870,8649,25999 days 16:47:18.678841,197,2.0,0.0,360,2823,2230.0
395000.0,5,2.5,2820,6305,2.0,3,8,2820,0.0,2003,2610,6306,7006 days 16:47:18.678841,096,2.0,0.0,210,-1,2820.0
212644.0,3,1.0,1570,9650,1.5,5,5,1570,0.0,1922,1330,9650,36591 days 16:47:18.678841,325,3.0,0.0,240,0,1570.0
510000.0,3,3.0,1845,5100,2.0,5,8,1845,0.0,1947,2100,7650,27460 days 16:47:18.678841,282,1.0,0.0,-255,-2550,1845.0
85000.0,2,1.0,830,9000,1.0,3,6,830,0.0,1939,1160,7680,30382 days 16:47:18.678841,258,2.0,0.0,-330,1320,830.0
235000.0,2,1.0,830,9000,1.0,3,6,830,0.0,1939,1160,7680,30382 days 16:47:18.678841,364,2.0,0.0,-330,1320,830.0
295000.0,4,2.5,2030,5754,2.0,3,8,2030,0.0,2001,2030,5784,7736 days 16:47:18.678841,098,1.6,0.0,0,-30,2030.0
720001.0,3,2.5,1430,2200,1.5,4,7,1430,0.0,1910,1740,4275,40974 days 16:47:18.678841,222,1.2,0.0,-310,-2075,1430.0
313950.0,3,1.0,1510,6083,1.0,4,6,860,650.0,1940,1510,5712,30017 days 16:47:18.678841,126,3.0,1.323076923076923,0,371,210.0
415000.0,3,1.0,1510,6083,1.0,4,6,860,650.0,1940,1510,5712,30017 days 16:47:18.678841,281,3.0,1.323076923076923,0,371,210.0
305000.0,3,1.75,1610,12247,1.0,3,8,1610,0.0,1981,2010,9271,15041 days 16:47:18.678841,139,1.7142857142857142,0.0,-400,2976,1610.0
625000.0,3,1.5,1600,4128,1.5,3,8,1250,350.0,1906,1540,3976,42435 days 16:47:18.678841,274,2.0,3.5714285714285716,60,152,900.0
490000.0,3,1.0,1420,11040,1.0,4,7,1420,0.0,1961,1530,8208,22346 days 16:47:18.678841,104,3.0,0.0,-110,2832,1420.0
269950.0,3,2.0,1660,8641,2.0,4,8,1660,0.0,1987,1490,8641,12850 days 16:47:18.678841,203,1.5,0.0,170,0,1660.0
2700000.0,5,4.0,4230,27295,2.0,3,8,3230,1000.0,1949,2660,27295,26729 days 16:47:18.678841,225,1.25,3.23,1570,0,2230.0
829000.0,4,3.0,3310,4500,2.5,5,9,2910,400.0,1900,1440,3750,44626 days 16:47:18.678841,225,1.3333333333333333,7.275,1870,750,2510.0
635000.0,4,2.5,2470,77550,1.0,4,7,2470,0.0,1987,2490,40894,12850 days 16:47:18.678841,241,1.6,0.0,-20,36656,2470.0
217500.0,3,1.0,1040,9750,1.0,3,7,1040,0.0,1959,1510,11100,23077 days 16:47:18.678841,071,3.0,0.0,-470,-1350,1040.0
270000.0,4,1.75,1850,7350,1.0,3,7,1050,800.0,1965,1450,7250,20885 days 16:47:18.678841,197,2.2857142857142856,1.3125,400,100,250.0
1250000.0,3,3.0,4610,8400,2.0,3,8,2790,1820.0,1947,2160,5000,27460 days 16:47:18.678841,269,1.0,1.532967032967033,2450,3400,970.0
480000.0,4,2.5,2480,5100,2.0,3,8,2480,0.0,2007,2270,5115,5545 days 16:47:18.678841,027,1.6,0.0,210,-15,2480.0
575000.0,3,1.75,2130,6500,1.0,3,8,1170,960.0,1954,2020,5000,24903 days 16:47:18.678841,126,1.7142857142857142,1.21875,110,1500,210.0
426950.0,4,2.75,2350,5589,2.0,3,7,2350,0.0,2001,2014,6365,7736 days 16:47:18.678841,307,1.4545454545454546,0.0,336,-776,2350.0
125000.0,3,1.0,920,7314,1.0,3,6,920,0.0,1960,1010,7420,22712 days 16:47:18.678841,248,3.0,0.0,-90,-106,920.0
208000.0,3,1.0,920,7314,1.0,3,6,920,0.0,1960,1010,7420,22712 days 16:47:18.678841,075,3.0,0.0,-90,-106,920.0
325000.0,4,2.0,1780,10622,1.0,4,7,900,880.0,1976,1550,8900,16868 days 16:47:18.678841,267,2.0,1.0227272727272727,230,1722,20.0
597157.0,7,4.0,2690,10880,1.0,4,8,2690,0.0,1960,1840,10836,22712 days 16:47:18.678841,265,1.75,0.0,850,44,2690.0
728725.0,4,2.5,3010,3120,2.5,3,8,3010,0.0,2006,2140,3840,5910 days 16:47:18.678841,007,1.6,0.0,870,-720,3010.0
708000.0,5,2.0,3180,10800,1.0,3,8,1910,1270.0,1968,2440,9750,19790 days 16:47:18.678841,230,2.5,1.5039370078740157,740,1050,640.0
1300000.0,4,3.0,4120,14021,2.0,3,1,4120,0.0,2005,4390,14684,6275 days 16:47:18.678841,204,1.3333333333333333,0.0,-270,-663,4120.0
405000.0,3,1.0,1280,11625,1.0,4,7,1280,0.0,1977,1320,10875,16502 days 16:47:18.678841,114,3.0,0.0,-40,750,1280.0
550000.0,4,2.75,1690,6090,1.5,3,7,1400,290.0,1945,1820,6090,28190 days 16:47:18.678841,301,1.4545454545454546,4.827586206896552,-130,0,1110.0
451000.0,4,2.5,2320,5375,2.0,3,7,2320,0.0,2006,2060,5395,5910 days 16:47:18.678841,099,1.6,0.0,260,-20,2320.0
540500.0,5,3.75,3090,7415,2.0,3,8,3090,0.0,2014,2790,7425,2988 days 16:47:18.678841,170,1.3333333333333333,0.0,300,-10,3090.0
1030000.0,5,3.5,5050,16500,2.0,3,1,5050,0.0,2001,4570,16500,7736 days 16:47:18.678841,280,1.4285714285714286,0.0,480,0,5050.0
218000.0,4,1.0,1640,10455,1.0,3,7,950,690.0,1963,1360,9750,21616 days 16:47:18.678841,329,4.0,1.3768115942028984,280,705,260.0
562000.0,4,2.25,2170,7007,1.0,3,8,1540,630.0,1974,2040,7700,17598 days 16:47:18.678841,293,1.7777777777777777,2.4444444444444446,130,-693,910.0
401500.0,4,2.5,3140,94525,2.0,4,8,2280,860.0,1977,1910,14300,16502 days 16:47:18.678841,224,1.6,2.6511627906976742,1230,80225,1420.0
196700.0,2,1.0,1090,9994,1.0,3,7,1090,0.0,1954,1090,11700,24903 days 16:47:18.678841,316,2.0,0.0,0,-1706,1090.0
583000.0,3,1.75,1930,10183,1.0,4,8,1480,450.0,1975,2320,10000,17233 days 16:47:18.678841,234,1.7142857142857142,3.2888888888888888,-390,183,1030.0
309900.0,5,2.5,2100,17825,1.0,4,7,1400,700.0,1974,2200,14602,17598 days 16:47:18.678841,338,2.0,2.0,-100,3223,700.0
485000.0,4,3.0,3110,18843,2.0,3,9,3110,0.0,1995,3080,14735,9928 days 16:47:18.678841,289,1.3333333333333333,0.0,30,4108,3110.0
465000.0,3,1.0,930,3348,1.0,4,6,930,0.0,1926,1210,3348,35130 days 16:47:18.678841,114,3.0,0.0,-280,0,930.0
595000.0,4,2.25,2050,8372,2.0,4,8,2050,0.0,1984,2010,8037,13946 days 16:47:18.678841,224,1.7777777777777777,0.0,40,335,2050.0
254000.0,3,1.0,1160,7560,1.0,4,6,1160,0.0,1958,1160,7560,23442 days 16:47:18.678841,199,3.0,0.0,0,0,1160.0
488500.0,3,2.75,1820,9490,2.0,3,7,1820,0.0,1994,1950,8851,10293 days 16:47:18.678841,303,1.0909090909090908,0.0,-130,639,1820.0
260000.0,4,2.5,2110,8990,2.0,3,8,2110,0.0,1977,2040,8800,16502 days 16:47:18.678841,300,1.6,0.0,70,190,2110.0
166000.0,2,1.0,870,8487,1.0,4,6,870,0.0,1944,1350,6850,28556 days 16:47:18.678841,002,2.0,0.0,-480,1637,870.0
440000.0,2,1.5,1080,6760,1.0,3,6,1080,0.0,1923,2080,5800,36226 days 16:47:18.678841,311,1.3333333333333333,0.0,-1000,960,1080.0
375000.0,3,2.0,1260,7560,2.0,5,6,1260,0.0,1943,1260,7595,28921 days 16:47:18.678841,033,1.5,0.0,0,-35,1260.0
529500.0,2,1.0,900,4800,1.0,4,6,780,120.0,1944,1270,5520,28556 days 16:47:18.678841,056,2.0,6.5,-370,-720,660.0
338000.0,2,1.0,750,6439,1.0,4,6,750,0.0,1934,1470,6374,32208 days 16:47:18.678841,287,2.0,0.0,-720,65,750.0
335620.0,3,2.25,1800,15903,1.0,3,8,1340,460.0,1986,2000,15233,13215 days 16:47:18.678841,075,1.3333333333333333,2.9130434782608696,-200,670,880.0
464000.0,4,2.25,2220,15232,1.0,3,9,1690,530.0,1978,2110,15280,16137 days 16:47:18.678841,036,1.7777777777777777,3.188679245283019,110,-48,1160.0
354000.0,2,1.0,1390,7740,1.0,4,6,1390,0.0,1925,1290,7740,35495 days 16:47:18.678841,276,2.0,0.0,100,0,1390.0
601000.0,4,3.5,2160,3600,2.0,3,8,1660,500.0,1998,1230,3840,8832 days 16:47:18.678841,226,1.1428571428571428,3.32,930,-240,1160.0
285000.0,3,2.25,1840,9040,1.0,3,8,1370,470.0,1979,1870,8992,15772 days 16:47:18.678841,114,1.3333333333333333,2.9148936170212765,-30,48,900.0
462500.0,2,2.0,1690,4200,2.0,3,7,1690,0.0,1906,1540,4200,42435 days 16:47:18.678841,273,1.0,0.0,150,0,1690.0
350000.0,4,2.5,2650,10459,2.0,4,8,2650,0.0,1989,2340,8777,12119 days 16:47:18.678841,192,1.6,0.0,310,1682,2650.0
329000.0,4,1.0,1120,3844,1.0,3,7,1120,0.0,1972,1480,3844,18329 days 16:47:18.678841,358,4.0,0.0,-360,0,1120.0
312500.0,4,2.5,2500,11983,1.0,3,7,1320,1180.0,1984,1460,9005,13946 days 16:47:18.678841,101,1.6,1.11864406779661,1040,2978,140.0
370000.0,4,2.5,2220,5338,2.0,3,7,2220,0.0,2001,2220,5338,7736 days 16:47:18.678841,164,1.6,0.0,0,0,2220.0
399900.0,3,1.75,1260,12750,1.0,3,7,1260,0.0,1979,1460,7865,15772 days 16:47:18.678841,070,1.7142857142857142,0.0,-200,4885,1260.0
398000.0,3,1.0,1480,6550,1.5,4,6,1480,0.0,1925,1200,6550,35495 days 16:47:18.678841,324,3.0,0.0,280,0,1480.0
550500.0,2,1.5,930,7400,1.0,4,7,830,100.0,1909,1920,4152,41339 days 16:47:18.678841,063,1.3333333333333333,8.3,-990,3248,730.0
709000.0,3,2.75,2780,7200,1.5,4,8,1870,910.0,1913,1700,7200,39878 days 16:47:18.678841,055,1.0909090909090908,2.0549450549450547,1080,0,960.0
402000.0,5,2.75,2770,7620,1.0,3,7,1700,1070.0,1965,1720,7620,20885 days 16:47:18.678841,346,1.8181818181818181,1.588785046728972,1050,0,630.0
450000.0,3,1.5,1530,23660,1.0,3,7,1530,0.0,1952,1800,11407,25634 days 16:47:18.678841,177,2.0,0.0,-270,12253,1530.0
524000.0,3,2.25,2140,6720,1.0,3,8,1440,700.0,1961,2060,6720,22346 days 16:47:18.678841,324,1.3333333333333333,2.057142857142857,80,0,740.0
800000.0,4,2.75,4600,322188,1.0,3,1,2400,2200.0,1989,3740,114562,12119 days 16:47:18.678841,351,1.4545454545454546,1.0909090909090908,860,207626,200.0
185000.0,4,1.0,1760,8906,1.0,3,7,1230,530.0,1966,1180,10407,20520 days 16:47:18.678841,266,4.0,2.3207547169811322,580,-1501,700.0
365000.0,4,1.0,1760,8906,1.0,3,7,1230,530.0,1966,1180,10407,20520 days 16:47:18.678841,051,4.0,2.3207547169811322,580,-1501,700.0
925000.0,4,2.5,3110,11422,2.0,3,9,3110,0.0,1989,2850,7254,12119 days 16:47:18.678841,252,1.6,0.0,260,4168,3110.0
714000.0,3,1.75,2260,11781,1.0,4,8,1520,740.0,1968,2530,10176,19790 days 16:47:18.678841,092,1.7142857142857142,2.054054054054054,-270,1605,780.0
495000.0,3,2.0,1460,9759,1.0,5,7,1460,0.0,1972,1620,8421,18329 days 16:47:18.678841,289,1.5,0.0,-160,1338,1460.0
535000.0,3,2.25,2050,6648,1.0,3,7,1230,820.0,1990,1760,7200,11754 days 16:47:18.678841,110,1.3333333333333333,1.5,290,-552,410.0
880000.0,4,2.5,2340,10800,1.0,3,8,2340,0.0,1953,2650,13500,25268 days 16:47:18.678841,297,1.6,0.0,-310,-2700,2340.0
150000.0,3,1.5,1230,8056,1.0,4,6,1230,0.0,1949,850,6714,26729 days 16:47:18.678841,167,2.0,0.0,380,1342,1230.0
554500.0,3,2.25,1880,6565,1.0,4,8,1420,460.0,1972,2060,7280,18329 days 16:47:18.678841,086,1.3333333333333333,3.0869565217391304,-180,-715,960.0
520000.0,3,1.75,1280,3880,1.5,5,7,1280,0.0,1916,980,3880,38783 days 16:47:18.678841,098,1.7142857142857142,0.0,300,0,1280.0
839990.0,4,2.75,3660,5637,2.0,3,9,3660,0.0,2014,3625,5639,2988 days 16:47:18.678841,234,1.4545454545454546,0.0,35,-2,3660.0
500000.0,3,2.5,1650,5683,2.0,3,7,1650,0.0,2003,1650,4193,7006 days 16:47:18.678841,234,1.2,0.0,0,1490,1650.0
305000.0,2,1.0,1960,186872,1.5,4,6,1960,0.0,1936,1650,19200,31478 days 16:47:18.678841,007,2.0,0.0,310,167672,1960.0
247800.0,3,2.5,1580,2170,2.0,3,7,1580,0.0,2003,1610,1917,7006 days 16:47:18.678841,214,1.2,0.0,-30,253,1580.0
344200.0,4,2.5,2490,5812,2.0,3,8,2490,0.0,2000,2690,6012,8102 days 16:47:18.678841,192,1.6,0.0,-200,-200,2490.0
459950.0,4,2.5,2000,6107,2.0,3,8,2000,0.0,2003,2040,6520,7006 days 16:47:18.678841,174,1.6,0.0,-40,-413,2000.0
229900.0,4,1.75,1550,9899,1.0,4,7,1550,0.0,1967,1500,11272,20155 days 16:47:18.678841,258,2.2857142857142856,0.0,50,-1373,1550.0
750000.0,4,2.25,2820,9602,1.0,3,8,1950,870.0,1974,2890,9602,17598 days 16:47:18.678841,050,1.7777777777777777,2.2413793103448274,-70,0,1080.0
509000.0,4,2.5,2600,9355,1.0,3,9,1840,760.0,1983,2250,7691,14311 days 16:47:18.678841,297,1.6,2.4210526315789473,350,1664,1080.0
680000.0,4,1.0,2200,12137,1.0,4,8,1640,560.0,1956,3250,17153,24173 days 16:47:18.678841,084,4.0,2.9285714285714284,-1050,-5016,1080.0
661500.0,5,2.5,2500,7200,1.0,4,7,1490,1010.0,1977,1960,8325,16502 days 16:47:18.678841,178,2.0,1.4752475247524752,540,-1125,480.0
370000.0,2,1.0,1270,1399,3.0,3,7,1270,0.0,2000,1140,1442,8102 days 16:47:18.678841,329,2.0,0.0,130,-43,1270.0
785000.0,4,2.75,2900,17400,1.0,4,8,2410,490.0,1978,2620,12240,16137 days 16:47:18.678841,198,1.4545454545454546,4.918367346938775,280,5160,1920.0
355000.0,2,1.0,840,6720,1.0,3,7,840,0.0,1952,1250,6720,25634 days 16:47:18.678841,230,2.0,0.0,-410,0,840.0
446000.0,4,2.0,1940,6350,1.0,4,7,970,970.0,1951,960,6350,25999 days 16:47:18.678841,212,2.0,1.0,980,0,0.0
830000.0,5,3.5,3490,21780,2.0,3,8,3490,0.0,1996,3070,7829,9563 days 16:47:18.678841,028,1.4285714285714286,0.0,420,13951,3490.0
324000.0,3,2.5,1940,8347,2.0,3,8,1940,0.0,1990,1940,7131,11754 days 16:47:18.678841,301,1.2,0.0,0,1216,1940.0
500000.0,4,2.25,2490,23478,2.0,3,8,2490,0.0,1981,2030,12611,15041 days 16:47:18.678841,281,1.7777777777777777,0.0,460,10867,2490.0
745000.0,3,1.0,1390,9112,1.0,4,7,1390,0.0,1951,2290,9112,25999 days 16:47:18.678841,290,3.0,0.0,-900,0,1390.0
1200000.0,4,2.5,3940,4407,2.0,4,8,2620,1320.0,1921,1790,4407,36956 days 16:47:18.678841,314,1.6,1.9848484848484849,2150,0,1300.0
385000.0,2,2.5,1760,3710,1.0,3,8,1130,630.0,1988,1760,4200,12485 days 16:47:18.678841,349,0.8,1.7936507936507937,0,-490,500.0
565000.0,3,2.25,2560,8040,1.0,3,8,1510,1050.0,1958,1980,8040,23442 days 16:47:18.678841,345,1.3333333333333333,1.438095238095238,580,0,460.0
465000.0,4,2.5,2300,7314,1.0,4,8,1420,880.0,1979,2010,7314,15772 days 16:47:18.678841,323,1.6,1.6136363636363635,290,0,540.0
401000.0,3,3.25,1770,1977,3.0,3,8,1770,0.0,2001,1860,2210,7736 days 16:47:18.678841,239,0.9230769230769231,0.0,-90,-233,1770.0
385000.0,3,1.75,2310,11200,1.0,4,8,1630,680.0,1978,2350,13300,16137 days 16:47:18.678841,170,1.7142857142857142,2.3970588235294117,-40,-2100,950.0
395000.0,3,2.5,2310,4930,2.0,4,8,2310,0.0,1989,2230,5324,12119 days 16:47:18.678841,290,1.2,0.0,80,-394,2310.0
245000.0,5,1.5,2000,8100,1.5,3,6,2000,0.0,1946,960,9239,27825 days 16:47:18.678841,104,3.3333333333333335,0.0,1040,-1139,2000.0
500000.0,3,2.0,1540,3600,1.0,3,7,890,650.0,1994,1540,3600,10293 days 16:47:18.678841,084,1.5,1.3692307692307693,0,0,240.0
334000.0,5,1.75,2590,6720,1.0,4,7,1750,840.0,1979,1820,7521,15772 days 16:47:18.678841,307,2.857142857142857,2.0833333333333335,770,-801,910.0
550000.0,3,1.0,980,10960,1.0,4,7,980,0.0,1953,2100,10960,25268 days 16:47:18.678841,121,3.0,0.0,-1120,0,980.0
216000.0,3,1.0,1730,7950,1.0,4,7,1180,550.0,1961,1830,8890,22346 days 16:47:18.678841,328,3.0,2.1454545454545455,-100,-940,630.0
340500.0,3,2.5,3070,5871,3.0,4,8,2510,560.0,1928,2220,4000,34400 days 16:47:18.678841,303,1.2,4.482142857142857,850,1871,1950.0
375000.0,4,2.25,2100,12738,2.0,4,8,2100,0.0,1975,2000,12090,17233 days 16:47:18.678841,225,1.7777777777777777,0.0,100,648,2100.0
600000.0,3,2.75,2080,16740,1.0,3,8,1580,500.0,1966,2175,7568,20520 days 16:47:18.678841,009,1.0909090909090908,3.16,-95,9172,1080.0
375000.0,4,1.75,1890,8000,1.0,4,7,1250,640.0,1960,1870,8270,22712 days 16:47:18.678841,135,2.2857142857142856,1.953125,20,-270,610.0
536500.0,4,1.75,2000,4000,1.5,5,7,1450,550.0,1926,1430,4000,35130 days 16:47:18.679838,129,2.2857142857142856,2.6363636363636362,570,0,900.0
599900.0,3,3.0,3030,35123,2.0,4,8,1760,1270.0,1984,2810,36205,13946 days 16:47:18.679838,267,1.0,1.3858267716535433,220,-1082,490.0
750000.0,2,1.5,1110,3600,1.0,5,7,1110,0.0,1904,1670,5400,43166 days 16:47:18.679838,063,1.3333333333333333,0.0,-560,-1800,1110.0
355000.0,3,1.0,1650,10075,1.0,3,7,1170,480.0,1955,1690,8125,24538 days 16:47:18.679838,042,3.0,2.4375,-40,1950,690.0
590000.0,3,2.0,1410,6413,1.0,4,7,910,500.0,1947,1330,6050,27460 days 16:47:18.679838,182,1.5,1.82,80,363,410.0
680000.0,2,1.0,2140,6000,1.0,4,7,1070,1070.0,1946,1560,6000,27825 days 16:47:18.679838,127,2.0,1.0,580,0,0.0
429000.0,3,2.5,1860,11122,2.0,3,8,1860,0.0,1994,2420,8542,10293 days 16:47:18.679838,279,1.2,0.0,-560,2580,1860.0
581000.0,2,1.0,1170,4080,1.0,4,7,1170,0.0,1909,1560,4586,41339 days 16:47:18.679838,122,2.0,0.0,-390,-506,1170.0
463800.0,3,1.5,980,7770,1.0,4,7,980,0.0,1968,1470,7350,19790 days 16:47:18.679838,090,2.0,0.0,-490,420,980.0
2980000.0,5,5.5,7400,18898,2.0,3,1,6290,1110.0,2001,6110,26442,7736 days 16:47:18.679838,346,0.9090909090909091,5.666666666666667,1290,-7544,5180.0
443000.0,5,1.75,1650,3000,1.5,3,8,1650,0.0,1902,1740,4000,43896 days 16:47:18.679838,188,2.857142857142857,0.0,-90,-1000,1650.0
276200.0,3,2.5,1480,7210,1.0,3,7,1180,300.0,1986,1690,7396,13215 days 16:47:18.679838,268,1.2,3.933333333333333,-210,-186,880.0
630000.0,5,3.5,4060,8309,2.0,3,9,2960,1100.0,2001,1730,11711,7736 days 16:47:18.679838,113,1.4285714285714286,2.690909090909091,2330,-3402,1860.0
570000.0,3,1.75,1370,3300,2.0,5,7,1370,0.0,1927,1560,3927,34765 days 16:47:18.679838,356,1.7142857142857142,0.0,-190,-627,1370.0
979700.0,4,2.25,2480,6000,2.0,3,1,2380,100.0,1929,3030,5600,34034 days 16:47:18.679838,286,1.7777777777777777,23.8,-550,400,2280.0
730000.0,4,2.5,2030,4080,1.5,4,8,1730,300.0,1921,1980,4080,36956 days 16:47:18.679838,345,1.6,5.766666666666667,50,0,1430.0
268450.0,5,2.25,2200,9600,1.0,4,7,1100,1100.0,1963,1780,9680,21616 days 16:47:18.679838,338,2.2222222222222223,1.0,420,-80,0.0
490000.0,3,1.75,1770,7508,1.0,3,7,1270,500.0,1962,1690,8880,21981 days 16:47:18.679838,063,1.7142857142857142,2.54,80,-1372,770.0
808000.0,3,2.5,2550,6240,1.0,5,8,1750,800.0,1957,2180,5200,23807 days 16:47:18.679838,239,1.2,2.1875,370,1040,950.0
350000.0,3,1.0,1250,9786,1.0,4,7,1250,0.0,1969,1660,9621,19424 days 16:47:18.679838,120,3.0,0.0,-410,165,1250.0
695000.0,4,1.75,2390,5880,1.0,3,8,1390,1000.0,1957,2210,6260,23807 days 16:47:18.679838,301,2.2857142857142856,1.39,180,-380,390.0
1230000.0,4,2.5,5730,44947,2.0,3,1,4280,1450.0,1991,3310,17628,11389 days 16:47:18.679838,163,1.6,2.9517241379310346,2420,27319,2830.0
309950.0,1,1.0,1120,11800,1.5,3,7,1120,0.0,1950,2330,9290,26364 days 16:47:18.679838,225,1.0,0.0,-1210,2510,1120.0
134000.0,3,1.0,1270,8508,1.0,4,6,650,620.0,1942,1200,9415,29286 days 16:47:18.679838,303,3.0,1.0483870967741935,70,-907,30.0
645500.0,4,2.5,2390,9638,2.0,3,1,2390,0.0,1988,2630,9258,12485 days 16:47:18.679838,322,1.6,0.0,-240,380,2390.0
750000.0,3,2.0,1760,5488,1.5,3,7,1540,220.0,1927,1760,5943,34765 days 16:47:18.679838,068,1.5,7.0,0,-455,1320.0
1400000.0,3,2.5,2560,3600,2.0,3,9,2110,450.0,1967,2690,4800,20155 days 16:47:18.679838,283,1.2,4.688888888888889,-130,-1200,1660.0
344900.0,4,1.75,1820,7700,1.0,4,7,1100,720.0,1955,1700,8500,24538 days 16:47:18.679838,268,2.2857142857142856,1.5277777777777777,120,-800,380.0
601450.0,2,3.25,1840,1500,3.0,3,8,1840,0.0,2001,1910,2500,7736 days 16:47:18.679838,281,0.6153846153846154,0.0,-70,-1000,1840.0
575000.0,4,2.0,1810,4400,2.0,3,8,1700,110.0,1909,1470,4400,41339 days 16:47:18.679838,007,2.0,15.454545454545455,340,0,1590.0
405000.0,3,1.75,2470,9620,1.0,4,7,1570,900.0,1962,2600,9620,21981 days 16:47:18.679838,141,1.7142857142857142,1.7444444444444445,-130,0,670.0
518000.0,4,2.75,2520,14021,2.0,3,9,2520,0.0,1999,2330,14007,8467 days 16:47:18.679838,175,1.4545454545454546,0.0,190,14,2520.0
265000.0,2,1.0,1600,7936,1.0,3,7,1600,0.0,1947,1580,7440,27460 days 16:47:18.679838,198,2.0,0.0,20,496,1600.0
180000.0,3,1.0,1280,4875,1.0,5,6,1280,0.0,1969,1060,4875,19424 days 16:47:18.679838,268,3.0,0.0,220,0,1280.0
285000.0,3,2.5,1590,9736,2.0,3,7,1590,0.0,1985,1580,7500,13580 days 16:47:18.679838,077,1.2,0.0,10,2236,1590.0
433000.0,3,2.75,2000,7200,1.0,3,7,1000,1000.0,1954,1440,7200,24903 days 16:47:18.679838,075,1.0909090909090908,1.0,560,0,0.0
399000.0,3,1.75,1780,11440,1.0,3,8,1350,430.0,1977,2180,11440,16502 days 16:47:18.679838,054,1.7142857142857142,3.13953488372093,-400,0,920.0
406500.0,3,1.5,1970,10080,1.0,3,7,1970,0.0,1966,2240,10080,20520 days 16:47:18.679838,055,2.0,0.0,-270,0,1970.0
420000.0,4,1.75,1940,11500,1.0,4,7,1090,850.0,1955,1700,8360,24538 days 16:47:18.679838,219,2.2857142857142856,1.2823529411764707,240,3140,240.0
965000.0,4,3.5,3290,5559,1.5,3,8,2290,1000.0,1906,1790,6000,42435 days 16:47:18.679838,051,1.1428571428571428,2.29,1500,-441,1290.0
1380000.0,4,3.5,3500,9523,2.0,3,1,2460,1040.0,1996,3160,5997,9563 days 16:47:18.679838,297,1.1428571428571428,2.3653846153846154,340,3526,1420.0
353950.0,5,2.25,3260,7969,2.0,4,8,3260,0.0,1982,2070,7962,14676 days 16:47:18.679838,280,2.2222222222222223,0.0,1190,7,3260.0
847700.0,5,3.25,4230,10260,2.0,3,1,3860,370.0,1996,2980,10997,9563 days 16:47:18.679838,191,1.5384615384615385,10.432432432432432,1250,-737,3490.0
185000.0,5,1.0,1590,6700,1.5,3,6,1090,500.0,1942,1370,8040,29286 days 16:47:18.679838,183,5.0,2.18,220,-1340,590.0
269000.0,2,1.5,1010,6000,1.0,4,7,1010,0.0,1923,1290,6000,36226 days 16:47:18.679838,323,1.3333333333333333,0.0,-280,0,1010.0
422800.0,3,1.75,1820,8400,1.0,3,7,1340,480.0,1976,1900,8112,16868 days 16:47:18.679838,358,1.7142857142857142,2.7916666666666665,-80,288,860.0
379950.0,2,1.0,870,7500,1.0,3,7,870,0.0,1947,1240,5709,27460 days 16:47:18.679838,349,2.0,0.0,-370,1791,870.0
525000.0,3,2.0,1620,7800,1.0,3,7,1200,420.0,1969,1540,7565,19424 days 16:47:18.679838,360,1.5,2.857142857142857,80,235,780.0
810000.0,4,3.5,3980,209523,2.0,3,9,3980,0.0,2006,2220,65775,5910 days 16:47:18.679838,199,1.1428571428571428,0.0,1760,143748,3980.0
209950.0,4,1.0,1630,8400,1.0,3,6,1630,0.0,1962,1190,8989,21981 days 16:47:18.679838,203,4.0,0.0,440,-589,1630.0
439950.0,3,2.0,1230,1613,2.0,3,8,1010,220.0,2003,1610,1873,7006 days 16:47:18.679838,338,1.5,4.590909090909091,-380,-260,790.0
554820.0,4,2.0,3510,12905,1.0,3,8,2210,1300.0,1965,2530,16143,20885 days 16:47:18.679838,143,2.0,1.7,980,-3238,910.0
359000.0,4,2.5,2160,4500,2.0,3,7,2160,0.0,2002,2160,4496,7371 days 16:47:18.679838,113,1.6,0.0,0,4,2160.0
242500.0,3,1.0,1020,5870,1.0,3,6,1020,0.0,1941,1160,6901,29651 days 16:47:18.679838,253,3.0,0.0,-140,-1031,1020.0
330000.0,3,1.75,1590,9417,1.0,4,7,1590,0.0,1954,1600,9272,24903 days 16:47:18.679838,269,1.7142857142857142,0.0,-10,145,1590.0
740000.0,3,2.25,3440,44374,2.0,4,1,2190,1250.0,1979,3470,40185,15772 days 16:47:18.679838,309,1.3333333333333333,1.752,-30,4189,940.0
630000.0,5,1.0,3020,4800,2.0,3,7,3020,0.0,1901,1350,1307,44261 days 16:47:18.679838,352,5.0,0.0,1670,3493,3020.0
750000.0,3,1.75,2280,7800,1.0,4,8,1360,920.0,1941,2280,5200,29651 days 16:47:18.679838,227,1.7142857142857142,1.4782608695652173,0,2600,440.0
695000.0,4,2.5,2790,6540,2.0,3,9,2790,0.0,1999,2790,6270,8467 days 16:47:18.679838,286,1.6,0.0,0,270,2790.0
109000.0,2,0.5,580,6900,1.0,3,5,580,0.0,1941,1570,5040,29651 days 16:47:18.679838,014,4.0,0.0,-990,1860,580.0
389000.0,3,1.5,2030,10075,1.0,5,7,1080,950.0,1961,2210,10075,22346 days 16:47:18.679838,056,2.0,1.1368421052631579,-180,0,130.0
1200000.0,3,2.0,2480,13310,1.0,2,7,2480,0.0,1955,2400,11340,24538 days 16:47:18.679838,364,1.5,0.0,80,1970,2480.0
315000.0,3,1.75,1010,12000,1.0,4,7,1010,0.0,1977,1080,10619,16502 days 16:47:18.679838,344,1.7142857142857142,0.0,-70,1381,1010.0
640000.0,3,2.5,2420,8244,2.0,3,1,2420,0.0,1988,2500,9320,12485 days 16:47:18.679838,104,1.2,0.0,-80,-1076,2420.0
570000.0,3,2.25,2180,9246,2.0,3,9,2180,0.0,1984,2300,9298,13946 days 16:47:18.679838,323,1.3333333333333333,0.0,-120,-52,2180.0
495000.0,3,2.75,1830,208216,2.0,3,8,1830,0.0,1997,1530,16988,9197 days 16:47:18.679838,217,1.0909090909090908,0.0,300,191228,1830.0
449500.0,5,2.75,2040,7488,1.0,4,7,1200,840.0,1969,1530,7488,19424 days 16:47:18.679838,154,1.8181818181818181,1.4285714285714286,510,0,360.0
1080000.0,4,2.75,2640,5000,2.0,3,9,1840,800.0,1943,2010,5000,28921 days 16:47:18.679838,076,1.4545454545454546,2.3,630,0,1040.0
170500.0,3,1.0,1640,13939,1.0,3,7,1040,600.0,1960,2080,13000,22712 days 16:47:18.679838,266,3.0,1.7333333333333334,-440,939,440.0
312000.0,4,1.0,1190,7620,1.5,3,6,1190,0.0,1926,1060,7320,35130 days 16:47:18.679838,342,4.0,0.0,130,300,1190.0
690000.0,4,2.5,2120,8448,2.0,4,9,2120,0.0,1989,2140,8122,12119 days 16:47:18.679838,209,1.6,0.0,-20,326,2120.0
375000.0,4,2.5,2210,9427,2.0,3,7,2210,0.0,1999,1770,8770,8467 days 16:47:18.679838,161,1.6,0.0,440,657,2210.0
575000.0,4,2.5,2510,47044,2.0,3,9,2510,0.0,1987,2600,42612,12850 days 16:47:18.679838,218,1.6,0.0,-90,4432,2510.0
646000.0,4,2.25,2500,8500,1.0,4,8,1600,900.0,1978,2290,8927,16137 days 16:47:18.679838,155,1.7777777777777777,1.7777777777777777,210,-427,700.0
239950.0,3,2.5,1560,4800,2.0,4,7,1560,0.0,1974,1510,12240,17598 days 16:47:18.679838,086,1.2,0.0,50,-7440,1560.0
400000.0,5,2.5,2510,7525,1.5,4,7,1710,800.0,1929,1270,6741,34034 days 16:47:18.679838,210,2.0,2.1375,1240,784,910.0
455000.0,4,1.75,3060,94089,1.0,3,8,3060,0.0,1958,2180,43995,23442 days 16:47:18.679838,021,2.2857142857142856,0.0,880,50094,3060.0
240000.0,3,2.0,1310,8069,1.0,3,7,1310,0.0,1990,1310,8392,11754 days 16:47:18.679838,247,1.5,0.0,0,-323,1310.0
3400000.0,4,4.0,4260,11765,2.0,3,1,3280,980.0,1939,4260,10408,30382 days 16:47:18.679838,128,1.0,3.3469387755102042,0,1357,2300.0
695000.0,3,2.0,2500,4080,1.5,5,7,1680,820.0,1922,1550,3060,36591 days 16:47:18.679838,182,1.5,2.048780487804878,950,1020,860.0
304950.0,2,1.0,670,6720,1.0,5,6,670,0.0,1942,710,6720,29286 days 16:47:18.679838,267,2.0,0.0,-40,0,670.0
650000.0,3,1.75,1840,2310,1.0,4,8,1140,700.0,1914,1670,4000,39513 days 16:47:18.679838,217,1.7142857142857142,1.6285714285714286,170,-1690,440.0
402500.0,3,1.75,1480,2211,2.0,3,7,1480,0.0,1995,1480,2197,9928 days 16:47:18.679838,196,1.7142857142857142,0.0,0,14,1480.0
482000.0,3,2.5,2420,7307,2.0,3,7,2420,0.0,1998,2420,5577,8832 days 16:47:18.679838,176,1.2,0.0,0,1730,2420.0
655000.0,3,2.0,1820,4480,1.0,5,7,1120,700.0,1923,1920,4480,36226 days 16:47:18.679838,304,1.5,1.6,-100,0,420.0
577000.0,5,2.75,1940,5000,2.0,5,7,1940,0.0,1951,1940,4230,25999 days 16:47:18.679838,269,1.8181818181818181,0.0,0,770,1940.0
350000.0,3,2.5,1630,5996,2.0,3,7,1630,0.0,1986,1660,4504,13215 days 16:47:18.679838,293,1.2,0.0,-30,1492,1630.0
415000.0,4,2.25,2520,8000,1.0,3,8,1680,840.0,1970,2300,8000,19059 days 16:47:18.679838,251,1.7777777777777777,2.0,220,0,840.0
396400.0,4,2.5,2120,215186,2.0,2,7,2120,0.0,1983,2000,215186,14311 days 16:47:18.679838,211,1.6,0.0,120,0,2120.0
654300.0,3,2.5,2490,8582,2.0,3,9,2490,0.0,2000,2870,7598,8102 days 16:47:18.679838,099,1.2,0.0,-380,984,2490.0
774950.0,4,2.5,3410,179419,2.0,3,1,3410,0.0,2004,3350,175421,6641 days 16:47:18.679838,328,1.6,0.0,60,3998,3410.0
855000.0,4,2.0,2380,10800,2.0,3,8,2380,0.0,1925,2112,6600,35495 days 16:47:18.679838,245,2.0,0.0,268,4200,2380.0
1150000.0,3,2.5,2490,4000,2.0,5,8,1670,820.0,1918,2310,4000,38052 days 16:47:18.679838,177,1.2,2.0365853658536586,180,0,850.0
330000.0,2,2.5,1240,1546,2.0,3,7,1240,0.0,2007,1520,2468,5545 days 16:47:18.679838,150,0.8,0.0,-280,-922,1240.0
290000.0,4,2.25,1900,10950,1.0,4,7,1400,500.0,1959,1700,11850,23077 days 16:47:18.679838,266,1.7777777777777777,2.8,200,-900,900.0
519500.0,3,3.0,2390,19454,1.5,3,8,2390,0.0,2008,1540,26979,5180 days 16:47:18.679838,323,1.0,0.0,850,-7525,2390.0
450000.0,3,1.75,1810,12600,1.0,3,7,1400,410.0,1977,1934,12600,16502 days 16:47:18.679838,226,1.7142857142857142,3.4146341463414633,-124,0,990.0
3120000.0,3,3.5,4490,56609,2.0,3,1,4490,0.0,1993,2710,51330,10658 days 16:47:18.679838,328,0.8571428571428571,0.0,1780,5279,4490.0
265000.0,3,1.0,1620,9450,1.5,3,7,1620,0.0,1928,2070,11970,34400 days 16:47:18.679838,174,3.0,0.0,-450,-2520,1620.0
359000.0,4,2.5,2640,7883,2.0,3,8,2640,0.0,1990,2150,7683,11754 days 16:47:18.679838,126,1.6,0.0,490,200,2640.0
2000000.0,4,3.75,2870,4500,2.0,3,1,2510,360.0,2012,2870,6354,3719 days 16:47:18.679838,061,1.0666666666666667,6.972222222222222,0,-1854,2150.0
1050000.0,4,2.5,3250,48037,1.0,3,8,2030,1220.0,1985,2970,48037,13580 days 16:47:18.679838,041,1.6,1.6639344262295082,280,0,810.0
402500.0,2,1.0,800,2280,1.0,5,6,800,0.0,1946,1310,4200,27825 days 16:47:18.679838,182,2.0,0.0,-510,-1920,800.0
450000.0,3,1.75,1360,5445,1.0,4,7,1360,0.0,1957,1570,7840,23807 days 16:47:18.679838,237,1.7142857142857142,0.0,-210,-2395,1360.0
262500.0,5,2.25,1950,8086,1.0,3,7,1130,820.0,1980,1670,8550,15407 days 16:47:18.679838,065,2.2222222222222223,1.3780487804878048,280,-464,310.0
285000.0,4,2.25,1970,7200,2.0,3,8,1970,0.0,1979,1790,7500,15772 days 16:47:18.679838,056,1.7777777777777777,0.0,180,-300,1970.0
290000.0,3,2.5,2020,4861,2.0,3,7,2020,0.0,2005,2170,4600,6275 days 16:47:18.679838,063,1.2,0.0,-150,261,2020.0
752500.0,2,2.5,2280,6230,1.0,3,8,2280,0.0,2005,1640,5931,6275 days 16:47:18.679838,219,0.8,0.0,640,299,2280.0
820000.0,4,2.75,3540,13515,2.0,3,1,3540,0.0,1998,3540,11538,8832 days 16:47:18.679838,342,1.4545454545454546,0.0,0,1977,3540.0
292000.0,3,2.5,1560,2740,2.0,3,8,1560,0.0,1999,1310,2698,8467 days 16:47:18.679838,223,1.2,0.0,250,42,1560.0
213000.0,2,1.0,750,6089,1.0,3,6,750,0.0,1937,1430,6451,31112 days 16:47:18.679838,276,2.0,0.0,-680,-362,750.0
400000.0,4,3.0,2240,7035,2.0,3,7,2240,0.0,1942,1060,6300,29286 days 16:47:18.679838,321,1.3333333333333333,0.0,1180,735,2240.0
202000.0,1,0.75,590,5650,1.0,3,6,590,0.0,1944,980,5650,28556 days 16:47:18.679838,195,1.3333333333333333,0.0,-390,0,590.0
617450.0,3,2.0,1580,14398,1.0,3,7,1080,500.0,1981,1650,14407,15041 days 16:47:18.679838,124,1.5,2.16,-70,-9,580.0
250000.0,3,1.0,1040,8000,1.0,4,7,1040,0.0,1956,1170,9450,24173 days 16:47:18.679838,014,3.0,0.0,-130,-1450,1040.0
405000.0,5,1.75,1880,10000,1.0,3,7,960,920.0,1963,1580,10000,21616 days 16:47:18.679838,149,2.857142857142857,1.0434782608695652,300,0,40.0
325000.0,2,1.0,1070,8750,1.0,3,7,1070,0.0,1951,1300,9670,25999 days 16:47:18.679838,090,2.0,0.0,-230,-920,1070.0
301350.0,3,3.0,1860,7440,1.0,5,7,1040,820.0,1954,1490,8160,24903 days 16:47:18.679838,142,1.0,1.2682926829268293,370,-720,220.0
425000.0,2,1.75,1550,7800,1.0,3,7,1050,500.0,1940,1370,5000,30017 days 16:47:18.679838,062,1.1428571428571428,2.1,180,2800,550.0
460000.0,3,1.0,1860,6360,1.0,3,8,1470,390.0,1954,1770,6175,24903 days 16:47:18.679838,248,3.0,3.769230769230769,90,185,1080.0
938000.0,3,2.5,3090,10940,2.0,3,1,3090,0.0,1992,3410,12157,11024 days 16:47:18.679838,109,1.2,0.0,-320,-1217,3090.0
348000.0,3,1.75,1720,8867,1.0,3,8,1320,400.0,1985,2200,9170,13580 days 16:47:18.679838,210,1.7142857142857142,3.3,-480,-303,920.0
435000.0,2,1.0,1260,4080,1.5,5,7,1260,0.0,1926,1720,4080,35130 days 16:47:18.679838,157,2.0,0.0,-460,0,1260.0
227950.0,3,1.5,1120,11430,1.0,4,7,1120,0.0,1963,1790,8760,21616 days 16:47:18.679838,317,2.0,0.0,-670,2670,1120.0
425000.0,2,1.0,1250,5880,1.0,3,6,900,350.0,1948,1520,5020,27095 days 16:47:18.679838,089,2.0,2.5714285714285716,-270,860,550.0
550000.0,3,2.0,1810,4064,1.5,3,7,1810,0.0,1925,1518,2945,35495 days 16:47:18.679838,153,1.5,0.0,292,1119,1810.0
347500.0,3,2.5,1890,7053,2.0,4,8,1890,0.0,1992,2000,7226,11024 days 16:47:18.679838,202,1.2,0.0,-110,-173,1890.0
397000.0,4,1.75,2020,6000,1.0,3,7,1620,400.0,1959,1870,4000,23077 days 16:47:18.679838,273,2.2857142857142856,4.05,150,2000,1220.0
410000.0,4,1.75,1790,11875,1.0,4,7,1490,300.0,1969,1870,11760,19424 days 16:47:18.679838,153,2.2857142857142856,4.966666666666667,-80,115,1190.0
780000.0,3,3.5,3190,6776,2.0,3,1,3190,0.0,1998,3230,7189,8832 days 16:47:18.679838,192,0.8571428571428571,0.0,-40,-413,3190.0
1350000.0,4,3.25,3030,5164,1.5,5,9,2700,330.0,1925,1890,4415,35495 days 16:47:18.679838,252,1.2307692307692308,8.181818181818182,1140,749,2370.0
476000.0,3,2.25,1630,3070,2.0,3,7,1630,0.0,2004,1690,3200,6641 days 16:47:18.679838,301,1.3333333333333333,0.0,-60,-130,1630.0
390000.0,3,1.75,1180,16552,1.0,4,7,1180,0.0,1967,2780,45302,20155 days 16:47:18.679838,189,1.7142857142857142,0.0,-1600,-28750,1180.0
226500.0,3,2.0,1560,7000,1.0,4,7,1560,0.0,1968,1560,7200,19790 days 16:47:18.679838,364,1.5,0.0,0,-200,1560.0
495000.0,3,2.0,1340,2550,2.0,3,7,1340,0.0,1984,1370,5100,13946 days 16:47:18.679838,212,1.5,0.0,-30,-2550,1340.0
1500000.0,5,3.25,2590,11500,1.0,4,9,2590,0.0,1968,2780,11989,19790 days 16:47:18.679838,078,1.5384615384615385,0.0,-190,-489,2590.0
385000.0,3,1.0,1020,5950,1.0,3,6,880,140.0,1950,1800,5950,26364 days 16:47:18.679838,112,3.0,6.285714285714286,-780,0,740.0
535950.0,3,2.5,2370,5344,2.0,3,9,2370,0.0,2003,2990,5418,7006 days 16:47:18.679838,068,1.2,0.0,-620,-74,2370.0
910000.0,4,2.5,3170,32430,2.5,3,1,3170,0.0,1989,3360,35610,12119 days 16:47:18.679838,295,1.6,0.0,-190,-3180,3170.0
465000.0,2,1.0,1120,4000,1.0,3,7,1120,0.0,1926,1620,4000,35130 days 16:47:18.679838,085,2.0,0.0,-500,0,1120.0
495000.0,3,1.75,1440,11787,1.0,3,8,1440,0.0,1983,2190,11787,14311 days 16:47:18.679838,177,1.7142857142857142,0.0,-750,0,1440.0
250000.0,4,2.0,2170,5404,1.5,5,6,1470,700.0,1920,1030,5477,37322 days 16:47:18.679838,041,2.0,2.1,1140,-73,770.0
1230000.0,4,2.25,3490,6906,2.0,4,1,2280,1210.0,1928,2540,6223,34400 days 16:47:18.679838,126,1.7777777777777777,1.884297520661157,950,683,1070.0
400000.0,4,2.25,1970,8941,2.0,3,7,1970,0.0,1973,1880,7793,17963 days 16:47:18.679838,048,1.7777777777777777,0.0,90,1148,1970.0
715000.0,4,2.5,2780,13521,2.0,3,1,2780,0.0,1987,2980,11454,12850 days 16:47:18.679838,233,1.6,0.0,-200,2067,2780.0
342000.0,3,2.0,2250,7757,1.0,3,8,2250,0.0,1992,1970,6866,11024 days 16:47:18.679838,054,1.5,0.0,280,891,2250.0
420000.0,4,1.75,1340,8400,1.0,5,7,1340,0.0,1967,1980,8400,20155 days 16:47:18.679838,120,2.2857142857142856,0.0,-640,0,1340.0
148226.0,3,1.0,1400,7360,1.0,4,7,1400,0.0,1968,1600,8030,19790 days 16:47:18.679838,189,3.0,0.0,-200,-670,1400.0
313000.0,3,1.0,1510,10369,1.0,4,7,1010,500.0,1968,1510,16057,19790 days 16:47:18.679838,307,3.0,2.02,0,-5688,510.0
150000.0,2,1.0,820,10270,1.0,3,7,820,0.0,1954,1670,10086,24903 days 16:47:18.679838,142,2.0,0.0,-850,184,820.0
230000.0,2,1.0,1080,9435,1.0,3,6,1080,0.0,1958,1200,9210,23442 days 16:47:18.679838,169,2.0,0.0,-120,225,1080.0
389100.0,2,1.0,840,5400,1.0,4,7,840,0.0,1948,1340,5400,27095 days 16:47:18.679838,245,2.0,0.0,-500,0,840.0
645000.0,4,2.25,2070,8720,1.0,5,8,1360,710.0,1974,2180,8510,17598 days 16:47:18.679838,350,1.7777777777777777,1.9154929577464788,-110,210,650.0
310000.0,3,1.0,1520,6500,1.0,3,7,990,530.0,1958,1500,7500,23442 days 16:47:18.679838,061,3.0,1.8679245283018868,20,-1000,460.0
351358.0,2,1.75,1210,1189,2.0,3,8,1210,0.0,2014,1540,1672,2988 days 16:47:18.679838,277,1.1428571428571428,0.0,-330,-483,1210.0
1700000.0,5,2.75,3810,9360,2.0,3,1,3810,0.0,2014,2110,9870,2988 days 16:47:18.679838,069,1.8181818181818181,0.0,1700,-510,3810.0
1570000.0,4,3.5,5370,323215,2.0,3,1,5370,0.0,2002,3780,9891,7371 days 16:47:18.679838,097,1.1428571428571428,0.0,1590,313324,5370.0
850000.0,3,2.0,1540,3600,2.0,3,8,1540,0.0,1900,2970,3600,44626 days 16:47:18.679838,293,1.5,0.0,-1430,0,1540.0
470000.0,4,2.5,2310,14023,2.0,3,9,2310,0.0,1991,2410,14007,11389 days 16:47:18.679838,134,1.6,0.0,-100,16,2310.0
770000.0,3,2.25,1870,1900,3.0,3,8,1870,0.0,2008,1690,1694,5180 days 16:47:18.679838,322,1.3333333333333333,0.0,180,206,1870.0
366000.0,3,1.75,1840,11440,1.0,4,8,1340,500.0,1977,1940,11440,16502 days 16:47:18.679838,175,1.7142857142857142,2.68,-100,0,840.0
545000.0,3,2.5,2060,7184,2.0,3,8,2060,0.0,1987,2230,7788,12850 days 16:47:18.679838,191,1.2,0.0,-170,-604,2060.0
205000.0,3,1.0,1010,8800,1.0,4,7,1010,0.0,1968,1550,7700,19790 days 16:47:18.679838,252,3.0,0.0,-540,1100,1010.0
405000.0,2,1.0,1020,8155,1.0,4,7,1020,0.0,1948,1430,8157,27095 days 16:47:18.679838,128,2.0,0.0,-410,-2,1020.0
467000.0,4,2.5,2220,7210,1.0,3,7,1270,950.0,1973,2220,7313,17963 days 16:47:18.679838,100,1.6,1.3368421052631578,0,-103,320.0
392500.0,2,1.0,1050,4125,1.0,4,7,1050,0.0,1909,1650,4125,41339 days 16:47:18.679838,269,2.0,0.0,-600,0,1050.0
901000.0,4,2.75,3030,18400,1.5,3,9,2360,670.0,1973,3030,12486,17963 days 16:47:18.679838,300,1.4545454545454546,3.5223880597014925,0,5914,1690.0
500000.0,3,1.75,1800,7199,1.0,3,7,1300,500.0,1972,1800,8100,18329 days 16:47:18.679838,337,1.7142857142857142,2.6,0,-901,800.0
384950.0,3,2.5,1860,3690,2.0,3,7,1860,0.0,2000,1870,4394,8102 days 16:47:18.679838,150,1.2,0.0,-10,-704,1860.0
1700000.0,4,3.5,4070,336283,2.0,3,1,4070,0.0,2006,3020,44613,5910 days 16:47:18.679838,071,1.1428571428571428,0.0,1050,291670,4070.0
245000.0,2,1.0,860,6120,1.0,3,7,860,0.0,1948,1100,6860,27095 days 16:47:18.679838,198,2.0,0.0,-240,-740,860.0
1170000.0,4,2.25,3080,10487,2.0,4,9,3080,0.0,1968,2480,10607,19790 days 16:47:18.679838,040,1.7777777777777777,0.0,600,-120,3080.0
184500.0,3,1.5,1280,3640,2.0,3,6,1280,0.0,1983,1150,4105,14311 days 16:47:18.679838,111,2.0,0.0,130,-465,1280.0
269000.0,2,2.0,1540,5000,1.5,3,8,1540,0.0,1986,1590,5000,13215 days 16:47:18.679838,104,1.0,0.0,-50,0,1540.0
570000.0,3,2.5,1530,3296,2.0,3,8,1530,0.0,1998,1530,4099,8832 days 16:47:18.679838,202,1.2,0.0,0,-803,1530.0
850000.0,4,1.75,2350,11914,1.0,4,8,2350,0.0,1961,2240,10706,22346 days 16:47:18.679838,132,2.2857142857142856,0.0,110,1208,2350.0
209000.0,3,1.0,920,5200,1.0,4,6,920,0.0,1969,920,4875,19424 days 16:47:18.679838,033,3.0,0.0,0,325,920.0
327000.0,4,1.75,1840,5100,1.0,4,5,1840,0.0,1933,2160,5400,32573 days 16:47:18.679838,218,2.2857142857142856,0.0,-320,-300,1840.0
369500.0,3,1.5,1650,9957,1.0,4,7,1100,550.0,1961,1650,7957,22346 days 16:47:18.679838,164,2.0,2.0,0,2000,550.0
440000.0,3,1.75,1760,8025,1.0,4,7,1230,530.0,1976,1590,7543,16868 days 16:47:18.679838,057,1.7142857142857142,2.3207547169811322,170,482,700.0
947500.0,4,2.25,3290,12329,1.5,4,1,3290,0.0,1968,3170,12329,19790 days 16:47:18.679838,132,1.7777777777777777,0.0,120,0,3290.0
510000.0,2,1.0,1270,4500,1.5,4,7,1270,0.0,1919,2140,4550,37687 days 16:47:18.679838,076,2.0,0.0,-870,-50,1270.0
385000.0,3,2.0,1600,10318,1.0,3,7,930,670.0,1941,1590,7040,29651 days 16:47:18.679838,118,1.5,1.3880597014925373,10,3278,260.0
370000.0,5,3.0,2670,9920,1.0,3,8,1400,1270.0,1990,1890,10341,11754 days 16:47:18.679838,232,1.6666666666666667,1.1023622047244095,780,-421,130.0
660000.0,4,1.5,1960,4500,1.5,3,7,1960,0.0,1922,1960,4500,36591 days 16:47:18.679838,335,2.6666666666666665,0.0,0,0,1960.0
729000.0,3,4.25,3300,308080,2.0,4,9,2520,780.0,1976,2130,90604,16868 days 16:47:18.679838,015,0.7058823529411765,3.230769230769231,1170,217476,1740.0
445000.0,4,2.5,2360,81892,1.0,3,8,2360,0.0,2000,1730,18096,8102 days 16:47:18.679838,253,1.6,0.0,630,63796,2360.0
460000.0,2,1.0,1430,12092,1.0,4,7,1430,0.0,1938,2320,10800,30747 days 16:47:18.679838,335,2.0,0.0,-890,1292,1430.0
516000.0,3,3.0,2330,7304,1.0,3,9,1300,1030.0,1971,2330,9518,18694 days 16:47:18.679838,336,1.0,1.2621359223300972,0,-2214,270.0
343888.0,4,2.5,2060,5607,2.0,3,7,2060,0.0,2002,2060,5367,7371 days 16:47:18.679838,227,1.6,0.0,0,240,2060.0
500000.0,4,1.75,2240,9886,1.5,4,7,2240,0.0,1965,1540,8040,20885 days 16:47:18.679838,160,2.2857142857142856,0.0,700,1846,2240.0
465000.0,5,1.75,2330,6450,1.0,3,8,1330,1000.0,1958,2330,8258,23442 days 16:47:18.679838,128,2.857142857142857,1.33,0,-1808,330.0
302000.0,5,2.25,2180,7813,2.0,3,7,2180,0.0,1986,1880,8649,13215 days 16:47:18.679838,132,2.2222222222222223,0.0,300,-836,2180.0
195000.0,2,1.0,1280,7861,1.0,4,6,1280,0.0,1913,1020,6480,39878 days 16:47:18.679838,311,2.0,0.0,260,1381,1280.0
640000.0,3,2.5,2140,8925,2.0,3,8,2140,0.0,1991,2310,8956,11389 days 16:47:18.679838,160,1.2,0.0,-170,-31,2140.0
502000.0,6,2.5,2890,8122,1.0,3,8,1630,1260.0,1977,2730,9915,16502 days 16:47:18.679838,174,2.4,1.2936507936507937,160,-1793,370.0
360000.0,3,2.5,1480,3851,2.0,3,8,1480,0.0,1998,1650,4716,8832 days 16:47:18.679838,107,1.2,0.0,-170,-865,1480.0
290500.0,4,2.5,1680,3000,2.0,3,7,1680,0.0,2003,1420,5500,7006 days 16:47:18.679838,084,1.6,0.0,260,-2500,1680.0
248000.0,4,3.0,2163,5883,2.0,3,7,2163,0.0,2006,1700,10143,5910 days 16:47:18.679838,129,1.3333333333333333,0.0,463,-4260,2163.0
433000.0,4,2.5,2280,7568,2.0,4,7,2280,0.0,2001,2280,5312,7736 days 16:47:18.679838,136,1.6,0.0,0,2256,2280.0
480000.0,2,1.0,820,4200,1.0,3,7,820,0.0,1980,1290,4000,15407 days 16:47:18.679838,103,2.0,0.0,-470,200,820.0
410000.0,3,1.0,1330,5000,1.0,3,7,1120,210.0,1957,1920,7790,23807 days 16:47:18.679838,111,3.0,5.333333333333333,-590,-2790,910.0
309950.0,4,2.75,2310,5000,2.0,3,7,2310,0.0,2006,1980,5000,5910 days 16:47:18.679838,125,1.4545454545454546,0.0,330,0,2310.0
253000.0,3,2.0,1290,7372,1.0,5,7,1290,0.0,1990,1290,7366,11754 days 16:47:18.679838,335,1.5,0.0,0,6,1290.0
280000.0,3,1.75,1630,11800,1.0,4,7,1630,0.0,1971,2090,57428,18694 days 16:47:18.679838,126,1.7142857142857142,0.0,-460,-45628,1630.0
440000.0,3,1.0,1410,8925,1.0,3,7,1410,0.0,1958,1330,8925,23442 days 16:47:18.679838,114,3.0,0.0,80,0,1410.0
333000.0,5,1.75,1240,8936,1.0,3,7,1240,0.0,1954,1600,9341,24903 days 16:47:18.679838,322,2.857142857142857,0.0,-360,-405,1240.0
759950.0,3,2.5,3100,23790,2.0,3,9,3100,0.0,2002,2250,40854,7371 days 16:47:18.679838,167,1.2,0.0,850,-17064,3100.0
345000.0,3,2.25,2020,9000,2.0,3,7,2020,0.0,1979,1460,9680,15772 days 16:47:18.679838,358,1.3333333333333333,0.0,560,-680,2020.0
350000.0,4,2.5,2500,5831,2.0,3,8,2500,0.0,2007,2500,5188,5545 days 16:47:18.679838,269,1.6,0.0,0,643,2500.0
198000.0,2,1.0,790,14200,1.0,3,7,790,0.0,1951,1430,10000,25999 days 16:47:18.679838,219,2.0,0.0,-640,4200,790.0
730000.0,3,1.75,2040,11294,1.0,4,7,1340,700.0,1952,2120,9587,25634 days 16:47:18.679838,206,1.7142857142857142,1.9142857142857144,-80,1707,640.0
266200.0,3,1.5,1430,9600,1.0,4,7,1430,0.0,1966,1590,10240,20520 days 16:47:18.679838,148,2.0,0.0,-160,-640,1430.0
1060000.0,4,2.5,2250,10160,2.0,5,8,2250,0.0,1967,2660,10125,20155 days 16:47:18.679838,075,1.6,0.0,-410,35,2250.0
95000.0,2,1.0,1070,20450,1.0,2,6,1070,0.0,1948,1360,15581,27095 days 16:47:18.679838,262,2.0,0.0,-290,4869,1070.0
430000.0,3,1.75,1300,12731,1.0,3,8,1300,0.0,1981,1700,13556,15041 days 16:47:18.679838,174,1.7142857142857142,0.0,-400,-825,1300.0
650000.0,4,2.25,2560,9731,2.0,4,7,2560,0.0,1973,1860,9731,17963 days 16:47:18.679838,161,1.7777777777777777,0.0,700,0,2560.0
379900.0,3,2.5,2190,5071,2.0,3,8,2190,0.0,2004,2300,5654,6641 days 16:47:18.679838,076,1.2,0.0,-110,-583,2190.0
325000.0,2,1.5,940,1222,2.0,3,7,860,80.0,2004,1302,1840,6641 days 16:47:18.679838,117,1.3333333333333333,10.75,-362,-618,780.0
455000.0,4,2.25,1740,8449,1.0,4,7,1170,570.0,1958,1980,11175,23442 days 16:47:18.679838,157,1.7777777777777777,2.0526315789473686,-240,-2726,600.0
392000.0,4,3.75,2220,3797,1.5,4,6,1330,890.0,1917,1490,4340,38417 days 16:47:18.679838,258,1.0666666666666667,1.4943820224719102,730,-543,440.0
373000.0,3,1.75,1310,7811,1.0,3,7,1310,0.0,1976,1530,7800,16868 days 16:47:18.679838,247,1.7142857142857142,0.0,-220,11,1310.0
951250.0,5,3.0,2710,8227,1.0,3,8,1910,800.0,1953,2060,5400,25268 days 16:47:18.679838,289,1.6666666666666667,2.3875,650,2827,1110.0
502000.0,3,2.0,1300,14350,1.0,3,7,1300,0.0,1955,1520,10670,24538 days 16:47:18.679838,175,1.5,0.0,-220,3680,1300.0
362500.0,3,2.0,1940,40588,1.0,3,7,1940,0.0,2000,1860,9657,8102 days 16:47:18.679838,117,1.5,0.0,80,30931,1940.0
525000.0,2,1.0,1080,3500,1.0,3,7,1080,0.0,1924,1790,4000,35861 days 16:47:18.679838,174,2.0,0.0,-710,-500,1080.0
580000.0,4,2.5,2110,11680,1.0,4,7,1420,690.0,1977,1890,9600,16502 days 16:47:18.679838,056,1.6,2.0579710144927534,220,2080,730.0
278000.0,3,2.25,1590,9425,1.0,3,7,1170,420.0,1985,1590,9394,13580 days 16:47:18.679838,356,1.3333333333333333,2.7857142857142856,0,31,750.0
422500.0,2,1.0,910,4800,1.0,4,7,910,0.0,1923,1450,5000,36226 days 16:47:18.679838,350,2.0,0.0,-540,-200,910.0
783200.0,4,2.0,1590,5400,1.0,3,7,990,600.0,1900,2190,4800,44626 days 16:47:18.679838,252,2.0,1.65,-600,600,390.0
715000.0,4,2.5,3290,6628,2.0,3,9,3290,0.0,2003,3240,5831,7006 days 16:47:18.679838,171,1.6,0.0,50,797,3290.0
244615.0,3,2.5,2060,4030,2.0,3,7,2060,0.0,1999,2060,4029,8467 days 16:47:18.679838,148,1.2,0.0,0,1,2060.0
385000.0,3,1.75,1560,14288,1.0,3,6,780,780.0,1944,1320,8928,28556 days 16:47:18.679838,346,1.7142857142857142,1.0,240,5360,0.0
549995.0,3,1.0,1120,6600,1.0,3,7,1120,0.0,1943,1300,6600,28921 days 16:47:18.679838,206,3.0,0.0,-180,0,1120.0
959900.0,4,3.75,3550,15151,2.0,3,1,3550,0.0,2004,4340,15151,6641 days 16:47:18.679838,228,1.0666666666666667,0.0,-790,0,3550.0
510000.0,6,4.5,3300,7200,2.0,3,8,3300,0.0,1980,2470,7561,15407 days 16:47:18.679838,204,1.3333333333333333,0.0,830,-361,3300.0
367000.0,3,1.75,2000,12669,1.0,4,7,1200,800.0,1965,1580,12055,20885 days 16:47:18.679838,225,1.7142857142857142,1.5,420,614,400.0
375000.0,5,3.0,2680,8410,2.0,3,8,1810,870.0,1990,1860,8410,11754 days 16:47:18.679838,281,1.6666666666666667,2.0804597701149423,820,0,940.0
500000.0,2,2.25,1290,1334,3.0,3,8,1290,0.0,2007,1350,1334,5545 days 16:47:18.679838,132,0.8888888888888888,0.0,-60,0,1290.0
489000.0,2,2.25,1290,1334,3.0,3,8,1290,0.0,2007,1350,1334,5545 days 16:47:18.679838,013,0.8888888888888888,0.0,-60,0,1290.0
340000.0,3,2.0,1150,700,2.0,3,7,800,350.0,2000,1060,1910,8102 days 16:47:18.679838,117,1.5,2.2857142857142856,90,-1210,450.0
562000.0,3,1.75,1880,5978,1.0,5,7,940,940.0,1957,1930,4770,23807 days 16:47:18.679838,121,1.7142857142857142,1.0,-50,1208,0.0
489950.0,3,2.5,2400,7478,2.0,3,9,2400,0.0,2002,2980,8182,7371 days 16:47:18.679838,255,1.2,0.0,-580,-704,2400.0
652000.0,3,2.25,1920,9600,1.0,4,8,1560,360.0,1968,2040,9600,19790 days 16:47:18.679838,276,1.3333333333333333,4.333333333333333,-120,0,1200.0
472000.0,4,3.25,4350,7090,2.0,3,8,2870,1480.0,1999,2490,7266,8467 days 16:47:18.679838,297,1.2307692307692308,1.9391891891891893,1860,-176,1390.0
333000.0,4,2.5,1910,9244,1.0,4,6,1910,0.0,1963,2590,9286,21616 days 16:47:18.679838,163,1.6,0.0,-680,-42,1910.0
560000.0,3,1.5,2000,7350,1.0,3,8,2000,0.0,1953,1890,6960,25268 days 16:47:18.679838,150,2.0,0.0,110,390,2000.0
799000.0,4,3.5,3290,20107,2.0,3,1,2220,1070.0,1990,2990,16988,11754 days 16:47:18.679838,335,1.1428571428571428,2.074766355140187,300,3119,1150.0
860000.0,5,2.25,3480,9200,2.0,3,8,3480,0.0,1979,3130,9200,15772 days 16:47:18.679838,191,2.2222222222222223,0.0,350,0,3480.0
449500.0,4,2.5,2410,55931,2.0,3,9,2410,0.0,1989,2780,55931,12119 days 16:47:18.679838,120,1.6,0.0,-370,0,2410.0
692500.0,4,3.0,2820,11500,2.0,3,1,2820,0.0,1991,2770,9694,11389 days 16:47:18.679838,339,1.3333333333333333,0.0,50,1806,2820.0
925000.0,4,1.75,2710,11400,1.0,4,9,1430,1280.0,1976,2640,11000,16868 days 16:47:18.679838,224,2.2857142857142856,1.1171875,70,400,150.0
267500.0,3,2.25,2080,2856,1.5,3,7,1550,530.0,2003,2080,2275,7006 days 16:47:18.679838,294,1.3333333333333333,2.9245283018867925,0,581,1020.0
396800.0,4,2.5,2200,6018,2.0,3,8,2200,0.0,2010,2480,5899,4449 days 16:47:18.679838,195,1.6,0.0,-280,119,2200.0
220000.0,4,1.5,1180,8058,1.0,5,7,1180,0.0,1969,1800,9348,19424 days 16:47:18.679838,099,2.6666666666666665,0.0,-620,-1290,1180.0
892500.0,3,1.75,2120,56192,1.0,3,9,1720,400.0,1959,2240,20500,23077 days 16:47:18.679838,234,1.7142857142857142,4.3,-120,35692,1320.0
455500.0,3,2.0,1460,10311,1.0,4,7,1460,0.0,1975,1690,9679,17233 days 16:47:18.679838,147,1.5,0.0,-230,632,1460.0
743000.0,3,1.75,2110,11250,1.0,4,8,2110,0.0,1961,2560,10992,22346 days 16:47:18.679838,163,1.7142857142857142,0.0,-450,258,2110.0
338000.0,4,1.5,1790,17925,1.0,4,6,1790,0.0,1951,1660,15165,25999 days 16:47:18.679838,339,2.6666666666666665,0.0,130,2760,1790.0
332000.0,3,1.75,1340,13115,1.0,3,7,1340,0.0,1978,1370,10800,16137 days 16:47:18.679838,276,1.7142857142857142,0.0,-30,2315,1340.0
563225.0,3,1.0,2460,4000,1.5,4,7,1370,1090.0,1918,1680,4000,38052 days 16:47:18.679838,023,3.0,1.2568807339449541,780,0,280.0
1150000.0,4,3.5,3760,20609,2.0,3,1,3760,0.0,1990,3360,15761,11754 days 16:47:18.679838,117,1.1428571428571428,0.0,400,4848,3760.0
645000.0,2,1.0,1240,5000,1.0,3,7,1000,240.0,1920,1480,3500,37322 days 16:47:18.679838,286,2.0,4.166666666666667,-240,1500,760.0
739000.0,3,2.5,2750,16000,2.0,4,9,2560,190.0,1981,2370,11279,15041 days 16:47:18.679838,364,1.2,13.473684210526315,380,4721,2370.0
435000.0,3,2.5,2530,13446,2.0,3,9,2530,0.0,1993,2450,13446,10658 days 16:47:18.679838,182,1.2,0.0,80,0,2530.0
995000.0,3,2.25,3200,3800,2.0,5,9,2650,550.0,1914,2400,3900,39513 days 16:47:18.679838,210,1.3333333333333333,4.818181818181818,800,-100,2100.0
520000.0,4,2.75,2020,7357,1.0,3,7,1350,670.0,1986,1690,7804,13215 days 16:47:18.679838,079,1.4545454545454546,2.014925373134328,330,-447,680.0
400000.0,4,2.5,3030,180263,2.0,3,7,2030,1000.0,1987,2600,182509,12850 days 16:47:18.679838,119,1.6,2.03,430,-2246,1030.0
440000.0,3,1.75,2350,7641,1.0,3,7,1510,840.0,1978,2190,7500,16137 days 16:47:18.679838,280,1.7142857142857142,1.7976190476190477,160,141,670.0
440000.0,3,1.5,1690,6010,1.0,3,7,1230,460.0,1946,1690,5418,27825 days 16:47:18.679838,260,2.0,2.6739130434782608,0,592,770.0
738000.0,3,1.0,1280,3900,1.0,4,7,1280,0.0,1921,2020,4560,36956 days 16:47:18.679838,083,3.0,0.0,-740,-660,1280.0
250000.0,3,1.5,1170,9848,1.0,3,7,1170,0.0,1963,2220,5542,21616 days 16:47:18.679838,093,2.0,0.0,-1050,4306,1170.0
338150.0,4,2.25,2700,8580,2.0,3,8,2700,0.0,1992,2420,8580,11024 days 16:47:18.679838,245,1.7777777777777777,0.0,280,0,2700.0
425000.0,3,2.25,1800,7371,1.0,3,7,1280,520.0,1979,1960,7675,15772 days 16:47:18.679838,245,1.3333333333333333,2.4615384615384617,-160,-304,760.0
883000.0,4,2.5,3670,54450,2.0,3,1,3670,0.0,1999,2900,49658,8467 days 16:47:18.679838,164,1.6,0.0,770,4792,3670.0
510000.0,3,2.0,2350,266151,1.5,3,7,2350,0.0,1983,2270,222156,14311 days 16:47:18.679838,336,1.5,0.0,80,43995,2350.0
950000.0,4,1.75,3100,21303,1.0,4,9,3100,0.0,1962,3480,9697,21981 days 16:47:18.679838,256,2.2857142857142856,0.0,-380,11606,3100.0
435000.0,3,1.0,1120,9656,1.0,5,7,1120,0.0,1955,1720,9908,24538 days 16:47:18.679838,286,3.0,0.0,-600,-252,1120.0
415000.0,5,1.5,1900,10226,1.0,3,7,1130,770.0,1961,1690,10227,22346 days 16:47:18.679838,147,3.3333333333333335,1.4675324675324675,210,-1,360.0
439000.0,2,2.5,1350,944,2.0,3,9,870,480.0,2004,1440,1350,6641 days 16:47:18.679838,279,0.8,1.8125,-90,-406,390.0
295832.0,5,1.0,1410,6400,1.0,5,7,960,450.0,1955,1400,6500,24538 days 16:47:18.679838,147,5.0,2.1333333333333333,10,-100,510.0
285000.0,3,1.75,1560,9514,1.0,4,7,1560,0.0,1967,1550,9600,20155 days 16:47:18.679838,304,1.7142857142857142,0.0,10,-86,1560.0
350000.0,3,1.5,1090,5003,1.0,3,7,1090,0.0,1962,1540,5279,21981 days 16:47:18.679838,120,2.0,0.0,-450,-276,1090.0
489000.0,2,2.75,1465,972,2.0,3,7,1050,415.0,2006,1480,1430,5910 days 16:47:18.679838,294,0.7272727272727273,2.5301204819277108,-15,-458,635.0
304500.0,3,2.25,1790,6930,1.0,3,7,1390,400.0,1974,1810,7420,17598 days 16:47:18.679838,328,1.3333333333333333,3.475,-20,-490,990.0
288000.0,3,1.5,1300,7313,1.0,4,7,1300,0.0,1968,1770,8075,19790 days 16:47:18.679838,076,2.0,0.0,-470,-762,1300.0
417000.0,3,1.75,1920,9512,1.0,3,8,1440,480.0,1980,1820,9512,15407 days 16:47:18.679838,042,1.7142857142857142,3.0,100,0,960.0
615000.0,3,3.0,1420,991,2.0,3,8,1040,380.0,2005,1500,1301,6275 days 16:47:18.679838,091,1.0,2.736842105263158,-80,-310,660.0
730000.0,5,3.5,3760,4857,2.0,3,9,2820,940.0,2004,3000,5693,6641 days 16:47:18.679838,261,1.4285714285714286,3.0,760,-836,1880.0
178500.0,2,1.0,930,3447,1.0,4,8,930,0.0,1978,1160,3447,16137 days 16:47:18.679838,233,2.0,0.0,-230,0,930.0
300000.0,4,2.0,1580,9600,1.0,5,7,1050,530.0,1965,1710,9600,20885 days 16:47:18.679838,227,2.0,1.9811320754716981,-130,0,520.0
415000.0,4,2.5,2170,8518,1.0,3,7,1350,820.0,1955,1880,7680,24538 days 16:47:18.679838,174,1.6,1.646341463414634,290,838,530.0
1010000.0,4,2.75,3430,15877,1.0,3,1,3430,0.0,2005,4080,14577,6275 days 16:47:18.679838,226,1.4545454545454546,0.0,-650,1300,3430.0
653000.0,4,2.5,2160,7000,2.0,4,9,2160,0.0,1989,2300,7440,12119 days 16:47:18.679838,335,1.6,0.0,-140,-440,2160.0
715000.0,4,2.25,2060,5649,1.0,5,8,1360,700.0,1941,2060,5626,29651 days 16:47:18.679838,134,1.7777777777777777,1.9428571428571428,0,23,660.0
541000.0,3,1.75,1410,4080,1.5,4,7,1410,0.0,1927,1820,4080,34765 days 16:47:18.679838,240,1.7142857142857142,0.0,-410,0,1410.0
245000.0,4,1.5,1850,7547,1.5,4,7,1850,0.0,1960,1730,7577,22712 days 16:47:18.679838,343,2.6666666666666665,0.0,120,-30,1850.0
547000.0,2,1.0,1370,10038,1.5,4,7,1370,0.0,1922,1610,8822,36591 days 16:47:18.679838,048,2.0,0.0,-240,1216,1370.0
750000.0,5,2.75,3330,12408,1.0,3,1,1740,1590.0,1976,2780,12000,16868 days 16:47:18.679838,092,1.8181818181818181,1.0943396226415094,550,408,150.0
575000.0,5,2.5,1970,12375,1.0,3,8,1570,400.0,1959,1970,8941,23077 days 16:47:18.679838,026,2.0,3.925,0,3434,1170.0
216000.0,3,1.75,1310,8670,1.0,4,6,1310,0.0,1984,2622,7191,13946 days 16:47:18.679838,225,1.7142857142857142,0.0,-1312,1479,1310.0
443000.0,3,1.75,1640,4579,1.0,4,6,1640,0.0,1916,1580,5040,38783 days 16:47:18.679838,265,1.7142857142857142,0.0,60,-461,1640.0
257700.0,4,2.25,1600,6202,2.0,4,7,1600,0.0,1986,1530,6298,13215 days 16:47:18.679838,307,1.7777777777777777,0.0,70,-96,1600.0
278000.0,3,1.0,1230,9440,1.0,3,7,1230,0.0,1978,1230,10296,16137 days 16:47:18.679838,104,3.0,0.0,0,-856,1230.0
300000.0,3,2.5,2240,3691,2.0,3,7,2240,0.0,2003,2619,3691,7006 days 16:47:18.679838,309,1.2,0.0,-379,0,2240.0
269100.0,3,2.5,2190,7904,2.0,3,8,2190,0.0,1995,2190,7669,9928 days 16:47:18.679838,044,1.2,0.0,0,235,2190.0
402500.0,3,1.0,990,10752,1.5,4,7,990,0.0,1929,1820,7600,34034 days 16:47:18.679838,230,3.0,0.0,-830,3152,990.0
306888.0,2,1.5,1010,7719,2.0,3,7,1010,0.0,1981,1210,7719,15041 days 16:47:18.679838,161,1.3333333333333333,0.0,-200,0,1010.0
795000.0,4,2.5,2920,14210,2.0,4,1,2920,0.0,1978,2840,13702,16137 days 16:47:18.679838,360,1.6,0.0,80,508,2920.0
525000.0,4,2.5,2310,5573,2.0,4,9,2310,0.0,2003,2310,6189,7006 days 16:47:18.679838,216,1.6,0.0,0,-616,2310.0
1050000.0,3,2.5,3470,12076,2.0,3,1,2560,910.0,1988,3590,17677,12485 days 16:47:18.679838,201,1.2,2.8131868131868134,-120,-5601,1650.0
452000.0,2,1.0,1220,6000,1.0,3,6,880,340.0,1938,1220,6840,30747 days 16:47:18.679838,241,2.0,2.588235294117647,0,-840,540.0
350000.0,3,2.25,1550,5401,2.0,3,7,1550,0.0,2000,1740,4485,8102 days 16:47:18.679838,103,1.3333333333333333,0.0,-190,916,1550.0
410000.0,4,2.5,2070,6180,2.0,3,8,2070,0.0,2007,1250,6018,5545 days 16:47:18.679838,099,1.6,0.0,820,162,2070.0
595000.0,3,1.75,2060,3600,1.5,3,7,1180,880.0,1905,1730,2475,42800 days 16:47:18.679838,317,1.7142857142857142,1.3409090909090908,330,1125,300.0
499000.0,3,2.5,1690,4851,2.0,3,7,1690,0.0,2004,2330,4851,6641 days 16:47:18.679838,097,1.2,0.0,-640,0,1690.0
340000.0,4,2.5,2550,7555,2.0,3,8,2550,0.0,2001,2550,6800,7736 days 16:47:18.679838,295,1.6,0.0,0,755,2550.0
1070000.0,5,3.25,3370,7947,2.0,3,1,3370,0.0,2001,2040,7900,7736 days 16:47:18.679838,176,1.5384615384615385,0.0,1330,47,3370.0
460000.0,4,3.0,2230,52983,2.0,3,8,2230,0.0,1991,2060,8755,11389 days 16:47:18.679838,148,1.3333333333333333,0.0,170,44228,2230.0
345000.0,4,2.5,2382,5899,2.0,3,8,2382,0.0,2011,2382,5897,4084 days 16:47:18.679838,231,1.6,0.0,0,2,2382.0
280500.0,3,2.25,1620,7566,2.0,3,7,1620,0.0,1990,1470,7566,11754 days 16:47:18.679838,049,1.3333333333333333,0.0,150,0,1620.0
704000.0,3,1.0,1140,6120,1.5,3,7,1140,0.0,1926,1800,4080,35130 days 16:47:18.679838,056,3.0,0.0,-660,2040,1140.0
545000.0,3,2.5,2140,40173,2.0,4,8,2140,0.0,1990,2380,43016,11754 days 16:47:18.679838,280,1.2,0.0,-240,-2843,2140.0
335000.0,3,1.5,1900,7584,1.0,5,7,1900,0.0,1962,1410,7584,21981 days 16:47:18.679838,219,2.0,0.0,490,0,1900.0
420000.0,3,2.75,2300,8000,1.0,3,7,1430,870.0,1965,2070,10200,20885 days 16:47:18.679838,223,1.0909090909090908,1.6436781609195403,230,-2200,560.0
705000.0,4,2.0,2040,5050,1.0,5,7,1160,880.0,1937,2040,5050,31112 days 16:47:18.679838,051,2.0,1.3181818181818181,0,0,280.0
274900.0,4,1.75,1840,10528,1.0,3,7,1210,630.0,1990,1620,9331,11754 days 16:47:18.679838,308,2.2857142857142856,1.9206349206349207,220,1197,580.0
499950.0,4,2.5,2860,3345,2.0,3,8,2190,670.0,2004,2860,3596,6641 days 16:47:18.679838,122,1.6,3.2686567164179103,0,-251,1520.0
415250.0,3,1.5,1400,7550,1.0,4,7,1400,0.0,1953,1730,7562,25268 days 16:47:18.679838,077,2.0,0.0,-330,-12,1400.0
222000.0,3,1.0,990,7520,1.0,4,7,990,0.0,1958,990,7440,23442 days 16:47:18.679838,076,3.0,0.0,0,80,990.0
375000.0,3,2.0,3120,42247,1.0,4,7,2150,970.0,1980,2100,43416,15407 days 16:47:18.679838,226,1.5,2.216494845360825,1020,-1169,1180.0
300000.0,3,2.5,1640,5707,2.0,3,7,1640,0.0,1995,1850,5827,9928 days 16:47:18.679838,120,1.2,0.0,-210,-120,1640.0
456700.0,3,1.75,2820,8879,1.0,5,7,1540,1280.0,1920,1640,7850,37322 days 16:47:18.679838,322,1.7142857142857142,1.203125,1180,1029,260.0
925500.0,3,2.75,1970,5200,1.5,3,8,1970,0.0,1915,2140,5200,39148 days 16:47:18.679838,078,1.0909090909090908,0.0,-170,0,1970.0
375000.0,5,2.5,2840,15598,1.0,4,8,1470,1370.0,1975,2570,14930,17233 days 16:47:18.679838,204,2.0,1.072992700729927,270,668,100.0
420000.0,3,2.5,2370,15375,2.0,3,9,2370,0.0,1993,2450,9800,10658 days 16:47:18.679838,287,1.2,0.0,-80,5575,2370.0
575000.0,3,2.5,2610,7301,2.0,3,8,2610,0.0,2004,2460,7181,6641 days 16:47:18.679838,290,1.2,0.0,150,120,2610.0
335000.0,3,2.0,1340,1951,1.0,3,6,670,670.0,1915,1520,2248,39148 days 16:47:18.679838,118,1.5,1.0,-180,-297,0.0
428000.0,4,2.0,1300,7200,1.0,3,7,1300,0.0,1958,1540,6600,23442 days 16:47:18.679838,049,2.0,0.0,-240,600,1300.0
655000.0,4,2.5,3340,34238,1.0,4,8,2060,1280.0,1977,2400,36590,16502 days 16:47:18.679838,274,1.6,1.609375,940,-2352,780.0
738000.0,3,3.0,2630,4896,2.0,3,9,2630,0.0,2006,2880,4972,5910 days 16:47:18.679838,178,1.0,0.0,-250,-76,2630.0
415000.0,5,1.75,1960,3748,1.0,3,7,980,980.0,1965,1410,3844,20885 days 16:47:18.679838,231,2.857142857142857,1.0,550,-96,0.0
392000.0,3,1.0,1090,6125,1.0,4,6,790,300.0,1945,1050,6125,28190 days 16:47:18.679838,237,3.0,2.6333333333333333,40,0,490.0
555000.0,2,1.0,1550,4600,1.0,4,7,1050,500.0,1941,1550,4600,29651 days 16:47:18.679838,310,2.0,2.1,0,0,550.0
260000.0,3,2.5,1770,2677,2.0,3,7,1770,0.0,2005,1550,1798,6275 days 16:47:18.679838,065,1.2,0.0,220,879,1770.0
392500.0,3,1.0,1390,10500,1.5,3,6,1390,0.0,1940,1350,9800,30017 days 16:47:18.679838,068,3.0,0.0,40,700,1390.0
912000.0,3,2.5,2979,17313,2.0,3,1,2979,0.0,1993,3890,14797,10658 days 16:47:18.679838,213,1.2,0.0,-911,2516,2979.0
500000.0,3,2.75,1560,77536,1.0,3,7,1400,160.0,1978,2210,41449,16137 days 16:47:18.679838,225,1.0909090909090908,8.75,-650,36087,1240.0
238000.0,3,1.5,1360,7488,1.0,4,7,1050,310.0,1975,1580,7508,17233 days 16:47:18.679838,363,2.0,3.3870967741935485,-220,-20,740.0
251000.0,4,2.0,1650,5974,1.0,5,7,860,790.0,1972,1940,6001,18329 days 16:47:18.679838,274,2.0,1.0886075949367089,-290,-27,70.0
406500.0,2,1.75,1510,5319,2.0,4,8,1510,0.0,1978,1740,6160,16137 days 16:47:18.679838,195,1.1428571428571428,0.0,-230,-841,1510.0
433495.0,4,2.25,3010,10925,2.0,4,9,3010,0.0,1988,2690,10925,12485 days 16:47:18.679838,071,1.7777777777777777,0.0,320,0,3010.0
265000.0,3,2.25,1510,6071,1.0,4,7,1150,360.0,1985,1510,7271,13580 days 16:47:18.679838,358,1.3333333333333333,3.1944444444444446,0,-1200,790.0
360000.0,3,1.75,1950,7260,1.0,3,8,1520,430.0,1957,1950,7548,23807 days 16:47:18.679838,037,1.7142857142857142,3.5348837209302326,0,-288,1090.0
425000.0,4,1.0,1800,12485,1.0,5,7,950,850.0,1955,1290,9840,24538 days 16:47:18.679838,198,4.0,1.1176470588235294,510,2645,100.0
450000.0,2,2.75,2810,11205,1.0,3,7,1510,1300.0,1968,2520,13000,19790 days 16:47:18.679838,086,0.7272727272727273,1.1615384615384616,290,-1795,210.0
449900.0,3,1.75,1760,8266,1.0,5,7,1760,0.0,1954,1400,8519,24903 days 16:47:18.679838,075,1.7142857142857142,0.0,360,-253,1760.0
345000.0,4,2.5,2040,5875,2.0,3,8,2040,0.0,2004,2230,5459,6641 days 16:47:18.679838,290,1.6,0.0,-190,416,2040.0
612500.0,4,2.0,1690,35346,1.0,3,7,1690,0.0,1967,2050,37846,20155 days 16:47:18.679838,282,2.0,0.0,-360,-2500,1690.0
317000.0,3,1.75,1530,7650,1.0,4,8,1530,0.0,1977,1850,6804,16502 days 16:47:18.679838,217,1.7142857142857142,0.0,-320,846,1530.0
585000.0,3,1.5,1810,3880,1.5,4,8,1310,500.0,1929,1400,3880,34034 days 16:47:18.679838,127,2.0,2.62,410,0,810.0
455000.0,3,1.75,1180,14292,1.0,3,7,1180,0.0,1981,1480,14400,15041 days 16:47:18.679838,169,1.7142857142857142,0.0,-300,-108,1180.0
1040000.0,4,4.0,4090,51908,2.0,3,1,4090,0.0,1991,4290,41655,11389 days 16:47:18.679838,335,1.0,0.0,-200,10253,4090.0
497000.0,4,2.25,2250,3463,2.0,4,8,2250,0.0,1968,1850,2811,19790 days 16:47:18.679838,232,1.7777777777777777,0.0,400,652,2250.0
226750.0,3,1.75,1070,6315,1.0,3,7,1070,0.0,1992,1520,5707,11024 days 16:47:18.679838,112,1.7142857142857142,0.0,-450,608,1070.0
385000.0,4,2.0,1820,7102,1.0,3,7,1220,600.0,1950,1650,8184,26364 days 16:47:18.679838,231,2.0,2.033333333333333,170,-1082,620.0
205000.0,3,0.75,1080,5025,1.0,3,5,1080,0.0,1948,1370,6000,27095 days 16:47:18.679838,345,4.0,0.0,-290,-975,1080.0
745000.0,4,2.5,2760,13093,2.0,4,9,2760,0.0,1989,2810,13545,12119 days 16:47:18.679838,272,1.6,0.0,-50,-452,2760.0
371000.0,4,2.5,2550,4770,2.0,3,8,2550,0.0,2005,2380,4590,6275 days 16:47:18.679838,171,1.6,0.0,170,180,2550.0
545000.0,4,2.5,2080,8504,2.0,3,8,2080,0.0,1991,2000,6773,11389 days 16:47:18.679838,241,1.6,0.0,80,1731,2080.0
443000.0,3,1.0,1280,5460,1.5,4,7,1280,0.0,1931,1390,5500,33304 days 16:47:18.679838,128,3.0,0.0,-110,-40,1280.0
287000.0,2,1.0,950,6350,1.0,3,7,950,0.0,1951,1080,7620,25999 days 16:47:18.679838,077,2.0,0.0,-130,-1270,950.0
194000.0,3,1.0,1050,7577,1.0,3,7,1050,0.0,1983,1430,7245,14311 days 16:47:18.679838,175,3.0,0.0,-380,332,1050.0
265000.0,3,1.0,1800,7650,1.0,5,7,1800,0.0,1957,1230,7650,23807 days 16:47:18.679838,180,3.0,0.0,570,0,1800.0
1140000.0,4,2.75,3840,10004,1.0,4,9,2110,1730.0,1963,3500,12118,21616 days 16:47:18.679838,098,1.4545454545454546,1.2196531791907514,340,-2114,380.0
699950.0,4,3.25,3674,12793,2.0,3,9,3674,0.0,1987,3220,13100,12850 days 16:47:18.679838,128,1.2307692307692308,0.0,454,-307,3674.0
433000.0,4,1.0,1710,7000,1.5,3,7,1710,0.0,1950,2030,7938,26364 days 16:47:18.679838,288,4.0,0.0,-320,-938,1710.0
200000.0,2,1.75,910,2693,1.0,3,6,910,0.0,2003,1360,2693,7006 days 16:47:18.679838,289,1.1428571428571428,0.0,-450,0,910.0
289571.0,3,1.5,1340,25160,1.0,3,7,1340,0.0,1968,1440,23680,19790 days 16:47:18.679838,099,2.0,0.0,-100,1480,1340.0
440000.0,4,2.75,2340,11034,1.0,3,8,1720,620.0,1967,2370,11941,20155 days 16:47:18.679838,153,1.4545454545454546,2.774193548387097,-30,-907,1100.0
400000.0,3,1.5,1510,8360,1.0,3,7,1120,390.0,1960,1700,8360,22712 days 16:47:18.679838,317,2.0,2.871794871794872,-190,0,730.0
589000.0,4,2.5,2630,15000,2.0,5,8,2630,0.0,1962,1770,8700,21981 days 16:47:18.679838,287,1.6,0.0,860,6300,2630.0
850000.0,5,2.25,3100,97661,2.0,3,9,3100,0.0,1986,2370,53993,13215 days 16:47:18.679838,083,2.2222222222222223,0.0,730,43668,3100.0
520000.0,3,1.0,940,3000,1.5,3,7,940,0.0,1903,1210,3500,43531 days 16:47:18.679838,002,3.0,0.0,-270,-500,940.0
555000.0,2,2.25,1370,1248,2.0,3,7,1200,170.0,2000,1800,3360,8102 days 16:47:18.679838,113,0.8888888888888888,7.0588235294117645,-430,-2112,1030.0
470000.0,3,2.5,2480,5082,2.0,3,7,2480,0.0,2004,2480,5874,6641 days 16:47:18.679838,068,1.2,0.0,0,-792,2480.0
207000.0,2,1.5,1068,1158,2.0,3,7,1068,0.0,1990,1078,1278,11754 days 16:47:18.679838,363,1.3333333333333333,0.0,-10,-120,1068.0
379750.0,4,2.75,2390,9650,1.0,3,8,1620,770.0,1976,2390,10000,16868 days 16:47:18.679838,317,1.4545454545454546,2.103896103896104,0,-350,850.0
709000.0,4,1.75,2170,4600,1.0,3,7,1270,900.0,1950,1750,4000,26364 days 16:47:18.679838,127,2.2857142857142856,1.4111111111111112,420,600,370.0
240000.0,3,2.5,1520,9864,1.0,3,7,1160,360.0,1993,1580,7425,10658 days 16:47:18.679838,266,1.2,3.2222222222222223,-60,2439,800.0
445500.0,4,1.5,2210,10497,1.0,4,8,1650,560.0,1953,1840,12697,25268 days 16:47:18.679838,035,2.6666666666666665,2.9464285714285716,370,-2200,1090.0
1310000.0,5,2.5,3200,7863,1.0,5,8,1600,1600.0,1959,2640,7680,23077 days 16:47:18.679838,252,2.0,1.0,560,183,0.0
210000.0,3,1.5,1160,10125,1.0,4,7,1160,0.0,1959,1440,10018,23077 days 16:47:18.679838,083,2.0,0.0,-280,107,1160.0
603000.0,4,2.5,2670,5895,2.0,3,8,2670,0.0,1999,2820,6531,8467 days 16:47:18.679838,223,1.6,0.0,-150,-636,2670.0
720000.0,3,2.5,2520,10012,2.0,3,1,2520,0.0,1987,2680,10071,12850 days 16:47:18.679838,097,1.2,0.0,-160,-59,2520.0
92000.0,2,1.0,760,5500,1.5,3,5,760,0.0,1947,1040,5515,27460 days 16:47:18.679838,167,2.0,0.0,-280,-15,760.0
600000.0,3,1.75,1310,5000,2.0,4,7,1310,0.0,1901,1270,4750,44261 days 16:47:18.679838,026,1.7142857142857142,0.0,40,250,1310.0
725000.0,4,2.5,2750,13950,1.0,4,8,1380,1370.0,1948,2460,13950,27095 days 16:47:18.679838,098,1.6,1.0072992700729928,290,0,10.0
409950.0,5,2.25,1790,10300,1.0,3,7,1270,520.0,1961,1790,10300,22346 days 16:47:18.679838,344,2.2222222222222223,2.4423076923076925,0,0,750.0
515000.0,3,2.5,1790,7167,2.0,3,8,1790,0.0,1989,1680,7418,12119 days 16:47:18.679838,126,1.2,0.0,110,-251,1790.0
495000.0,4,2.5,2400,11640,1.0,5,8,1800,600.0,1968,2440,10823,19790 days 16:47:18.679838,132,1.6,3.0,-40,817,1200.0
998000.0,4,2.25,2420,10200,2.0,4,9,2420,0.0,1973,2390,10200,17963 days 16:47:18.679838,175,1.7777777777777777,0.0,30,0,2420.0
630000.0,3,1.75,1710,8767,1.0,4,8,1710,0.0,1986,2050,9200,13215 days 16:47:18.679838,190,1.7142857142857142,0.0,-340,-433,1710.0
410000.0,3,1.75,2000,7480,1.0,3,8,1320,680.0,1972,2000,8610,18329 days 16:47:18.679838,213,1.7142857142857142,1.9411764705882353,0,-1130,640.0
602000.0,3,2.25,1580,11580,1.0,4,8,1580,0.0,1979,2630,10009,15772 days 16:47:18.679838,231,1.3333333333333333,0.0,-1050,1571,1580.0
750000.0,4,2.75,2310,10232,1.0,5,8,1310,1000.0,1980,2820,9886,15407 days 16:47:18.679838,316,1.4545454545454546,1.31,-510,346,310.0
711600.0,4,3.0,3580,9316,2.5,3,1,2370,1210.0,1991,2580,9242,11389 days 16:47:18.679838,189,1.3333333333333333,1.9586776859504131,1000,74,1160.0
1050000.0,4,4.0,4320,8709,2.0,3,1,3190,1130.0,2006,4010,8321,5910 days 16:47:18.679838,237,1.0,2.8230088495575223,310,388,2060.0
700500.0,3,2.5,2560,35265,2.0,3,9,2560,0.0,1981,2820,35496,15041 days 16:47:18.679838,351,1.2,0.0,-260,-231,2560.0
710000.0,4,2.5,3220,18618,2.0,3,1,3220,0.0,1991,2650,11896,11389 days 16:47:18.679838,035,1.6,0.0,570,6722,3220.0
250000.0,3,2.0,1660,13085,1.0,3,7,1010,650.0,1985,1660,7778,13580 days 16:47:18.679838,338,1.5,1.5538461538461539,0,5307,360.0
350000.0,4,1.75,2420,8400,1.0,5,7,1620,800.0,1964,1660,8400,21251 days 16:47:18.679838,288,2.2857142857142856,2.025,760,0,820.0
475000.0,7,3.5,2870,29699,1.0,3,7,1520,1350.0,1961,1380,7555,22346 days 16:47:18.679838,135,2.0,1.125925925925926,1490,22144,170.0
200000.0,2,1.0,830,7200,1.0,2,6,830,0.0,1920,1150,6600,37322 days 16:47:18.679838,016,2.0,0.0,-320,600,830.0
450000.0,4,2.25,1710,7000,1.0,4,7,1040,670.0,1972,1780,6500,18329 days 16:47:18.679838,303,1.7777777777777777,1.5522388059701493,-70,500,370.0
316000.0,5,2.5,2600,4641,2.0,3,7,2600,0.0,2005,2330,4589,6275 days 16:47:18.679838,213,2.0,0.0,270,52,2600.0
310000.0,1,1.0,670,4920,1.0,3,5,670,0.0,1920,1050,4920,37322 days 16:47:18.679838,289,1.0,0.0,-380,0,670.0
392000.0,3,1.5,1500,11975,1.0,4,7,1500,0.0,1970,1510,13875,19059 days 16:47:18.679838,054,2.0,0.0,-10,-1900,1500.0
521000.0,3,3.25,1460,1254,3.0,3,8,1460,0.0,2000,1400,1255,8102 days 16:47:18.679838,279,0.9230769230769231,0.0,60,-1,1460.0
495000.0,2,2.0,1540,7110,1.0,3,7,960,580.0,1949,1860,7065,26729 days 16:47:18.679838,234,1.0,1.6551724137931034,-320,45,380.0
809950.0,4,2.0,2230,9900,1.5,5,9,2230,0.0,1959,2510,11041,23077 days 16:47:18.679838,157,2.0,0.0,-280,-1141,2230.0
400000.0,2,1.75,1800,224769,1.0,3,7,1420,380.0,1950,1620,112384,26364 days 16:47:18.679838,260,1.1428571428571428,3.736842105263158,180,112385,1040.0
415000.0,4,2.5,2400,7292,1.0,3,8,1530,870.0,1980,1710,7909,15407 days 16:47:18.679838,071,1.6,1.7586206896551724,690,-617,660.0
411000.0,4,2.0,2370,76665,2.0,4,8,2370,0.0,1978,2110,19334,16137 days 16:47:18.679838,183,2.0,0.0,260,57331,2370.0
825000.0,2,2.0,1830,3600,1.0,4,7,1230,600.0,1926,2020,3600,35130 days 16:47:18.679838,254,1.0,2.05,-190,0,630.0
436000.0,3,2.25,1480,1384,3.0,3,8,1480,0.0,2008,1310,1329,5180 days 16:47:18.679838,054,1.3333333333333333,0.0,170,55,1480.0
460000.0,4,2.5,2620,8331,2.0,3,9,2620,0.0,1991,2760,8174,11389 days 16:47:18.679838,189,1.6,0.0,-140,157,2620.0
281000.0,3,1.0,1300,5782,1.0,4,6,1300,0.0,1959,1020,7200,23077 days 16:47:18.679838,195,3.0,0.0,280,-1418,1300.0
976000.0,4,1.5,3120,7680,1.0,3,8,1660,1460.0,1956,2900,7680,24173 days 16:47:18.679838,237,2.6666666666666665,1.1369863013698631,220,0,200.0
485000.0,4,2.5,2400,10364,2.0,3,8,2400,0.0,1995,2390,9918,9928 days 16:47:18.679838,110,1.6,0.0,10,446,2400.0
429000.0,3,2.5,1430,9240,2.0,3,7,1430,0.0,1984,1480,8125,13946 days 16:47:18.679838,206,1.2,0.0,-50,1115,1430.0
729000.0,3,2.5,2480,7428,2.0,3,9,2480,0.0,1990,2600,8322,11754 days 16:47:18.679838,063,1.2,0.0,-120,-894,2480.0
625000.0,3,2.5,2280,4757,2.0,3,8,2280,0.0,2003,2280,4534,7006 days 16:47:18.679838,099,1.2,0.0,0,223,2280.0
218500.0,3,1.75,1390,9328,1.0,4,7,1390,0.0,1987,1550,8374,12850 days 16:47:18.679838,016,1.7142857142857142,0.0,-160,954,1390.0
175000.0,3,1.0,1030,8395,1.0,4,7,1030,0.0,1960,1370,9380,22712 days 16:47:18.679838,037,3.0,0.0,-340,-985,1030.0
442500.0,3,1.0,1120,8200,1.0,4,7,1120,0.0,1938,1820,7205,30747 days 16:47:18.679838,036,3.0,0.0,-700,995,1120.0
480000.0,3,2.0,1300,3000,2.0,3,7,1300,0.0,1986,1670,4500,13215 days 16:47:18.679838,080,1.5,0.0,-370,-1500,1300.0
715500.0,3,2.25,2410,9668,1.0,4,8,1540,870.0,1965,2510,5250,20885 days 16:47:18.679838,281,1.3333333333333333,1.7701149425287357,-100,4418,670.0
432500.0,3,1.75,1470,7350,1.0,3,8,1470,0.0,1963,1470,7350,21616 days 16:47:18.679838,324,1.7142857142857142,0.0,0,0,1470.0
875000.0,5,4.25,4720,18741,2.0,3,1,3210,1510.0,2005,3880,37328,6275 days 16:47:18.679838,212,1.1764705882352942,2.1258278145695364,840,-18587,1700.0
605000.0,5,2.75,2910,13332,2.0,4,8,2910,0.0,1940,1760,8900,30017 days 16:47:18.679838,318,1.8181818181818181,0.0,1150,4432,2910.0
1690000.0,4,4.0,5000,12941,3.0,3,1,5000,0.0,2002,4560,12941,7371 days 16:47:18.679838,013,1.0,0.0,440,0,5000.0
318000.0,3,2.25,1690,12662,1.0,5,7,1090,600.0,1982,1950,9642,14676 days 16:47:18.679838,041,1.3333333333333333,1.8166666666666667,-260,3020,490.0
311300.0,2,1.0,1000,7228,1.0,4,7,1000,0.0,1947,1100,7228,27460 days 16:47:18.679838,289,2.0,0.0,-100,0,1000.0
325000.0,5,2.75,2400,7904,1.0,3,7,1450,950.0,1992,2400,7475,11024 days 16:47:18.679838,105,1.8181818181818181,1.5263157894736843,0,429,500.0
795000.0,5,3.5,3330,3705,2.0,3,9,2610,720.0,2008,2810,3971,5180 days 16:47:18.679838,321,1.4285714285714286,3.625,520,-266,1890.0
558000.0,4,2.25,2060,10358,1.0,4,8,1320,740.0,1962,2060,9676,21981 days 16:47:18.679838,170,1.7777777777777777,1.7837837837837838,0,682,580.0
370000.0,4,2.5,3090,18645,2.0,3,9,3090,0.0,1995,3610,20114,9928 days 16:47:18.679838,148,1.6,0.0,-520,-1469,3090.0
598850.0,4,2.5,2350,7245,2.0,3,8,2350,0.0,1993,2350,9419,10658 days 16:47:18.679838,322,1.6,0.0,0,-2174,2350.0
515700.0,3,2.5,2180,9722,2.0,3,8,2180,0.0,1994,2440,9722,10293 days 16:47:18.679838,296,1.2,0.0,-260,0,2180.0
458000.0,3,2.5,1870,5013,2.0,3,8,1870,0.0,2003,2040,5555,7006 days 16:47:18.679838,171,1.2,0.0,-170,-542,1870.0
583500.0,3,2.25,3530,13000,2.5,4,1,3530,0.0,1985,2960,13000,13580 days 16:47:18.679838,055,1.3333333333333333,0.0,570,0,3530.0
653750.0,4,2.5,2460,4166,2.0,3,9,2460,0.0,2003,2460,4964,7006 days 16:47:18.679838,204,1.6,0.0,0,-798,2460.0
299000.0,3,2.5,1650,4725,2.0,3,8,1650,0.0,2011,2000,4725,4084 days 16:47:18.679838,192,1.2,0.0,-350,0,1650.0
532000.0,5,3.0,3480,57499,1.0,4,8,2340,1140.0,1976,2020,40946,16868 days 16:47:18.679838,129,1.6666666666666667,2.0526315789473686,1460,16553,1200.0
819000.0,3,2.75,3176,13391,2.0,4,9,2726,450.0,1985,3470,12779,13580 days 16:47:18.679838,189,1.0909090909090908,6.057777777777778,-294,612,2276.0
945000.0,4,2.25,2420,9000,1.0,5,9,2000,420.0,1967,2400,9035,20155 days 16:47:18.679838,199,1.7777777777777777,4.761904761904762,20,-35,1580.0
608700.0,4,2.5,2260,9696,1.0,3,9,2260,0.0,1983,2400,12111,14311 days 16:47:18.679838,310,1.6,0.0,-140,-2415,2260.0
812000.0,4,2.0,2380,6122,1.0,4,8,1310,1070.0,1949,1810,5202,26729 days 16:47:18.679838,129,2.0,1.2242990654205608,570,920,240.0
464000.0,5,2.5,3400,8970,1.0,4,8,1700,1700.0,1959,1890,8475,23077 days 16:47:18.679838,133,2.0,1.0,1510,495,0.0
700000.0,4,2.5,2672,4297,2.0,3,8,2020,652.0,2005,1720,6120,6275 days 16:47:18.679838,337,1.6,3.098159509202454,952,-1823,1368.0
435000.0,3,1.0,1180,4219,1.0,3,7,1060,120.0,1939,1630,4219,30382 days 16:47:18.679838,289,3.0,8.833333333333334,-450,0,940.0
229500.0,3,1.5,1810,14400,1.0,4,7,1810,0.0,1954,1710,12000,24903 days 16:47:18.679838,280,2.0,0.0,100,2400,1810.0
1580000.0,3,3.0,2610,22672,1.5,4,8,2610,0.0,1952,2810,22672,25634 days 16:47:18.679838,321,1.0,0.0,-200,0,2610.0
265000.0,3,2.25,1450,13439,1.0,4,7,1180,270.0,1963,1520,12348,21616 days 16:47:18.679838,307,1.3333333333333333,4.37037037037037,-70,1091,910.0
995000.0,2,2.0,1600,64468,1.0,3,7,1600,0.0,1950,1950,64468,26364 days 16:47:18.679838,240,1.0,0.0,-350,0,1600.0
590000.0,3,2.5,2650,9380,1.0,5,8,1680,970.0,1975,2310,9600,17233 days 16:47:18.679838,190,1.2,1.731958762886598,340,-220,710.0
740000.0,4,2.75,2490,17833,2.0,3,9,1490,1000.0,1979,2640,16943,15772 days 16:47:18.679838,162,1.4545454545454546,1.49,-150,890,490.0
360000.0,2,0.75,850,7710,1.0,5,6,550,300.0,1909,2500,6022,41339 days 16:47:18.679838,141,2.6666666666666665,1.8333333333333333,-1650,1688,250.0
548500.0,4,2.0,1820,7200,1.0,3,7,1300,520.0,1976,1770,8149,16868 days 16:47:18.679838,096,2.0,2.5,50,-949,780.0
599000.0,3,1.75,1960,4788,1.0,4,7,1090,870.0,1920,1960,3960,37322 days 16:47:18.679838,127,1.7142857142857142,1.2528735632183907,0,828,220.0
615000.0,3,1.75,2350,20820,1.0,4,8,1800,550.0,1978,2040,10800,16137 days 16:47:18.679838,164,1.7142857142857142,3.272727272727273,310,10020,1250.0
292000.0,3,1.75,1320,6600,1.0,3,7,1320,0.0,1988,1070,6594,12485 days 16:47:18.679838,342,1.7142857142857142,0.0,250,6,1320.0
899000.0,4,2.5,3720,30649,2.0,3,1,3720,0.0,1988,3220,29434,12485 days 16:47:18.679838,296,1.6,0.0,500,1215,3720.0
500000.0,3,1.5,2210,6500,1.0,4,7,1030,1180.0,1912,1750,6370,40244 days 16:47:18.679838,342,2.0,0.8728813559322034,460,130,-150.0
580000.0,3,2.5,1910,11550,1.5,3,8,1910,0.0,2003,2230,11550,7006 days 16:47:18.679838,317,1.2,0.0,-320,0,1910.0
580000.0,4,2.5,2840,6268,2.0,3,9,2840,0.0,1998,2790,6526,8832 days 16:47:18.679838,129,1.6,0.0,50,-258,2840.0
594000.0,3,1.0,1320,5000,1.0,4,7,1090,230.0,1920,1700,5000,37322 days 16:47:18.679838,322,3.0,4.739130434782608,-380,0,860.0
500000.0,3,2.5,2440,7600,1.0,3,7,1420,1020.0,1981,2060,7700,15041 days 16:47:18.679838,099,1.2,1.392156862745098,380,-100,400.0
550000.0,4,2.5,2420,8056,1.0,3,8,1680,740.0,1988,2160,6807,12485 days 16:47:18.679838,279,1.6,2.27027027027027,260,1249,940.0
275000.0,3,1.75,1180,6260,1.0,4,8,1180,0.0,1993,1580,7272,10658 days 16:47:18.679838,119,1.7142857142857142,0.0,-400,-1012,1180.0
390000.0,3,2.25,1820,7420,2.0,4,8,1820,0.0,1983,1900,7526,14311 days 16:47:18.679838,120,1.3333333333333333,0.0,-80,-106,1820.0
1250000.0,3,3.0,3760,8500,2.5,4,1,3060,700.0,1910,2610,5500,40974 days 16:47:18.679838,177,1.0,4.371428571428571,1150,3000,2360.0
250000.0,3,2.25,1560,15340,2.0,3,7,1560,0.0,1997,1560,8260,9197 days 16:47:18.679838,238,1.3333333333333333,0.0,0,7080,1560.0
405000.0,2,2.5,1790,5400,2.0,4,8,1790,0.0,1979,1700,5760,15772 days 16:47:18.679838,272,0.8,0.0,90,-360,1790.0
213950.0,3,1.0,1430,7000,1.0,3,6,1430,0.0,1968,1050,7700,19790 days 16:47:18.679838,225,3.0,0.0,380,-700,1430.0
232000.0,3,1.5,1390,11340,1.0,4,7,1390,0.0,1963,1740,11340,21616 days 16:47:18.679838,356,2.0,0.0,-350,0,1390.0
207000.0,3,1.0,990,10800,1.0,4,6,990,0.0,1959,1060,10364,23077 days 16:47:18.679838,101,3.0,0.0,-70,436,990.0
310000.0,3,1.75,1880,30346,1.0,3,8,1880,0.0,1988,2260,5883,12485 days 16:47:18.679838,345,1.7142857142857142,0.0,-380,24463,1880.0
540000.0,3,2.5,2520,5000,3.0,3,9,2520,0.0,1990,1130,5000,11754 days 16:47:18.679838,246,1.2,0.0,1390,0,2520.0
750000.0,4,1.5,2060,4000,1.5,3,7,1580,480.0,1920,1160,4000,37322 days 16:47:18.679838,127,2.6666666666666665,3.2916666666666665,900,0,1100.0
392500.0,4,2.5,2150,7303,2.0,3,8,2150,0.0,2005,1940,9569,6275 days 16:47:18.679838,155,1.6,0.0,210,-2266,2150.0
305000.0,5,2.5,2500,12220,1.0,3,8,1690,810.0,1962,2130,12000,21981 days 16:47:18.679838,035,2.0,2.0864197530864197,370,220,880.0
735000.0,3,2.5,2390,9157,2.0,3,9,2390,0.0,1984,2360,8250,13946 days 16:47:18.679838,143,1.2,0.0,30,907,2390.0
575000.0,4,2.5,2400,6137,2.0,3,8,2400,0.0,1990,2120,7468,11754 days 16:47:18.679838,188,1.6,0.0,280,-1331,2400.0
175000.0,2,1.0,660,5000,1.0,3,6,660,0.0,1915,1000,5000,39148 days 16:47:18.679838,169,2.0,0.0,-340,0,660.0
291000.0,4,2.5,1580,6633,2.0,4,7,1580,0.0,1984,1590,6633,13946 days 16:47:18.679838,337,1.6,0.0,-10,0,1580.0
791500.0,4,2.5,3250,8970,2.0,3,1,3250,0.0,1994,3240,8449,10293 days 16:47:18.679838,216,1.6,0.0,10,521,3250.0
475000.0,3,2.0,1880,9659,1.0,3,8,1180,700.0,1951,1780,9659,25999 days 16:47:18.679838,191,1.5,1.6857142857142857,100,0,480.0
238950.0,2,1.0,1190,11400,1.0,3,7,1190,0.0,1951,1410,11400,25999 days 16:47:18.679838,317,2.0,0.0,-220,0,1190.0
470000.0,3,3.5,1280,1257,2.0,3,8,1040,240.0,2000,1280,1249,8102 days 16:47:18.679838,293,0.8571428571428571,4.333333333333333,0,8,800.0
420000.0,4,1.75,2380,15324,1.0,3,8,1610,770.0,1978,2540,12608,16137 days 16:47:18.679838,117,2.2857142857142856,2.090909090909091,-160,2716,840.0
440000.0,3,2.5,2040,7605,2.0,3,8,2040,0.0,1996,2150,7545,9563 days 16:47:18.679838,110,1.2,0.0,-110,60,2040.0
656000.0,4,1.75,1440,4300,1.5,4,8,1290,150.0,1929,1640,5000,34034 days 16:47:18.679838,232,2.2857142857142856,8.6,-200,-700,1140.0
559950.0,3,2.5,2120,4310,2.0,3,7,2120,0.0,2001,2280,4380,7736 days 16:47:18.679838,195,1.2,0.0,-160,-70,2120.0
600000.0,2,2.0,990,5416,1.0,3,6,990,0.0,1935,1650,3360,31843 days 16:47:18.679838,317,1.0,0.0,-660,2056,990.0
255000.0,3,1.0,1710,12000,1.0,4,7,1710,0.0,1972,1310,9600,18329 days 16:47:18.679838,216,3.0,0.0,400,2400,1710.0
210750.0,4,1.5,1840,7076,1.5,3,7,1840,0.0,1957,1510,7320,23807 days 16:47:18.679838,091,2.6666666666666665,0.0,330,-244,1840.0
485000.0,4,1.0,1150,2560,1.5,3,7,1150,0.0,1909,1890,3000,41339 days 16:47:18.679838,199,4.0,0.0,-740,-440,1150.0
390000.0,3,2.5,2250,8076,2.0,3,8,2250,0.0,1995,2180,7244,9928 days 16:47:18.679838,293,1.2,0.0,70,832,2250.0
405000.0,3,2.5,2460,12600,1.0,4,8,1810,650.0,1970,1820,11180,19059 days 16:47:18.679838,082,1.2,2.7846153846153845,640,1420,1160.0
462500.0,4,1.0,1540,4500,1.5,2,7,1540,0.0,1905,1920,6000,42800 days 16:47:18.679838,253,4.0,0.0,-380,-1500,1540.0
435000.0,4,2.25,2210,14073,1.0,3,8,1630,580.0,1978,2340,11340,16137 days 16:47:18.679838,041,1.7777777777777777,2.810344827586207,-130,2733,1050.0
440000.0,3,2.5,1440,5434,2.0,3,7,1440,0.0,2003,1560,3770,7006 days 16:47:18.679838,323,1.2,0.0,-120,1664,1440.0
299950.0,3,1.75,1790,7650,1.0,3,9,1790,0.0,1978,2540,7600,16137 days 16:47:18.679838,176,1.7142857142857142,0.0,-750,50,1790.0
440000.0,2,1.5,1120,1024,2.0,3,8,1120,0.0,1970,1120,1549,19059 days 16:47:18.679838,124,1.3333333333333333,0.0,0,-525,1120.0
312620.0,3,2.5,1260,11877,1.0,3,7,1260,0.0,1975,1430,9790,17233 days 16:47:18.679838,317,1.2,0.0,-170,2087,1260.0
372500.0,3,1.5,1180,12324,1.0,3,7,800,380.0,1981,1280,11371,15041 days 16:47:18.679838,156,2.0,2.1052631578947367,-100,953,420.0
297262.0,3,2.5,1730,8076,2.0,3,8,1730,0.0,1994,1780,6930,10293 days 16:47:18.679838,040,1.2,0.0,-50,1146,1730.0
735000.0,4,3.0,2250,7245,1.0,4,7,1250,1000.0,1963,1960,7245,21616 days 16:47:18.679838,041,1.3333333333333333,1.25,290,0,250.0
430000.0,3,1.5,1550,5034,2.0,4,7,1550,0.0,1922,1820,7200,36591 days 16:47:18.679838,238,2.0,0.0,-270,-2166,1550.0
241000.0,2,1.75,1070,9750,1.5,3,7,1070,0.0,1995,970,9750,9928 days 16:47:18.679838,295,1.1428571428571428,0.0,100,0,1070.0
201000.0,3,1.0,1460,9750,1.0,4,7,1460,0.0,1969,1270,9750,19424 days 16:47:18.679838,132,3.0,0.0,190,0,1460.0
570000.0,2,1.0,1060,4000,1.0,4,7,1060,0.0,1910,1770,4000,40974 days 16:47:18.679838,110,2.0,0.0,-710,0,1060.0
538000.0,4,1.75,1840,9600,1.0,3,7,1220,620.0,1967,1770,9720,20155 days 16:47:18.679838,128,2.2857142857142856,1.967741935483871,70,-120,600.0
729000.0,3,2.5,2440,4244,2.0,3,8,2440,0.0,2011,2690,4556,4084 days 16:47:18.679838,132,1.2,0.0,-250,-312,2440.0
331500.0,4,1.75,1700,14756,1.0,3,7,850,850.0,1955,1680,10250,24538 days 16:47:18.679838,008,2.2857142857142856,1.0,20,4506,0.0
110700.0,2,1.0,680,8064,1.0,3,6,680,0.0,1941,1340,10800,29651 days 16:47:18.679838,139,2.0,0.0,-660,-2736,680.0
245000.0,3,2.0,1700,8448,1.0,3,7,1700,0.0,1996,1350,8587,9563 days 16:47:18.679838,275,1.5,0.0,350,-139,1700.0
427000.0,3,1.75,2000,7111,1.0,4,7,1360,640.0,1956,1830,9000,24173 days 16:47:18.679838,202,1.7142857142857142,2.125,170,-1889,720.0
650500.0,4,1.75,2340,5940,1.0,3,8,1290,1050.0,1953,1930,5940,25268 days 16:47:18.679838,218,2.2857142857142856,1.2285714285714286,410,0,240.0
335900.0,2,1.0,1120,7440,1.0,4,7,1120,0.0,1939,1170,7440,30382 days 16:47:18.679838,226,2.0,0.0,-50,0,1120.0
535000.0,2,2.0,1510,5133,1.5,3,7,1510,0.0,1939,1470,6000,30382 days 16:47:18.679838,246,1.0,0.0,40,-867,1510.0
360000.0,5,2.0,2120,2400,1.0,4,6,1080,1040.0,1906,1690,4400,42435 days 16:47:18.679838,022,2.5,1.0384615384615385,430,-2000,40.0
294900.0,3,2.25,1500,8100,1.0,3,7,1210,290.0,1968,1600,7896,19790 days 16:47:18.679838,035,1.3333333333333333,4.172413793103448,-100,204,920.0
460000.0,2,1.0,1030,5934,1.0,4,7,1030,0.0,1928,1420,5588,34400 days 16:47:18.679838,070,2.0,0.0,-390,346,1030.0
1770000.0,4,3.5,5440,38900,2.0,3,1,5440,0.0,1990,4830,41313,11754 days 16:47:18.679838,258,1.1428571428571428,0.0,610,-2413,5440.0
463000.0,2,1.0,1150,4400,1.0,4,7,1150,0.0,1905,1240,4400,42800 days 16:47:18.679838,129,2.0,0.0,-90,0,1150.0
332000.0,5,1.5,2420,43560,1.0,3,8,1500,920.0,1962,1620,17331,21981 days 16:47:18.679838,356,3.3333333333333335,1.6304347826086956,800,26229,580.0
199500.0,4,2.0,1750,8116,1.0,4,5,1750,0.0,1943,1440,7865,28921 days 16:47:18.679838,252,2.0,0.0,310,251,1750.0
247000.0,4,2.0,1750,8116,1.0,4,5,1750,0.0,1943,1440,7865,28921 days 16:47:18.679838,328,2.0,0.0,310,251,1750.0
442500.0,4,2.5,2170,14024,2.0,3,8,2170,0.0,1992,2240,14029,11024 days 16:47:18.679838,160,1.6,0.0,-70,-5,2170.0
600000.0,3,2.0,2540,237402,1.0,3,9,2540,0.0,2007,2200,229125,5545 days 16:47:18.679838,170,1.5,0.0,340,8277,2540.0
449000.0,3,2.5,1690,3827,2.0,3,7,1690,0.0,2005,1690,3129,6275 days 16:47:18.679838,246,1.2,0.0,0,698,1690.0
725000.0,4,1.0,1600,4500,1.5,4,7,1600,0.0,1926,1720,4500,35130 days 16:47:18.679838,065,4.0,0.0,-120,0,1600.0
582500.0,2,1.75,1990,6549,1.0,3,7,1170,820.0,1948,1640,7202,27095 days 16:47:18.679838,352,1.1428571428571428,1.4268292682926829,350,-653,350.0
305000.0,4,2.25,2210,9371,2.0,4,8,2210,0.0,1968,2300,11584,19790 days 16:47:18.679838,175,1.7777777777777777,0.0,-90,-2213,2210.0
734000.0,4,2.75,3090,7650,2.0,3,8,2340,750.0,1959,2760,10370,23077 days 16:47:18.679838,266,1.4545454545454546,3.12,330,-2720,1590.0
300000.0,3,2.0,1050,10072,1.0,3,7,1050,0.0,1986,1130,10087,13215 days 16:47:18.679838,125,1.5,0.0,-80,-15,1050.0
525888.0,5,1.75,2550,71874,1.0,5,7,1810,740.0,1960,2170,51400,22712 days 16:47:18.679838,125,2.857142857142857,2.445945945945946,380,20474,1070.0
711000.0,4,2.5,2095,4400,1.5,5,8,1295,800.0,1910,1980,4400,40974 days 16:47:18.679838,254,1.6,1.61875,115,0,495.0
360000.0,3,1.75,1520,12282,1.0,3,8,1220,300.0,1978,1860,13500,16137 days 16:47:18.679838,197,1.7142857142857142,4.066666666666666,-340,-1218,920.0
357000.0,5,2.5,2750,12350,2.0,3,8,2750,0.0,1987,1650,9810,12850 days 16:47:18.679838,344,2.0,0.0,1100,2540,2750.0
235000.0,3,1.75,1200,9266,1.0,4,7,1200,0.0,1960,1200,9266,22712 days 16:47:18.679838,273,1.7142857142857142,0.0,0,0,1200.0
550000.0,3,1.75,1830,9720,1.0,3,7,1150,680.0,1928,3380,10854,34400 days 16:47:18.679838,220,1.7142857142857142,1.6911764705882353,-1550,-1134,470.0
324000.0,3,1.0,1160,7202,1.0,4,7,1160,0.0,1957,1620,8598,23807 days 16:47:18.679838,339,3.0,0.0,-460,-1396,1160.0
420000.0,3,2.0,1750,9239,1.0,3,8,1410,340.0,1989,1720,7874,12119 days 16:47:18.679838,118,1.5,4.147058823529412,30,1365,1070.0
450000.0,4,2.5,2400,7693,2.0,3,8,2400,0.0,2003,2400,8038,7006 days 16:47:18.679838,170,1.6,0.0,0,-345,2400.0
825000.0,5,3.5,4140,6770,2.0,3,9,3030,1110.0,2004,3960,5431,6641 days 16:47:18.679838,110,1.4285714285714286,2.72972972972973,180,1339,1920.0
272000.0,4,2.25,2115,6234,2.0,3,7,2115,0.0,1998,2440,6366,8832 days 16:47:18.679838,203,1.7777777777777777,0.0,-325,-132,2115.0
481000.0,3,2.0,2580,15653,1.5,3,9,2580,0.0,1990,1920,9840,11754 days 16:47:18.679838,295,1.5,0.0,660,5813,2580.0
500000.0,3,1.0,1220,3400,1.0,3,7,1060,160.0,1927,1350,3750,34765 days 16:47:18.679838,217,3.0,6.625,-130,-350,900.0
448000.0,2,1.5,1630,3780,1.0,4,7,890,740.0,1940,1770,6400,30017 days 16:47:18.679838,163,1.3333333333333333,1.2027027027027026,-140,-2620,150.0
480000.0,2,2.0,1350,4220,1.0,3,8,1350,0.0,2004,1350,4409,6641 days 16:47:18.679838,078,1.0,0.0,0,-189,1350.0
475000.0,3,2.5,1690,2890,2.0,3,7,1690,0.0,2004,1690,2730,6641 days 16:47:18.679838,251,1.2,0.0,0,160,1690.0
472500.0,2,2.25,1700,2383,2.0,3,8,1700,0.0,2005,1700,2700,6275 days 16:47:18.679838,294,0.8888888888888888,0.0,0,-317,1700.0
291000.0,4,2.25,1890,7616,1.0,4,8,1260,630.0,1979,1890,7420,15772 days 16:47:18.679838,266,1.7777777777777777,2.0,0,196,630.0
294000.0,2,1.0,850,5250,1.0,4,7,850,0.0,1950,1440,5250,26364 days 16:47:18.679838,203,2.0,0.0,-590,0,850.0
1010000.0,4,2.5,2480,12688,1.0,4,9,1820,660.0,1967,2910,11979,20155 days 16:47:18.679838,211,1.6,2.757575757575758,-430,709,1160.0
442500.0,3,2.5,1690,3129,2.0,3,7,1690,0.0,2002,1690,3129,7371 days 16:47:18.679838,290,1.2,0.0,0,0,1690.0
170000.0,2,1.0,810,8424,1.0,4,6,810,0.0,1959,820,8424,23077 days 16:47:18.679838,178,2.0,0.0,-10,0,810.0
1580000.0,4,2.5,3980,16304,1.0,3,1,2480,1500.0,1968,3980,16304,19790 days 16:47:18.679838,118,1.6,1.6533333333333333,0,0,980.0
665000.0,3,2.25,2580,6000,2.0,3,8,1780,800.0,1925,2300,5995,35495 days 16:47:18.679838,049,1.3333333333333333,2.225,280,5,980.0
1610000.0,5,4.5,6085,142725,3.0,3,1,6085,0.0,2000,4830,128457,8102 days 16:47:18.679838,240,1.1111111111111112,0.0,1255,14268,6085.0
675000.0,2,1.75,2140,5000,1.0,3,7,1000,1140.0,1930,2250,4000,33669 days 16:47:18.679838,195,1.1428571428571428,0.8771929824561403,-110,1000,-140.0
279900.0,2,1.75,1360,10000,1.0,3,6,1360,0.0,1957,1430,10000,23807 days 16:47:18.679838,035,1.1428571428571428,0.0,-70,0,1360.0
875000.0,4,1.5,1800,3245,1.5,4,8,1800,0.0,1929,1800,4275,34034 days 16:47:18.679838,181,2.6666666666666665,0.0,0,-1030,1800.0
571000.0,3,2.5,1920,3867,2.0,3,8,1920,0.0,2005,2190,3841,6275 days 16:47:18.679838,216,1.2,0.0,-270,26,1920.0
320000.0,3,1.0,860,5060,1.5,3,7,860,0.0,1927,880,5060,34765 days 16:47:18.679838,168,3.0,0.0,-20,0,860.0
525000.0,3,2.5,2340,35021,1.0,3,9,2340,0.0,1986,2630,35190,13215 days 16:47:18.679838,238,1.2,0.0,-290,-169,2340.0
1650000.0,8,2.75,4040,20666,1.0,4,9,2020,2020.0,1962,3670,20500,21981 days 16:47:18.679838,192,2.909090909090909,1.0,370,166,0.0
137900.0,3,1.75,1160,5082,1.0,3,6,580,580.0,1942,1730,6000,29286 days 16:47:18.679838,091,1.7142857142857142,1.0,-570,-918,0.0
440000.0,3,2.25,1680,57063,2.0,4,8,1680,0.0,1989,1910,57063,12119 days 16:47:18.679838,154,1.3333333333333333,0.0,-230,0,1680.0
360000.0,3,1.0,1280,3870,1.0,3,7,640,640.0,1945,1280,4800,28190 days 16:47:18.679838,063,3.0,1.0,0,-930,0.0
271000.0,4,1.5,1800,9576,1.0,4,7,1800,0.0,1977,1370,9576,16502 days 16:47:18.679838,036,2.6666666666666665,0.0,430,0,1800.0
465000.0,6,3.25,4250,23326,1.0,3,1,2150,2100.0,1967,3370,15983,20155 days 16:47:18.679838,148,1.8461538461538463,1.0238095238095237,880,7343,50.0
280000.0,4,2.5,2400,4596,2.0,3,8,2400,0.0,2004,2230,4763,6641 days 16:47:18.679838,269,1.6,0.0,170,-167,2400.0
283000.0,2,1.0,940,6350,1.0,4,5,940,0.0,1942,1490,6350,29286 days 16:47:18.679838,118,2.0,0.0,-550,0,940.0
411500.0,3,1.0,1110,7208,1.0,3,7,1110,0.0,1980,1440,7210,15407 days 16:47:18.679838,044,3.0,0.0,-330,-2,1110.0
282000.0,3,2.25,2420,7548,1.0,4,8,1370,1050.0,1967,2150,8000,20155 days 16:47:18.679838,260,1.3333333333333333,1.3047619047619048,270,-452,320.0
535000.0,3,2.5,1850,1499,2.5,3,9,1790,60.0,2005,1770,1539,6275 days 16:47:18.679838,343,1.2,29.833333333333332,80,-40,1730.0
554729.0,4,2.5,2020,4350,2.0,5,9,1730,290.0,1943,1620,5800,28921 days 16:47:18.679838,184,1.6,5.9655172413793105,400,-1450,1440.0
868000.0,4,2.5,2020,4350,2.0,5,9,1730,290.0,1943,1620,5800,28921 days 16:47:18.679838,055,1.6,5.9655172413793105,400,-1450,1440.0
427000.0,3,2.5,1830,65340,1.0,3,8,1520,310.0,1991,2100,84942,11389 days 16:47:18.679838,167,1.2,4.903225806451613,-270,-19602,1210.0
455000.0,4,1.75,1920,6000,1.0,4,7,960,960.0,1954,1850,7200,24903 days 16:47:18.679838,321,2.2857142857142856,1.0,70,-1200,0.0
595000.0,2,1.75,1280,8500,1.0,3,7,1280,0.0,1953,1950,10356,25268 days 16:47:18.679838,302,1.1428571428571428,0.0,-670,-1856,1280.0
400000.0,4,2.5,3130,5240,2.0,3,8,3130,0.0,2004,2470,5240,6641 days 16:47:18.679838,079,1.6,0.0,660,0,3130.0
770000.0,4,2.5,3920,12415,2.0,3,1,3920,0.0,1997,3639,12805,9197 days 16:47:18.679838,176,1.6,0.0,281,-390,3920.0
742500.0,4,2.75,3100,3773,2.0,3,8,2000,1100.0,1919,2130,3777,37687 days 16:47:18.679838,129,1.4545454545454546,1.8181818181818181,970,-4,900.0
1250000.0,4,2.5,3220,15600,1.0,5,9,1680,1540.0,1973,2990,15600,17963 days 16:47:18.679838,175,1.6,1.0909090909090908,230,0,140.0
375000.0,3,2.0,1670,13775,1.0,3,8,1670,0.0,1968,2130,14500,19790 days 16:47:18.679838,224,1.5,0.0,-460,-725,1670.0
1560000.0,4,2.5,2700,17853,2.0,4,9,2700,0.0,1960,3790,16672,22712 days 16:47:18.679838,097,1.6,0.0,-1090,1181,2700.0
545000.0,4,2.0,5461,22880,1.0,4,9,3265,2196.0,1964,1940,10995,21251 days 16:47:18.679838,028,2.0,1.4867941712204007,3521,11885,1069.0
1050000.0,4,3.25,4400,16625,2.0,3,1,4400,0.0,2003,4440,15523,7006 days 16:47:18.679838,133,1.2307692307692308,0.0,-40,1102,4400.0
1570000.0,3,1.75,2190,8500,1.0,4,9,2190,0.0,1957,2850,8868,23807 days 16:47:18.679838,351,1.7142857142857142,0.0,-660,-368,2190.0
178000.0,4,1.5,1200,11163,1.5,4,6,1200,0.0,1970,1200,11163,19059 days 16:47:18.679838,077,2.6666666666666665,0.0,0,0,1200.0
262500.0,3,1.75,1470,10390,1.0,3,7,1470,0.0,1989,1770,7507,12119 days 16:47:18.679838,282,1.7142857142857142,0.0,-300,2883,1470.0
730000.0,3,1.75,1650,5000,1.5,4,8,1650,0.0,1900,1630,5000,44626 days 16:47:18.679838,105,1.7142857142857142,0.0,20,0,1650.0
395000.0,5,1.75,1840,10453,1.0,3,8,1360,480.0,1948,2250,11250,27095 days 16:47:18.679838,184,2.857142857142857,2.8333333333333335,-410,-797,880.0
355000.0,3,1.0,1210,6650,1.0,3,6,1210,0.0,1959,990,7590,23077 days 16:47:18.679838,297,3.0,0.0,220,-940,1210.0
299990.0,3,2.5,1870,8541,2.0,3,8,1870,0.0,1989,2150,7789,12119 days 16:47:18.679838,251,1.2,0.0,-280,752,1870.0
1130000.0,4,3.25,3890,422096,1.5,3,9,3150,740.0,2001,2180,229996,7736 days 16:47:18.679838,086,1.2307692307692308,4.256756756756757,1710,192100,2410.0
425000.0,4,2.25,2660,11200,2.0,4,8,2660,0.0,1972,2090,11120,18329 days 16:47:18.679838,322,1.7777777777777777,0.0,570,80,2660.0
349000.0,2,1.0,1150,7552,1.0,3,7,1150,0.0,1951,1150,7346,25999 days 16:47:18.679838,007,2.0,0.0,0,206,1150.0
554950.0,4,1.75,1740,4816,1.0,5,7,870,870.0,1942,1210,5074,29286 days 16:47:18.679838,315,2.2857142857142856,1.0,530,-258,0.0
326000.0,6,3.0,2580,8064,1.5,3,7,1880,700.0,1913,1510,6084,39878 days 16:47:18.679838,320,2.0,2.6857142857142855,1070,1980,1180.0
580000.0,4,1.75,1720,6975,1.0,3,8,1420,300.0,1975,2210,7875,17233 days 16:47:18.679838,177,2.2857142857142856,4.733333333333333,-490,-900,1120.0
699000.0,3,2.5,2740,18455,2.0,4,1,1510,1230.0,1977,2840,16438,16502 days 16:47:18.679838,239,1.2,1.2276422764227641,-100,2017,280.0
757000.0,3,2.75,2610,11290,1.0,3,7,1630,980.0,1985,2570,9125,13580 days 16:47:18.679838,329,1.0909090909090908,1.663265306122449,40,2165,650.0
335000.0,3,1.75,1400,7920,1.0,3,7,1400,0.0,1965,1310,7876,20885 days 16:47:18.679838,204,1.7142857142857142,0.0,90,44,1400.0
660000.0,3,2.0,2570,28500,1.0,3,9,1970,600.0,1983,3070,32400,14311 days 16:47:18.679838,182,1.5,3.283333333333333,-500,-3900,1370.0
540000.0,4,2.75,2830,7334,2.0,3,8,2830,0.0,2005,2830,7378,6275 days 16:47:18.679838,107,1.4545454545454546,0.0,0,-44,2830.0
320000.0,5,2.25,2630,8625,2.0,3,8,2630,0.0,1966,1880,8670,20520 days 16:47:18.679838,283,2.2222222222222223,0.0,750,-45,2630.0
280000.0,3,2.5,1580,7918,2.0,3,7,1580,0.0,1994,1650,7916,10293 days 16:47:18.679838,111,1.2,0.0,-70,2,1580.0
324000.0,3,2.0,1540,10931,1.0,3,7,1540,0.0,1989,1570,10485,12119 days 16:47:18.679838,204,1.5,0.0,-30,446,1540.0
300000.0,3,1.0,2120,7735,1.0,4,7,1060,1060.0,1967,1010,8570,20155 days 16:47:18.679838,140,3.0,1.0,1110,-835,0.0
360000.0,3,1.75,1830,10000,2.0,4,7,1830,0.0,1913,1480,10000,39878 days 16:47:18.679838,240,1.7142857142857142,0.0,350,0,1830.0
600000.0,3,2.5,2260,10153,2.0,3,1,2260,0.0,1987,2740,10153,12850 days 16:47:18.679838,174,1.2,0.0,-480,0,2260.0
950000.0,4,1.75,2500,92347,1.0,4,8,1500,1000.0,1970,3750,20267,19059 days 16:47:18.679838,150,2.2857142857142856,1.5,-1250,72080,500.0
599950.0,3,3.25,1830,1804,3.0,3,8,1830,0.0,2014,1830,1804,2988 days 16:47:18.679838,190,0.9230769230769231,0.0,0,0,1830.0
190000.0,4,1.0,1190,7920,1.0,3,6,890,300.0,1951,1140,7920,25999 days 16:47:18.679838,084,4.0,2.966666666666667,50,0,590.0
350000.0,4,1.75,2310,9002,1.0,3,7,1780,530.0,1970,2090,8814,19059 days 16:47:18.679838,089,2.2857142857142856,3.358490566037736,220,188,1250.0
522000.0,3,1.0,1230,4600,1.5,3,7,1230,0.0,1929,1230,4600,34034 days 16:47:18.679838,100,3.0,0.0,0,0,1230.0
850000.0,3,2.5,2940,10809,2.0,3,1,2940,0.0,1992,3090,10348,11024 days 16:47:18.679838,077,1.2,0.0,-150,461,2940.0
1020000.0,6,2.25,2550,5000,2.0,4,7,2550,0.0,1907,1480,5000,42070 days 16:47:18.679838,336,2.6666666666666665,0.0,1070,0,2550.0
397500.0,3,1.0,1480,5100,1.5,3,7,1480,0.0,1938,1300,5100,30747 days 16:47:18.679838,301,3.0,0.0,180,0,1480.0
186000.0,3,1.75,1460,7967,1.0,3,7,1040,420.0,1977,1460,6835,16502 days 16:47:18.679838,027,1.7142857142857142,2.4761904761904763,0,1132,620.0
436500.0,5,3.0,3110,12429,1.0,3,8,1790,1320.0,1977,3050,11902,16502 days 16:47:18.679838,171,1.6666666666666667,1.356060606060606,60,527,470.0
710000.0,3,2.0,2140,4923,1.0,4,8,1070,1070.0,1928,1470,4923,34400 days 16:47:18.679838,154,1.5,1.0,670,0,0.0
1380000.0,5,3.25,3450,6360,2.0,5,9,1860,1590.0,1905,2310,5000,42800 days 16:47:18.679838,014,1.5384615384615385,1.169811320754717,1140,1360,270.0
450000.0,3,2.25,1960,10682,1.0,3,7,1960,0.0,1957,1540,10682,23807 days 16:47:18.679838,118,1.3333333333333333,0.0,420,0,1960.0
375000.0,4,2.75,1890,5240,1.0,3,7,980,910.0,1981,1600,5240,15041 days 16:47:18.679838,021,1.4545454545454546,1.0769230769230769,290,0,70.0
315000.0,2,1.0,2080,14659,1.0,3,7,1040,1040.0,1960,1920,15208,22712 days 16:47:18.679838,317,2.0,1.0,160,-549,0.0
467500.0,3,1.0,1700,4165,1.5,3,7,1700,0.0,1918,1400,4165,38052 days 16:47:18.679838,044,3.0,0.0,300,0,1700.0
330000.0,3,1.0,1140,7316,1.0,3,6,1140,0.0,1959,1140,7440,23077 days 16:47:18.679838,058,3.0,0.0,0,-124,1140.0
665000.0,3,2.5,3136,54450,1.5,5,8,3136,0.0,1910,2300,54450,40974 days 16:47:18.679838,206,1.2,0.0,836,0,3136.0
760000.0,4,3.25,2590,3889,3.0,3,9,2590,0.0,2013,2590,4062,3353 days 16:47:18.679838,083,1.2307692307692308,0.0,0,-173,2590.0
469000.0,3,1.75,1480,800,2.0,3,8,1000,480.0,2014,1480,1143,2988 days 16:47:18.679838,364,1.7142857142857142,2.0833333333333335,0,-343,520.0
408000.0,3,3.0,1500,1473,2.0,3,8,1120,380.0,2000,1720,1976,8102 days 16:47:18.679838,225,1.0,2.9473684210526314,-220,-503,740.0
851000.0,3,2.75,2660,10350,1.0,4,8,1330,1330.0,1971,2820,10043,18694 days 16:47:18.679838,276,1.0909090909090908,1.0,-160,307,0.0
410000.0,2,2.0,1350,3926,1.0,3,8,1350,0.0,2007,1440,3926,5545 days 16:47:18.679838,206,1.0,0.0,-90,0,1350.0
235000.0,2,1.0,860,10500,1.0,3,6,860,0.0,1943,950,10500,28921 days 16:47:18.679838,072,2.0,0.0,-90,0,860.0
207100.0,2,1.0,1000,4500,1.0,3,6,1000,0.0,1916,980,4837,38783 days 16:47:18.679838,240,2.0,0.0,20,-337,1000.0
560000.0,4,2.5,2480,16360,1.0,5,7,1510,970.0,1959,1770,15205,23077 days 16:47:18.679838,177,1.6,1.556701030927835,710,1155,540.0
903000.0,3,2.75,3860,12786,2.0,4,1,3860,0.0,1984,2820,14636,13946 days 16:47:18.679838,304,1.0909090909090908,0.0,1040,-1850,3860.0
998500.0,3,1.75,2140,4800,2.0,3,8,1690,450.0,1905,2440,4800,42800 days 16:47:18.679838,007,1.7142857142857142,3.7555555555555555,-300,0,1240.0
268500.0,4,1.75,1820,13600,1.5,3,7,1120,700.0,1959,1810,11970,23077 days 16:47:18.679838,211,2.2857142857142856,1.6,10,1630,420.0
494950.0,2,1.75,2220,33000,1.0,4,8,2220,0.0,1970,2220,33000,19059 days 16:47:18.679838,288,1.1428571428571428,0.0,0,0,2220.0
1130000.0,4,2.5,2660,11200,2.0,3,9,2660,0.0,1999,3290,11275,8467 days 16:47:18.679838,213,1.6,0.0,-630,-75,2660.0
250000.0,3,2.0,1470,12096,1.0,4,6,1470,0.0,1942,1470,10966,29286 days 16:47:18.679838,322,1.5,0.0,0,1130,1470.0
449000.0,4,1.75,2350,54450,1.0,4,7,1250,1100.0,1971,2180,50529,18694 days 16:47:18.679838,079,2.2857142857142856,1.1363636363636365,170,3921,150.0
1230000.0,3,2.25,2980,7700,1.0,3,9,2530,450.0,1964,3020,8234,21251 days 16:47:18.679838,012,1.3333333333333333,5.622222222222222,-40,-534,2080.0
325000.0,4,2.0,1870,7700,1.0,3,8,1870,0.0,1966,2270,8580,20520 days 16:47:18.679838,076,2.0,0.0,-400,-880,1870.0
506000.0,5,3.0,2430,8000,1.0,4,7,1370,1060.0,1957,1770,8000,23807 days 16:47:18.679838,166,1.6666666666666667,1.2924528301886793,660,0,310.0
751000.0,4,2.5,2790,6538,2.0,3,9,2790,0.0,2003,2990,6538,7006 days 16:47:18.679838,084,1.6,0.0,-200,0,2790.0
280000.0,3,2.5,1370,22326,2.0,3,7,1370,0.0,1993,1580,10920,10658 days 16:47:18.679838,224,1.2,0.0,-210,11406,1370.0
1120000.0,4,2.25,4470,60373,2.0,3,1,4470,0.0,1988,3210,40450,12485 days 16:47:18.679838,134,1.7777777777777777,0.0,1260,19923,4470.0
580000.0,3,1.75,2040,81021,1.0,3,8,2040,0.0,1980,2260,39280,15407 days 16:47:18.679838,262,1.7142857142857142,0.0,-220,41741,2040.0
665000.0,4,2.25,2340,5300,1.0,5,8,1700,640.0,1963,1890,8250,21616 days 16:47:18.679838,113,1.7777777777777777,2.65625,450,-2950,1060.0
450000.0,4,2.5,2520,8515,2.0,3,7,2520,0.0,1999,2130,6930,8467 days 16:47:18.679838,147,1.6,0.0,390,1585,2520.0
389900.0,4,1.0,1710,117176,1.5,4,6,1710,0.0,1942,1940,12223,29286 days 16:47:18.679838,253,4.0,0.0,-230,104953,1710.0
427000.0,3,1.0,1200,5252,1.0,3,7,1200,0.0,1962,1800,7920,21981 days 16:47:18.679838,321,3.0,0.0,-600,-2668,1200.0
265000.0,3,1.75,1330,12618,1.0,3,7,1330,0.0,1983,1870,8429,14311 days 16:47:18.679838,106,1.7142857142857142,0.0,-540,4189,1330.0
398000.0,3,1.5,1310,2996,2.0,3,7,1310,0.0,1998,1310,2997,8832 days 16:47:18.679838,309,2.0,0.0,0,-1,1310.0
354000.0,6,3.5,3020,4500,2.0,3,7,3020,0.0,1941,900,6000,29651 days 16:47:18.679838,308,1.7142857142857142,0.0,2120,-1500,3020.0
339950.0,4,2.5,2260,6086,2.0,3,8,2260,0.0,1999,2260,6218,8467 days 16:47:18.679838,103,1.6,0.0,0,-132,2260.0
399000.0,2,1.0,790,4000,1.0,3,6,790,0.0,1948,990,5000,27095 days 16:47:18.679838,316,2.0,0.0,-200,-1000,790.0
325000.0,2,2.0,970,5000,1.0,3,7,970,0.0,1983,1540,5000,14311 days 16:47:18.679838,283,1.0,0.0,-570,0,970.0
998800.0,3,2.0,2250,8000,1.0,4,9,2250,0.0,1955,2880,10960,24538 days 16:47:18.679838,231,1.5,0.0,-630,-2960,2250.0
350000.0,4,2.5,1530,2248,1.5,3,7,1530,0.0,1914,1340,3700,39513 days 16:47:18.679838,262,1.6,0.0,190,-1452,1530.0
1000000.0,4,1.75,1780,11436,1.0,5,9,1780,0.0,1967,2100,12052,20155 days 16:47:18.679838,217,2.2857142857142856,0.0,-320,-616,1780.0
561000.0,3,2.5,2120,5277,2.0,3,7,2120,0.0,2005,2370,5257,6275 days 16:47:18.679838,077,1.2,0.0,-250,20,2120.0
245000.0,2,1.0,1500,6685,1.0,3,7,1190,310.0,1926,1420,6561,35130 days 16:47:18.679838,188,2.0,3.838709677419355,80,124,880.0
570000.0,2,1.0,1500,6685,1.0,3,7,1190,310.0,1926,1420,6561,35130 days 16:47:18.679838,044,2.0,3.838709677419355,80,124,880.0
845000.0,4,3.0,2390,4000,1.5,5,8,1460,930.0,1931,1670,4000,33304 days 16:47:18.679838,303,1.3333333333333333,1.5698924731182795,720,0,530.0
314500.0,4,2.5,2390,9600,2.0,3,7,2390,0.0,1996,1900,9603,9563 days 16:47:18.679838,272,1.6,0.0,490,-3,2390.0
650000.0,3,1.75,2920,9370,1.0,4,8,1620,1300.0,1981,2890,9609,15041 days 16:47:18.679838,169,1.7142857142857142,1.2461538461538462,30,-239,320.0
298000.0,2,1.0,850,5000,1.0,3,5,850,0.0,1907,910,4815,42070 days 16:47:18.679838,126,2.0,0.0,-60,185,850.0
500000.0,2,1.0,930,3200,1.0,3,7,930,0.0,1904,1690,3840,43166 days 16:47:18.679838,099,2.0,0.0,-760,-640,930.0
870000.0,4,2.5,3340,12248,2.0,3,9,2470,870.0,1998,2110,5679,8832 days 16:47:18.679838,161,1.6,2.839080459770115,1230,6569,1600.0
299000.0,2,1.0,710,6732,1.0,5,6,710,0.0,1942,710,6720,29286 days 16:47:18.679838,096,2.0,0.0,0,12,710.0
527000.0,3,2.25,2240,6450,1.0,3,7,1440,800.0,1979,1390,6450,15772 days 16:47:18.679838,224,1.3333333333333333,1.8,850,0,640.0
420000.0,3,1.0,1060,7638,1.0,5,7,1060,0.0,1966,1470,8097,20520 days 16:47:18.679838,310,3.0,0.0,-410,-459,1060.0
290000.0,3,2.5,2360,8764,2.0,3,8,2360,0.0,1991,2360,8746,11389 days 16:47:18.679838,043,1.2,0.0,0,18,2360.0
1660000.0,4,2.75,3520,19200,1.0,4,9,1950,1570.0,1951,2450,7000,25999 days 16:47:18.679838,288,1.4545454545454546,1.2420382165605095,1070,12200,380.0
499990.0,3,1.75,1730,9334,1.0,3,8,1220,510.0,1977,2020,10000,16502 days 16:47:18.680835,227,1.7142857142857142,2.392156862745098,-290,-666,710.0
315000.0,3,1.75,1170,4000,1.0,3,6,720,450.0,1943,1130,4000,28921 days 16:47:18.680835,300,1.7142857142857142,1.6,40,0,270.0
425000.0,4,2.25,3680,26266,2.0,4,9,3680,0.0,1981,2340,19939,15041 days 16:47:18.680835,293,1.7777777777777777,0.0,1340,6327,3680.0
630000.0,3,2.5,2900,46609,2.0,3,9,2900,0.0,1987,2570,42188,12850 days 16:47:18.680835,048,1.2,0.0,330,4421,2900.0
365000.0,3,1.75,1290,7205,1.5,3,7,1290,0.0,1971,1340,7214,18694 days 16:47:18.680835,322,1.7142857142857142,0.0,-50,-9,1290.0
774000.0,4,2.75,2010,7000,2.0,5,8,2010,0.0,1901,1420,4400,44261 days 16:47:18.680835,310,1.4545454545454546,0.0,590,2600,2010.0
368888.0,3,1.5,1490,12186,1.0,4,7,1490,0.0,1950,1180,14285,26364 days 16:47:18.680835,096,2.0,0.0,310,-2099,1490.0
339500.0,4,2.5,1930,7862,2.0,3,7,1930,0.0,1994,1640,9145,10293 days 16:47:18.680835,275,1.6,0.0,290,-1283,1930.0
344950.0,4,1.75,2240,7500,1.0,4,7,1120,1120.0,1956,1440,7500,24173 days 16:47:18.680835,266,2.2857142857142856,1.0,800,0,0.0
450000.0,3,2.0,2320,17688,1.0,3,8,2320,0.0,1952,1610,14482,25634 days 16:47:18.680835,316,1.5,0.0,710,3206,2320.0
814950.0,4,2.75,2990,6626,2.0,3,9,2990,0.0,2014,2910,5533,2988 days 16:47:18.680835,322,1.4545454545454546,0.0,80,1093,2990.0
299900.0,4,2.5,2200,5730,2.0,3,8,2200,0.0,2003,2200,5772,7006 days 16:47:18.680835,248,1.6,0.0,0,-42,2200.0
315000.0,3,2.0,1500,7828,1.0,4,7,1500,0.0,1967,1500,7700,20155 days 16:47:18.680835,058,1.5,0.0,0,128,1500.0
880000.0,3,1.75,3860,9000,1.0,3,9,1930,1930.0,1970,2960,9000,19059 days 16:47:18.680835,350,1.7142857142857142,1.0,900,0,0.0
195000.0,3,1.5,1430,5200,1.0,4,7,1030,400.0,1977,1190,5200,16502 days 16:47:18.680835,363,2.0,2.575,240,0,630.0
910000.0,5,2.75,3750,8279,2.0,3,9,3750,0.0,2001,3450,8279,7736 days 16:47:18.680835,342,1.8181818181818181,0.0,300,0,3750.0
540000.0,5,2.5,3100,10189,2.0,3,8,3100,0.0,2002,2840,10189,7371 days 16:47:18.680835,239,2.0,0.0,260,0,3100.0
306000.0,3,2.5,1870,5874,2.0,3,7,1870,0.0,2005,2090,4060,6275 days 16:47:18.680835,136,1.2,0.0,-220,1814,1870.0
272000.0,4,2.25,2040,7600,1.0,4,8,1580,460.0,1978,2130,7200,16137 days 16:47:18.680835,289,1.7777777777777777,3.4347826086956523,-90,400,1120.0
1300000.0,5,3.5,3700,8504,2.0,3,8,2750,950.0,1950,2370,6246,26364 days 16:47:18.680835,343,1.4285714285714286,2.8947368421052633,1330,2258,1800.0
450000.0,3,1.75,3150,9258,1.0,3,8,2370,780.0,1970,2740,10274,19059 days 16:47:18.680835,290,1.7142857142857142,3.0384615384615383,410,-1016,1590.0
450000.0,3,2.5,1990,12793,2.0,3,8,1990,0.0,1993,2290,9035,10658 days 16:47:18.680835,188,1.2,0.0,-300,3758,1990.0
530000.0,2,2.25,2080,11285,1.0,4,8,1180,900.0,1954,2590,13048,24903 days 16:47:18.680835,132,0.8888888888888888,1.3111111111111111,-510,-1763,280.0
435000.0,4,2.5,2060,10125,2.0,4,7,1560,500.0,1979,1760,9876,15772 days 16:47:18.680835,012,1.6,3.12,300,249,1060.0
485000.0,3,2.0,1590,11222,1.0,4,7,1590,0.0,1948,2160,16300,27095 days 16:47:18.680835,125,1.5,0.0,-570,-5078,1590.0
690000.0,3,1.5,1760,4000,2.0,3,8,1760,0.0,1922,1760,4000,36591 days 16:47:18.680835,183,2.0,0.0,0,0,1760.0
305000.0,4,2.5,1620,4000,2.0,3,7,1620,0.0,2008,1580,3780,5180 days 16:47:18.680835,091,1.6,0.0,40,220,1620.0
300000.0,3,1.75,1210,7000,1.0,3,7,1210,0.0,1975,1670,7000,17233 days 16:47:18.680835,309,1.7142857142857142,0.0,-460,0,1210.0
289950.0,4,3.0,2040,5050,1.0,3,8,1490,550.0,1993,2020,6118,10658 days 16:47:18.680835,022,1.3333333333333333,2.709090909090909,20,-1068,940.0
575000.0,3,2.5,2270,9600,2.0,3,9,2270,0.0,1990,2580,9617,11754 days 16:47:18.680835,309,1.2,0.0,-310,-17,2270.0
1820000.0,4,4.5,6640,53330,2.0,3,1,6640,0.0,1993,4620,68625,10658 days 16:47:18.680835,178,0.8888888888888888,0.0,2020,-15295,6640.0
219000.0,3,1.5,1060,9600,1.0,4,7,1060,0.0,1962,1440,9600,21981 days 16:47:18.680835,196,2.0,0.0,-380,0,1060.0
265000.0,4,3.0,1940,8170,1.0,4,7,1940,0.0,1948,1310,8169,27095 days 16:47:18.680835,183,1.3333333333333333,0.0,630,1,1940.0
1110000.0,5,3.25,3070,5000,2.0,3,9,2050,1020.0,2006,2070,5000,5910 days 16:47:18.680835,195,1.5384615384615385,2.0098039215686274,1000,0,1030.0
200000.0,3,1.0,930,7590,1.0,3,6,820,110.0,1943,1220,7590,28921 days 16:47:18.680835,068,3.0,7.454545454545454,-290,0,710.0
545000.0,4,2.75,2180,8480,1.0,4,7,1210,970.0,1959,2240,8497,23077 days 16:47:18.680835,114,1.4545454545454546,1.2474226804123711,-60,-17,240.0
378000.0,3,2.5,2130,8404,2.0,3,8,2130,0.0,1991,2130,8404,11389 days 16:47:18.680835,078,1.2,0.0,0,0,2130.0
388000.0,2,1.75,800,4800,1.0,4,6,800,0.0,1922,1090,5000,36591 days 16:47:18.680835,085,1.1428571428571428,0.0,-290,-200,800.0
425000.0,4,2.25,2200,8384,1.0,3,7,1250,950.0,1959,1750,8384,23077 days 16:47:18.680835,330,1.7777777777777777,1.3157894736842106,450,0,300.0
536000.0,2,1.5,1130,746,2.0,3,8,1030,100.0,2009,1520,1519,4814 days 16:47:18.680835,188,1.3333333333333333,10.3,-390,-773,930.0
1180000.0,3,2.5,1970,23180,1.0,3,8,1100,870.0,1937,3030,34689,31112 days 16:47:18.680835,148,1.2,1.264367816091954,-1060,-11509,230.0
629950.0,3,2.5,1680,1620,2.0,3,9,1120,560.0,2014,1610,1618,2988 days 16:47:18.680835,083,1.2,2.0,70,2,560.0
465000.0,4,1.75,1470,5350,1.0,3,7,980,490.0,1955,1970,6138,24538 days 16:47:18.680835,162,2.2857142857142856,2.0,-500,-788,490.0
545000.0,4,2.25,2390,40510,1.0,4,8,2390,0.0,1969,3200,36989,19424 days 16:47:18.680835,239,1.7777777777777777,0.0,-810,3521,2390.0
592000.0,4,2.5,2300,11165,2.0,4,8,2300,0.0,1979,2170,11165,15772 days 16:47:18.680835,028,1.6,0.0,130,0,2300.0
446000.0,4,2.0,2280,43692,1.0,3,7,1140,1140.0,1957,2580,37938,23807 days 16:47:18.680835,230,2.0,1.0,-300,5754,0.0
375000.0,3,2.5,1330,816,3.0,3,8,1330,0.0,2004,1330,1113,6641 days 16:47:18.680835,197,1.2,0.0,0,-297,1330.0
632500.0,5,2.5,2640,7096,2.0,3,7,2640,0.0,2003,2640,4850,7006 days 16:47:18.680835,167,2.0,0.0,0,2246,2640.0
459950.0,4,1.75,2430,9747,1.0,3,8,1780,650.0,1974,2340,10296,17598 days 16:47:18.680835,220,2.2857142857142856,2.7384615384615385,90,-549,1130.0
485000.0,4,2.5,2470,35073,2.0,3,9,2470,0.0,1989,2990,35259,12119 days 16:47:18.680835,163,1.6,0.0,-520,-186,2470.0
255000.0,3,1.0,1440,11330,1.0,3,7,1440,0.0,1965,1580,10100,20885 days 16:47:18.680835,015,3.0,0.0,-140,1230,1440.0
251750.0,3,2.0,1320,7200,1.0,5,7,1320,0.0,1975,1540,7200,17233 days 16:47:18.680835,161,1.5,0.0,-220,0,1320.0
725000.0,3,2.5,2810,6300,2.0,3,8,2810,0.0,2001,2860,6630,7736 days 16:47:18.680835,121,1.2,0.0,-50,-330,2810.0
460000.0,3,3.25,1370,1194,3.0,3,8,1370,0.0,2005,1320,1217,6275 days 16:47:18.680835,289,0.9230769230769231,0.0,50,-23,1370.0
625000.0,3,2.5,2000,6341,1.0,5,8,1040,960.0,1981,2030,6341,15041 days 16:47:18.680835,240,1.2,1.0833333333333333,-30,0,80.0
530000.0,3,1.75,1980,6760,1.0,4,8,1980,0.0,1973,2120,7280,17963 days 16:47:18.680835,128,1.7142857142857142,0.0,-140,-520,1980.0
394950.0,3,2.5,2050,8172,2.0,3,8,2050,0.0,2002,2140,5664,7371 days 16:47:18.680835,117,1.2,0.0,-90,2508,2050.0
324950.0,4,1.75,2320,9240,1.0,3,7,1160,1160.0,1959,2130,7320,23077 days 16:47:18.680835,226,2.2857142857142856,1.0,190,1920,0.0
330000.0,3,2.25,1960,1985,2.0,3,7,1750,210.0,2003,1760,1985,7006 days 16:47:18.680835,126,1.3333333333333333,8.333333333333334,200,0,1540.0
220000.0,4,1.75,1910,8171,1.0,3,7,1910,0.0,1986,1910,7542,13215 days 16:47:18.680835,048,2.2857142857142856,0.0,0,629,1910.0
685000.0,3,3.25,2030,11070,2.0,4,8,2030,0.0,1980,2450,11070,15407 days 16:47:18.680835,188,0.9230769230769231,0.0,-420,0,2030.0
500000.0,3,2.25,2210,7680,1.0,3,8,1730,480.0,1972,2390,7680,18329 days 16:47:18.680835,055,1.3333333333333333,3.6041666666666665,-180,0,1250.0
368000.0,4,2.75,2610,9426,1.0,3,7,1360,1250.0,1965,1600,9426,20885 days 16:47:18.680835,247,1.4545454545454546,1.088,1010,0,110.0
825000.0,3,2.25,2520,7975,2.0,4,9,1550,970.0,1990,2520,9900,11754 days 16:47:18.680835,307,1.3333333333333333,1.597938144329897,0,-1925,580.0
660000.0,6,1.75,1840,2774,1.0,3,7,1060,780.0,1900,1680,4292,44626 days 16:47:18.680835,167,3.4285714285714284,1.358974358974359,160,-1518,280.0
253000.0,3,1.75,1570,7416,1.0,4,7,1570,0.0,1971,1900,7416,18694 days 16:47:18.680835,272,1.7142857142857142,0.0,-330,0,1570.0
392500.0,4,2.75,2400,19923,1.0,5,7,1320,1080.0,1953,2470,10736,25268 days 16:47:18.680835,066,1.4545454545454546,1.2222222222222223,-70,9187,240.0
605000.0,3,1.75,1930,5400,2.0,3,9,1930,0.0,1978,2100,6840,16137 days 16:47:18.680835,045,1.7142857142857142,0.0,-170,-1440,1930.0
215000.0,3,1.0,1160,10384,1.0,4,6,1160,0.0,1969,1200,9880,19424 days 16:47:18.680835,135,3.0,0.0,-40,504,1160.0
650000.0,4,2.5,2820,15000,2.0,4,9,2820,0.0,1985,2440,15000,13580 days 16:47:18.680835,268,1.6,0.0,380,0,2820.0
877500.0,4,2.0,3060,8000,2.0,4,8,2040,1020.0,1922,2730,5800,36591 days 16:47:18.680835,050,2.0,2.0,330,2200,1020.0
232500.0,3,1.0,1320,8450,1.0,3,6,880,440.0,1961,1320,8450,22346 days 16:47:18.680835,170,3.0,2.0,0,0,440.0
234000.0,2,2.0,1200,3624,2.0,3,6,1200,0.0,2003,1360,2693,7006 days 16:47:18.680835,336,1.0,0.0,-160,931,1200.0
380000.0,3,1.75,1560,104108,1.0,3,7,1250,310.0,1970,2000,110957,19059 days 16:47:18.680835,103,1.7142857142857142,4.032258064516129,-440,-6849,940.0
420000.0,5,2.25,3070,64033,1.0,3,9,2730,340.0,1983,1560,28260,14311 days 16:47:18.680835,259,2.2222222222222223,8.029411764705882,1510,35773,2390.0
399950.0,3,1.0,1040,9600,1.0,3,7,1040,0.0,1978,1370,10889,16137 days 16:47:18.680835,363,3.0,0.0,-330,-1289,1040.0
256750.0,3,2.5,1990,8991,1.0,3,7,1570,420.0,1969,1920,8991,19424 days 16:47:18.680835,141,1.2,3.738095238095238,70,0,1150.0
535000.0,3,2.5,1690,9626,2.0,3,8,1690,0.0,1984,1860,8958,13946 days 16:47:18.680835,153,1.2,0.0,-170,668,1690.0
515000.0,3,2.0,1810,2738,2.0,4,9,1810,0.0,1979,1760,2754,15772 days 16:47:18.680835,311,1.5,0.0,50,-16,1810.0
770000.0,4,1.75,2520,8442,1.0,4,7,1640,880.0,1953,2110,8442,25268 days 16:47:18.680835,043,2.2857142857142856,1.8636363636363635,410,0,760.0
256000.0,3,2.5,1570,5113,1.0,3,7,1090,480.0,1996,1570,5150,9563 days 16:47:18.680835,002,1.2,2.2708333333333335,0,-37,610.0
489900.0,3,1.0,1680,8910,1.0,4,7,1680,0.0,1940,1620,7182,30017 days 16:47:18.680835,233,3.0,0.0,60,1728,1680.0
165000.0,3,1.5,1250,7200,1.0,4,7,1250,0.0,1978,1250,7560,16137 days 16:47:18.680835,232,2.0,0.0,0,-360,1250.0
220000.0,3,1.5,1280,7742,1.0,4,7,1280,0.0,1962,1450,8316,21981 days 16:47:18.680835,077,2.0,0.0,-170,-574,1280.0
575000.0,4,2.5,4620,20793,2.0,4,1,4620,0.0,1991,3640,20793,11389 days 16:47:18.680835,175,1.6,0.0,980,0,4620.0
375000.0,3,2.5,1580,5725,2.0,3,7,1580,0.0,2004,1510,5725,6641 days 16:47:18.680835,303,1.2,0.0,70,0,1580.0
422250.0,3,1.75,1650,7145,2.0,5,8,1300,350.0,1977,1760,7206,16502 days 16:47:18.680835,022,1.7142857142857142,3.7142857142857144,-110,-61,950.0
608000.0,4,2.5,2410,7140,2.0,3,8,2410,0.0,1993,2350,7140,10658 days 16:47:18.680835,266,1.6,0.0,60,0,2410.0
620000.0,3,2.25,1720,4000,1.5,4,7,1450,270.0,1921,1410,4000,36956 days 16:47:18.680835,136,1.3333333333333333,5.37037037037037,310,0,1180.0
850000.0,3,2.5,3120,12406,2.0,3,9,1940,1180.0,1983,3240,13141,14311 days 16:47:18.680835,048,1.2,1.6440677966101696,-120,-735,760.0
463000.0,4,2.5,2680,9928,1.0,4,8,1340,1340.0,1974,2180,10478,17598 days 16:47:18.680835,016,1.6,1.0,500,-550,0.0
750000.0,5,1.75,2640,13290,1.0,4,8,1400,1240.0,1954,2400,11942,24903 days 16:47:18.680835,027,2.857142857142857,1.1290322580645162,240,1348,160.0
1070000.0,3,3.25,3730,13264,2.0,3,9,3730,0.0,1989,3730,14933,12119 days 16:47:18.680835,084,0.9230769230769231,0.0,0,-1669,3730.0
290000.0,3,2.0,1700,6498,1.0,3,7,1700,0.0,1986,1700,6654,13215 days 16:47:18.680835,252,1.5,0.0,0,-156,1700.0
525000.0,4,1.75,2280,5959,1.0,3,7,1250,1030.0,1947,1640,5911,27460 days 16:47:18.680835,191,2.2857142857142856,1.2135922330097086,640,48,220.0
319000.0,3,2.25,1220,2980,2.0,3,7,1220,0.0,1986,1220,2140,13215 days 16:47:18.680835,048,1.3333333333333333,0.0,0,840,1220.0
592500.0,6,4.5,3500,8504,2.0,3,7,3500,0.0,1980,1550,8460,15407 days 16:47:18.680835,033,1.3333333333333333,0.0,1950,44,3500.0
350000.0,3,2.5,2010,14298,2.0,3,7,2010,0.0,1977,2010,14298,16502 days 16:47:18.680835,133,1.2,0.0,0,0,2010.0
454900.0,3,1.75,2130,9775,1.0,4,8,1430,700.0,1973,2130,11250,17963 days 16:47:18.680835,057,1.7142857142857142,2.0428571428571427,0,-1475,730.0
272000.0,4,2.25,1800,9018,2.0,3,7,1800,0.0,1992,1670,9380,11024 days 16:47:18.680835,105,1.7777777777777777,0.0,130,-362,1800.0
357500.0,3,1.0,1070,10125,1.0,3,7,1070,0.0,1961,1540,10200,22346 days 16:47:18.680835,197,3.0,0.0,-470,-75,1070.0
285000.0,3,1.75,1020,5000,1.0,5,6,1020,0.0,1954,1360,5000,24903 days 16:47:18.680835,240,1.7142857142857142,0.0,-340,0,1020.0
280000.0,4,2.0,1600,6861,1.0,3,7,1600,0.0,1994,1870,7455,10293 days 16:47:18.680835,085,2.0,0.0,-270,-594,1600.0
477000.0,4,1.5,1380,7800,1.0,3,7,1080,300.0,1928,1770,7503,34400 days 16:47:18.680835,246,2.6666666666666665,3.6,-390,297,780.0
750000.0,3,2.25,3270,168000,2.0,4,1,3270,0.0,1982,3220,7963,14676 days 16:47:18.680835,203,1.3333333333333333,0.0,50,160037,3270.0
595000.0,4,2.5,2100,3125,2.0,3,7,1400,700.0,1907,2060,5040,42070 days 16:47:18.680835,323,1.6,2.0,40,-1915,700.0
525000.0,3,2.25,2110,2850,3.0,3,8,2110,0.0,2001,1340,5001,7736 days 16:47:18.680835,198,1.3333333333333333,0.0,770,-2151,2110.0
319000.0,3,1.75,1640,53400,1.0,4,7,1640,0.0,1966,1850,380279,20520 days 16:47:18.680835,192,1.7142857142857142,0.0,-210,-326879,1640.0
225000.0,3,2.0,1320,5665,1.0,3,7,1320,0.0,1986,1336,7080,13215 days 16:47:18.680835,239,1.5,0.0,-16,-1415,1320.0
485000.0,4,2.5,2420,10603,1.0,5,7,1210,1210.0,1958,1750,10800,23442 days 16:47:18.680835,204,1.6,1.0,670,-197,0.0
341000.0,3,1.0,1390,4814,1.5,3,6,1390,0.0,1908,1730,3990,41705 days 16:47:18.680835,184,3.0,0.0,-340,824,1390.0
674000.0,3,3.25,2320,6744,2.0,3,9,1930,390.0,2014,1700,6744,2988 days 16:47:18.680835,016,0.9230769230769231,4.948717948717949,620,0,1540.0
442250.0,3,2.5,2170,8169,2.0,3,8,2170,0.0,2003,2240,6733,7006 days 16:47:18.680835,027,1.2,0.0,-70,1436,2170.0
591000.0,4,2.25,2710,38180,2.0,4,8,2710,0.0,1977,2590,38180,16502 days 16:47:18.680835,133,1.7777777777777777,0.0,120,0,2710.0
276000.0,3,2.0,1450,8928,1.0,3,7,1450,0.0,1998,2050,8523,8832 days 16:47:18.680835,317,1.5,0.0,-600,405,1450.0
394000.0,3,2.5,1370,4400,1.0,3,8,1370,0.0,1988,1630,4400,12485 days 16:47:18.680835,234,1.2,0.0,-260,0,1370.0
355000.0,3,2.5,1810,3192,1.0,3,7,1070,740.0,2001,1740,3720,7736 days 16:47:18.680835,323,1.2,1.445945945945946,70,-528,330.0
260000.0,3,2.5,1420,14850,1.0,4,7,1020,400.0,1963,2060,8800,21616 days 16:47:18.680835,129,1.2,2.55,-640,6050,620.0
300000.0,3,2.75,2090,9620,1.0,3,8,1340,750.0,1987,2150,9660,12850 days 16:47:18.680835,182,1.0909090909090908,1.7866666666666666,-60,-40,590.0
310000.0,3,2.75,2090,9620,1.0,3,8,1340,750.0,1987,2150,9660,12850 days 16:47:18.680835,083,1.0909090909090908,1.7866666666666666,-60,-40,590.0
209000.0,3,1.0,1330,6900,1.0,3,7,1330,0.0,1976,1530,7000,16868 days 16:47:18.680835,336,3.0,0.0,-200,-100,1330.0
344950.0,3,2.0,1330,7419,1.0,3,7,1330,0.0,1985,1330,7297,13580 days 16:47:18.680835,345,1.5,0.0,0,122,1330.0
230000.0,5,2.0,1910,7200,1.0,4,6,1110,800.0,1951,1150,5948,25999 days 16:47:18.680835,162,2.5,1.3875,760,1252,310.0
336950.0,3,1.75,2310,7680,1.0,4,8,1410,900.0,1978,2080,7680,16137 days 16:47:18.680835,114,1.7142857142857142,1.5666666666666667,230,0,510.0
700000.0,3,2.75,2500,7378,1.0,5,7,1390,1110.0,1948,2040,7140,27095 days 16:47:18.680835,162,1.0909090909090908,1.2522522522522523,460,238,280.0
230000.0,3,2.0,1310,7332,1.0,3,7,1310,0.0,1987,1530,7362,12850 days 16:47:18.680835,247,1.5,0.0,-220,-30,1310.0
443500.0,4,2.5,2040,21781,2.0,3,8,2040,0.0,1994,2410,21781,10293 days 16:47:18.680835,171,1.6,0.0,-370,0,2040.0
471000.0,4,2.5,2040,21781,2.0,3,8,2040,0.0,1994,2410,21781,10293 days 16:47:18.680835,104,1.6,0.0,-370,0,2040.0
595000.0,3,2.25,2400,16301,1.0,3,8,1400,1000.0,1962,1720,9828,21981 days 16:47:18.680835,344,1.3333333333333333,1.4,680,6473,400.0
470000.0,3,1.0,1400,4914,1.5,3,7,1400,0.0,1929,1400,3744,34034 days 16:47:18.680835,325,3.0,0.0,0,1170,1400.0
600000.0,4,1.75,1700,7800,1.0,4,8,1700,0.0,1975,2430,8342,17233 days 16:47:18.680835,346,2.2857142857142856,0.0,-730,-542,1700.0
1380000.0,4,3.75,3160,9525,2.5,3,1,3160,0.0,1997,2400,9525,9197 days 16:47:18.680835,147,1.0666666666666667,0.0,760,0,3160.0
427800.0,3,1.75,1340,13241,1.0,3,7,1340,0.0,1985,2090,9704,13580 days 16:47:18.680835,318,1.7142857142857142,0.0,-750,3537,1340.0
445000.0,4,2.0,1470,8395,1.0,4,7,1470,0.0,1965,1760,7976,20885 days 16:47:18.680835,157,2.0,0.0,-290,419,1470.0
382000.0,3,1.75,1790,7679,1.0,4,7,1790,0.0,1953,1560,7680,25268 days 16:47:18.680835,197,1.7142857142857142,0.0,230,-1,1790.0
577000.0,3,1.5,1560,20251,1.0,5,7,1200,360.0,1989,1560,19119,12119 days 16:47:18.680835,315,2.0,3.3333333333333335,0,1132,840.0
427000.0,3,2.5,2620,108464,2.0,4,8,2620,0.0,1990,3190,105850,11754 days 16:47:18.680835,126,1.2,0.0,-570,2614,2620.0
240000.0,3,1.0,1090,10000,1.0,3,6,1090,0.0,1961,1040,7500,22346 days 16:47:18.680835,202,3.0,0.0,50,2500,1090.0
1230000.0,5,3.25,3240,6551,1.5,4,9,2500,740.0,1939,2740,9300,30382 days 16:47:18.680835,171,1.5384615384615385,3.3783783783783785,500,-2749,1760.0
435000.0,4,1.75,2520,7200,1.0,5,7,1260,1260.0,1955,2360,7300,24538 days 16:47:18.680835,044,2.2857142857142856,1.0,160,-100,0.0
1450000.0,3,1.75,2230,13529,1.0,3,9,2230,0.0,1949,2230,11900,26729 days 16:47:18.680835,086,1.7142857142857142,0.0,0,1629,2230.0
425000.0,4,3.0,2430,5502,2.0,3,8,2430,0.0,2002,2000,5702,7371 days 16:47:18.680835,126,1.3333333333333333,0.0,430,-200,2430.0
393000.0,2,1.0,1020,4200,1.0,5,6,1020,0.0,1923,1660,4200,36226 days 16:47:18.680835,350,2.0,0.0,-640,0,1020.0
264950.0,4,1.0,1810,7500,1.0,2,7,1410,400.0,1959,1250,6255,23077 days 16:47:18.680835,171,4.0,3.525,560,1245,1010.0
746500.0,4,2.5,3460,9699,2.0,3,1,3460,0.0,1987,3140,10631,12850 days 16:47:18.680835,102,1.6,0.0,320,-932,3460.0
450000.0,3,1.0,2020,8100,1.0,3,7,1170,850.0,1956,1480,7620,24173 days 16:47:18.680835,328,3.0,1.3764705882352941,540,480,320.0
229950.0,3,2.0,1410,7466,1.0,3,7,1410,0.0,1983,1410,7610,14311 days 16:47:18.680835,168,1.5,0.0,0,-144,1410.0
425000.0,2,1.0,750,4000,1.0,2,6,750,0.0,1933,1160,4000,32573 days 16:47:18.680835,013,2.0,0.0,-410,0,750.0
2560000.0,4,2.5,5300,26211,2.0,2,1,4570,730.0,1923,3890,19281,36226 days 16:47:18.680835,133,1.6,6.260273972602739,1410,6930,3840.0
1400000.0,4,3.5,4380,66613,1.5,3,1,4380,0.0,1993,4010,70109,10658 days 16:47:18.680835,117,1.1428571428571428,0.0,370,-3496,4380.0
753000.0,3,2.25,2290,9047,2.0,4,8,2290,0.0,1984,2120,9275,13946 days 16:47:18.680835,304,1.3333333333333333,0.0,170,-228,2290.0
310000.0,2,1.0,720,5750,1.0,2,6,720,0.0,1943,980,6125,28921 days 16:47:18.680835,279,2.0,0.0,-260,-375,720.0
395000.0,2,1.0,1200,6014,1.0,4,6,600,600.0,1949,1270,4652,26729 days 16:47:18.680835,353,2.0,1.0,-70,1362,0.0
725000.0,3,2.5,2620,28703,1.0,3,1,2620,0.0,1985,2950,30290,13580 days 16:47:18.680835,345,1.2,0.0,-330,-1587,2620.0
295000.0,4,3.0,2120,7650,2.0,3,8,2120,0.0,1964,2260,7885,21251 days 16:47:18.680835,240,1.3333333333333333,0.0,-140,-235,2120.0
225000.0,3,1.75,1580,8820,1.0,4,7,1580,0.0,1967,1280,8500,20155 days 16:47:18.680835,174,1.7142857142857142,0.0,300,320,1580.0
1700000.0,3,3.25,4160,35153,3.0,3,1,3690,470.0,2001,3290,11533,7736 days 16:47:18.680835,226,0.9230769230769231,7.851063829787234,870,23620,3220.0
431000.0,3,2.25,1830,8831,1.0,3,7,1460,370.0,1979,2330,8064,15772 days 16:47:18.680835,033,1.3333333333333333,3.945945945945946,-500,767,1090.0
358500.0,3,2.5,2000,8057,1.0,3,8,1360,640.0,1998,2530,8964,8832 days 16:47:18.680835,085,1.2,2.125,-530,-907,720.0
595000.0,2,1.0,980,3600,1.0,3,6,980,0.0,1907,1690,3600,42070 days 16:47:18.680835,118,2.0,0.0,-710,0,980.0
468000.0,4,2.5,3040,20682,2.0,3,7,3040,0.0,2000,2670,9742,8102 days 16:47:18.680835,078,1.6,0.0,370,10940,3040.0
260000.0,4,1.0,1740,8100,1.0,4,7,1020,720.0,1962,1600,8949,21981 days 16:47:18.680835,337,4.0,1.4166666666666667,140,-849,300.0
375000.0,3,2.0,1450,7300,1.5,5,7,1450,0.0,1955,1660,9069,24538 days 16:47:18.680835,260,1.5,0.0,-210,-1769,1450.0
295000.0,3,2.5,1560,4200,2.0,3,7,1560,0.0,2003,1560,4200,7006 days 16:47:18.680835,145,1.2,0.0,0,0,1560.0
403900.0,4,2.5,2050,8909,1.0,4,8,1690,360.0,1986,2190,8912,13215 days 16:47:18.680835,212,1.6,4.694444444444445,-140,-3,1330.0
269950.0,3,1.75,1760,12823,1.0,4,7,1460,300.0,1956,1450,10800,24173 days 16:47:18.680835,203,1.7142857142857142,4.866666666666666,310,2023,1160.0
640000.0,3,3.5,1740,1975,2.0,3,8,1310,430.0,1998,1740,1975,8832 days 16:47:18.680835,049,0.8571428571428571,3.046511627906977,0,0,880.0
221000.0,3,1.0,910,8789,1.0,3,7,910,0.0,1966,1160,8789,20520 days 16:47:18.680835,178,3.0,0.0,-250,0,910.0
255000.0,3,1.75,1700,7532,1.0,3,7,1700,0.0,1987,1690,7405,12850 days 16:47:18.680835,168,1.7142857142857142,0.0,10,127,1700.0
300000.0,4,2.5,2620,4469,2.0,3,7,2620,0.0,2008,2250,4500,5180 days 16:47:18.680835,174,1.6,0.0,370,-31,2620.0
270000.0,3,2.25,1500,7410,1.0,4,7,1500,0.0,1973,1750,7990,17963 days 16:47:18.680835,079,1.3333333333333333,0.0,-250,-580,1500.0
575000.0,4,1.75,1630,5750,1.0,3,7,1160,470.0,1947,1640,5750,27460 days 16:47:18.680835,062,2.2857142857142856,2.4680851063829787,-10,0,690.0
246900.0,3,1.5,1370,9800,1.0,5,7,1370,0.0,1968,1370,9800,19790 days 16:47:18.680835,042,2.0,0.0,0,0,1370.0
635000.0,2,2.5,1390,1132,2.0,3,8,1130,260.0,2006,1400,1237,5910 days 16:47:18.680835,096,0.8,4.346153846153846,-10,-105,870.0
450000.0,3,2.0,1540,67756,1.0,3,7,1540,0.0,1900,2060,67756,44626 days 16:47:18.680835,076,1.5,0.0,-520,0,1540.0
215000.0,3,1.0,1190,7500,1.0,5,7,1190,0.0,1968,1200,9750,19790 days 16:47:18.680835,253,3.0,0.0,-10,-2250,1190.0
785000.0,3,3.5,4500,21870,2.0,3,1,4500,0.0,2004,4670,23058,6641 days 16:47:18.680835,162,0.8571428571428571,0.0,-170,-1188,4500.0
522500.0,4,3.0,2370,8154,1.0,3,7,1380,990.0,1977,2100,8148,16502 days 16:47:18.680835,051,1.3333333333333333,1.393939393939394,270,6,390.0
150000.0,2,1.5,1360,1934,2.0,4,7,1360,0.0,1978,1360,1898,16137 days 16:47:18.680835,203,1.3333333333333333,0.0,0,36,1360.0
199950.0,2,1.75,870,18537,1.0,4,6,870,0.0,1946,1300,22800,27825 days 16:47:18.680835,349,1.1428571428571428,0.0,-430,-4263,870.0
3000000.0,4,4.25,4850,12445,2.0,5,1,3850,1000.0,1989,3350,12210,12119 days 16:47:18.680835,169,0.9411764705882353,3.85,1500,235,2850.0
379900.0,3,2.0,3110,44967,2.0,3,9,3020,90.0,1999,2150,44967,8467 days 16:47:18.680835,191,1.5,33.55555555555556,960,0,2930.0
950000.0,4,2.5,3700,7051,2.0,3,1,3700,0.0,2006,3580,6175,5910 days 16:47:18.680835,325,1.6,0.0,120,876,3700.0
865000.0,6,2.75,3500,5150,2.0,5,8,2430,1070.0,1909,1430,3860,41339 days 16:47:18.680835,337,2.1818181818181817,2.2710280373831777,2070,1290,1360.0
785000.0,3,1.75,1670,9600,1.0,5,8,1670,0.0,1961,1900,9600,22346 days 16:47:18.680835,155,1.7142857142857142,0.0,-230,0,1670.0
245700.0,3,2.25,1640,8400,1.0,3,8,1180,460.0,1968,1600,8120,19790 days 16:47:18.680835,176,1.3333333333333333,2.5652173913043477,40,280,720.0
951000.0,3,2.25,3400,12825,1.0,3,9,3400,0.0,1961,2510,11574,22346 days 16:47:18.680835,105,1.3333333333333333,0.0,890,1251,3400.0
499950.0,3,1.75,2060,3500,1.0,5,7,1030,1030.0,1951,1110,6000,25999 days 16:47:18.680835,092,1.7142857142857142,1.0,950,-2500,0.0
257000.0,3,1.75,1330,36537,1.0,4,7,1330,0.0,1989,1650,35100,12119 days 16:47:18.680835,042,1.7142857142857142,0.0,-320,1437,1330.0
549000.0,3,2.0,2330,3600,1.5,4,7,1580,750.0,1900,1750,3600,44626 days 16:47:18.680835,260,1.5,2.1066666666666665,580,0,830.0
1600000.0,3,2.75,3040,21052,2.0,4,1,3040,0.0,1980,2950,21052,15407 days 16:47:18.680835,040,1.0909090909090908,0.0,90,0,3040.0
1400000.0,5,3.75,3700,7920,3.0,3,9,2900,800.0,1983,2860,6360,14311 days 16:47:18.680835,345,1.3333333333333333,3.625,840,1560,2100.0
619000.0,3,2.0,1990,3000,1.5,5,8,1430,560.0,1927,1780,5000,34765 days 16:47:18.680835,232,1.5,2.5535714285714284,210,-2000,870.0
311000.0,5,3.0,2020,5917,1.0,3,7,1220,800.0,1993,2130,5529,10658 days 16:47:18.680835,282,1.6666666666666667,1.525,-110,388,420.0
600000.0,5,2.25,2980,7781,1.0,3,9,1580,1400.0,1960,2310,7781,22712 days 16:47:18.680835,182,2.2222222222222223,1.1285714285714286,670,0,180.0
1080000.0,4,3.5,3990,5267,2.0,3,1,3990,0.0,2008,3230,6481,5180 days 16:47:18.680835,177,1.1428571428571428,0.0,760,-1214,3990.0
436000.0,2,1.0,790,6600,1.0,3,6,790,0.0,1949,1520,4400,26729 days 16:47:18.680835,170,2.0,0.0,-730,2200,790.0
205000.0,2,1.0,1060,8000,1.0,3,6,1060,0.0,1941,1390,8000,29651 days 16:47:18.680835,196,2.0,0.0,-330,0,1060.0
514000.0,3,2.25,2260,54014,1.0,3,7,1450,810.0,1962,2140,44431,21981 days 16:47:18.680835,246,1.3333333333333333,1.7901234567901234,120,9583,640.0
530000.0,2,2.5,1900,2983,2.0,3,8,1900,0.0,2006,1510,3876,5910 days 16:47:18.680835,246,0.8,0.0,390,-893,1900.0
511000.0,5,2.5,3361,6983,2.0,3,1,3361,0.0,2006,3112,6920,5910 days 16:47:18.680835,223,2.0,0.0,249,63,3361.0
2100000.0,4,1.75,3550,19865,2.0,3,9,3550,0.0,1962,3000,19862,21981 days 16:47:18.680835,135,2.2857142857142856,0.0,550,3,3550.0
370000.0,5,2.5,2740,5460,2.0,3,8,2740,0.0,2005,2900,5971,6275 days 16:47:18.680835,069,2.0,0.0,-160,-511,2740.0
500000.0,4,1.75,2040,6000,1.0,5,7,1020,1020.0,1943,1440,6000,28921 days 16:47:18.680835,350,2.2857142857142856,1.0,600,0,0.0
710000.0,4,2.5,4070,129808,2.0,3,1,4070,0.0,1998,4070,102366,8832 days 16:47:18.680835,309,1.6,0.0,0,27442,4070.0
270000.0,1,1.0,720,5196,1.0,3,7,720,0.0,1911,1580,5762,40609 days 16:47:18.680835,251,1.0,0.0,-860,-566,720.0
415000.0,3,1.75,2000,8400,1.5,4,8,2000,0.0,1959,2000,8400,23077 days 16:47:18.680835,217,1.7142857142857142,0.0,0,0,2000.0
1800000.0,5,4.5,4400,15580,2.0,3,1,3390,1010.0,2003,2150,14249,7006 days 16:47:18.680835,156,1.1111111111111112,3.3564356435643563,2250,1331,2380.0
236000.0,3,1.75,1300,8976,1.0,3,7,1300,0.0,1967,1430,9750,20155 days 16:47:18.680835,351,1.7142857142857142,0.0,-130,-774,1300.0
278000.0,2,2.5,1420,2229,2.0,3,7,1420,0.0,2004,1500,2230,6641 days 16:47:18.680835,342,0.8,0.0,-80,-1,1420.0
312000.0,3,2.25,1540,5338,1.0,5,7,770,770.0,1954,1680,6525,24903 days 16:47:18.680835,154,1.3333333333333333,1.0,-140,-1187,0.0
539000.0,3,2.25,1540,5338,1.0,5,7,770,770.0,1954,1680,6525,24903 days 16:47:18.680835,063,1.3333333333333333,1.0,-140,-1187,0.0
498000.0,3,3.0,2360,2750,2.0,3,7,1780,580.0,1983,1970,5800,14311 days 16:47:18.680835,253,1.0,3.0689655172413794,390,-3050,1200.0
857000.0,4,3.0,3720,29043,2.0,3,9,3720,0.0,1991,1610,23000,11389 days 16:47:18.680835,147,1.3333333333333333,0.0,2110,6043,3720.0
780000.0,3,1.75,1690,13500,1.0,4,7,1690,0.0,1978,1950,10500,16137 days 16:47:18.680835,056,1.7142857142857142,0.0,-260,3000,1690.0
650000.0,3,2.0,2300,5000,1.0,4,8,1150,1150.0,1938,2300,5000,30747 days 16:47:18.680835,266,1.5,1.0,0,0,0.0
559500.0,4,1.75,1650,7088,1.0,3,8,1650,0.0,1973,1850,7523,17963 days 16:47:18.680835,099,2.2857142857142856,0.0,-200,-435,1650.0
219950.0,2,1.0,990,6448,1.0,3,7,990,0.0,1948,1130,7200,27095 days 16:47:18.680835,205,2.0,0.0,-140,-752,990.0
813000.0,4,2.5,3320,52707,2.0,3,1,3320,0.0,1999,3040,54450,8467 days 16:47:18.680835,246,1.6,0.0,280,-1743,3320.0
182000.0,3,2.25,1960,8875,1.0,3,7,1290,670.0,1965,1890,8700,20885 days 16:47:18.680835,209,1.3333333333333333,1.9253731343283582,70,175,620.0
203700.0,2,1.0,770,2500,1.0,3,6,770,0.0,1913,1500,8286,39878 days 16:47:18.680835,234,2.0,0.0,-730,-5786,770.0
740000.0,4,1.75,2010,3600,1.5,3,7,2010,0.0,1902,2010,3600,43896 days 16:47:18.680835,125,2.2857142857142856,0.0,0,0,2010.0
128000.0,3,1.0,910,11117,1.0,3,7,910,0.0,1955,1490,8416,24538 days 16:47:18.680835,282,3.0,0.0,-580,2701,910.0
345000.0,3,1.0,1200,6628,1.0,4,7,1200,0.0,1952,1330,6768,25634 days 16:47:18.680835,234,3.0,0.0,-130,-140,1200.0
663000.0,4,2.5,3570,6246,2.0,3,7,3570,0.0,2005,2260,5231,6275 days 16:47:18.680835,117,1.6,0.0,1310,1015,3570.0
329950.0,3,2.5,1820,8085,2.0,3,7,1820,0.0,1983,1860,8625,14311 days 16:47:18.680835,171,1.2,0.0,-40,-540,1820.0
1050000.0,3,2.25,2930,7005,3.0,3,9,2670,260.0,1999,2450,6460,8467 days 16:47:18.680835,223,1.3333333333333333,10.26923076923077,480,545,2410.0
402300.0,3,1.75,1480,4050,1.0,3,7,870,610.0,1926,1350,4500,35130 days 16:47:18.680835,316,1.7142857142857142,1.4262295081967213,130,-450,260.0
492000.0,4,2.5,3305,16164,1.5,5,7,2245,1060.0,1922,1620,8883,36591 days 16:47:18.680835,127,1.6,2.1179245283018866,1685,7281,1185.0
448000.0,4,2.5,2230,5000,1.0,3,7,1650,580.0,2006,2090,4637,5910 days 16:47:18.680835,127,1.6,2.8448275862068964,140,363,1070.0
273000.0,3,1.0,1560,7800,1.0,3,7,1560,0.0,1955,1468,9375,24538 days 16:47:18.680835,056,3.0,0.0,92,-1575,1560.0
335000.0,3,1.0,1030,7200,1.0,3,6,880,150.0,1948,1030,7200,27095 days 16:47:18.680835,276,3.0,5.866666666666666,0,0,730.0
695000.0,3,3.75,2380,3600,1.5,3,7,1690,690.0,1927,1990,3520,34765 days 16:47:18.680835,248,0.8,2.449275362318841,390,80,1000.0
279000.0,3,1.0,1010,7903,1.0,3,6,1010,0.0,1948,1010,7903,27095 days 16:47:18.680835,123,3.0,0.0,0,0,1010.0
485000.0,2,1.75,2060,2700,1.0,3,7,1030,1030.0,1929,1390,2700,34034 days 16:47:18.680835,339,1.1428571428571428,1.0,670,0,0.0
383000.0,4,2.5,2370,10580,2.0,3,8,2370,0.0,1966,1590,8584,20520 days 16:47:18.680835,224,1.6,0.0,780,1996,2370.0
490000.0,4,2.5,2242,37451,2.0,3,8,2242,0.0,1995,2242,13125,9928 days 16:47:18.680835,350,1.6,0.0,0,24326,2242.0
240000.0,2,1.5,1078,1263,2.0,3,7,1078,0.0,1990,1078,1263,11754 days 16:47:18.680835,323,1.3333333333333333,0.0,0,0,1078.0
285000.0,2,1.0,890,7250,1.0,3,7,890,0.0,1943,900,7000,28921 days 16:47:18.680835,055,2.0,0.0,-10,250,890.0
524950.0,3,1.5,2700,24539,2.0,3,7,2120,580.0,1977,1830,11000,16502 days 16:47:18.680835,056,2.0,3.6551724137931036,870,13539,1540.0
729000.0,4,2.5,2450,27081,2.0,3,8,2450,0.0,1985,2630,12025,13580 days 16:47:18.680835,097,1.6,0.0,-180,15056,2450.0
460000.0,3,1.75,1420,8250,1.0,4,7,1420,0.0,1960,2020,8250,22712 days 16:47:18.680835,248,1.7142857142857142,0.0,-600,0,1420.0
687500.0,3,1.5,1280,2114,1.5,3,8,1280,0.0,1904,1540,1456,43166 days 16:47:18.680835,287,2.0,0.0,-260,658,1280.0
1170000.0,5,2.75,2910,15118,1.0,5,9,1780,1130.0,1972,2880,15253,18329 days 16:47:18.680835,226,1.8181818181818181,1.575221238938053,30,-135,650.0
825000.0,4,2.25,2430,10050,2.0,4,8,2430,0.0,1979,2390,10250,15772 days 16:47:18.680835,288,1.7777777777777777,0.0,40,-200,2430.0
314950.0,2,2.5,1860,6359,2.0,3,7,1860,0.0,2003,1860,6359,7006 days 16:47:18.680835,210,0.8,0.0,0,0,1860.0
470000.0,3,2.0,1800,12669,1.0,3,7,1800,0.0,1956,1970,9775,24173 days 16:47:18.680835,155,1.5,0.0,-170,2894,1800.0
500000.0,3,1.5,1960,8815,1.0,4,7,1020,940.0,1958,1760,9534,23442 days 16:47:18.680835,230,2.0,1.0851063829787233,200,-719,80.0
313000.0,3,1.5,1550,7260,1.5,2,6,1550,0.0,1925,1190,7620,35495 days 16:47:18.680835,321,2.0,0.0,360,-360,1550.0
445000.0,2,1.0,840,3840,1.0,4,7,840,0.0,1926,1310,3840,35130 days 16:47:18.680835,191,2.0,0.0,-470,0,840.0
300000.0,4,1.75,2080,8750,1.0,4,8,1330,750.0,1967,1790,8750,20155 days 16:47:18.680835,240,2.2857142857142856,1.7733333333333334,290,0,580.0
619500.0,4,2.5,2210,5077,1.5,4,8,1480,730.0,1912,1740,5000,40244 days 16:47:18.680835,287,1.6,2.0273972602739727,470,77,750.0
874000.0,3,2.5,1350,941,3.0,3,9,1350,0.0,2007,1640,1369,5545 days 16:47:18.680835,091,1.2,0.0,-290,-428,1350.0
477500.0,3,2.0,1860,5146,2.0,3,8,1860,0.0,1991,1950,5146,11389 days 16:47:18.680835,072,1.5,0.0,-90,0,1860.0
700000.0,3,2.0,1940,4500,1.0,3,7,1090,850.0,1926,1700,4500,35130 days 16:47:18.680835,314,1.5,1.2823529411764707,240,0,240.0
515000.0,4,3.5,3400,5222,2.0,3,9,3400,0.0,2005,3190,5326,6275 days 16:47:18.680835,065,1.1428571428571428,0.0,210,-104,3400.0
590000.0,4,2.5,2240,9385,2.0,3,8,2240,0.0,1991,2010,9000,11389 days 16:47:18.680835,289,1.6,0.0,230,385,2240.0
205000.0,3,1.75,1170,8239,1.0,3,7,1170,0.0,1981,1180,7866,15041 days 16:47:18.680835,182,1.7142857142857142,0.0,-10,373,1170.0
310000.0,3,3.25,3130,9302,2.0,3,8,2190,940.0,1987,2350,7949,12850 days 16:47:18.680835,295,0.9230769230769231,2.3297872340425534,780,1353,1250.0
442500.0,2,2.25,1510,7280,2.0,3,7,1510,0.0,1987,1510,8120,12850 days 16:47:18.680835,233,0.8888888888888888,0.0,0,-840,1510.0
1080000.0,4,3.5,3740,41458,2.0,3,1,3740,0.0,2000,3750,38325,8102 days 16:47:18.680835,310,1.1428571428571428,0.0,-10,3133,3740.0
530000.0,4,2.5,2690,46609,2.0,3,8,2690,0.0,1980,1500,34800,15407 days 16:47:18.680835,237,1.6,0.0,1190,11809,2690.0
343500.0,4,1.75,1760,6204,1.0,4,7,1180,580.0,1950,1990,6240,26364 days 16:47:18.680835,175,2.2857142857142856,2.0344827586206895,-230,-36,600.0
334900.0,4,1.75,2180,4066,1.5,3,6,1270,910.0,1911,1400,1343,40609 days 16:47:18.680835,113,2.2857142857142856,1.3956043956043955,780,2723,360.0
544300.0,4,1.75,1560,9000,1.0,5,7,1560,0.0,1969,1510,8848,19424 days 16:47:18.680835,309,2.2857142857142856,0.0,50,152,1560.0
370000.0,3,2.5,1780,4050,2.0,3,7,1780,0.0,2001,1571,4976,7736 days 16:47:18.680835,146,1.2,0.0,209,-926,1780.0
245000.0,3,1.75,1260,6908,1.0,3,7,1260,0.0,1994,1810,7159,10293 days 16:47:18.680835,144,1.7142857142857142,0.0,-550,-251,1260.0
535000.0,4,1.75,1570,3250,1.5,5,8,1570,0.0,1928,1570,5720,34400 days 16:47:18.680835,041,2.2857142857142856,0.0,0,-2470,1570.0
202000.0,2,1.0,740,6550,1.0,4,5,740,0.0,1946,1080,8515,27825 days 16:47:18.680835,096,2.0,0.0,-340,-1965,740.0
490000.0,4,2.25,2020,4960,2.0,3,7,1710,310.0,1938,1590,4550,30747 days 16:47:18.680835,322,1.7777777777777777,5.516129032258065,430,410,1400.0
651500.0,4,1.5,1500,3075,2.0,5,7,1420,80.0,1929,1480,3774,34034 days 16:47:18.680835,350,2.6666666666666665,17.75,20,-699,1340.0
270000.0,4,2.5,1670,8056,1.0,3,7,1170,500.0,1961,1360,8056,22346 days 16:47:18.680835,014,1.6,2.34,310,0,670.0
1160000.0,3,3.5,3620,8072,2.0,3,1,2920,700.0,1999,3680,9624,8467 days 16:47:18.680835,097,0.8571428571428571,4.171428571428572,-60,-1552,2220.0
289000.0,2,1.5,1010,1309,2.0,3,7,860,150.0,2007,1190,3060,5545 days 16:47:18.680835,197,1.3333333333333333,5.733333333333333,-180,-1751,710.0
240000.0,3,1.5,1460,13503,1.0,4,6,1460,0.0,1977,1460,13394,16502 days 16:47:18.680835,107,2.0,0.0,0,109,1460.0
790000.0,3,1.75,1790,6117,1.0,3,8,1350,440.0,1940,1960,5554,30017 days 16:47:18.680835,135,1.7142857142857142,3.0681818181818183,-170,563,910.0
350000.0,3,2.25,1760,9621,2.0,3,7,1760,0.0,1995,1810,6589,9928 days 16:47:18.680835,356,1.3333333333333333,0.0,-50,3032,1760.0
246950.0,3,3.5,1790,1682,2.0,3,7,1480,310.0,2006,1150,4000,5910 days 16:47:18.680835,302,0.8571428571428571,4.774193548387097,640,-2318,1170.0
400000.0,3,1.0,1050,6000,1.0,3,7,1050,0.0,1952,1720,6000,25634 days 16:47:18.680835,005,3.0,0.0,-670,0,1050.0
533000.0,4,2.5,2590,6394,2.0,3,8,2590,0.0,2003,2500,5328,7006 days 16:47:18.680835,056,1.6,0.0,90,1066,2590.0
198400.0,3,1.0,1040,8645,1.0,4,7,1040,0.0,1962,1290,8645,21981 days 16:47:18.680835,294,3.0,0.0,-250,0,1040.0
495000.0,4,2.5,4060,8547,2.0,3,9,2790,1270.0,2007,2810,8313,5545 days 16:47:18.680835,302,1.6,2.1968503937007875,1250,234,1520.0
862000.0,4,2.5,3190,14565,2.0,3,1,3190,0.0,1990,3420,20475,11754 days 16:47:18.680835,167,1.6,0.0,-230,-5910,3190.0
870000.0,4,2.5,3190,14565,2.0,3,1,3190,0.0,1990,3420,20475,11754 days 16:47:18.680835,231,1.6,0.0,-230,-5910,3190.0
875000.0,4,1.75,2180,9726,1.0,4,9,2180,0.0,1966,2560,10244,20520 days 16:47:18.680835,055,2.2857142857142856,0.0,-380,-518,2180.0
317000.0,6,3.5,2120,5840,2.0,5,7,2120,0.0,1979,1860,8000,15772 days 16:47:18.680835,246,1.7142857142857142,0.0,260,-2160,2120.0
325000.0,4,2.75,2110,6838,2.0,4,8,2110,0.0,1991,2100,7280,11389 days 16:47:18.680835,206,1.4545454545454546,0.0,10,-442,2110.0
615000.0,2,1.5,1210,5000,1.5,5,6,1210,0.0,1907,1570,5000,42070 days 16:47:18.680835,263,1.3333333333333333,0.0,-360,0,1210.0
334950.0,4,2.5,2410,7846,2.0,3,8,2410,0.0,1992,2380,7914,11024 days 16:47:18.680835,202,1.6,0.0,30,-68,2410.0
775000.0,3,2.5,1980,7807,2.0,4,9,1980,0.0,1989,1590,7579,12119 days 16:47:18.680835,233,1.2,0.0,390,228,1980.0
600000.0,4,2.5,2370,9135,1.0,4,8,1600,770.0,1967,2050,9468,20155 days 16:47:18.680835,234,1.6,2.0779220779220777,320,-333,830.0
565000.0,3,1.75,1720,2218,1.5,3,7,1270,450.0,1931,1130,1600,33304 days 16:47:18.680835,209,1.7142857142857142,2.8222222222222224,590,618,820.0
292500.0,2,1.0,750,5026,1.0,4,6,750,0.0,1942,1260,5040,29286 days 16:47:18.680835,301,2.0,0.0,-510,-14,750.0
825000.0,3,2.25,2510,10418,1.0,3,8,1810,700.0,1968,2510,9435,19790 days 16:47:18.680835,119,1.3333333333333333,2.585714285714286,0,983,1110.0
495000.0,3,2.5,2577,156816,2.0,3,8,2577,0.0,2000,2090,156816,8102 days 16:47:18.680835,105,1.2,0.0,487,0,2577.0
525000.0,3,1.5,1540,4773,2.0,3,8,1540,0.0,1941,1540,5750,29651 days 16:47:18.680835,140,2.0,0.0,0,-977,1540.0
438600.0,1,1.0,720,2500,1.0,3,7,720,0.0,1910,1520,3750,40974 days 16:47:18.680835,131,1.0,0.0,-800,-1250,720.0
507000.0,3,2.25,1810,8158,1.0,3,8,1450,360.0,1984,1740,9532,13946 days 16:47:18.680835,226,1.3333333333333333,4.027777777777778,70,-1374,1090.0
275900.0,3,1.75,1380,8400,1.0,3,7,1380,0.0,1967,1540,8400,20155 days 16:47:18.680835,119,1.7142857142857142,0.0,-160,0,1380.0
1170000.0,4,2.5,2570,6251,2.0,3,9,2570,0.0,2000,2570,9588,8102 days 16:47:18.680835,168,1.6,0.0,0,-3337,2570.0
275000.0,4,1.75,1690,6000,1.0,3,7,1690,0.0,1957,1350,6000,23807 days 16:47:18.680835,343,2.2857142857142856,0.0,340,0,1690.0
355000.0,3,0.75,1420,3060,1.0,4,7,860,560.0,1923,1350,4000,36226 days 16:47:18.680835,300,4.0,1.5357142857142858,70,-940,300.0
233000.0,4,2.0,2130,9579,1.0,4,7,1250,880.0,1968,1590,9800,19790 days 16:47:18.680835,026,2.0,1.4204545454545454,540,-221,370.0
317500.0,4,2.5,2150,9000,1.0,4,7,1360,790.0,1979,1620,8400,15772 days 16:47:18.680835,223,1.6,1.7215189873417722,530,600,570.0
420000.0,4,2.0,2280,10319,1.0,4,8,1270,1010.0,1989,2280,9767,12119 days 16:47:18.680835,203,2.0,1.2574257425742574,0,552,260.0
290000.0,4,2.0,1560,8800,2.0,5,6,1560,0.0,1942,1480,10000,29286 days 16:47:18.680835,071,2.0,0.0,80,-1200,1560.0
320000.0,3,2.0,1880,10758,1.0,5,6,940,940.0,1952,2060,21000,25634 days 16:47:18.680835,154,1.5,1.0,-180,-10242,0.0
650000.0,3,2.5,2320,5284,2.0,3,8,2320,0.0,2004,2320,4383,6641 days 16:47:18.680835,082,1.2,0.0,0,901,2320.0
325000.0,3,1.75,1010,7171,1.0,4,7,1010,0.0,1967,1250,7560,20155 days 16:47:18.680835,195,1.7142857142857142,0.0,-240,-389,1010.0
165000.0,3,1.0,1120,5000,1.0,3,6,1120,0.0,1917,1050,5000,38417 days 16:47:18.680835,232,3.0,0.0,70,0,1120.0
500000.0,3,1.75,1560,16194,1.0,3,8,1560,0.0,1961,2430,16193,22346 days 16:47:18.680835,219,1.7142857142857142,0.0,-870,1,1560.0
443000.0,4,1.5,1860,12197,1.0,3,7,1860,0.0,1964,1510,11761,21251 days 16:47:18.680835,197,2.6666666666666665,0.0,350,436,1860.0
213400.0,3,1.5,1150,8686,1.0,4,7,1150,0.0,1963,1760,8798,21616 days 16:47:18.680835,160,2.0,0.0,-610,-112,1150.0
480000.0,4,1.75,1920,9380,1.0,3,7,1920,0.0,1964,1580,8580,21251 days 16:47:18.680835,275,2.2857142857142856,0.0,340,800,1920.0
275000.0,4,2.25,2490,7233,1.0,3,8,1460,1030.0,1978,2000,8000,16137 days 16:47:18.680835,015,1.7777777777777777,1.4174757281553398,490,-767,430.0
299880.0,3,2.5,1460,3044,2.0,3,7,1460,0.0,2000,1490,3044,8102 days 16:47:18.680835,190,1.2,0.0,-30,0,1460.0
499950.0,3,3.5,1820,1501,2.0,3,8,1430,390.0,2014,1550,1501,2988 days 16:47:18.680835,147,0.8571428571428571,3.6666666666666665,270,0,1040.0
1710000.0,5,3.0,4290,17100,1.0,3,9,2480,1810.0,1972,3550,16988,18329 days 16:47:18.680835,337,1.6666666666666667,1.3701657458563536,740,112,670.0
550000.0,4,2.75,2230,9460,1.0,5,7,1480,750.0,1960,1760,10878,22712 days 16:47:18.680835,218,1.4545454545454546,1.9733333333333334,470,-1418,730.0
300000.0,4,2.5,2070,7476,2.0,3,8,2070,0.0,2003,2430,5500,7006 days 16:47:18.680835,153,1.6,0.0,-360,1976,2070.0
920000.0,3,1.75,2480,4000,1.0,3,8,1240,1240.0,1948,2450,4000,27095 days 16:47:18.680835,287,1.7142857142857142,1.0,30,0,0.0
2300000.0,4,3.25,4110,15929,2.0,3,1,2720,1390.0,2001,2640,15929,7736 days 16:47:18.680835,231,1.2307692307692308,1.9568345323741008,1470,0,1330.0
620000.0,4,2.75,2290,3060,1.5,5,7,1550,740.0,1928,1460,3060,34400 days 16:47:18.680835,205,1.4545454545454546,2.0945945945945947,830,0,810.0
253500.0,3,1.0,1220,20400,1.0,5,6,1220,0.0,1959,1640,53578,23077 days 16:47:18.680835,223,3.0,0.0,-420,-33178,1220.0
978000.0,4,2.75,2620,13777,1.5,4,9,1720,900.0,1926,3530,9287,35130 days 16:47:18.680835,140,1.4545454545454546,1.9111111111111112,-910,4490,820.0
387500.0,4,2.5,3190,9856,2.0,3,8,3190,0.0,1979,2260,7996,15772 days 16:47:18.680835,336,1.6,0.0,930,1860,3190.0
325000.0,3,1.0,850,6906,1.0,3,6,850,0.0,1948,1150,6907,27095 days 16:47:18.680835,175,3.0,0.0,-300,-1,850.0
568000.0,3,2.5,1740,1308,3.0,3,8,1740,0.0,2008,1740,1280,5180 days 16:47:18.680835,100,1.2,0.0,0,28,1740.0
525000.0,4,2.5,2140,7754,2.0,3,8,2140,0.0,1996,1690,7775,9563 days 16:47:18.680835,265,1.6,0.0,450,-21,2140.0
560000.0,3,2.5,2070,12708,2.0,3,8,2070,0.0,1996,2620,9617,9563 days 16:47:18.680835,155,1.2,0.0,-550,3091,2070.0
394000.0,3,2.5,1680,4075,2.0,3,7,1680,0.0,2008,1710,4075,5180 days 16:47:18.680835,293,1.2,0.0,-30,0,1680.0
484950.0,2,1.0,1000,4956,1.0,4,7,1000,0.0,1916,1830,4959,38783 days 16:47:18.680835,301,2.0,0.0,-830,-3,1000.0
1300000.0,3,2.75,3340,12690,1.0,3,1,2550,790.0,1956,3340,9480,24173 days 16:47:18.680835,309,1.0909090909090908,3.2278481012658227,0,3210,1760.0
315000.0,3,2.5,1260,2767,2.0,3,8,1260,0.0,1999,1310,2767,8467 days 16:47:18.680835,210,1.2,0.0,-50,0,1260.0
590000.0,4,2.25,2430,32496,1.0,3,9,2430,0.0,1993,2750,35506,10658 days 16:47:18.680835,129,1.7777777777777777,0.0,-320,-3010,2430.0
106000.0,1,1.0,560,5700,1.0,3,5,560,0.0,1947,1120,5000,27460 days 16:47:18.680835,330,1.0,0.0,-560,700,560.0
751000.0,3,2.5,3380,9528,2.0,3,1,3380,0.0,1994,3630,14089,10293 days 16:47:18.680835,322,1.2,0.0,-250,-4561,3380.0
474000.0,2,1.0,1100,3500,1.0,5,7,1100,0.0,1908,2050,4000,41705 days 16:47:18.680835,290,2.0,0.0,-950,-500,1100.0
189000.0,2,2.0,1700,3171,1.0,5,5,850,850.0,1927,1380,5906,34765 days 16:47:18.680835,148,1.0,1.0,320,-2735,0.0
440500.0,3,2.5,1600,3172,2.0,3,7,1600,0.0,2002,1690,3698,7371 days 16:47:18.680835,297,1.2,0.0,-90,-526,1600.0
1020000.0,3,2.5,2605,2216,2.0,4,9,2090,515.0,1979,2605,1979,15772 days 16:47:18.680835,077,1.2,4.058252427184466,0,237,1575.0
589000.0,2,2.0,1850,4667,1.0,3,8,1850,0.0,2010,1860,6008,4449 days 16:47:18.680835,131,1.0,0.0,-10,-1341,1850.0
273000.0,3,2.25,1830,7651,2.0,3,8,1830,0.0,1986,2160,8442,13215 days 16:47:18.680835,241,1.3333333333333333,0.0,-330,-791,1830.0
950000.0,3,3.25,3050,18892,1.0,4,8,1650,1400.0,1962,1170,70973,21981 days 16:47:18.680835,171,0.9230769230769231,1.1785714285714286,1880,-52081,250.0
277700.0,2,1.5,1240,1055,2.0,3,8,1200,40.0,1967,1410,1340,20155 days 16:47:18.680835,314,1.3333333333333333,30.0,-170,-285,1160.0
299900.0,3,2.25,2100,8163,2.0,3,7,2100,0.0,1984,1410,7515,13946 days 16:47:18.680835,328,1.3333333333333333,0.0,690,648,2100.0
235000.0,3,1.0,1250,15603,1.0,4,7,1250,0.0,1959,1720,10220,23077 days 16:47:18.680835,154,3.0,0.0,-470,5383,1250.0
464000.0,2,2.0,1230,4800,2.0,3,7,1230,0.0,1952,1560,7200,25634 days 16:47:18.680835,126,1.0,0.0,-330,-2400,1230.0
281000.0,3,1.75,1690,9826,1.0,4,7,1690,0.0,1988,1980,9826,12485 days 16:47:18.680835,076,1.7142857142857142,0.0,-290,0,1690.0
320000.0,3,1.0,1520,8870,1.5,4,7,1520,0.0,1951,1520,7800,25999 days 16:47:18.680835,311,3.0,0.0,0,1070,1520.0
282000.0,4,2.0,1890,6302,2.0,3,7,1890,0.0,1997,1690,5369,9197 days 16:47:18.680835,171,2.0,0.0,200,933,1890.0
745000.0,4,1.75,1990,8900,1.0,4,8,1990,0.0,1972,2620,8925,18329 days 16:47:18.680835,051,2.2857142857142856,0.0,-630,-25,1990.0
245000.0,3,1.75,1480,3900,1.0,4,7,1480,0.0,1980,1830,6956,15407 days 16:47:18.680835,232,1.7142857142857142,0.0,-350,-3056,1480.0
250000.0,3,1.75,1480,3900,1.0,4,7,1480,0.0,1980,1830,6956,15407 days 16:47:18.680835,293,1.7142857142857142,0.0,-350,-3056,1480.0
470000.0,3,2.5,2120,2374,2.0,3,8,1770,350.0,2005,2480,3043,6275 days 16:47:18.680835,265,1.2,5.057142857142857,-360,-669,1420.0
216650.0,3,3.5,1480,1077,2.0,3,7,1300,180.0,2007,1140,2003,5545 days 16:47:18.680835,288,0.8571428571428571,7.222222222222222,340,-926,1120.0
440000.0,3,1.0,1250,8412,1.0,4,7,1250,0.0,1975,1840,8976,17233 days 16:47:18.680835,125,3.0,0.0,-590,-564,1250.0
590000.0,4,2.5,2010,7972,2.0,4,8,2010,0.0,1989,2100,8511,12119 days 16:47:18.680835,164,1.6,0.0,-90,-539,2010.0
935000.0,5,2.5,3150,35283,1.0,3,1,1800,1350.0,1975,3280,35283,17233 days 16:47:18.680835,301,2.0,1.3333333333333333,-130,0,450.0
848000.0,3,3.5,3010,5717,2.0,3,1,3010,0.0,2000,2780,5138,8102 days 16:47:18.680835,265,0.8571428571428571,0.0,230,579,3010.0
827500.0,5,4.25,3920,5823,2.0,3,9,3000,920.0,2000,3000,5297,8102 days 16:47:18.680835,071,1.1764705882352942,3.260869565217391,920,526,2080.0
1130000.0,6,3.0,2880,3192,2.0,4,8,2180,700.0,1919,1870,4533,37687 days 16:47:18.680835,140,2.0,3.1142857142857143,1010,-1341,1480.0
630000.0,2,2.25,2550,5663,1.0,3,1,1720,830.0,2011,2560,3828,4084 days 16:47:18.680835,127,0.8888888888888888,2.072289156626506,-10,1835,890.0
340000.0,5,1.0,1120,9022,1.5,4,7,1120,0.0,1962,1310,7500,21981 days 16:47:18.680835,125,5.0,0.0,-190,1522,1120.0
570000.0,4,2.75,3140,10918,1.0,3,8,1900,1240.0,1968,3170,10918,19790 days 16:47:18.680835,266,1.4545454545454546,1.532258064516129,-30,0,660.0
2750000.0,4,4.0,4130,5575,2.0,4,1,2860,1270.0,1993,2980,5575,10658 days 16:47:18.680835,343,1.0,2.251968503937008,1150,0,1590.0
514500.0,4,2.5,2990,9614,1.0,4,9,1740,1250.0,1976,3370,12085,16868 days 16:47:18.680835,002,1.6,1.392,-380,-2471,490.0
360000.0,2,1.0,1120,12625,1.0,3,7,1120,0.0,1940,1880,6828,30017 days 16:47:18.680835,103,2.0,0.0,-760,5797,1120.0
228900.0,4,1.5,1570,8775,1.0,3,7,1570,0.0,1943,980,8775,28921 days 16:47:18.680835,351,2.6666666666666665,0.0,590,0,1570.0
660000.0,3,2.75,2210,4000,2.0,3,8,2210,0.0,2008,2230,4674,5180 days 16:47:18.680835,176,1.0909090909090908,0.0,-20,-674,2210.0
647000.0,4,2.5,2390,5800,2.0,3,9,2390,0.0,2000,2590,6507,8102 days 16:47:18.680835,062,1.6,0.0,-200,-707,2390.0
366000.0,3,1.75,1520,8625,1.0,3,8,1520,0.0,1976,2080,9200,16868 days 16:47:18.680835,161,1.7142857142857142,0.0,-560,-575,1520.0
354000.0,5,1.75,1830,7986,1.0,4,7,1060,770.0,1962,1410,7260,21981 days 16:47:18.680835,199,2.857142857142857,1.3766233766233766,420,726,290.0
496700.0,3,2.5,1740,5782,2.0,4,8,1740,0.0,1989,2080,5782,12119 days 16:47:18.680835,144,1.2,0.0,-340,0,1740.0
300000.0,3,2.0,1550,8300,1.0,4,8,1550,0.0,1965,1860,8000,20885 days 16:47:18.680835,308,1.5,0.0,-310,300,1550.0
390000.0,3,1.0,1040,8075,1.0,4,7,1040,0.0,1961,1450,8075,22346 days 16:47:18.680835,290,3.0,0.0,-410,0,1040.0
350000.0,3,2.25,1640,7200,2.0,4,8,1640,0.0,1985,1830,8372,13580 days 16:47:18.680835,139,1.3333333333333333,0.0,-190,-1172,1640.0
561000.0,3,2.25,1640,7200,2.0,4,8,1640,0.0,1985,1830,8372,13580 days 16:47:18.680835,265,1.3333333333333333,0.0,-190,-1172,1640.0
475000.0,3,1.75,1260,10065,1.0,3,7,1260,0.0,1954,1320,10278,24903 days 16:47:18.680835,211,1.7142857142857142,0.0,-60,-213,1260.0
275000.0,3,1.5,1170,1174,2.0,3,7,840,330.0,2007,1170,2537,5545 days 16:47:18.680835,289,2.0,2.5454545454545454,0,-1363,510.0
290000.0,3,1.75,1590,13500,1.0,4,7,1090,500.0,1980,1540,10375,15407 days 16:47:18.680835,301,1.7142857142857142,2.18,50,3125,590.0
199000.0,3,2.5,1750,6725,1.0,3,7,1330,420.0,1993,1670,7744,10658 days 16:47:18.680835,042,1.2,3.1666666666666665,80,-1019,910.0
279900.0,4,2.5,1770,4338,2.0,3,7,1770,0.0,2001,1770,6606,7736 days 16:47:18.680835,083,1.6,0.0,0,-2268,1770.0
1660000.0,4,2.25,3530,5500,2.0,3,8,2860,670.0,1940,2840,5500,30017 days 16:47:18.680835,125,1.7777777777777777,4.268656716417911,690,0,2190.0
405000.0,3,2.5,2160,10200,1.0,3,7,1360,800.0,1978,2010,7850,16137 days 16:47:18.680835,103,1.2,1.7,150,2350,560.0
615000.0,4,2.25,2360,15860,1.0,3,9,2360,0.0,1977,2650,11798,16502 days 16:47:18.680835,027,1.7777777777777777,0.0,-290,4062,2360.0
268000.0,3,1.75,1980,12543,1.0,3,8,1180,800.0,1978,2090,8539,16137 days 16:47:18.680835,275,1.7142857142857142,1.475,-110,4004,380.0
451000.0,4,1.5,1620,5444,1.5,3,8,1620,0.0,1955,1620,6912,24538 days 16:47:18.680835,237,2.6666666666666665,0.0,0,-1468,1620.0
850000.0,2,2.75,2700,9854,1.0,3,9,2700,0.0,2012,1440,4168,3719 days 16:47:18.680835,349,0.7272727272727273,0.0,1260,5686,2700.0
1180000.0,5,2.25,3270,16553,2.0,5,9,2470,800.0,1968,3690,17916,19790 days 16:47:18.680835,264,2.2222222222222223,3.0875,-420,-1363,1670.0
245000.0,2,1.0,870,6150,1.0,3,6,870,0.0,1941,1120,6150,29651 days 16:47:18.680835,136,2.0,0.0,-250,0,870.0
450000.0,2,1.75,840,3340,1.0,3,6,700,140.0,1912,1700,3980,40244 days 16:47:18.680835,177,1.1428571428571428,5.0,-860,-640,560.0
370350.0,3,3.5,1340,1168,2.0,3,8,1080,260.0,2002,1650,1378,7371 days 16:47:18.680835,099,0.8571428571428571,4.153846153846154,-310,-210,820.0
265000.0,2,2.0,1650,8975,1.0,5,6,1650,0.0,1942,1260,8668,29286 days 16:47:18.680835,027,1.0,0.0,390,307,1650.0
497000.0,3,2.5,2630,4611,2.0,3,8,2630,0.0,2001,2220,5250,7736 days 16:47:18.680835,084,1.2,0.0,410,-639,2630.0
419000.0,4,2.25,1880,9727,1.0,3,7,1100,780.0,1979,1790,10274,15772 days 16:47:18.680835,102,1.7777777777777777,1.4102564102564104,90,-547,320.0
545800.0,4,2.5,1980,4500,2.0,3,8,1980,0.0,1989,1770,4595,12119 days 16:47:18.680835,205,1.6,0.0,210,-95,1980.0
403000.0,3,1.0,1500,10730,1.0,3,7,1000,500.0,1977,1570,12210,16502 days 16:47:18.680835,093,3.0,2.0,-70,-1480,500.0
195000.0,3,2.0,1230,8235,1.5,3,6,1230,0.0,1959,1080,10281,23077 days 16:47:18.680835,314,1.5,0.0,150,-2046,1230.0
1130000.0,4,2.5,2520,2600,2.0,5,8,1670,850.0,1925,2290,3600,35495 days 16:47:18.680835,345,1.6,1.964705882352941,230,-1000,820.0
255000.0,5,1.75,1970,8925,1.0,5,7,1170,800.0,1977,1910,8025,16502 days 16:47:18.680835,272,2.857142857142857,1.4625,60,900,370.0
500000.0,2,1.5,1520,8040,1.0,5,7,1520,0.0,1951,1440,8040,25999 days 16:47:18.680835,178,1.3333333333333333,0.0,80,0,1520.0
855000.0,4,2.75,2600,5390,1.0,4,8,1300,1300.0,1960,2550,5600,22712 days 16:47:18.680835,125,1.4545454545454546,1.0,50,-210,0.0
390000.0,4,2.0,2290,9200,1.5,3,7,2290,0.0,1920,2140,9200,37322 days 16:47:18.680835,007,2.0,0.0,150,0,2290.0
339000.0,3,2.0,1979,8470,1.0,4,7,1329,650.0,1956,1650,8591,24173 days 16:47:18.680835,083,1.5,2.0446153846153847,329,-121,679.0
1330000.0,4,3.5,2170,3672,2.0,3,9,2170,0.0,1905,1950,3450,42800 days 16:47:18.680835,065,1.1428571428571428,0.0,220,222,2170.0
370900.0,3,1.5,1200,8560,1.0,4,7,1200,0.0,1975,1550,7800,17233 days 16:47:18.680835,268,2.0,0.0,-350,760,1200.0
457500.0,3,1.0,1210,7636,1.0,4,7,1210,0.0,1952,1530,5900,25634 days 16:47:18.680835,119,3.0,0.0,-320,1736,1210.0
499000.0,4,2.5,1970,2601,2.0,3,7,1440,530.0,1999,1760,3025,8467 days 16:47:18.680835,058,1.6,2.7169811320754715,210,-424,910.0
225000.0,2,1.0,1040,11500,1.0,5,7,1040,0.0,1947,1300,11954,27460 days 16:47:18.680835,043,2.0,0.0,-260,-454,1040.0
615000.0,3,1.75,1920,4000,1.0,3,7,1070,850.0,1950,2280,4000,26364 days 16:47:18.680835,258,1.7142857142857142,1.2588235294117647,-360,0,220.0
455000.0,2,1.5,1020,1146,3.0,3,7,1020,0.0,2001,1138,1156,7736 days 16:47:18.680835,013,1.3333333333333333,0.0,-118,-10,1020.0
458000.0,3,1.0,1660,7500,1.0,4,7,1060,600.0,1940,1450,7500,30017 days 16:47:18.680835,134,3.0,1.7666666666666666,210,0,460.0
580000.0,3,2.25,1670,7416,1.0,4,7,1220,450.0,1974,1710,7416,17598 days 16:47:18.680835,303,1.3333333333333333,2.7111111111111112,-40,0,770.0
966000.0,5,4.5,3810,8019,2.0,3,1,3810,0.0,2008,3390,7713,5180 days 16:47:18.680835,134,1.1111111111111112,0.0,420,306,3810.0
240000.0,4,1.75,2020,10332,1.0,3,7,1010,1010.0,1954,2240,8379,24903 days 16:47:18.680835,280,2.2857142857142856,1.0,-220,1953,0.0
229050.0,1,1.0,420,3298,1.0,4,4,420,0.0,1949,1460,4975,26729 days 16:47:18.680835,090,1.0,0.0,-1040,-1677,420.0
328500.0,3,2.25,1390,1407,3.0,3,7,1390,0.0,2004,1390,1628,6641 days 16:47:18.680835,054,1.3333333333333333,0.0,0,-221,1390.0
319000.0,3,1.5,2010,10100,1.0,4,7,1110,900.0,1964,1900,10100,21251 days 16:47:18.680835,021,2.0,1.2333333333333334,110,0,210.0
650000.0,4,2.0,1820,5000,1.5,3,7,1640,180.0,1945,2060,5000,28190 days 16:47:18.680835,122,2.0,9.11111111111111,-240,0,1460.0
398500.0,3,2.5,1630,1971,2.0,3,8,1630,0.0,1996,1630,3451,9563 days 16:47:18.680835,048,1.2,0.0,0,-1480,1630.0
250000.0,1,1.0,800,16306,1.0,2,6,680,120.0,1931,1270,8666,33304 days 16:47:18.680835,171,1.0,5.666666666666667,-470,7640,560.0
1070000.0,3,2.75,2290,5002,2.0,4,9,1950,340.0,1995,2290,5100,9928 days 16:47:18.680835,075,1.0909090909090908,5.735294117647059,0,-98,1610.0
510000.0,3,2.25,2750,219542,2.0,3,7,1870,880.0,1981,2430,219542,15041 days 16:47:18.680835,274,1.3333333333333333,2.125,320,0,990.0
156000.0,2,1.75,590,6138,1.0,2,5,590,0.0,1947,1360,7112,27460 days 16:47:18.680835,318,1.1428571428571428,0.0,-770,-974,590.0
254500.0,4,2.75,2570,7264,2.0,3,8,1720,850.0,1998,2420,7911,8832 days 16:47:18.680835,142,1.4545454545454546,2.023529411764706,150,-647,870.0
760000.0,3,2.5,2050,15020,1.0,3,9,1600,450.0,1960,2930,15050,22712 days 16:47:18.680835,202,1.2,3.5555555555555554,-880,-30,1150.0
210000.0,3,2.5,1610,6732,2.0,3,7,1610,0.0,1994,1680,7414,10293 days 16:47:18.680835,126,1.2,0.0,-70,-682,1610.0
676000.0,3,2.0,1730,6784,2.5,4,7,1730,0.0,1942,1210,6784,29286 days 16:47:18.680835,092,1.5,0.0,520,0,1730.0
475000.0,4,3.5,2440,3052,2.0,3,8,1940,500.0,2006,2390,4600,5910 days 16:47:18.680835,002,1.1428571428571428,3.88,50,-1548,1440.0
880000.0,4,2.75,3220,4392,1.5,4,9,2320,900.0,1931,2310,5795,33304 days 16:47:18.680835,181,1.4545454545454546,2.577777777777778,910,-1403,1420.0
1210000.0,4,3.25,4330,26162,2.0,3,1,4330,0.0,1997,5110,26319,9197 days 16:47:18.680835,246,1.2307692307692308,0.0,-780,-157,4330.0
420000.0,3,1.5,1780,5000,1.0,4,7,1030,750.0,1958,1780,7500,23442 days 16:47:18.680835,346,2.0,1.3733333333333333,0,-2500,280.0
607000.0,3,1.0,1230,8114,1.0,4,7,1230,0.0,1951,2220,8114,25999 days 16:47:18.680835,143,3.0,0.0,-990,0,1230.0
475000.0,4,1.75,2160,19283,2.0,3,8,2160,0.0,1981,1990,9744,15041 days 16:47:18.680835,328,2.2857142857142856,0.0,170,9539,2160.0
395000.0,2,1.75,1400,2500,1.0,5,7,710,690.0,1916,1250,5700,38783 days 16:47:18.680835,295,1.1428571428571428,1.0289855072463767,150,-3200,20.0
650000.0,4,1.75,1900,10454,1.0,4,7,1180,720.0,1954,2060,11325,24903 days 16:47:18.680835,051,2.2857142857142856,1.6388888888888888,-160,-871,460.0
625000.0,5,2.75,2910,85377,1.0,4,8,1510,1400.0,1966,2160,66120,20520 days 16:47:18.680835,090,1.8181818181818181,1.0785714285714285,750,19257,110.0
849000.0,3,3.0,2960,42159,2.0,3,1,2960,0.0,1995,2640,25209,9928 days 16:47:18.680835,210,1.0,0.0,320,16950,2960.0
429950.0,3,1.5,2010,9480,1.0,3,8,1570,440.0,1951,1920,8791,25999 days 16:47:18.680835,161,2.0,3.5681818181818183,90,689,1130.0
825000.0,3,2.5,3760,5260,2.0,3,9,3230,530.0,2002,3080,5312,7371 days 16:47:18.680835,301,1.2,6.09433962264151,680,-52,2700.0
505000.0,2,1.0,1020,5000,1.0,4,7,1020,0.0,1916,1480,5000,38783 days 16:47:18.680835,241,2.0,0.0,-460,0,1020.0
265000.0,2,1.0,1290,2828,2.0,3,7,1290,0.0,2008,1290,2628,5180 days 16:47:18.680835,132,2.0,0.0,0,200,1290.0
283000.0,3,1.0,890,8400,1.0,4,6,890,0.0,1954,1850,5565,24903 days 16:47:18.680835,176,3.0,0.0,-960,2835,890.0
560000.0,3,2.75,1620,7500,1.0,5,7,1140,480.0,1979,1900,7500,15772 days 16:47:18.680835,097,1.0909090909090908,2.375,-280,0,660.0
765000.0,4,2.5,3360,13636,2.0,3,1,3360,0.0,1987,2980,10615,12850 days 16:47:18.680835,317,1.6,0.0,380,3021,3360.0
610000.0,5,2.75,2930,31411,1.0,4,9,1520,1410.0,1975,3070,12378,17233 days 16:47:18.680835,203,1.8181818181818181,1.0780141843971631,-140,19033,110.0
589000.0,3,2.5,2940,4799,1.0,3,9,1710,1230.0,1996,2540,4616,9563 days 16:47:18.680835,246,1.2,1.3902439024390243,400,183,480.0
192500.0,3,1.0,1080,8580,1.5,3,6,1080,0.0,1900,1800,12672,44626 days 16:47:18.680835,169,3.0,0.0,-720,-4092,1080.0
3200000.0,3,3.25,4560,13363,1.0,3,1,2760,1800.0,1995,4060,13362,9928 days 16:47:18.680835,009,0.9230769230769231,1.5333333333333334,500,1,960.0
550000.0,3,1.0,1010,6120,1.0,3,7,860,150.0,1940,1930,6120,30017 days 16:47:18.680835,044,3.0,5.733333333333333,-920,0,710.0
460000.0,2,1.5,1790,3760,1.5,4,8,1280,510.0,1928,1540,5080,34400 days 16:47:18.680835,287,1.3333333333333333,2.5098039215686274,250,-1320,770.0
264500.0,4,2.25,2060,11385,1.0,4,7,1200,860.0,1962,2110,11385,21981 days 16:47:18.680835,184,1.7777777777777777,1.3953488372093024,-50,0,340.0
339000.0,3,1.0,1150,2496,1.0,3,6,1010,140.0,1947,1340,1203,27460 days 16:47:18.680835,117,3.0,7.214285714285714,-190,1293,870.0
950000.0,4,3.5,4030,4200,3.0,3,9,4030,0.0,1992,2130,5000,11024 days 16:47:18.680835,316,1.1428571428571428,0.0,1900,-800,4030.0
677500.0,3,1.75,2020,9718,1.0,3,8,2020,0.0,1956,2370,8604,24173 days 16:47:18.680835,234,1.7142857142857142,0.0,-350,1114,2020.0
690000.0,4,2.5,2740,8120,2.0,3,9,2740,0.0,1999,2780,8344,8467 days 16:47:18.680835,339,1.6,0.0,-40,-224,2740.0
312000.0,4,2.25,1930,7452,1.0,3,7,1430,500.0,1984,1714,7200,13946 days 16:47:18.680835,129,1.7777777777777777,2.86,216,252,930.0
840000.0,5,1.75,2500,11617,1.0,4,9,1560,940.0,1966,3370,11617,20520 days 16:47:18.680835,295,2.857142857142857,1.6595744680851063,-870,0,620.0
357500.0,3,3.5,2080,5100,2.0,3,8,2080,0.0,2004,2080,5100,6641 days 16:47:18.680835,182,0.8571428571428571,0.0,0,0,2080.0
675000.0,3,1.5,1460,6480,1.0,4,7,980,480.0,1940,2180,6912,30017 days 16:47:18.680835,117,2.0,2.0416666666666665,-720,-432,500.0
515000.0,3,2.75,3290,11441,2.0,4,1,3290,0.0,1988,2600,12070,12485 days 16:47:18.680835,294,1.0909090909090908,0.0,690,-629,3290.0
491234.0,4,2.5,1540,1860,2.0,3,8,1540,0.0,2014,1210,1090,2988 days 16:47:18.680835,174,1.6,0.0,330,770,1540.0
290000.0,3,2.0,1310,6265,1.0,3,7,1310,0.0,1988,1100,6360,12485 days 16:47:18.680835,078,1.5,0.0,210,-95,1310.0
490000.0,4,2.5,2120,7820,1.0,3,8,1280,840.0,1975,2350,8605,17233 days 16:47:18.680835,233,1.6,1.5238095238095237,-230,-785,440.0
810000.0,4,2.0,2920,10424,1.0,5,8,1520,1400.0,1964,2360,10696,21251 days 16:47:18.680835,118,2.0,1.0857142857142856,560,-272,120.0
252000.0,3,1.5,1150,13200,1.0,3,7,1150,0.0,1956,1220,13066,24173 days 16:47:18.680835,051,2.0,0.0,-70,134,1150.0
299999.0,3,2.5,2380,9719,2.0,3,8,2380,0.0,2001,2830,11505,7736 days 16:47:18.680835,100,1.2,0.0,-450,-1786,2380.0
400000.0,3,2.75,2220,5000,2.0,3,7,2220,0.0,1993,960,5000,10658 days 16:47:18.680835,068,1.0909090909090908,0.0,1260,0,2220.0
530000.0,5,2.0,3020,6000,1.5,5,7,1860,1160.0,1925,1380,6000,35495 days 16:47:18.680835,363,2.5,1.603448275862069,1640,0,700.0
357000.0,3,2.0,2460,53882,1.0,3,7,2460,0.0,1955,2660,32625,24538 days 16:47:18.680835,254,1.5,0.0,-200,21257,2460.0
365000.0,3,1.75,1820,5555,1.0,4,7,1030,790.0,1939,1420,4000,30382 days 16:47:18.680835,069,1.7142857142857142,1.3037974683544304,400,1555,240.0
804000.0,4,2.5,2620,5060,2.0,3,9,2620,0.0,2005,900,5060,6275 days 16:47:18.680835,034,1.6,0.0,1720,0,2620.0
808250.0,3,2.0,1750,2640,1.0,3,8,1010,740.0,1914,1750,4560,39513 days 16:47:18.680835,247,1.5,1.364864864864865,0,-1920,270.0
360000.0,4,2.5,2020,7289,2.0,3,7,2020,0.0,1994,2090,7259,10293 days 16:47:18.680835,134,1.6,0.0,-70,30,2020.0
240000.0,3,1.75,1240,10956,1.0,3,6,1240,0.0,1987,1240,8137,12850 days 16:47:18.680835,296,1.7142857142857142,0.0,0,2819,1240.0
335000.0,2,2.0,1380,5840,1.0,3,7,1380,0.0,1988,1810,5035,12485 days 16:47:18.680835,203,1.0,0.0,-430,805,1380.0
380000.0,3,1.75,1920,8775,1.0,3,7,1920,0.0,1953,1560,8100,25268 days 16:47:18.680835,241,1.7142857142857142,0.0,360,675,1920.0
350000.0,3,1.75,1680,250470,1.0,4,7,1070,610.0,1940,1680,360000,30017 days 16:47:18.680835,135,1.7142857142857142,1.7540983606557377,0,-109530,460.0
194000.0,3,1.0,1400,7955,1.0,3,7,1400,0.0,1964,1160,14959,21251 days 16:47:18.680835,268,3.0,0.0,240,-7004,1400.0
310000.0,3,1.0,1240,7194,1.0,3,6,1090,150.0,1936,2090,8514,31478 days 16:47:18.680835,084,3.0,7.266666666666667,-850,-1320,940.0
315000.0,3,1.75,1410,15134,1.0,3,7,1410,0.0,1980,1770,15337,15407 days 16:47:18.680835,040,1.7142857142857142,0.0,-360,-203,1410.0
258950.0,3,1.75,1440,8050,1.0,3,8,1440,0.0,1985,1790,7488,13580 days 16:47:18.680835,342,1.7142857142857142,0.0,-350,562,1440.0
479000.0,2,2.25,1230,932,2.0,3,8,1020,210.0,2004,1230,1064,6641 days 16:47:18.680835,168,0.8888888888888888,4.857142857142857,0,-132,810.0
510000.0,5,1.5,1550,9750,1.0,4,7,1550,0.0,1966,1970,9750,20520 days 16:47:18.680835,314,3.3333333333333335,0.0,-420,0,1550.0
400000.0,3,2.0,1760,6875,1.0,4,8,1760,0.0,1967,1670,13650,20155 days 16:47:18.680835,190,1.5,0.0,90,-6775,1760.0
1450000.0,4,3.5,5000,38012,2.0,3,1,3610,1390.0,2004,3850,18054,6641 days 16:47:18.680835,091,1.1428571428571428,2.597122302158273,1150,19958,2220.0
680000.0,5,2.0,2140,5000,1.5,4,7,2020,120.0,1913,1810,4400,39878 days 16:47:18.680835,302,2.5,16.833333333333332,330,600,1900.0
1750000.0,6,3.0,3510,5760,2.5,4,1,3510,0.0,1906,3450,5760,42435 days 16:47:18.680835,128,2.0,0.0,60,0,3510.0
335000.0,3,1.75,2010,9417,1.0,4,8,1500,510.0,1967,1200,8250,20155 days 16:47:18.680835,216,1.7142857142857142,2.9411764705882355,810,1167,990.0
440000.0,4,2.25,2160,8119,1.0,3,8,1080,1080.0,1966,1850,9000,20520 days 16:47:18.680835,122,1.7777777777777777,1.0,310,-881,0.0
412250.0,2,2.0,1300,2983,1.0,3,8,1300,0.0,2006,1510,3876,5910 days 16:47:18.680835,085,1.0,0.0,-210,-893,1300.0
185000.0,3,1.5,1280,4031,2.0,4,6,1280,0.0,1985,1150,4500,13580 days 16:47:18.680835,324,2.0,0.0,130,-469,1280.0
286500.0,3,2.0,1840,8140,1.0,4,7,1040,800.0,1975,1600,6720,17233 days 16:47:18.680835,097,1.5,1.3,240,1420,240.0
422000.0,4,2.5,3200,6691,2.0,3,7,3200,0.0,2002,2610,6510,7371 days 16:47:18.680835,122,1.6,0.0,590,181,3200.0
408000.0,3,2.25,2800,35362,2.0,3,9,2800,0.0,1985,2800,37058,13580 days 16:47:18.680835,078,1.3333333333333333,0.0,0,-1696,2800.0
306500.0,2,1.0,1390,19988,1.0,4,7,1390,0.0,1949,2580,10490,26729 days 16:47:18.680835,300,2.0,0.0,-1190,9498,1390.0
359900.0,4,2.5,2600,5188,2.0,3,8,2600,0.0,2005,2610,5188,6275 days 16:47:18.680835,103,1.6,0.0,-10,0,2600.0
560000.0,3,2.5,1960,6058,2.0,3,8,1960,0.0,2002,2480,6656,7371 days 16:47:18.680835,190,1.2,0.0,-520,-598,1960.0
259875.0,3,1.0,1250,21303,1.0,3,6,1250,0.0,1970,1250,17920,19059 days 16:47:18.680835,239,3.0,0.0,0,3383,1250.0
385000.0,3,1.0,1250,21303,1.0,3,6,1250,0.0,1970,1250,17920,19059 days 16:47:18.680835,309,3.0,0.0,0,3383,1250.0
188000.0,1,1.0,550,16345,1.0,3,4,550,0.0,1945,1100,9240,28190 days 16:47:18.680835,280,1.0,0.0,-550,7105,550.0
1140000.0,4,3.25,2500,5801,1.5,3,8,1960,540.0,1926,3670,7350,35130 days 16:47:18.680835,166,1.2307692307692308,3.6296296296296298,-1170,-1549,1420.0
255000.0,3,1.0,1250,10094,1.0,4,6,1250,0.0,1927,1300,10094,34765 days 16:47:18.680835,283,3.0,0.0,-50,0,1250.0
1190000.0,4,2.75,3020,8622,2.0,3,9,3020,0.0,1976,3060,14303,16868 days 16:47:18.680835,211,1.4545454545454546,0.0,-40,-5681,3020.0
635200.0,4,1.75,1640,4240,1.0,5,7,920,720.0,1921,1300,4240,36956 days 16:47:18.680835,149,2.2857142857142856,1.2777777777777777,340,0,200.0
355000.0,3,1.75,1870,8250,2.0,3,7,1870,0.0,1956,1350,8714,24173 days 16:47:18.680835,118,1.7142857142857142,0.0,520,-464,1870.0
544000.0,3,2.5,1760,1755,3.5,3,8,1760,0.0,1998,1700,1721,8832 days 16:47:18.680835,030,1.2,0.0,60,34,1760.0
402000.0,3,1.5,1320,3145,2.0,3,7,1320,0.0,1998,1320,3002,8832 days 16:47:18.680835,112,2.0,0.0,0,143,1320.0
575000.0,4,1.5,1430,4163,1.5,3,7,1430,0.0,1910,1500,4000,40974 days 16:47:18.680835,360,2.6666666666666665,0.0,-70,163,1430.0
216000.0,3,1.75,1580,9705,1.0,4,7,1580,0.0,1977,1580,9942,16502 days 16:47:18.680835,205,1.7142857142857142,0.0,0,-237,1580.0
850000.0,4,3.25,3090,6744,2.0,3,9,3090,0.0,1923,2020,6656,36226 days 16:47:18.680835,142,1.2307692307692308,0.0,1070,88,3090.0
238000.0,3,2.0,1020,1204,2.0,3,7,720,300.0,2004,1360,1506,6641 days 16:47:18.680835,136,1.5,2.4,-340,-302,420.0
625000.0,4,1.75,2180,4431,1.5,3,8,2020,160.0,1912,1890,4400,40244 days 16:47:18.680835,103,2.2857142857142856,12.625,290,31,1860.0
1110000.0,5,3.25,3350,4000,2.0,4,8,2510,840.0,1997,1620,4000,9197 days 16:47:18.680835,182,1.5384615384615385,2.988095238095238,1730,0,1670.0
355000.0,3,2.5,1880,5290,1.0,3,8,1250,630.0,1974,2030,5092,17598 days 16:47:18.680835,335,1.2,1.9841269841269842,-150,198,620.0
495000.0,4,1.5,1810,7998,1.0,3,8,1210,600.0,1960,1830,7763,22712 days 16:47:18.680835,062,2.6666666666666665,2.0166666666666666,-20,235,610.0
1300000.0,5,2.5,4170,33310,2.0,4,1,4170,0.0,1991,4670,37960,11389 days 16:47:18.680835,061,2.0,0.0,-500,-4650,4170.0
398750.0,3,2.5,2230,4000,2.0,3,7,2230,0.0,1954,1310,4000,24903 days 16:47:18.680835,125,1.2,0.0,920,0,2230.0
835000.0,4,2.5,3650,7784,2.0,3,9,3650,0.0,2006,3150,6442,5910 days 16:47:18.680835,197,1.6,0.0,500,1342,3650.0
705000.0,6,2.75,2830,10579,1.0,4,8,1430,1400.0,1967,2060,10745,20155 days 16:47:18.680835,275,2.1818181818181817,1.0214285714285714,770,-166,30.0
625000.0,4,1.5,2120,5000,2.0,4,8,2120,0.0,1900,1830,5000,44626 days 16:47:18.680835,124,2.6666666666666665,0.0,290,0,2120.0
550000.0,4,2.5,2090,6926,2.0,3,8,2090,0.0,1990,2000,7151,11754 days 16:47:18.680835,042,1.6,0.0,90,-225,2090.0
540000.0,3,1.5,2600,5085,1.0,4,7,1400,1200.0,1940,1320,4000,30017 days 16:47:18.680835,149,2.0,1.1666666666666667,1280,1085,200.0
519000.0,2,1.0,830,2820,1.0,4,7,830,0.0,1920,1460,3150,37322 days 16:47:18.680835,155,2.0,0.0,-630,-330,830.0
311000.0,4,2.5,1975,8734,2.0,3,7,1975,0.0,1996,1975,8538,9563 days 16:47:18.680835,028,1.6,0.0,0,196,1975.0
305000.0,4,2.5,1900,7000,1.0,2,7,1420,480.0,1968,1600,7600,19790 days 16:47:18.680835,096,1.6,2.9583333333333335,300,-600,940.0
395000.0,4,2.75,2640,35070,1.5,3,8,2640,0.0,1963,2520,34986,21616 days 16:47:18.680835,184,1.4545454545454546,0.0,120,84,2640.0
275000.0,4,1.5,1610,6923,1.0,3,6,1010,600.0,1969,1320,7684,19424 days 16:47:18.680835,311,2.6666666666666665,1.6833333333333333,290,-761,410.0
450000.0,3,3.25,1770,1863,2.0,3,8,1430,340.0,2003,1410,1375,7006 days 16:47:18.680835,219,0.9230769230769231,4.205882352941177,360,488,1090.0
324000.0,2,1.0,1070,6000,1.0,3,7,1070,0.0,1955,1490,7622,24538 days 16:47:18.680835,254,2.0,0.0,-420,-1622,1070.0
2800000.0,5,3.25,4590,12793,2.0,5,1,3590,1000.0,1928,2920,8609,34400 days 16:47:18.680835,105,1.5384615384615385,3.59,1670,4184,2590.0
565000.0,4,1.0,1540,2452,1.5,4,7,1540,0.0,1906,1290,3360,42435 days 16:47:18.680835,197,4.0,0.0,250,-908,1540.0
373000.0,4,1.75,1590,7920,2.0,4,7,1590,0.0,1960,1720,7998,22712 days 16:47:18.680835,188,2.2857142857142856,0.0,-130,-78,1590.0
613000.0,2,2.0,1170,1890,1.5,4,8,1170,0.0,1927,2160,4000,34765 days 16:47:18.680835,189,1.0,0.0,-990,-2110,1170.0
614000.0,4,2.25,2880,9996,1.0,4,8,1920,960.0,1981,2410,10584,15041 days 16:47:18.680835,311,1.7777777777777777,2.0,470,-588,960.0
595000.0,4,1.75,2510,8989,1.0,4,8,1680,830.0,1964,2510,8931,21251 days 16:47:18.680835,125,2.2857142857142856,2.0240963855421685,0,58,850.0
440000.0,2,1.0,1280,12086,1.0,3,7,850,430.0,1983,1280,10452,14311 days 16:47:18.680835,233,2.0,1.9767441860465116,0,1634,420.0
425000.0,3,1.5,1570,12412,1.0,3,8,1570,0.0,1954,2130,12412,24903 days 16:47:18.680835,076,2.0,0.0,-560,0,1570.0
407000.0,2,1.0,740,6380,1.0,3,6,740,0.0,1912,1800,6380,40244 days 16:47:18.680835,268,2.0,0.0,-1060,0,740.0
472000.0,3,1.5,1740,9038,1.0,4,7,1740,0.0,1955,1390,9770,24538 days 16:47:18.680835,237,2.0,0.0,350,-732,1740.0
472000.0,3,2.5,1180,1262,3.0,3,8,1180,0.0,2010,1180,2632,4449 days 16:47:18.680835,168,1.2,0.0,0,-1370,1180.0
1250000.0,5,2.75,2960,28300,1.0,4,9,2160,800.0,1959,2940,23250,23077 days 16:47:18.680835,295,1.8181818181818181,2.7,20,5050,1360.0
412000.0,3,1.75,1880,5752,1.0,4,7,940,940.0,1945,1110,5201,28190 days 16:47:18.680835,189,1.7142857142857142,1.0,770,551,0.0
717000.0,3,1.0,1150,5000,1.0,3,8,1150,0.0,1959,1160,5000,23077 days 16:47:18.680835,096,3.0,0.0,-10,0,1150.0
425000.0,3,1.0,1320,7076,1.0,4,7,1320,0.0,1959,1510,9000,23077 days 16:47:18.680835,224,3.0,0.0,-190,-1924,1320.0
299999.0,4,2.0,1640,7200,1.0,5,6,820,820.0,1944,1640,8200,28556 days 16:47:18.680835,231,2.0,1.0,0,-1000,0.0
254000.0,3,2.0,1470,7694,1.0,4,7,1470,0.0,1992,1580,7480,11024 days 16:47:18.680835,127,1.5,0.0,-110,214,1470.0
178500.0,3,1.0,900,10511,1.0,4,6,900,0.0,1961,1460,10643,22346 days 16:47:18.680835,043,3.0,0.0,-560,-132,900.0
800000.0,3,1.75,1510,3600,1.0,5,8,1230,280.0,1910,1300,3600,40974 days 16:47:18.680835,325,1.7142857142857142,4.392857142857143,210,0,950.0
420000.0,3,1.0,1440,5623,1.0,4,6,720,720.0,1922,1280,5623,36591 days 16:47:18.680835,254,3.0,1.0,160,0,0.0
319900.0,2,1.0,1380,9251,1.0,3,7,1380,0.0,1940,1870,12158,30017 days 16:47:18.680835,071,2.0,0.0,-490,-2907,1380.0
350000.0,2,1.5,1150,7552,1.0,3,7,1150,0.0,1944,1910,8145,28556 days 16:47:18.680835,061,1.3333333333333333,0.0,-760,-593,1150.0
968000.0,6,2.75,3610,17580,1.0,5,9,2070,1540.0,1959,2890,14060,23077 days 16:47:18.680835,148,2.1818181818181817,1.344155844155844,720,3520,530.0
491000.0,3,2.0,1250,1306,3.0,3,7,1250,0.0,2000,1320,1306,8102 days 16:47:18.680835,056,1.5,0.0,-70,0,1250.0
948000.0,3,2.5,3510,9824,2.0,3,9,3510,0.0,2002,3510,10588,7371 days 16:47:18.680835,111,1.2,0.0,0,-764,3510.0
900000.0,3,2.5,2260,9577,2.0,3,8,1700,560.0,1925,1740,10240,35495 days 16:47:18.680835,267,1.2,3.0357142857142856,520,-663,1140.0
270000.0,3,1.75,2840,9800,1.0,4,7,1420,1420.0,1977,1650,9590,16502 days 16:47:18.680835,068,1.7142857142857142,1.0,1190,210,0.0
198000.0,3,1.5,1430,7347,1.0,3,7,820,610.0,1980,1430,8723,15407 days 16:47:18.680835,168,2.0,1.3442622950819672,0,-1376,210.0
250000.0,2,1.0,1420,21158,1.0,3,7,1420,0.0,1953,1220,8625,25268 days 16:47:18.680835,325,2.0,0.0,200,12533,1420.0
615000.0,4,2.5,2120,3720,2.0,3,8,2120,0.0,2004,2170,3720,6641 days 16:47:18.680835,211,1.6,0.0,-50,0,2120.0
550000.0,3,2.5,2080,7749,2.0,3,8,2080,0.0,1988,2210,7471,12485 days 16:47:18.680835,259,1.2,0.0,-130,278,2080.0
190000.0,2,2.5,1370,3438,2.0,3,7,1370,0.0,1987,1370,2308,12850 days 16:47:18.680835,290,0.8,0.0,0,1130,1370.0
629000.0,4,2.25,1900,11171,1.0,3,8,1280,620.0,1984,2330,9934,13946 days 16:47:18.680835,280,1.7777777777777777,2.064516129032258,-430,1237,660.0
434000.0,3,1.75,1660,8301,1.0,5,7,1660,0.0,1955,1660,9489,24538 days 16:47:18.680835,280,1.7142857142857142,0.0,0,-1188,1660.0
415885.0,3,1.0,1310,4163,1.0,4,7,1310,0.0,1964,1120,4166,21251 days 16:47:18.680835,281,3.0,0.0,190,-3,1310.0
272000.0,1,0.75,1040,6034,1.0,3,7,580,460.0,1991,1560,5650,11389 days 16:47:18.680835,021,1.3333333333333333,1.2608695652173914,-520,384,120.0
665000.0,3,2.5,2610,35000,2.0,3,1,2610,0.0,1988,3060,35427,12485 days 16:47:18.680835,178,1.2,0.0,-450,-427,2610.0
510000.0,3,2.0,1990,7405,1.0,5,7,1990,0.0,1971,2120,6462,18694 days 16:47:18.680835,282,1.5,0.0,-130,943,1990.0
530000.0,3,2.0,3080,17700,1.0,4,8,1740,1340.0,1965,2100,15100,20885 days 16:47:18.680835,247,1.5,1.2985074626865671,980,2600,400.0
355000.0,3,1.0,1200,16000,1.0,3,7,1200,0.0,1970,1960,15500,19059 days 16:47:18.680835,293,3.0,0.0,-760,500,1200.0
255000.0,4,1.0,1250,9102,1.0,3,7,1250,0.0,1955,1260,9180,24538 days 16:47:18.680835,054,4.0,0.0,-10,-78,1250.0
790000.0,4,2.75,2640,9000,2.0,3,1,2640,0.0,1990,2980,9137,11754 days 16:47:18.680835,205,1.4545454545454546,0.0,-340,-137,2640.0
695000.0,5,1.75,1790,9335,2.0,5,8,1790,0.0,1952,1840,9612,25634 days 16:47:18.680835,336,2.857142857142857,0.0,-50,-277,1790.0
255000.0,2,2.0,1140,8400,1.0,2,7,1140,0.0,1954,1130,9375,24903 days 16:47:18.680835,311,1.0,0.0,10,-975,1140.0
410000.0,3,2.25,1790,5794,1.5,3,7,1380,410.0,1985,2140,7769,13580 days 16:47:18.680835,204,1.3333333333333333,3.3658536585365852,-350,-1975,970.0
650000.0,4,2.75,1910,16532,1.0,4,7,1420,490.0,1940,2300,8250,30017 days 16:47:18.680835,176,1.4545454545454546,2.8979591836734695,-390,8282,930.0
675000.0,4,1.75,1530,3615,1.5,4,7,1530,0.0,1913,1650,4200,39878 days 16:47:18.680835,077,2.2857142857142856,0.0,-120,-585,1530.0
332888.0,2,2.5,1050,1029,2.0,3,8,950,100.0,2007,1350,3600,5545 days 16:47:18.680835,182,0.8,9.5,-300,-2571,850.0
300000.0,3,1.75,1730,6900,1.0,4,7,1130,600.0,1976,1950,7200,16868 days 16:47:18.680835,051,1.7142857142857142,1.8833333333333333,-220,-300,530.0
320000.0,4,1.5,1100,11824,1.0,4,7,1100,0.0,1954,1380,11796,24903 days 16:47:18.680835,213,2.6666666666666665,0.0,-280,28,1100.0
342500.0,5,2.25,2100,10726,1.0,4,7,1050,1050.0,1963,2100,10726,21616 days 16:47:18.680835,128,2.2222222222222223,1.0,0,0,0.0
752875.0,4,2.5,2800,72309,2.0,3,9,2800,0.0,1992,2280,36420,11024 days 16:47:18.680835,079,1.6,0.0,520,35889,2800.0
1730000.0,5,3.5,5000,26540,2.0,3,1,3410,1590.0,2008,3360,17398,5180 days 16:47:18.680835,181,1.4285714285714286,2.1446540880503147,1640,9142,1820.0
255000.0,1,0.5,880,1642,1.0,3,6,500,380.0,1910,1410,2992,40974 days 16:47:18.680835,226,2.0,1.3157894736842106,-530,-1350,120.0
244000.0,3,2.5,1470,9337,2.0,3,7,1470,0.0,1991,1360,8684,11389 days 16:47:18.680835,307,1.2,0.0,110,653,1470.0
1420000.0,5,3.25,3950,11438,2.0,3,1,3430,520.0,2006,2070,10751,5910 days 16:47:18.680835,091,1.5384615384615385,6.596153846153846,1880,687,2910.0
218000.0,3,1.0,980,12812,1.0,3,7,980,0.0,1956,1430,8986,24173 days 16:47:18.680835,314,3.0,0.0,-450,3826,980.0
359000.0,4,1.0,2180,10617,1.5,3,7,2180,0.0,1950,1360,9519,26364 days 16:47:18.680835,337,4.0,0.0,820,1098,2180.0
840000.0,4,2.75,3040,13559,2.0,3,1,3040,0.0,2003,3830,12202,7006 days 16:47:18.680835,300,1.4545454545454546,0.0,-790,1357,3040.0
900000.0,5,3.75,4130,226076,2.0,3,9,3170,960.0,1985,4130,55321,13580 days 16:47:18.680835,127,1.3333333333333333,3.3020833333333335,0,170755,2210.0
205000.0,4,1.75,1850,65340,1.5,4,7,1850,0.0,1972,1750,40946,18329 days 16:47:18.680835,282,2.2857142857142856,0.0,100,24394,1850.0
205000.0,3,2.5,1600,7295,2.0,2,7,1600,0.0,1993,1410,9000,10658 days 16:47:18.680835,021,1.2,0.0,190,-1705,1600.0
500000.0,2,1.5,2070,5432,2.0,3,7,1370,700.0,1951,2070,5505,25999 days 16:47:18.680835,098,1.3333333333333333,1.957142857142857,0,-73,670.0
510000.0,4,2.5,3180,5405,2.0,3,7,3180,0.0,2001,2610,5403,7736 days 16:47:18.680835,009,1.6,0.0,570,2,3180.0
1140000.0,6,4.25,6900,244716,2.0,4,9,4820,2080.0,2002,4170,266587,7371 days 16:47:18.680835,171,1.411764705882353,2.3173076923076925,2730,-21871,2740.0
1550000.0,4,2.25,2640,3000,2.0,3,7,2080,560.0,1908,1910,3000,41705 days 16:47:18.680835,120,1.7777777777777777,3.7142857142857144,730,0,1520.0
210000.0,3,1.5,1920,61014,1.0,3,6,1920,0.0,1953,1616,61014,25268 days 16:47:18.680835,202,2.0,0.0,304,0,1920.0
597500.0,3,1.75,2030,32565,1.0,3,8,1600,430.0,1981,2910,34190,15041 days 16:47:18.680835,343,1.7142857142857142,3.7209302325581395,-880,-1625,1170.0
400000.0,2,1.0,1140,101529,1.5,3,6,1140,0.0,1932,1580,101529,32939 days 16:47:18.680835,302,2.0,0.0,-440,0,1140.0
412000.0,3,1.0,1660,6992,1.0,5,7,1260,400.0,1952,1390,7359,25634 days 16:47:18.680835,233,3.0,3.15,270,-367,860.0
299950.0,2,1.5,1390,1756,3.0,3,7,1390,0.0,2005,1340,1756,6275 days 16:47:18.680835,084,1.3333333333333333,0.0,50,0,1390.0
1080000.0,4,3.0,2490,4325,1.5,3,8,1690,800.0,1922,1960,4284,36591 days 16:47:18.680835,113,1.3333333333333333,2.1125,530,41,890.0
422500.0,4,2.5,2550,8824,2.0,3,9,2550,0.0,1990,2630,11237,11754 days 16:47:18.680835,322,1.6,0.0,-80,-2413,2550.0
410000.0,3,2.0,1270,10227,1.0,4,6,1270,0.0,1968,1470,9750,19790 days 16:47:18.680835,195,1.5,0.0,-200,477,1270.0
1400000.0,4,3.25,2980,7000,2.0,3,1,2140,840.0,1900,2200,4800,44626 days 16:47:18.680835,148,1.2307692307692308,2.5476190476190474,780,2200,1300.0
245000.0,3,2.0,1470,8000,1.0,4,8,1470,0.0,1974,1980,8000,17598 days 16:47:18.680835,196,1.5,0.0,-510,0,1470.0
720000.0,4,3.0,3550,12327,1.5,4,1,2180,1370.0,1990,3170,12937,11754 days 16:47:18.680835,183,1.3333333333333333,1.5912408759124088,380,-610,810.0
315000.0,2,1.0,780,7200,1.0,2,6,780,0.0,1935,1750,7200,31843 days 16:47:18.680835,297,2.0,0.0,-970,0,780.0
191950.0,2,2.5,1390,1302,2.0,3,7,1390,0.0,1987,1390,2052,12850 days 16:47:18.680835,055,0.8,0.0,0,-750,1390.0
455000.0,4,2.5,2440,5001,2.0,3,8,2440,0.0,2005,2260,5001,6275 days 16:47:18.680835,266,1.6,0.0,180,0,2440.0
523000.0,3,1.5,1260,3135,1.5,3,8,1260,0.0,1931,1700,4180,33304 days 16:47:18.680835,136,2.0,0.0,-440,-1045,1260.0
250000.0,3,2.25,1640,4420,2.0,4,7,1640,0.0,1918,1230,6632,38052 days 16:47:18.680835,297,1.3333333333333333,0.0,410,-2212,1640.0
294000.0,3,3.0,1670,4120,1.5,3,7,1140,530.0,1929,1010,4120,34034 days 16:47:18.680835,013,1.0,2.150943396226415,660,0,610.0
490000.0,3,2.25,2380,6000,1.0,3,8,2040,340.0,1961,1680,7200,22346 days 16:47:18.680835,283,1.3333333333333333,6.0,700,-1200,1700.0
310000.0,4,1.0,1030,5750,1.0,3,7,1030,0.0,1971,1250,5750,18694 days 16:47:18.680835,259,4.0,0.0,-220,0,1030.0
265000.0,3,1.5,1560,10489,1.0,5,7,1560,0.0,1961,1400,10489,22346 days 16:47:18.680835,202,2.0,0.0,160,0,1560.0
402000.0,4,1.75,1640,10500,1.0,4,7,1010,630.0,1968,1680,7650,19790 days 16:47:18.680835,223,2.2857142857142856,1.6031746031746033,-40,2850,380.0
705000.0,2,2.5,2200,188200,1.0,3,8,2200,0.0,2007,2700,84942,5545 days 16:47:18.680835,129,0.8,0.0,-500,103258,2200.0
589450.0,4,2.5,3190,7941,2.0,3,1,3190,0.0,2005,3190,7255,6275 days 16:47:18.680835,328,1.6,0.0,0,686,3190.0
750000.0,3,2.25,2250,5301,2.0,4,8,1510,740.0,1975,2240,7200,17233 days 16:47:18.680835,225,1.3333333333333333,2.0405405405405403,10,-1899,770.0
478000.0,2,1.75,1960,6000,1.0,4,7,980,980.0,1904,1650,6000,43166 days 16:47:18.680835,233,1.1428571428571428,1.0,310,0,0.0
170000.0,3,1.0,1250,7015,1.0,3,7,1250,0.0,1958,1510,11460,23442 days 16:47:18.680835,195,3.0,0.0,-260,-4445,1250.0
489950.0,4,2.25,2640,31941,1.0,4,9,2640,0.0,1986,2780,35365,13215 days 16:47:18.680835,163,1.7777777777777777,0.0,-140,-3424,2640.0
1370000.0,2,2.25,2460,16940,1.5,4,9,1930,530.0,1936,2260,6851,31478 days 16:47:18.680835,157,0.8888888888888888,3.641509433962264,200,10089,1400.0
319950.0,3,2.5,1700,7000,2.0,3,7,1700,0.0,1996,1950,7000,9563 days 16:47:18.680835,061,1.2,0.0,-250,0,1700.0
208417.0,2,1.0,840,4200,1.0,3,5,840,0.0,1938,830,5000,30747 days 16:47:18.680835,328,2.0,0.0,10,-800,840.0
410000.0,4,2.0,1900,5100,1.0,3,6,950,950.0,1914,1230,5100,39513 days 16:47:18.680835,321,2.0,1.0,670,0,0.0
590000.0,4,2.75,2160,4205,1.0,3,7,1080,1080.0,1969,2450,6014,19424 days 16:47:18.680835,206,1.4545454545454546,1.0,-290,-1809,0.0
648000.0,3,1.75,1610,10229,1.0,5,8,1610,0.0,1961,2270,8800,22346 days 16:47:18.680835,119,1.7142857142857142,0.0,-660,1429,1610.0
255000.0,3,2.5,1720,6194,2.0,3,8,1720,0.0,1998,1720,6211,8832 days 16:47:18.680835,178,1.2,0.0,0,-17,1720.0
465000.0,4,2.75,2190,3267,2.0,3,8,2190,0.0,2004,2190,3619,6641 days 16:47:18.680835,237,1.4545454545454546,0.0,0,-352,2190.0
622000.0,4,1.75,3020,10714,1.0,5,8,1510,1510.0,1958,2230,14400,23442 days 16:47:18.680835,028,2.2857142857142856,1.0,790,-3686,0.0
306000.0,3,1.75,1980,9800,1.0,3,7,1980,0.0,1991,1630,7650,11389 days 16:47:18.680835,258,1.7142857142857142,0.0,350,2150,1980.0
617000.0,3,2.5,1880,5500,2.0,4,7,1880,0.0,1947,1230,5500,27460 days 16:47:18.680835,283,1.2,0.0,650,0,1880.0
438750.0,3,1.75,1610,6480,1.0,4,7,1610,0.0,1947,1230,8040,27460 days 16:47:18.680835,148,1.7142857142857142,0.0,380,-1560,1610.0
1280000.0,4,3.0,3260,4500,2.0,3,9,2300,960.0,1930,2410,4995,33669 days 16:47:18.680835,268,1.3333333333333333,2.3958333333333335,850,-495,1340.0
995000.0,5,3.25,3970,8029,2.0,3,9,2970,1000.0,1979,2520,8214,15772 days 16:47:18.680835,328,1.5384615384615385,2.97,1450,-185,1970.0
1580000.0,4,2.5,4570,74487,2.0,5,1,4570,0.0,1948,3810,74487,27095 days 16:47:18.680835,174,1.6,0.0,760,0,4570.0
635000.0,5,2.75,2620,5500,1.5,3,7,1710,910.0,1911,1790,5500,40609 days 16:47:18.680835,112,1.8181818181818181,1.879120879120879,830,0,800.0
215000.0,3,1.0,1180,9000,1.0,4,7,1180,0.0,1970,1290,8316,19059 days 16:47:18.680835,209,3.0,0.0,-110,684,1180.0
530000.0,3,2.5,1365,1090,3.0,3,7,1315,50.0,2003,1360,1124,7006 days 16:47:18.680835,300,1.2,26.3,5,-34,1265.0
295000.0,2,1.0,720,4125,1.0,4,6,720,0.0,1943,1000,6100,28921 days 16:47:18.680835,079,2.0,0.0,-280,-1975,720.0
245000.0,3,2.25,1350,6775,1.0,3,7,930,420.0,1981,1460,7210,15041 days 16:47:18.680835,061,1.3333333333333333,2.2142857142857144,-110,-435,510.0
303000.0,3,2.75,1850,8820,2.0,4,8,1850,0.0,1993,1850,8651,10658 days 16:47:18.680835,202,1.0909090909090908,0.0,0,169,1850.0
330000.0,3,1.75,1320,9675,1.5,4,7,1320,0.0,1970,1160,9675,19059 days 16:47:18.680835,288,1.7142857142857142,0.0,160,0,1320.0
700000.0,3,1.75,1990,13000,2.0,3,9,1990,0.0,1980,2880,11340,15407 days 16:47:18.680835,063,1.7142857142857142,0.0,-890,1660,1990.0
126000.0,1,1.0,610,4400,1.0,3,5,610,0.0,1922,1090,4930,36591 days 16:47:18.680835,238,1.0,0.0,-480,-530,610.0
850000.0,4,1.0,2500,35802,1.5,3,7,2500,0.0,1955,2880,40510,24538 days 16:47:18.680835,204,4.0,0.0,-380,-4708,2500.0
405000.0,3,2.0,1440,7425,1.0,4,7,1440,0.0,1965,1800,8344,20885 days 16:47:18.680835,352,1.5,0.0,-360,-919,1440.0
869900.0,6,4.5,2750,4400,2.0,3,8,1770,980.0,1987,1860,4400,12850 days 16:47:18.680835,231,1.3333333333333333,1.8061224489795917,890,0,790.0
485000.0,3,1.75,1790,6775,1.0,3,8,1790,0.0,1951,1310,6028,25999 days 16:47:18.680835,090,1.7142857142857142,0.0,480,747,1790.0
400000.0,2,2.0,1050,1173,2.0,3,8,720,330.0,2004,1340,1317,6641 days 16:47:18.680835,028,1.0,2.1818181818181817,-290,-144,390.0
299950.0,3,2.5,1780,4650,2.0,3,7,1780,0.0,2011,3050,3848,4084 days 16:47:18.680835,254,1.2,0.0,-1270,802,1780.0
585000.0,4,2.5,2200,9099,2.0,3,8,2200,0.0,1994,2270,8900,10293 days 16:47:18.680835,086,1.6,0.0,-70,199,2200.0
495000.0,4,2.0,1720,5413,2.0,3,7,1470,250.0,1938,1510,5413,30747 days 16:47:18.680835,126,2.0,5.88,210,0,1220.0
2200000.0,5,4.5,5840,17168,2.0,3,1,4570,1270.0,2006,4850,15017,5910 days 16:47:18.680835,070,1.1111111111111112,3.5984251968503935,990,2151,3300.0
447000.0,3,2.25,1520,14080,2.0,3,7,1520,0.0,1984,1530,9758,13946 days 16:47:18.680835,314,1.3333333333333333,0.0,-10,4322,1520.0
206000.0,3,1.0,1320,9239,1.0,4,7,1320,0.0,1968,1320,8415,19790 days 16:47:18.680835,107,3.0,0.0,0,824,1320.0
500000.0,3,1.0,1070,4600,1.0,3,7,950,120.0,1930,1090,4600,33669 days 16:47:18.680835,294,3.0,7.916666666666667,-20,0,830.0
302500.0,4,2.5,1990,5511,2.0,3,8,1990,0.0,1994,1850,6031,10293 days 16:47:18.680835,325,1.6,0.0,140,-520,1990.0
1250000.0,4,4.25,4980,13000,2.0,3,9,3080,1900.0,1982,2840,11308,14676 days 16:47:18.680835,329,0.9411764705882353,1.6210526315789473,2140,1692,1180.0
391000.0,2,1.0,890,5423,1.0,3,6,890,0.0,1946,1690,5993,27825 days 16:47:18.680835,204,2.0,0.0,-800,-570,890.0
250000.0,3,2.0,1440,5457,2.0,3,7,1440,0.0,1986,1480,6286,13215 days 16:47:18.680835,191,1.5,0.0,-40,-829,1440.0
435000.0,4,2.5,2440,5350,2.0,3,7,2440,0.0,2003,2440,5090,7006 days 16:47:18.680835,204,1.6,0.0,0,260,2440.0
160000.0,4,2.25,1800,14722,1.0,3,7,1440,360.0,1962,2400,10000,21981 days 16:47:18.680835,042,1.7777777777777777,4.0,-600,4722,1080.0
451000.0,5,3.0,2260,6508,1.0,3,7,1330,930.0,2003,1940,9450,7006 days 16:47:18.680835,203,1.6666666666666667,1.4301075268817205,320,-2942,400.0
206000.0,2,1.0,810,7158,1.0,5,6,810,0.0,1944,1090,7158,28556 days 16:47:18.680835,125,2.0,0.0,-280,0,810.0
590000.0,4,2.75,2240,5400,2.0,4,7,1540,700.0,1940,1830,5000,30017 days 16:47:18.680835,266,1.4545454545454546,2.2,410,400,840.0
350000.0,3,1.5,1550,40752,1.0,5,7,1550,0.0,1954,1550,8000,24903 days 16:47:18.680835,324,2.0,0.0,0,32752,1550.0
1240000.0,5,3.5,3180,4628,2.0,3,1,2420,760.0,2001,2060,4640,7736 days 16:47:18.680835,085,1.4285714285714286,3.1842105263157894,1120,-12,1660.0
395000.0,6,2.25,2950,11200,1.0,4,7,1700,1250.0,1970,1790,11200,19059 days 16:47:18.680835,089,2.6666666666666665,1.36,1160,0,450.0
419000.0,5,3.0,2190,9652,2.0,3,7,2190,0.0,1999,1440,6710,8467 days 16:47:18.680835,095,1.6666666666666667,0.0,750,2942,2190.0
592350.0,2,2.0,1570,4665,1.0,3,8,1570,0.0,2006,2165,6262,5910 days 16:47:18.680835,189,1.0,0.0,-595,-1597,1570.0
855000.0,5,3.25,3420,5669,2.0,3,9,2620,800.0,2003,3310,6006,7006 days 16:47:18.680835,218,1.5384615384615385,3.275,110,-337,1820.0
771000.0,4,2.5,2420,7200,2.0,3,9,2420,0.0,1991,2650,7800,11389 days 16:47:18.680835,364,1.6,0.0,-230,-600,2420.0
325000.0,3,2.25,1570,43350,1.0,4,7,1570,0.0,1967,1570,220849,20155 days 16:47:18.680835,352,1.3333333333333333,0.0,0,-177499,1570.0
1850000.0,5,3.25,3680,6060,2.0,5,9,2630,1050.0,1925,3050,5850,35495 days 16:47:18.680835,291,1.5384615384615385,2.5047619047619047,630,210,1580.0
545000.0,4,1.75,1910,6731,1.0,4,7,1210,700.0,1953,1780,6350,25268 days 16:47:18.680835,210,2.2857142857142856,1.7285714285714286,130,381,510.0
615000.0,3,1.75,1780,5175,1.0,4,7,990,790.0,1927,1780,5175,34765 days 16:47:18.680835,057,1.7142857142857142,1.2531645569620253,0,0,200.0
625500.0,2,1.0,2160,7439,1.0,4,6,1300,860.0,1953,1680,7439,25268 days 16:47:18.680835,100,2.0,1.5116279069767442,480,0,440.0
232000.0,3,1.5,1460,15000,1.0,3,7,1460,0.0,1966,1510,15000,20520 days 16:47:18.680835,189,2.0,0.0,-50,0,1460.0
168000.0,3,1.5,1370,7439,1.0,4,6,1370,0.0,1963,2350,3370,21616 days 16:47:18.680835,195,2.0,0.0,-980,4069,1370.0
238000.0,3,1.5,1370,7439,1.0,4,6,1370,0.0,1963,2350,3370,21616 days 16:47:18.680835,028,2.0,0.0,-980,4069,1370.0
260000.0,3,2.5,1500,7401,2.0,3,8,1500,0.0,1998,1720,7171,8832 days 16:47:18.680835,104,1.2,0.0,-220,230,1500.0
460000.0,3,1.75,1210,7500,1.0,3,7,1210,0.0,1951,1250,6000,25999 days 16:47:18.680835,061,1.7142857142857142,0.0,-40,1500,1210.0
900000.0,3,2.5,2850,11535,1.0,3,8,1680,1170.0,1952,2670,9942,25634 days 16:47:18.681833,237,1.2,1.435897435897436,180,1593,510.0
289950.0,3,1.0,1090,8280,1.0,3,6,1090,0.0,1947,1060,7609,27460 days 16:47:18.681833,294,3.0,0.0,30,671,1090.0
265000.0,3,1.75,1450,5858,1.0,4,7,1450,0.0,1991,1520,6573,11389 days 16:47:18.681833,051,1.7142857142857142,0.0,-70,-715,1450.0
465000.0,4,2.25,1820,20349,1.0,5,8,1340,480.0,1977,1270,12800,16502 days 16:47:18.681833,150,1.7777777777777777,2.7916666666666665,550,7549,860.0
370000.0,3,1.5,1320,7201,1.0,3,7,1320,0.0,1971,1380,7201,18694 days 16:47:18.681833,317,2.0,0.0,-60,0,1320.0
240000.0,2,1.5,1670,9880,1.0,4,7,1670,0.0,1941,1670,9807,29651 days 16:47:18.681833,218,1.3333333333333333,0.0,0,73,1670.0
232000.0,4,2.0,1440,5911,1.0,5,5,1440,0.0,1943,1500,11089,28921 days 16:47:18.681833,260,2.0,0.0,-60,-5178,1440.0
237502.0,3,1.0,980,7560,1.0,3,7,980,0.0,1951,1300,7560,25999 days 16:47:18.681833,210,3.0,0.0,-320,0,980.0
1280000.0,4,3.5,4340,5500,2.0,3,1,2850,1490.0,2008,1290,5500,5180 days 16:47:18.681833,349,1.1428571428571428,1.912751677852349,3050,0,1360.0
957000.0,4,2.25,2860,11545,1.0,4,8,1430,1430.0,1966,2190,11396,20520 days 16:47:18.681833,114,1.7777777777777777,1.0,670,149,0.0
218000.0,3,1.5,1140,4875,1.0,5,6,1140,0.0,1970,980,5070,19059 days 16:47:18.681833,064,2.0,0.0,160,-195,1140.0
205000.0,3,1.5,1120,8366,1.0,3,7,1120,0.0,1968,1260,9000,19790 days 16:47:18.681833,232,2.0,0.0,-140,-634,1120.0
350000.0,3,3.25,1460,1592,2.0,3,8,1130,330.0,2006,1560,1701,5910 days 16:47:18.681833,162,0.9230769230769231,3.4242424242424243,-100,-109,800.0
256000.0,4,2.5,2050,5787,2.0,3,7,2050,0.0,2002,2030,6615,7371 days 16:47:18.681833,183,1.6,0.0,20,-828,2050.0
275000.0,3,1.0,1250,7654,1.0,3,7,1000,250.0,1952,1310,7350,25634 days 16:47:18.681833,211,3.0,4.0,-60,304,750.0
372000.0,4,2.5,2520,9604,2.0,3,9,2520,0.0,1990,2540,9793,11754 days 16:47:18.681833,093,1.6,0.0,-20,-189,2520.0
688888.0,3,3.25,2580,9825,1.5,4,9,1760,820.0,1978,2140,10270,16137 days 16:47:18.681833,078,0.9230769230769231,2.1463414634146343,440,-445,940.0
170000.0,2,1.0,1200,24792,2.0,2,7,1200,0.0,1976,2150,24792,16868 days 16:47:18.681833,181,2.0,0.0,-950,0,1200.0
530000.0,5,2.25,2140,7910,1.0,3,7,1070,1070.0,1962,1680,8700,21981 days 16:47:18.681833,176,2.2222222222222223,1.0,460,-790,0.0
905000.0,4,3.25,3440,7661,2.0,3,1,3440,0.0,2006,3580,6478,5910 days 16:47:18.681833,174,1.2307692307692308,0.0,-140,1183,3440.0
365000.0,4,2.5,1800,5070,1.0,5,7,1080,720.0,1979,1870,5365,15772 days 16:47:18.681833,237,1.6,1.5,-70,-295,360.0
312000.0,4,2.5,1790,10584,1.0,4,7,1290,500.0,1981,1730,9120,15041 days 16:47:18.681833,096,1.6,2.58,60,1464,790.0
400000.0,2,1.75,1250,7680,1.0,3,7,1250,0.0,1922,1250,7680,36591 days 16:47:18.681833,234,1.1428571428571428,0.0,0,0,1250.0
278750.0,2,2.0,800,5765,1.0,4,6,800,0.0,1936,1160,3844,31478 days 16:47:18.681833,255,1.0,0.0,-360,1921,800.0
510000.0,3,2.0,1410,11995,1.0,4,8,1410,0.0,1965,2690,12650,20885 days 16:47:18.681833,091,1.5,0.0,-1280,-655,1410.0
527700.0,2,2.25,1330,806,3.0,3,8,1330,0.0,2009,1320,1389,4814 days 16:47:18.681833,104,0.8888888888888888,0.0,10,-583,1330.0
740000.0,4,2.75,2890,4000,1.5,4,9,2190,700.0,1931,2280,4000,33304 days 16:47:18.681833,105,1.4545454545454546,3.1285714285714286,610,0,1490.0
512000.0,4,2.5,2550,17209,2.0,3,9,2550,0.0,1996,2840,12560,9563 days 16:47:18.681833,220,1.6,0.0,-290,4649,2550.0
362000.0,5,2.5,2880,8216,2.0,3,8,2880,0.0,2001,1960,7200,7736 days 16:47:18.681833,316,2.0,0.0,920,1016,2880.0
225000.0,3,1.0,660,6600,1.0,4,5,660,0.0,1940,1320,6600,30017 days 16:47:18.681833,037,3.0,0.0,-660,0,660.0
491500.0,3,2.25,1470,4322,2.0,3,7,1470,0.0,1985,1610,4322,13580 days 16:47:18.681833,181,1.3333333333333333,0.0,-140,0,1470.0
429950.0,4,1.75,1700,10230,1.0,3,8,1320,380.0,1959,2000,8006,23077 days 16:47:18.681833,035,2.2857142857142856,3.473684210526316,-300,2224,940.0
375000.0,3,1.0,1040,9800,1.0,4,7,1040,0.0,1955,1280,8880,24538 days 16:47:18.681833,321,3.0,0.0,-240,920,1040.0
199400.0,2,1.0,880,4000,1.0,4,6,880,0.0,1916,1430,4000,38783 days 16:47:18.681833,225,2.0,0.0,-550,0,880.0
364900.0,4,2.5,2490,9346,2.0,3,9,2490,0.0,1996,2650,9454,9563 days 16:47:18.681833,026,1.6,0.0,-160,-108,2490.0
324950.0,3,1.5,1210,7560,1.0,3,7,1210,0.0,1941,980,7560,29651 days 16:47:18.681833,255,2.0,0.0,230,0,1210.0
467000.0,5,2.0,2080,4000,1.0,4,6,1040,1040.0,1909,1940,6000,41339 days 16:47:18.681833,089,2.5,1.0,140,-2000,0.0
380000.0,3,1.0,1380,5400,1.0,4,7,1380,0.0,1954,1190,6075,24903 days 16:47:18.681833,234,3.0,0.0,190,-675,1380.0
250000.0,3,2.25,1620,10850,1.0,3,7,1620,0.0,1966,1910,10568,20520 days 16:47:18.681833,307,1.3333333333333333,0.0,-290,282,1620.0
206990.0,3,1.0,1330,9620,1.0,5,6,1330,0.0,1976,1300,10360,16868 days 16:47:18.681833,317,3.0,0.0,30,-740,1330.0
670000.0,3,1.75,1730,3400,1.0,5,7,970,760.0,1928,1640,5000,34400 days 16:47:18.681833,096,1.7142857142857142,1.2763157894736843,90,-1600,210.0
315000.0,2,1.0,790,6969,1.0,3,6,790,0.0,1955,1380,12196,24538 days 16:47:18.681833,140,2.0,0.0,-590,-5227,790.0
319950.0,3,2.5,2240,7500,2.0,3,8,2240,0.0,1985,2190,7506,13580 days 16:47:18.681833,100,1.2,0.0,50,-6,2240.0
419000.0,3,1.5,1500,8272,1.0,4,7,1500,0.0,1958,1630,8270,23442 days 16:47:18.681833,211,2.0,0.0,-130,2,1500.0
205000.0,3,2.0,1800,11419,1.0,3,8,1800,0.0,1989,2220,11406,12119 days 16:47:18.681833,234,1.5,0.0,-420,13,1800.0
335000.0,4,2.5,1980,4745,2.0,3,7,1980,0.0,2004,1980,4878,6641 days 16:47:18.681833,296,1.6,0.0,0,-133,1980.0
397000.0,3,1.75,1340,5100,1.0,3,7,1340,0.0,1953,1550,5100,25268 days 16:47:18.681833,297,1.7142857142857142,0.0,-210,0,1340.0
370000.0,2,1.0,750,2020,1.0,3,7,750,0.0,1908,1630,2383,41705 days 16:47:18.681833,119,2.0,0.0,-880,-363,750.0
330000.0,4,2.25,1790,9920,1.0,4,7,1170,620.0,1969,1990,9648,19424 days 16:47:18.681833,261,1.7777777777777777,1.8870967741935485,-200,272,550.0
1790000.0,4,3.5,5490,14300,1.0,3,1,2910,2580.0,1996,4290,13822,9563 days 16:47:18.681833,303,1.1428571428571428,1.127906976744186,1200,478,330.0
399000.0,3,2.0,1940,16300,1.0,3,7,1140,800.0,1978,1940,11250,16137 days 16:47:18.681833,220,1.5,1.425,0,5050,340.0
400000.0,4,1.75,2670,189486,2.0,3,8,2670,0.0,1972,2190,218610,18329 days 16:47:18.681833,171,2.2857142857142856,0.0,480,-29124,2670.0
249900.0,3,2.0,1220,6404,1.0,3,7,1220,0.0,1994,1570,7000,10293 days 16:47:18.681833,198,1.5,0.0,-350,-596,1220.0
717000.0,3,1.5,1310,3880,1.0,3,7,1090,220.0,1956,1570,3880,24173 days 16:47:18.681833,133,2.0,4.954545454545454,-260,0,870.0
319000.0,4,2.5,1930,8336,2.0,3,8,1930,0.0,1995,2280,7959,9928 days 16:47:18.681833,219,1.6,0.0,-350,377,1930.0
635000.0,4,3.0,2100,3800,2.0,3,8,2100,0.0,1972,1320,3800,18329 days 16:47:18.681833,093,1.3333333333333333,0.0,780,0,2100.0
355000.0,3,1.0,1180,7573,1.0,4,7,1180,0.0,1977,1320,7573,16502 days 16:47:18.681833,253,3.0,0.0,-140,0,1180.0
1600000.0,5,3.25,4320,32840,2.0,3,1,4320,0.0,1990,4410,33210,11754 days 16:47:18.681833,091,1.5384615384615385,0.0,-90,-370,4320.0
585000.0,4,1.75,3140,12519,1.0,3,7,2320,820.0,1951,2240,7308,25999 days 16:47:18.681833,195,2.2857142857142856,2.8292682926829267,900,5211,1500.0
320000.0,3,2.0,2320,7800,1.0,4,7,1160,1160.0,1960,1380,7800,22712 days 16:47:18.681833,363,1.5,1.0,940,0,0.0
305495.0,3,1.75,2110,10200,2.0,4,7,2110,0.0,1966,1800,10200,20520 days 16:47:18.681833,134,1.7142857142857142,0.0,310,0,2110.0
240000.0,4,2.0,1790,14690,1.0,4,7,1670,120.0,1960,2440,10664,22712 days 16:47:18.681833,170,2.0,13.916666666666666,-650,4026,1550.0
199950.0,5,2.5,1740,8750,1.0,4,7,1740,0.0,1959,1740,8750,23077 days 16:47:18.681833,174,2.0,0.0,0,0,1740.0
1620000.0,4,3.25,3820,8114,2.0,3,1,3820,0.0,2005,2440,9195,6275 days 16:47:18.681833,238,1.2307692307692308,0.0,1380,-1081,3820.0
770000.0,3,3.5,2050,21744,2.0,4,9,1750,300.0,1930,2300,12200,33669 days 16:47:18.681833,049,0.8571428571428571,5.833333333333333,-250,9544,1450.0
255000.0,4,2.25,1680,3179,2.0,3,8,1680,0.0,2002,1678,3590,7371 days 16:47:18.681833,183,1.7777777777777777,0.0,2,-411,1680.0
289000.0,4,2.25,1930,8925,1.0,4,8,1930,0.0,1974,1930,8400,17598 days 16:47:18.681833,258,1.7777777777777777,0.0,0,525,1930.0
494500.0,4,3.0,3760,8804,2.0,3,8,2470,1290.0,2002,1960,7225,7371 days 16:47:18.681833,199,1.3333333333333333,1.9147286821705427,1800,1579,1180.0
746000.0,3,2.25,2370,9619,1.0,4,8,1650,720.0,1973,1960,9712,17963 days 16:47:18.681833,155,1.3333333333333333,2.2916666666666665,410,-93,930.0
385000.0,4,3.0,2120,13000,2.0,4,8,2120,0.0,1978,2180,11440,16137 days 16:47:18.681833,296,1.3333333333333333,0.0,-60,1560,2120.0
688100.0,4,2.5,2370,10513,2.0,4,8,2370,0.0,1987,2110,9540,12850 days 16:47:18.681833,322,1.6,0.0,260,973,2370.0
870300.0,4,2.5,2350,3150,1.5,4,8,1690,660.0,1910,1750,3150,40974 days 16:47:18.681833,132,1.6,2.5606060606060606,600,0,1030.0
310000.0,3,1.0,1180,8474,1.5,3,7,1180,0.0,1956,1180,7200,24173 days 16:47:18.681833,295,3.0,0.0,0,1274,1180.0
500000.0,3,2.5,2270,5654,2.0,3,8,2270,0.0,1999,1770,7840,8467 days 16:47:18.681833,071,1.2,0.0,500,-2186,2270.0
255000.0,3,2.25,1830,7770,1.0,4,7,1400,430.0,1977,1960,7272,16502 days 16:47:18.681833,226,1.3333333333333333,3.255813953488372,-130,498,970.0
1480000.0,3,2.75,3910,7080,1.0,5,9,1970,1940.0,1949,3480,7370,26729 days 16:47:18.681833,049,1.0909090909090908,1.0154639175257731,430,-290,30.0
154500.0,3,1.0,890,9465,1.0,3,6,890,0.0,1957,1590,9147,23807 days 16:47:18.681833,267,3.0,0.0,-700,318,890.0
425000.0,3,2.25,1820,8058,1.0,3,7,1260,560.0,1974,1850,7384,17598 days 16:47:18.681833,150,1.3333333333333333,2.25,-30,674,700.0
700000.0,4,2.5,2440,7491,2.0,4,1,2440,0.0,1988,2490,8580,12485 days 16:47:18.681833,202,1.6,0.0,-50,-1089,2440.0
410500.0,2,1.0,1110,3943,1.0,5,6,740,370.0,1916,1590,4311,38783 days 16:47:18.681833,325,2.0,2.0,-480,-368,370.0
432000.0,3,2.0,1870,7080,1.0,4,7,1210,660.0,1969,1620,8000,19424 days 16:47:18.681833,195,1.5,1.8333333333333333,250,-920,550.0
530000.0,3,1.5,1240,4080,1.5,3,8,1240,0.0,1914,1420,4080,39513 days 16:47:18.681833,104,2.0,0.0,-180,0,1240.0
465000.0,3,2.0,1560,8640,1.0,5,7,1560,0.0,1967,1970,8625,20155 days 16:47:18.681833,147,1.5,0.0,-410,15,1560.0
498688.0,3,2.5,1910,5600,2.0,3,8,1910,0.0,1989,1800,4928,12119 days 16:47:18.681833,266,1.2,0.0,110,672,1910.0
573500.0,3,1.0,2200,21450,1.0,4,9,1600,600.0,1952,1880,11250,25634 days 16:47:18.681833,092,3.0,2.6666666666666665,320,10200,1000.0
349900.0,4,2.75,2530,13474,2.0,4,8,2530,0.0,1994,2490,13140,10293 days 16:47:18.681833,288,1.4545454545454546,0.0,40,334,2530.0
220000.0,3,1.0,1130,12519,1.0,3,7,1130,0.0,1958,1460,12507,23442 days 16:47:18.681833,169,3.0,0.0,-330,12,1130.0
260000.0,2,1.0,820,6771,1.0,4,6,820,0.0,1918,1000,4440,38052 days 16:47:18.681833,212,2.0,0.0,-180,2331,820.0
290000.0,2,1.0,960,4000,1.0,3,6,960,0.0,1918,1210,4000,38052 days 16:47:18.681833,254,2.0,0.0,-250,0,960.0
615000.0,4,1.5,1980,3240,1.5,4,8,1780,200.0,1930,2250,4000,33669 days 16:47:18.681833,092,2.6666666666666665,8.9,-270,-760,1580.0
730000.0,4,3.5,3370,5638,2.0,3,1,2250,1120.0,2001,3080,7200,7736 days 16:47:18.681833,295,1.1428571428571428,2.0089285714285716,290,-1562,1130.0
1950000.0,4,3.25,7420,167869,2.0,3,1,7420,0.0,2002,5610,169549,7371 days 16:47:18.681833,012,1.2307692307692308,0.0,1810,-1680,7420.0
332500.0,3,2.25,1800,10500,2.0,3,7,1800,0.0,1995,1870,8555,9928 days 16:47:18.681833,141,1.3333333333333333,0.0,-70,1945,1800.0
650000.0,5,3.5,3990,10120,2.0,3,9,2820,1170.0,1990,2750,9622,11754 days 16:47:18.681833,358,1.4285714285714286,2.41025641025641,1240,498,1650.0
1400000.0,4,2.5,4070,7800,3.0,4,8,3390,680.0,2002,2020,6760,7371 days 16:47:18.681833,241,1.6,4.985294117647059,2050,1040,2710.0
465000.0,4,1.75,1640,7194,1.5,4,7,1480,160.0,1915,1440,9405,39148 days 16:47:18.681833,133,2.2857142857142856,9.25,200,-2211,1320.0
690000.0,4,3.25,3730,11820,2.0,3,1,2460,1270.0,1990,3680,10667,11754 days 16:47:18.681833,203,1.2307692307692308,1.937007874015748,50,1153,1190.0
289900.0,3,1.75,1220,7004,1.0,5,7,1220,0.0,1966,1640,7210,20520 days 16:47:18.681833,192,1.7142857142857142,0.0,-420,-206,1220.0
1620000.0,3,3.5,3490,4000,2.0,3,9,2570,920.0,2009,1880,4000,4814 days 16:47:18.681833,352,0.8571428571428571,2.7934782608695654,1610,0,1650.0
339950.0,3,2.5,1730,4286,2.0,3,7,1730,0.0,1999,1780,4343,8467 days 16:47:18.681833,112,1.2,0.0,-50,-57,1730.0
367999.0,4,2.75,3430,8000,1.5,4,8,3430,0.0,1972,2090,8000,18329 days 16:47:18.681833,113,1.4545454545454546,0.0,1340,0,3430.0
380000.0,4,2.5,2320,10079,2.0,3,7,2320,0.0,1994,2010,7438,10293 days 16:47:18.681833,049,1.6,0.0,310,2641,2320.0
440000.0,3,1.75,2030,17100,1.0,4,7,2030,0.0,1953,1950,14400,25268 days 16:47:18.681833,176,1.7142857142857142,0.0,80,2700,2030.0
975000.0,5,4.0,4850,36450,2.0,3,1,4850,0.0,1977,3850,35325,16502 days 16:47:18.681833,141,1.25,0.0,1000,1125,4850.0
309500.0,3,1.5,1340,13560,1.0,3,7,1340,0.0,1968,1540,15000,19790 days 16:47:18.681833,217,2.0,0.0,-200,-1440,1340.0
350000.0,3,1.0,1130,8201,1.0,5,6,1130,0.0,1948,1180,8203,27095 days 16:47:18.681833,204,3.0,0.0,-50,-2,1130.0
215000.0,2,2.0,1180,2521,2.0,3,6,1180,0.0,2005,1310,3003,6275 days 16:47:18.681833,075,1.0,0.0,-130,-482,1180.0
254000.0,2,1.0,910,6000,1.0,3,6,910,0.0,1943,1460,5800,28921 days 16:47:18.681833,238,2.0,0.0,-550,200,910.0
567000.0,3,1.75,1630,4275,1.5,3,7,1630,0.0,1908,1800,4275,41705 days 16:47:18.681833,110,1.7142857142857142,0.0,-170,0,1630.0
402000.0,2,1.0,710,1173,2.0,4,7,710,0.0,1943,1370,1173,28921 days 16:47:18.681833,149,2.0,0.0,-660,0,710.0
365000.0,4,1.0,1520,80150,1.0,2,5,1520,0.0,1948,1740,84506,27095 days 16:47:18.681833,324,4.0,0.0,-220,-4356,1520.0
625000.0,4,2.5,2820,8408,2.0,3,9,2820,0.0,2014,1300,8408,2988 days 16:47:18.681833,122,1.6,0.0,1520,0,2820.0
432000.0,4,1.75,1970,5160,1.5,3,7,1970,0.0,1942,1230,4920,29286 days 16:47:18.681833,113,2.2857142857142856,0.0,740,240,1970.0
335500.0,5,3.0,2240,19090,1.0,4,8,1700,540.0,1968,2280,20000,19790 days 16:47:18.681833,213,1.6666666666666667,3.1481481481481484,-40,-910,1160.0
672500.0,2,1.75,1860,5940,1.0,5,8,1020,840.0,1956,2130,5940,24173 days 16:47:18.681833,218,1.1428571428571428,1.2142857142857142,-270,0,180.0
336000.0,4,1.0,1780,4310,1.5,5,6,1780,0.0,1919,1460,4310,37687 days 16:47:18.681833,203,4.0,0.0,320,0,1780.0
294400.0,4,2.5,1788,10183,2.0,4,7,1788,0.0,1990,1700,6600,11754 days 16:47:18.681833,328,1.6,0.0,88,3583,1788.0
541900.0,3,2.5,1880,3054,2.0,3,8,1880,0.0,1988,1840,3815,12485 days 16:47:18.681833,110,1.2,0.0,40,-761,1880.0
505000.0,3,1.75,2300,11400,1.0,4,8,1520,780.0,1977,2300,10140,16502 days 16:47:18.681833,351,1.7142857142857142,1.9487179487179487,0,1260,740.0
255000.0,3,2.5,1610,6176,2.0,3,7,1610,0.0,1994,1680,7414,10293 days 16:47:18.681833,156,1.2,0.0,-70,-1238,1610.0
435000.0,6,2.5,2270,11970,1.0,3,7,1470,800.0,1964,2270,10640,21251 days 16:47:18.681833,022,2.4,1.8375,0,1330,670.0
636000.0,2,1.75,1230,3600,1.5,5,7,1230,0.0,1925,1210,4500,35495 days 16:47:18.681833,128,1.1428571428571428,0.0,20,-900,1230.0
655000.0,4,3.5,3420,33106,2.0,3,9,3420,0.0,2004,3420,36590,6641 days 16:47:18.681833,252,1.1428571428571428,0.0,0,-3484,3420.0
280500.0,3,1.5,1670,6988,1.0,3,7,1370,300.0,1953,1090,7753,25268 days 16:47:18.681833,077,2.0,4.566666666666666,580,-765,1070.0
520000.0,2,1.0,1120,6141,1.0,3,7,900,220.0,1946,1500,7529,27825 days 16:47:18.681833,112,2.0,4.090909090909091,-380,-1388,680.0
354000.0,4,2.5,2580,5476,2.0,3,8,2580,0.0,2005,2900,5476,6275 days 16:47:18.681833,177,1.6,0.0,-320,0,2580.0
810000.0,5,2.75,3847,17654,1.0,5,9,2299,1548.0,1975,2690,15344,17233 days 16:47:18.681833,234,1.8181818181818181,1.4851421188630491,1157,2310,751.0
400000.0,4,2.5,3630,42884,1.5,3,9,2300,1330.0,1979,2830,80148,15772 days 16:47:18.681833,122,1.6,1.7293233082706767,800,-37264,970.0
879900.0,4,2.75,3580,12000,1.0,3,1,1840,1740.0,1979,2910,12428,15772 days 16:47:18.681833,007,1.4545454545454546,1.0574712643678161,670,-428,100.0
1290000.0,5,4.0,4050,11358,2.0,4,1,2780,1270.0,1980,3120,13555,15407 days 16:47:18.681833,079,1.25,2.188976377952756,930,-2197,1510.0
902500.0,3,3.5,3240,23522,2.0,3,1,2130,1110.0,1992,3180,23273,11024 days 16:47:18.681833,092,0.8571428571428571,1.9189189189189189,60,249,1020.0
900000.0,3,1.75,1540,8400,1.5,3,7,1540,0.0,1902,1330,4800,43896 days 16:47:18.681833,133,1.7142857142857142,0.0,210,3600,1540.0
419500.0,4,2.5,2550,7200,2.0,3,7,2550,0.0,2003,2560,5715,7006 days 16:47:18.681833,198,1.6,0.0,-10,1485,2550.0
685000.0,4,2.0,2340,6000,1.0,5,8,1270,1070.0,1953,1600,6000,25268 days 16:47:18.681833,307,2.0,1.1869158878504673,740,0,200.0
429950.0,4,2.5,2320,4524,2.0,3,8,2320,0.0,2004,2330,4524,6641 days 16:47:18.681833,311,1.6,0.0,-10,0,2320.0
464950.0,4,2.5,1640,6000,2.0,3,7,1640,0.0,2011,1640,4800,4084 days 16:47:18.681833,113,1.6,0.0,0,1200,1640.0
239900.0,2,1.0,910,9000,1.0,4,6,910,0.0,1983,1410,9440,14311 days 16:47:18.681833,283,2.0,0.0,-500,-440,910.0
406250.0,4,3.25,2550,11524,2.0,3,8,2550,0.0,1990,2370,14001,11754 days 16:47:18.681833,049,1.2307692307692308,0.0,180,-2477,2550.0
447000.0,4,2.5,2660,8027,2.0,3,8,2660,0.0,1997,2480,8095,9197 days 16:47:18.681833,300,1.6,0.0,180,-68,2660.0
466800.0,3,2.5,1480,14250,2.0,3,7,1480,0.0,1996,1660,14250,9563 days 16:47:18.681833,156,1.2,0.0,-180,0,1480.0
674000.0,4,2.5,2810,11560,1.0,5,7,1740,1070.0,1962,1970,11560,21981 days 16:47:18.681833,260,1.6,1.6261682242990654,840,0,670.0
525000.0,1,1.0,830,3200,1.0,3,7,830,0.0,1924,1350,2512,35861 days 16:47:18.681833,330,1.0,0.0,-520,688,830.0
674950.0,3,2.75,3510,92347,2.0,3,1,3510,0.0,1990,2970,37070,11754 days 16:47:18.681833,121,1.0909090909090908,0.0,540,55277,3510.0
374900.0,3,2.5,2480,4950,2.0,3,7,2480,0.0,2004,2230,5298,6641 days 16:47:18.681833,119,1.2,0.0,250,-348,2480.0
1440000.0,4,3.0,3720,5000,2.5,5,9,2720,1000.0,1905,2610,5000,42800 days 16:47:18.681833,279,1.3333333333333333,2.72,1110,0,1720.0
559500.0,3,2.25,2150,9250,2.0,3,8,2150,0.0,1984,2240,9266,13946 days 16:47:18.681833,339,1.3333333333333333,0.0,-90,-16,2150.0
522500.0,3,2.5,2370,7875,2.0,3,9,2370,0.0,2003,2660,7752,7006 days 16:47:18.681833,136,1.2,0.0,-290,123,2370.0
1130000.0,5,2.5,4310,28008,2.0,3,1,4310,0.0,1988,3170,28559,12485 days 16:47:18.681833,117,2.0,0.0,1140,-551,4310.0
498500.0,5,2.75,2990,7420,2.0,3,8,2990,0.0,1996,2290,7678,9563 days 16:47:18.681833,163,1.8181818181818181,0.0,700,-258,2990.0
571000.0,4,1.0,1350,4000,1.5,3,8,1350,0.0,1930,1520,4000,33669 days 16:47:18.681833,237,4.0,0.0,-170,0,1350.0
543000.0,2,2.0,2370,217800,1.5,3,7,1600,770.0,1992,2370,157687,11024 days 16:47:18.681833,134,1.0,2.0779220779220777,0,60113,830.0
271920.0,3,2.0,1410,10248,1.0,3,7,1410,0.0,1985,2090,9414,13580 days 16:47:18.681833,063,1.5,0.0,-680,834,1410.0
104950.0,2,1.0,1170,8254,1.0,2,6,1170,0.0,1949,1820,8922,26729 days 16:47:18.681833,342,2.0,0.0,-650,-668,1170.0
1210000.0,4,2.75,3650,6982,2.0,4,9,2530,1120.0,1951,3140,7894,25999 days 16:47:18.681833,148,1.4545454545454546,2.2589285714285716,510,-912,1410.0
260250.0,3,1.75,1490,8357,1.0,4,7,1490,0.0,1993,1490,7376,10658 days 16:47:18.681833,022,1.7142857142857142,0.0,0,981,1490.0
875909.0,4,2.5,3610,13292,2.0,3,1,3610,0.0,1996,3000,10776,9563 days 16:47:18.681833,103,1.6,0.0,610,2516,3610.0
455000.0,4,1.75,2050,94525,1.0,4,7,1250,800.0,1959,2270,47480,23077 days 16:47:18.681833,157,2.2857142857142856,1.5625,-220,47045,450.0
309000.0,3,1.0,1092,7500,1.5,3,6,1092,0.0,1918,930,4000,38052 days 16:47:18.681833,140,3.0,0.0,162,3500,1092.0
229000.0,4,2.25,2010,7688,1.0,3,8,1170,840.0,1979,1990,7688,15772 days 16:47:18.681833,190,1.7777777777777777,1.3928571428571428,20,0,330.0
250000.0,3,2.0,1680,7900,2.0,4,7,1680,0.0,1953,1250,15600,25268 days 16:47:18.681833,119,1.5,0.0,430,-7700,1680.0
600000.0,4,2.0,2510,38141,1.0,3,9,2510,0.0,1960,3180,11760,22712 days 16:47:18.681833,148,2.0,0.0,-670,26381,2510.0
535000.0,4,2.5,2280,65836,2.0,3,8,2280,0.0,2004,2300,97574,6641 days 16:47:18.681833,128,1.6,0.0,-20,-31738,2280.0
571000.0,3,2.5,2510,5186,2.0,3,7,2510,0.0,2001,2530,5186,7736 days 16:47:18.681833,321,1.2,0.0,-20,0,2510.0
1030000.0,5,2.75,3190,16920,1.0,3,9,1690,1500.0,1976,3100,13100,16868 days 16:47:18.681833,125,1.8181818181818181,1.1266666666666667,90,3820,190.0
600000.0,4,3.25,4690,14930,2.0,3,1,3680,1010.0,1995,2910,13320,9928 days 16:47:18.681833,175,1.2307692307692308,3.6435643564356437,1780,1610,2670.0
469500.0,3,2.25,1850,12000,1.0,4,7,1300,550.0,1977,1580,12616,16502 days 16:47:18.681833,118,1.3333333333333333,2.3636363636363638,270,-616,750.0
1150000.0,4,3.0,4160,13170,2.0,3,1,3040,1120.0,2001,3780,13148,7736 days 16:47:18.681833,092,1.3333333333333333,2.7142857142857144,380,22,1920.0
785000.0,4,1.5,2220,4000,1.5,3,8,1970,250.0,1925,1984,4000,35495 days 16:47:18.681833,237,2.6666666666666665,7.88,236,0,1720.0
872750.0,3,2.5,2870,13695,2.0,3,1,2870,0.0,1991,2840,8472,11389 days 16:47:18.681833,118,1.2,0.0,30,5223,2870.0
900000.0,4,2.75,3950,10214,1.0,3,1,2050,1900.0,1955,3130,8608,24538 days 16:47:18.681833,227,1.4545454545454546,1.0789473684210527,820,1606,150.0
350000.0,2,1.75,1740,6620,1.5,3,8,1740,0.0,2002,1560,5400,7371 days 16:47:18.681833,198,1.1428571428571428,0.0,180,1220,1740.0
2580000.0,5,3.0,4780,20440,1.0,4,1,3660,1120.0,1975,4660,20440,17233 days 16:47:18.681833,100,1.6666666666666667,3.267857142857143,120,0,2540.0
940000.0,4,2.5,3160,39960,1.0,3,1,3160,0.0,1980,3900,36444,15407 days 16:47:18.681833,210,1.6,0.0,-740,3516,3160.0
185000.0,5,1.75,1990,27810,1.0,3,7,1990,0.0,1955,2240,20000,24538 days 16:47:18.681833,196,2.857142857142857,0.0,-250,7810,1990.0
850000.0,4,3.5,3920,37122,2.0,3,1,3920,0.0,1996,2550,32647,9563 days 16:47:18.681833,175,1.1428571428571428,0.0,1370,4475,3920.0
201000.0,3,1.0,960,15273,1.0,4,7,960,0.0,1963,1930,51400,21616 days 16:47:18.681833,260,3.0,0.0,-970,-36127,960.0
499000.0,2,1.5,1540,6549,2.0,3,7,1540,0.0,1980,1470,6552,15407 days 16:47:18.681833,007,1.3333333333333333,0.0,70,-3,1540.0
315000.0,4,2.5,1970,5190,2.0,3,7,1970,0.0,2002,1840,5564,7371 days 16:47:18.681833,098,1.6,0.0,130,-374,1970.0
509950.0,3,2.5,1880,4668,2.0,3,8,1880,0.0,1993,2060,4668,10658 days 16:47:18.681833,218,1.2,0.0,-180,0,1880.0
286300.0,3,2.75,2000,6405,1.0,3,8,1260,740.0,1964,2130,6510,21251 days 16:47:18.681833,056,1.0909090909090908,1.7027027027027026,-130,-105,520.0
590000.0,3,2.5,1990,8325,2.0,4,8,1310,680.0,1997,2450,10606,9197 days 16:47:18.681833,209,1.2,1.9264705882352942,-460,-2281,630.0
325000.0,4,1.0,1400,9384,1.5,4,6,1400,0.0,1948,1600,8432,27095 days 16:47:18.681833,247,4.0,0.0,-200,952,1400.0
625000.0,4,2.5,3190,27806,2.0,3,9,3190,0.0,1997,2810,28619,9197 days 16:47:18.681833,234,1.6,0.0,380,-813,3190.0
378000.0,3,1.5,1000,6914,1.0,3,7,1000,0.0,1947,1000,6947,27460 days 16:47:18.681833,317,2.0,0.0,0,-33,1000.0
239950.0,3,1.75,1670,6900,1.0,3,7,1170,500.0,1978,1740,7000,16137 days 16:47:18.681833,169,1.7142857142857142,2.34,-70,-100,670.0
550000.0,4,2.0,2100,4500,1.0,5,7,1060,1040.0,1924,1920,3900,35861 days 16:47:18.681833,315,2.0,1.0192307692307692,180,600,20.0
325000.0,2,1.0,1010,6180,1.0,3,6,1010,0.0,1903,1560,6180,43531 days 16:47:18.681833,112,2.0,0.0,-550,0,1010.0
831000.0,4,2.5,2030,3905,1.5,4,7,1630,400.0,1926,2000,3905,35130 days 16:47:18.681833,160,1.6,4.075,30,0,1230.0
249000.0,3,1.0,1090,10296,1.0,4,6,1090,0.0,1950,1910,10296,26364 days 16:47:18.681833,346,3.0,0.0,-820,0,1090.0
484000.0,4,1.75,2440,16730,1.0,3,7,1390,1050.0,1976,1390,11600,16868 days 16:47:18.681833,026,2.2857142857142856,1.3238095238095238,1050,5130,340.0
395000.0,4,3.0,2500,6278,2.0,3,9,2500,0.0,2002,2700,7200,7371 days 16:47:18.681833,325,1.3333333333333333,0.0,-200,-922,2500.0
839900.0,4,2.5,3420,7462,2.0,3,9,3420,0.0,2002,3080,8031,7371 days 16:47:18.681833,323,1.6,0.0,340,-569,3420.0
760000.0,4,2.5,2850,11000,2.0,3,8,2850,0.0,1998,1720,11000,8832 days 16:47:18.681833,317,1.6,0.0,1130,0,2850.0
750000.0,4,1.5,2030,3300,1.5,4,8,1530,500.0,1927,2610,5400,34765 days 16:47:18.681833,132,2.6666666666666665,3.06,-580,-2100,1030.0
3000000.0,5,3.75,4590,11265,2.0,4,1,3450,1140.0,1927,3870,8996,34765 days 16:47:18.681833,098,1.3333333333333333,3.026315789473684,720,2269,2310.0
440000.0,3,2.5,2230,5800,2.0,3,7,2230,0.0,2004,2230,6088,6641 days 16:47:18.681833,258,1.2,0.0,0,-288,2230.0
501000.0,2,1.75,1810,7523,1.0,3,8,1170,640.0,1962,2090,7523,21981 days 16:47:18.681833,337,1.1428571428571428,1.828125,-280,0,530.0
739000.0,6,4.5,4000,7500,2.0,3,7,4000,0.0,1978,1380,6298,16137 days 16:47:18.681833,267,1.3333333333333333,0.0,2620,1202,4000.0
685650.0,3,1.75,1490,16200,1.0,5,8,1490,0.0,1958,2070,16200,23442 days 16:47:18.681833,251,1.7142857142857142,0.0,-580,0,1490.0
1010000.0,4,4.5,4225,284011,2.0,4,1,4225,0.0,1985,2870,14576,13580 days 16:47:18.681833,176,0.8888888888888888,0.0,1355,269435,4225.0
980000.0,4,1.75,2120,4000,1.5,4,8,1920,200.0,1929,2300,4000,34034 days 16:47:18.681833,259,2.2857142857142856,9.6,-180,0,1720.0
275000.0,3,1.5,1030,7184,1.0,4,7,1030,0.0,1968,1330,7262,19790 days 16:47:18.681833,273,2.0,0.0,-300,-78,1030.0
319950.0,4,1.75,2310,8045,1.0,4,7,1650,660.0,1976,1790,8086,16868 days 16:47:18.681833,139,2.2857142857142856,2.5,520,-41,990.0
448500.0,3,2.25,1830,7943,2.0,3,8,1830,0.0,1985,2100,8070,13580 days 16:47:18.681833,079,1.3333333333333333,0.0,-270,-127,1830.0
437000.0,5,2.0,2120,137565,1.5,3,7,2120,0.0,1913,2120,157123,39878 days 16:47:18.681833,154,2.5,0.0,0,-19558,2120.0
330000.0,4,1.5,2500,9448,1.0,4,7,1250,1250.0,1966,1640,9490,20520 days 16:47:18.681833,311,2.6666666666666665,1.0,860,-42,0.0
365000.0,3,2.5,2470,7700,2.0,4,8,2470,0.0,1990,2400,7700,11754 days 16:47:18.681833,351,1.2,0.0,70,0,2470.0
329000.0,2,1.0,940,7700,1.0,4,6,940,0.0,1916,1290,7375,38783 days 16:47:18.681833,316,2.0,0.0,-350,325,940.0
681500.0,5,2.75,3260,11700,1.0,3,8,1630,1630.0,1964,2860,11700,21251 days 16:47:18.681833,171,1.8181818181818181,1.0,400,0,0.0
566000.0,3,2.25,1660,10140,1.0,4,8,1370,290.0,1980,2100,10125,15407 days 16:47:18.681833,129,1.3333333333333333,4.724137931034483,-440,15,1080.0
897500.0,4,3.0,4370,217882,2.0,3,1,4370,0.0,1984,2430,35096,13946 days 16:47:18.681833,293,1.3333333333333333,0.0,1940,182786,4370.0
738000.0,3,2.5,2620,9112,2.0,3,9,2620,0.0,1995,2620,9067,9928 days 16:47:18.681833,363,1.2,0.0,0,45,2620.0
185000.0,3,1.75,1500,7800,1.0,3,7,1500,0.0,1968,1490,7800,19790 days 16:47:18.681833,110,1.7142857142857142,0.0,10,0,1500.0
445000.0,2,1.0,910,7200,1.0,4,7,830,80.0,1936,1700,7200,31478 days 16:47:18.681833,063,2.0,10.375,-790,0,750.0
175000.0,3,1.75,1430,4920,1.0,2,6,1430,0.0,1957,1550,5646,23807 days 16:47:18.681833,084,1.7142857142857142,0.0,-120,-726,1430.0
315000.0,2,1.0,900,8556,1.0,3,6,760,140.0,1941,1500,8556,29651 days 16:47:18.681833,325,2.0,5.428571428571429,-600,0,620.0
445000.0,4,1.75,1250,7400,1.0,5,6,1250,0.0,1959,990,7600,23077 days 16:47:18.681833,175,2.2857142857142856,0.0,260,-200,1250.0
1400000.0,5,3.0,3850,14990,1.0,4,9,2290,1560.0,1964,3010,15001,21251 days 16:47:18.681833,217,1.6666666666666667,1.4679487179487178,840,-11,730.0
832500.0,4,2.5,3450,35100,2.0,3,1,3450,0.0,1987,3110,35894,12850 days 16:47:18.681833,330,1.6,0.0,340,-794,3450.0
771150.0,4,3.5,3950,12320,2.0,3,1,3950,0.0,2001,3920,11086,7736 days 16:47:18.681833,198,1.1428571428571428,0.0,30,1234,3950.0
225000.0,4,1.5,1950,12559,1.5,3,6,1950,0.0,1939,1950,9178,30382 days 16:47:18.681833,133,2.6666666666666665,0.0,0,3381,1950.0
389950.0,3,2.5,1700,6396,2.0,3,7,1700,0.0,2003,1700,4444,7006 days 16:47:18.681833,266,1.2,0.0,0,1952,1700.0
435000.0,3,2.5,2370,6082,2.0,3,7,2370,0.0,2004,2690,6152,6641 days 16:47:18.681833,216,1.2,0.0,-320,-70,2370.0
1300000.0,4,1.75,4060,5500,2.0,5,9,2660,1400.0,1924,3320,5500,35861 days 16:47:18.681833,206,2.2857142857142856,1.9,740,0,1260.0
350000.0,3,2.25,1322,1796,2.0,3,8,1087,235.0,2005,1690,2025,6275 days 16:47:18.681833,195,1.3333333333333333,4.625531914893617,-368,-229,852.0
250000.0,3,1.75,1140,10400,1.0,4,7,1140,0.0,1983,1280,9800,14311 days 16:47:18.681833,189,1.7142857142857142,0.0,-140,600,1140.0
370000.0,2,1.5,1280,2096,2.0,3,7,1080,200.0,2007,1340,7452,5545 days 16:47:18.681833,120,1.3333333333333333,5.4,-60,-5356,880.0
750000.0,4,2.5,3080,4553,2.5,3,8,3080,0.0,2008,2750,4929,5180 days 16:47:18.681833,210,1.6,0.0,330,-376,3080.0
439950.0,2,1.75,1210,3000,1.0,5,7,910,300.0,1906,1260,3000,42435 days 16:47:18.681833,237,1.1428571428571428,3.033333333333333,-50,0,610.0
395000.0,4,1.75,1950,10219,1.0,3,7,1950,0.0,1962,1500,9099,21981 days 16:47:18.681833,307,2.2857142857142856,0.0,450,1120,1950.0
375000.0,4,1.0,1450,6820,1.5,3,6,1450,0.0,1947,1450,6820,27460 days 16:47:18.681833,219,4.0,0.0,0,0,1450.0
263000.0,3,2.25,1590,7748,2.0,4,7,1590,0.0,1991,1590,7606,11389 days 16:47:18.681833,135,1.3333333333333333,0.0,0,142,1590.0
185000.0,3,1.0,1240,9198,1.5,4,7,1240,0.0,1959,1170,8970,23077 days 16:47:18.681833,342,3.0,0.0,70,228,1240.0
500000.0,3,1.0,1440,54315,1.0,3,7,790,650.0,1974,2690,40518,17598 days 16:47:18.681833,056,3.0,1.2153846153846153,-1250,13797,140.0
920000.0,4,2.5,3470,10045,2.0,3,1,3470,0.0,1993,4370,12359,10658 days 16:47:18.681833,269,1.6,0.0,-900,-2314,3470.0
936000.0,7,3.75,5100,21802,2.0,3,1,3640,1460.0,2001,3350,10005,7736 days 16:47:18.681833,297,1.8666666666666667,2.493150684931507,1750,11797,2180.0
1500000.0,3,1.75,2430,12757,1.0,4,8,1340,1090.0,1952,2930,12450,25634 days 16:47:18.681833,128,1.7142857142857142,1.2293577981651376,-500,307,250.0
1100000.0,3,2.25,2420,7200,1.0,3,8,1420,1000.0,1948,2500,7200,27095 days 16:47:18.681833,300,1.3333333333333333,1.42,-80,0,420.0
247000.0,3,2.5,1510,10875,1.0,3,7,1150,360.0,1990,1810,9916,11754 days 16:47:18.681833,002,1.2,3.1944444444444446,-300,959,790.0
289500.0,3,1.0,1200,5525,1.0,2,7,1200,0.0,1947,1580,7200,27460 days 16:47:18.681833,115,3.0,0.0,-380,-1675,1200.0
432500.0,3,2.5,2240,6396,2.0,3,7,2240,0.0,2002,2610,5128,7371 days 16:47:18.681833,153,1.2,0.0,-370,1268,2240.0
680000.0,3,1.75,1870,4320,1.0,4,7,970,900.0,1920,1810,3900,37322 days 16:47:18.681833,086,1.7142857142857142,1.0777777777777777,60,420,70.0
589000.0,3,1.0,1110,6000,1.5,5,7,1110,0.0,1932,1420,6000,32939 days 16:47:18.681833,148,3.0,0.0,-310,0,1110.0
756450.0,4,2.0,3210,8400,1.5,5,7,2040,1170.0,1914,2540,6458,39513 days 16:47:18.681833,357,2.0,1.7435897435897436,670,1942,870.0
536650.0,3,1.75,2090,8910,1.0,3,8,1230,860.0,1975,2310,10695,17233 days 16:47:18.681833,097,1.7142857142857142,1.430232558139535,-220,-1785,370.0
540000.0,3,2.25,1320,1800,2.0,3,7,1320,0.0,1994,2010,4500,10293 days 16:47:18.681833,183,1.3333333333333333,0.0,-690,-2700,1320.0
385000.0,3,1.75,1340,3850,1.0,4,7,1340,0.0,1960,1540,7645,22712 days 16:47:18.681833,118,1.7142857142857142,0.0,-200,-3795,1340.0
485000.0,3,1.0,1020,6120,1.0,3,7,1020,0.0,1941,2370,6695,29651 days 16:47:18.681833,245,3.0,0.0,-1350,-575,1020.0
240000.0,3,2.0,1220,17652,1.0,4,7,1220,0.0,1980,1990,17652,15407 days 16:47:18.681833,269,1.5,0.0,-770,0,1220.0
415500.0,3,2.0,1220,17652,1.0,4,7,1220,0.0,1980,1990,17652,15407 days 16:47:18.681833,085,1.5,0.0,-770,0,1220.0
550000.0,3,2.0,1390,2688,1.5,5,7,1390,0.0,1915,1440,2900,39148 days 16:47:18.681833,317,1.5,0.0,-50,-212,1390.0
430000.0,2,2.0,1440,213008,2.0,4,7,1440,0.0,1990,1630,161172,11754 days 16:47:18.681833,196,1.0,0.0,-190,51836,1440.0
415000.0,2,1.75,1550,4257,1.0,3,7,830,720.0,1953,1920,5100,25268 days 16:47:18.681833,316,1.1428571428571428,1.1527777777777777,-370,-843,110.0
365000.0,4,2.5,1904,8200,2.0,5,7,1904,0.0,1999,1560,12426,8467 days 16:47:18.681833,028,1.6,0.0,344,-4226,1904.0
257000.0,4,1.5,1400,8500,2.0,3,7,1400,0.0,1975,1580,7650,17233 days 16:47:18.681833,344,2.6666666666666665,0.0,-180,850,1400.0
420000.0,3,2.5,2140,3821,2.0,3,8,2140,0.0,2005,2860,3841,6275 days 16:47:18.681833,175,1.2,0.0,-720,-20,2140.0
338995.0,3,1.75,1320,9450,1.0,5,7,1320,0.0,1943,1320,8315,28921 days 16:47:18.681833,259,1.7142857142857142,0.0,0,1135,1320.0
615000.0,3,1.75,2620,8280,1.0,4,7,1330,1290.0,1948,1530,8160,27095 days 16:47:18.681833,100,1.7142857142857142,1.0310077519379846,1090,120,40.0
513000.0,4,2.5,2000,5684,2.0,3,8,2000,0.0,1996,2210,7066,9563 days 16:47:18.681833,126,1.6,0.0,-210,-1382,2000.0
857500.0,4,2.75,2960,5040,2.0,3,9,2210,750.0,1952,2270,5500,25634 days 16:47:18.681833,027,1.4545454545454546,2.9466666666666668,690,-460,1460.0
1060000.0,3,2.75,2700,22343,1.5,4,1,2700,0.0,1977,3390,15682,16502 days 16:47:18.681833,364,1.0909090909090908,0.0,-690,6661,2700.0
585000.0,3,1.75,1740,9500,1.0,4,8,1150,590.0,1958,2110,9450,23442 days 16:47:18.681833,203,1.7142857142857142,1.9491525423728813,-370,50,560.0
350500.0,2,2.5,1770,4950,1.0,3,7,1770,0.0,2003,1770,4500,7006 days 16:47:18.681833,281,0.8,0.0,0,450,1770.0
215000.0,3,2.0,1290,9312,1.0,3,7,1290,0.0,1947,1650,7300,27460 days 16:47:18.681833,279,1.5,0.0,-360,2012,1290.0
440000.0,4,2.0,1450,8400,1.5,4,7,1450,0.0,1962,1450,7440,21981 days 16:47:18.681833,168,2.0,0.0,0,960,1450.0
270000.0,3,2.25,1420,7800,1.0,4,7,1130,290.0,1985,1460,7800,13580 days 16:47:18.681833,117,1.3333333333333333,3.896551724137931,-40,0,840.0
385000.0,3,0.75,1330,7020,1.0,5,7,1330,0.0,1924,1410,5802,35861 days 16:47:18.681833,296,4.0,0.0,-80,1218,1330.0
688500.0,3,1.75,1760,4125,1.5,4,7,1760,0.0,1927,1760,4000,34765 days 16:47:18.681833,321,1.7142857142857142,0.0,0,125,1760.0
700000.0,3,1.75,2010,4905,1.0,5,7,1230,780.0,1912,2210,1834,40244 days 16:47:18.681833,139,1.7142857142857142,1.5769230769230769,-200,3071,450.0
585000.0,5,2.0,2560,14467,1.0,3,8,1280,1280.0,1960,2200,10267,22712 days 16:47:18.681833,234,2.5,1.0,360,4200,0.0
401000.0,2,1.5,1260,2625,2.0,4,7,1260,0.0,1983,1260,2625,14311 days 16:47:18.681833,057,1.3333333333333333,0.0,0,0,1260.0
655000.0,4,2.25,2420,7725,1.0,4,8,1890,530.0,1972,1740,7944,18329 days 16:47:18.681833,065,1.7777777777777777,3.5660377358490565,680,-219,1360.0
317000.0,3,1.0,1010,5400,1.0,3,6,1010,0.0,1959,960,5400,23077 days 16:47:18.681833,155,3.0,0.0,50,0,1010.0
500000.0,4,2.5,1770,8155,1.5,4,6,1770,0.0,1970,1460,7360,19059 days 16:47:18.681833,125,1.6,0.0,310,795,1770.0
314963.0,2,1.0,890,6350,1.0,3,6,890,0.0,1943,1490,6350,28921 days 16:47:18.681833,294,2.0,0.0,-600,0,890.0
715000.0,3,1.5,1670,5060,2.0,5,7,1670,0.0,1925,1670,5118,35495 days 16:47:18.681833,300,2.0,0.0,0,-58,1670.0
280000.0,3,2.25,1360,9600,2.0,3,7,1360,0.0,1992,1200,10400,11024 days 16:47:18.681833,287,1.3333333333333333,0.0,160,-800,1360.0
531000.0,3,2.5,2120,9736,2.0,3,9,2120,0.0,1988,2490,8763,12485 days 16:47:18.681833,163,1.2,0.0,-370,973,2120.0
440000.0,4,1.0,1480,7560,1.5,3,7,1480,0.0,1940,1480,7560,30017 days 16:47:18.681833,282,4.0,0.0,0,0,1480.0
140000.0,3,1.0,1090,10114,1.0,4,7,1090,0.0,1955,1380,7800,24538 days 16:47:18.681833,210,3.0,0.0,-290,2314,1090.0
661000.0,4,1.75,1670,13125,1.0,5,8,1670,0.0,1973,2360,12500,17963 days 16:47:18.681833,044,2.2857142857142856,0.0,-690,625,1670.0
697000.0,4,1.75,1670,13125,1.0,5,8,1670,0.0,1973,2360,12500,17963 days 16:47:18.681833,119,2.2857142857142856,0.0,-690,625,1670.0
1200000.0,5,2.75,3650,13297,2.0,5,9,2750,900.0,1969,2900,11568,19424 days 16:47:18.681833,178,1.8181818181818181,3.0555555555555554,750,1729,1850.0
535000.0,4,2.0,1970,3515,1.0,5,8,1030,940.0,1969,1650,4275,19424 days 16:47:18.681833,263,2.0,1.0957446808510638,320,-760,90.0
404500.0,2,2.0,1320,3060,1.5,4,6,1320,0.0,1910,1410,3264,40974 days 16:47:18.681833,083,1.0,0.0,-90,-204,1320.0
396500.0,3,1.0,1710,5110,1.0,3,7,1100,610.0,1954,1310,5110,24903 days 16:47:18.681833,316,3.0,1.8032786885245902,400,0,490.0
450000.0,3,2.25,1740,9488,1.0,4,8,1180,560.0,1977,1880,8615,16502 days 16:47:18.681833,079,1.3333333333333333,2.107142857142857,-140,873,620.0
605000.0,3,3.25,2200,2400,2.0,3,8,1740,460.0,1988,2200,3600,12485 days 16:47:18.681833,016,0.9230769230769231,3.782608695652174,0,-1200,1280.0
699000.0,3,2.0,2010,4320,2.0,3,9,2010,0.0,1999,1640,5225,8467 days 16:47:18.681833,254,1.5,0.0,370,-905,2010.0
805000.0,3,3.0,3910,19023,2.0,3,1,3910,0.0,1985,1860,15001,13580 days 16:47:18.681833,170,1.0,0.0,2050,4022,3910.0
156000.0,1,0.75,470,15000,1.0,3,4,470,0.0,1947,1730,22500,27460 days 16:47:18.681833,050,1.3333333333333333,0.0,-1260,-7500,470.0
595000.0,4,2.5,2330,7064,1.0,4,8,1780,550.0,1984,1740,8075,13946 days 16:47:18.681833,065,1.6,3.2363636363636363,590,-1011,1230.0
285000.0,3,1.75,1930,7200,1.5,3,6,1930,0.0,1929,1350,9000,34034 days 16:47:18.681833,209,1.7142857142857142,0.0,580,-1800,1930.0
725000.0,4,2.5,3270,6055,2.0,3,9,3270,0.0,2007,2740,7367,5545 days 16:47:18.681833,084,1.6,0.0,530,-1312,3270.0
216300.0,3,2.5,1650,5000,2.0,3,8,1650,0.0,1985,1720,5000,13580 days 16:47:18.681833,329,1.2,0.0,-70,0,1650.0
410000.0,4,2.75,2220,8450,1.0,4,7,1260,960.0,1983,1580,8450,14311 days 16:47:18.681833,293,1.4545454545454546,1.3125,640,0,300.0
597000.0,2,1.75,2470,4600,1.0,4,7,1140,1330.0,1916,1790,5175,38783 days 16:47:18.681833,246,1.1428571428571428,0.8571428571428571,680,-575,-190.0
325000.0,3,1.0,1300,9300,1.0,4,7,1300,0.0,1977,1300,10064,16502 days 16:47:18.681833,049,3.0,0.0,0,-764,1300.0
355000.0,5,2.75,2530,9375,1.0,5,7,1530,1000.0,1966,2250,8200,20520 days 16:47:18.681833,091,1.8181818181818181,1.53,280,1175,530.0
338000.0,3,1.5,2400,8215,1.0,3,7,1200,1200.0,1961,1460,8217,22346 days 16:47:18.681833,352,2.0,1.0,940,-2,0.0
210000.0,4,2.25,1500,5393,2.0,3,7,1500,0.0,1999,1700,5917,8467 days 16:47:18.681833,322,1.7777777777777777,0.0,-200,-524,1500.0
423000.0,4,1.75,1700,9000,1.0,3,7,1700,0.0,1967,1930,7818,20155 days 16:47:18.681833,226,2.2857142857142856,0.0,-230,1182,1700.0
249500.0,4,1.5,2120,8554,1.0,4,7,1170,950.0,1977,1790,8554,16502 days 16:47:18.681833,042,2.6666666666666665,1.231578947368421,330,0,220.0
325000.0,4,2.5,2240,5105,2.0,4,8,2240,0.0,2002,1920,5288,7371 days 16:47:18.681833,010,1.6,0.0,320,-183,2240.0
257000.0,3,1.75,1540,8223,1.0,4,7,1070,470.0,1987,1240,8113,12850 days 16:47:18.681833,084,1.7142857142857142,2.276595744680851,300,110,600.0
550000.0,3,1.75,1890,100623,1.0,3,8,1890,0.0,1978,2110,50529,16137 days 16:47:18.681833,110,1.7142857142857142,0.0,-220,50094,1890.0
490000.0,3,1.0,1260,9638,2.0,4,7,1260,0.0,1920,1760,7822,37322 days 16:47:18.681833,318,3.0,0.0,-500,1816,1260.0
299000.0,2,1.5,1160,3838,2.0,3,7,1160,0.0,1983,1410,3780,14311 days 16:47:18.681833,033,1.3333333333333333,0.0,-250,58,1160.0
295000.0,2,1.0,1300,39639,1.0,4,6,1300,0.0,1960,1880,98881,22712 days 16:47:18.681833,307,2.0,0.0,-580,-59242,1300.0
630000.0,4,2.5,3220,14463,2.0,3,8,3220,0.0,1978,2550,12109,16137 days 16:47:18.681833,302,1.6,0.0,670,2354,3220.0
320000.0,4,1.5,2020,8474,1.0,5,7,1010,1010.0,1962,1720,8166,21981 days 16:47:18.681833,114,2.6666666666666665,1.0,300,308,0.0
1110000.0,4,2.5,2990,8640,1.0,5,8,2100,890.0,1959,2270,8800,23077 days 16:47:18.681833,114,1.6,2.359550561797753,720,-160,1210.0
398000.0,4,1.0,1420,6458,1.0,4,7,1420,0.0,1953,1670,6350,25268 days 16:47:18.681833,265,4.0,0.0,-250,108,1420.0
218000.0,3,1.0,1020,7874,1.0,3,7,1020,0.0,1956,1290,7320,24173 days 16:47:18.681833,141,3.0,0.0,-270,554,1020.0
590000.0,4,2.75,2400,104108,2.0,3,8,2400,0.0,1988,2270,54450,12485 days 16:47:18.681833,062,1.4545454545454546,0.0,130,49658,2400.0
1600000.0,5,3.0,3640,8239,2.0,3,1,2540,1100.0,1982,3330,10643,14676 days 16:47:18.681833,152,1.6666666666666667,2.309090909090909,310,-2404,1440.0
348500.0,2,2.25,1550,1824,2.0,3,8,1550,0.0,2007,1460,1826,5545 days 16:47:18.681833,352,0.8888888888888888,0.0,90,-2,1550.0
592500.0,2,2.0,1870,4751,1.0,3,8,1870,0.0,2006,2170,5580,5910 days 16:47:18.681833,206,1.0,0.0,-300,-829,1870.0
505000.0,3,2.5,2340,5957,2.0,3,8,2340,0.0,1995,2340,6604,9928 days 16:47:18.681833,161,1.2,0.0,0,-647,2340.0
1430000.0,5,4.25,3350,3600,2.0,3,1,2260,1090.0,2014,1810,3600,2988 days 16:47:18.681833,302,1.1764705882352942,2.073394495412844,1540,0,1170.0
502000.0,3,1.0,1710,5000,1.0,5,7,1140,570.0,1921,1670,4000,36956 days 16:47:18.681833,202,3.0,2.0,40,1000,570.0
257500.0,2,2.0,1180,9265,1.0,3,7,1180,0.0,1940,460,18000,30017 days 16:47:18.681833,175,1.0,0.0,720,-8735,1180.0
405000.0,3,1.5,1600,7500,1.0,3,7,1600,0.0,1966,1700,7500,20520 days 16:47:18.681833,192,2.0,0.0,-100,0,1600.0
427000.0,3,1.75,1300,5111,1.0,4,7,1300,0.0,1959,1370,5111,23077 days 16:47:18.681833,076,1.7142857142857142,0.0,-70,0,1300.0
290000.0,3,1.5,1040,9997,1.0,4,7,1040,0.0,1955,1040,8699,24538 days 16:47:18.681833,338,2.0,0.0,0,1298,1040.0
222000.0,3,1.0,1220,7695,1.0,3,7,1220,0.0,1954,1210,7412,24903 days 16:47:18.681833,083,3.0,0.0,10,283,1220.0
315000.0,3,2.5,2240,6097,2.0,3,8,2240,0.0,2002,2240,5574,7371 days 16:47:18.681833,352,1.2,0.0,0,523,2240.0
371000.0,3,1.5,1420,4500,1.0,3,7,1420,0.0,1959,1540,6375,23077 days 16:47:18.681833,155,2.0,0.0,-120,-1875,1420.0
279900.0,3,1.75,1580,6620,1.0,3,7,1580,0.0,1988,1580,8137,12485 days 16:47:18.681833,177,1.7142857142857142,0.0,0,-1517,1580.0
250000.0,3,1.5,2390,23522,1.0,2,7,1890,500.0,1938,2430,23958,30747 days 16:47:18.681833,110,2.0,3.78,-40,-436,1390.0
599000.0,4,2.25,2260,29930,2.0,4,8,1400,860.0,1977,2770,29930,16502 days 16:47:18.681833,126,1.7777777777777777,1.627906976744186,-510,0,540.0
267300.0,3,1.75,1890,93218,1.0,4,7,1890,0.0,1964,1690,172062,21251 days 16:47:18.681833,197,1.7142857142857142,0.0,200,-78844,1890.0
585000.0,2,1.75,1830,7200,1.0,4,7,1070,760.0,1949,1570,6000,26729 days 16:47:18.681833,345,1.1428571428571428,1.4078947368421053,260,1200,310.0
350000.0,3,1.75,1000,8268,1.0,3,6,1000,0.0,1969,1220,7800,19424 days 16:47:18.681833,104,1.7142857142857142,0.0,-220,468,1000.0
506000.0,3,1.75,2180,7700,1.0,3,8,1480,700.0,1961,2180,7604,22346 days 16:47:18.681833,168,1.7142857142857142,2.1142857142857143,0,96,780.0
400000.0,6,2.0,2320,210830,2.0,4,8,2320,0.0,1962,2540,217800,21981 days 16:47:18.681833,317,3.0,0.0,-220,-6970,2320.0
151100.0,3,1.0,840,4495,1.0,3,6,840,0.0,1921,1260,7434,36956 days 16:47:18.681833,308,3.0,0.0,-420,-2939,840.0
251000.0,3,1.0,840,4495,1.0,3,6,840,0.0,1921,1260,7434,36956 days 16:47:18.681833,111,3.0,0.0,-420,-2939,840.0
555000.0,4,2.25,2350,8140,1.0,4,8,1430,920.0,1977,2640,8700,16502 days 16:47:18.681833,142,1.7777777777777777,1.5543478260869565,-290,-560,510.0
467500.0,3,1.75,2040,273556,1.0,3,7,2040,0.0,1997,1790,273556,9197 days 16:47:18.681833,279,1.7142857142857142,0.0,250,0,2040.0
479000.0,4,2.5,2370,30378,2.0,3,8,2370,0.0,1996,2870,34834,9563 days 16:47:18.681833,097,1.6,0.0,-500,-4456,2370.0
247000.0,5,2.0,1590,9350,1.0,5,7,1060,530.0,1962,1460,8210,21981 days 16:47:18.681833,106,2.5,2.0,130,1140,530.0
299500.0,3,1.0,1380,10875,1.0,3,7,1380,0.0,1977,1040,10875,16502 days 16:47:18.681833,023,3.0,0.0,340,0,1380.0
306888.0,4,1.5,1940,8970,1.5,3,7,1270,670.0,1980,1960,8470,15407 days 16:47:18.681833,127,2.6666666666666665,1.8955223880597014,-20,500,600.0
675000.0,4,2.5,3320,244807,2.0,3,9,3320,0.0,2001,2530,217800,7736 days 16:47:18.681833,279,1.6,0.0,790,27007,3320.0
577000.0,2,1.0,1090,5265,1.5,4,7,1090,0.0,1947,2080,4000,27460 days 16:47:18.681833,111,2.0,0.0,-990,1265,1090.0
219950.0,3,1.5,1650,9936,1.0,3,7,1090,560.0,1967,1560,9890,20155 days 16:47:18.681833,140,2.0,1.9464285714285714,90,46,530.0
375000.0,3,1.5,1110,5500,1.0,3,6,1110,0.0,1940,1670,6600,30017 days 16:47:18.681833,204,2.0,0.0,-560,-1100,1110.0
650000.0,4,2.5,2110,6820,1.0,5,7,1530,580.0,1942,1420,6431,29286 days 16:47:18.681833,311,1.6,2.6379310344827585,690,389,950.0
975000.0,3,3.0,1850,5000,1.5,2,6,1850,0.0,1900,1360,2500,44626 days 16:47:18.681833,096,1.0,0.0,490,2500,1850.0
229000.0,1,1.0,600,3720,1.0,3,6,600,0.0,1920,1480,4800,37322 days 16:47:18.681833,119,1.0,0.0,-880,-1080,600.0
575000.0,5,2.5,2760,4000,1.5,3,8,1730,1030.0,1926,1680,4000,35130 days 16:47:18.681833,264,2.0,1.6796116504854368,1080,0,700.0
815000.0,4,1.75,2970,14880,1.0,5,9,1560,1410.0,1962,3310,13388,21981 days 16:47:18.681833,118,2.2857142857142856,1.1063829787234043,-340,1492,150.0
525000.0,3,1.75,2300,43560,1.0,4,7,1350,950.0,1979,2320,57000,15772 days 16:47:18.681833,218,1.7142857142857142,1.4210526315789473,-20,-13440,400.0
471000.0,3,2.5,2030,2805,2.0,3,8,1720,310.0,2001,1670,2898,7736 days 16:47:18.681833,157,1.2,5.548387096774194,360,-93,1410.0
450000.0,4,1.75,2160,4333,1.0,4,8,1260,900.0,1942,1670,4426,29286 days 16:47:18.681833,174,2.2857142857142856,1.4,490,-93,360.0
590000.0,3,2.0,1650,6150,2.0,4,7,1650,0.0,1926,1280,6150,35130 days 16:47:18.681833,148,1.5,0.0,370,0,1650.0
744000.0,4,2.5,3140,7260,2.0,3,8,2200,940.0,2004,2860,8186,6641 days 16:47:18.681833,213,1.6,2.3404255319148937,280,-926,1260.0
460000.0,4,2.25,2690,36114,2.0,4,9,2690,0.0,1986,2570,35091,13215 days 16:47:18.681833,335,1.7777777777777777,0.0,120,1023,2690.0
299000.0,5,2.5,1940,9389,1.0,4,7,1290,650.0,1960,1810,9390,22712 days 16:47:18.681833,072,2.0,1.9846153846153847,130,-1,640.0
231000.0,4,1.0,1220,5120,1.5,5,6,1220,0.0,1940,1540,7670,30017 days 16:47:18.681833,029,4.0,0.0,-320,-2550,1220.0
195000.0,3,1.0,1300,9600,1.0,4,6,1300,0.0,1975,1150,10222,17233 days 16:47:18.681833,232,3.0,0.0,150,-622,1300.0
305000.0,3,1.75,1660,11500,1.0,3,7,1130,530.0,1979,1250,11000,15772 days 16:47:18.681833,113,1.7142857142857142,2.1320754716981134,410,500,600.0
895000.0,4,1.5,3390,6200,2.0,4,8,2530,860.0,1916,3080,6000,38783 days 16:47:18.681833,061,2.6666666666666665,2.941860465116279,310,200,1670.0
1110000.0,4,1.5,2310,13300,1.0,3,7,1890,420.0,1950,2840,12744,26364 days 16:47:18.681833,127,2.6666666666666665,4.5,-530,556,1470.0
339000.0,2,1.0,950,7954,1.0,4,7,950,0.0,1941,1180,6828,29651 days 16:47:18.681833,177,2.0,0.0,-230,1126,950.0
885000.0,4,3.75,2400,3520,1.0,3,7,1370,1030.0,1924,2230,1419,35861 days 16:47:18.681833,101,1.0666666666666667,1.3300970873786409,170,2101,340.0
375000.0,3,1.0,1780,5236,1.5,5,6,1050,730.0,1944,1260,5320,28556 days 16:47:18.681833,307,3.0,1.4383561643835616,520,-84,320.0
367400.0,4,1.5,1280,7400,1.0,3,7,1280,0.0,1958,1310,7400,23442 days 16:47:18.681833,216,2.6666666666666665,0.0,-30,0,1280.0
700000.0,4,2.0,1930,5398,1.0,3,7,1430,500.0,1953,1910,4902,25268 days 16:47:18.681833,114,2.0,2.86,20,496,930.0
667000.0,5,2.25,2560,10360,1.0,4,8,1870,690.0,1966,2070,7875,20520 days 16:47:18.681833,030,2.2222222222222223,2.710144927536232,490,2485,1180.0
200000.0,2,1.0,920,5250,1.0,4,6,920,0.0,1906,1210,5250,42435 days 16:47:18.681833,356,2.0,0.0,-290,0,920.0
552775.0,3,2.5,1900,18414,2.0,3,8,1900,0.0,1971,2900,39921,18694 days 16:47:18.681833,105,1.2,0.0,-1000,-21507,1900.0
452000.0,3,2.0,2270,148975,1.0,4,6,1270,1000.0,1900,2210,17388,44626 days 16:47:18.681833,203,1.5,1.27,60,131587,270.0
418000.0,3,2.5,2080,16050,1.0,5,8,1360,720.0,1978,1790,14550,16137 days 16:47:18.681833,325,1.2,1.8888888888888888,290,1500,640.0
601500.0,3,1.75,1460,10128,1.0,3,8,1460,0.0,1968,2240,10154,19790 days 16:47:18.681833,043,1.7142857142857142,0.0,-780,-26,1460.0
600000.0,3,1.75,1670,39639,1.0,4,8,1670,0.0,1976,2330,30492,16868 days 16:47:18.681833,125,1.7142857142857142,0.0,-660,9147,1670.0
340000.0,4,2.5,2810,6481,2.0,3,9,2810,0.0,1998,2660,6958,8832 days 16:47:18.681833,114,1.6,0.0,150,-477,2810.0
310000.0,3,2.5,2370,6752,2.0,3,8,2370,0.0,1994,1870,7455,10293 days 16:47:18.681833,238,1.2,0.0,500,-703,2370.0
290000.0,2,1.75,1700,18000,1.0,3,8,1700,0.0,1972,1700,8225,18329 days 16:47:18.681833,351,1.1428571428571428,0.0,0,9775,1700.0
438000.0,2,1.0,1630,9255,1.0,3,7,1630,0.0,1941,1800,8000,29651 days 16:47:18.681833,114,2.0,0.0,-170,1255,1630.0
718000.0,4,2.75,2930,4408,1.0,5,8,1660,1270.0,1939,2200,4000,30382 days 16:47:18.681833,055,1.4545454545454546,1.3070866141732282,730,408,390.0
200000.0,2,1.0,860,6600,1.0,5,6,860,0.0,1949,1030,6732,26729 days 16:47:18.681833,171,2.0,0.0,-170,-132,860.0
479900.0,3,2.0,1980,12150,1.0,3,9,1980,0.0,1994,2200,12150,10293 days 16:47:18.681833,148,1.5,0.0,-220,0,1980.0
400000.0,3,2.5,2080,7877,2.0,3,9,2080,0.0,1987,2550,7660,12850 days 16:47:18.681833,113,1.2,0.0,-470,217,2080.0
219950.0,3,1.0,1060,10042,1.0,4,7,1060,0.0,1957,1130,10925,23807 days 16:47:18.681833,082,3.0,0.0,-70,-883,1060.0
300000.0,3,2.5,1590,3381,2.0,3,7,1590,0.0,2000,1820,3383,8102 days 16:47:18.681833,239,1.2,0.0,-230,-2,1590.0
437000.0,3,2.25,1980,8775,1.0,3,7,1290,690.0,1959,1550,9240,23077 days 16:47:18.681833,217,1.3333333333333333,1.8695652173913044,430,-465,600.0
626000.0,4,1.75,1350,9293,1.0,4,7,1350,0.0,1954,1890,9293,24903 days 16:47:18.681833,272,2.2857142857142856,0.0,-540,0,1350.0
490000.0,3,2.5,2080,12032,2.0,3,8,2080,0.0,1978,2320,9900,16137 days 16:47:18.681833,055,1.2,0.0,-240,2132,2080.0
289000.0,3,2.5,2090,4700,2.0,3,8,2090,0.0,2002,2740,5040,7371 days 16:47:18.681833,140,1.2,0.0,-650,-340,2090.0
595000.0,3,2.5,2030,5100,2.0,3,7,2030,0.0,2008,1790,4380,5180 days 16:47:18.681833,318,1.2,0.0,240,720,2030.0
676000.0,3,2.25,2680,41804,1.0,3,9,2680,0.0,1989,2680,40866,12119 days 16:47:18.681833,345,1.3333333333333333,0.0,0,938,2680.0
389000.0,3,1.75,1820,8028,1.0,3,7,1220,600.0,1980,1940,11100,15407 days 16:47:18.681833,104,1.7142857142857142,2.033333333333333,-120,-3072,620.0
240000.0,3,2.0,1300,5000,1.0,4,7,1300,0.0,1983,1630,7500,14311 days 16:47:18.681833,258,1.5,0.0,-330,-2500,1300.0
382500.0,4,2.5,2210,7079,2.0,3,8,2210,0.0,1993,1970,7000,10658 days 16:47:18.681833,168,1.6,0.0,240,79,2210.0
511555.0,3,2.0,1400,7293,1.0,4,7,1400,0.0,1963,1600,7960,21616 days 16:47:18.681833,129,1.5,0.0,-200,-667,1400.0
710500.0,3,1.75,2040,4125,1.5,4,8,1540,500.0,1917,1620,4400,38417 days 16:47:18.681833,253,1.7142857142857142,3.08,420,-275,1040.0
429000.0,3,2.5,2420,49928,2.0,3,8,1860,560.0,1985,2620,37301,13580 days 16:47:18.681833,141,1.2,3.3214285714285716,-200,12627,1300.0
170000.0,4,1.75,1920,7500,1.0,4,7,1920,0.0,1962,1490,8000,21981 days 16:47:18.681833,204,2.2857142857142856,0.0,430,-500,1920.0
2140000.0,4,3.25,3860,17820,1.0,4,1,2630,1230.0,1975,4590,23760,17233 days 16:47:18.681833,233,1.2307692307692308,2.138211382113821,-730,-5940,1400.0
480000.0,5,2.75,2760,7200,1.0,3,7,1430,1330.0,1979,2460,8750,15772 days 16:47:18.681833,098,1.8181818181818181,1.0751879699248121,300,-1550,100.0
1670000.0,4,3.75,3450,8395,2.0,4,1,2640,810.0,1993,3180,5183,10658 days 16:47:18.681833,201,1.0666666666666667,3.259259259259259,270,3212,1830.0
225000.0,3,1.0,1040,6535,1.0,3,6,1040,0.0,1947,1100,6535,27460 days 16:47:18.681833,133,3.0,0.0,-60,0,1040.0
615000.0,3,1.75,2220,7224,1.0,3,8,2040,180.0,1975,2540,9990,17233 days 16:47:18.681833,335,1.7142857142857142,11.333333333333334,-320,-2766,1860.0
438950.0,4,2.5,2470,385506,2.0,3,7,2470,0.0,1991,1680,158994,11389 days 16:47:18.681833,324,1.6,0.0,790,226512,2470.0
242000.0,3,1.75,1300,9856,1.0,4,7,1300,0.0,1962,1400,9600,21981 days 16:47:18.681833,063,1.7142857142857142,0.0,-100,256,1300.0
560000.0,3,2.5,1960,9686,1.0,3,8,1460,500.0,1989,1960,8254,12119 days 16:47:18.681833,197,1.2,2.92,0,1432,960.0
857500.0,3,1.5,2040,3960,2.0,5,8,2040,0.0,1928,1540,3400,34400 days 16:47:18.681833,276,2.0,0.0,500,560,2040.0
685000.0,4,2.5,3030,7864,2.0,3,9,3030,0.0,1999,2790,7034,8467 days 16:47:18.681833,126,1.6,0.0,240,830,3030.0
486000.0,4,3.0,2260,7336,2.0,4,7,2260,0.0,1977,2200,7724,16502 days 16:47:18.681833,093,1.3333333333333333,0.0,60,-388,2260.0
749000.0,3,2.5,2670,10338,2.0,3,9,2670,0.0,1987,2670,8866,12850 days 16:47:18.681833,156,1.2,0.0,0,1472,2670.0
260000.0,3,2.5,1520,6298,2.0,3,7,1520,0.0,1986,1670,7207,13215 days 16:47:18.681833,318,1.2,0.0,-150,-909,1520.0
1020000.0,3,1.75,3610,8502,1.5,3,1,2610,1000.0,1930,2900,5016,33669 days 16:47:18.681833,014,1.7142857142857142,2.61,710,3486,1610.0
565000.0,3,1.75,1130,5111,1.0,4,7,930,200.0,1942,1360,4424,29286 days 16:47:18.681833,069,1.7142857142857142,4.65,-230,687,730.0
355000.0,3,2.0,1480,2502,2.0,3,7,1480,0.0,1991,1850,5000,11389 days 16:47:18.681833,287,1.5,0.0,-370,-2498,1480.0
775000.0,5,2.0,3540,9970,2.0,3,9,3540,0.0,1970,2280,7195,19059 days 16:47:18.681833,211,2.5,0.0,1260,2775,3540.0
335000.0,4,2.25,2100,7305,1.0,4,7,1050,1050.0,1963,1760,7308,21616 days 16:47:18.681833,112,1.7777777777777777,1.0,340,-3,0.0
1300000.0,5,4.0,3366,7800,2.5,3,8,2966,400.0,1937,2340,6000,31112 days 16:47:18.681833,171,1.25,7.415,1026,1800,2566.0
545000.0,3,1.75,1810,3000,1.5,4,7,1810,0.0,1903,1140,3000,43531 days 16:47:18.681833,154,1.7142857142857142,0.0,670,0,1810.0
540000.0,3,1.75,1680,4240,1.5,4,7,1680,0.0,1926,1460,4240,35130 days 16:47:18.681833,322,1.7142857142857142,0.0,220,0,1680.0
687500.0,3,1.75,2450,9377,1.0,4,8,1540,910.0,1962,2520,9725,21981 days 16:47:18.681833,258,1.7142857142857142,1.6923076923076923,-70,-348,630.0
115000.0,1,2.0,1150,9812,1.0,4,7,1150,0.0,1962,1200,9812,21981 days 16:47:18.681833,189,0.5,0.0,-50,0,1150.0
227000.0,1,2.0,1150,9812,1.0,4,7,1150,0.0,1962,1200,9812,21981 days 16:47:18.681833,329,0.5,0.0,-50,0,1150.0
870000.0,4,2.5,3240,7621,2.0,3,9,3240,0.0,2003,4610,7150,7006 days 16:47:18.681833,119,1.6,0.0,-1370,471,3240.0
1190000.0,4,2.5,3480,12164,1.5,4,1,3480,0.0,1984,3960,16855,13946 days 16:47:18.681833,316,1.6,0.0,-480,-4691,3480.0
375000.0,4,2.5,2800,5000,2.0,3,9,2800,0.0,2006,2960,5092,5910 days 16:47:18.681833,253,1.6,0.0,-160,-92,2800.0
902000.0,3,2.75,3240,7200,1.0,3,8,1620,1620.0,1960,2700,7200,22712 days 16:47:18.681833,240,1.0909090909090908,1.0,540,0,0.0
269500.0,2,1.5,1480,7276,1.0,4,6,940,540.0,1978,1090,6710,16137 days 16:47:18.681833,168,1.3333333333333333,1.7407407407407407,390,566,400.0
570000.0,3,1.0,1700,4750,1.5,4,6,1200,500.0,1909,1550,4750,41339 days 16:47:18.681833,069,3.0,2.4,150,0,700.0
359950.0,2,1.0,1240,7590,1.0,4,7,1040,200.0,1939,1190,5692,30382 days 16:47:18.681833,233,2.0,5.2,50,1898,840.0
1450000.0,4,3.5,3720,8301,2.0,3,1,2880,840.0,2008,2080,9676,5180 days 16:47:18.681833,084,1.1428571428571428,3.4285714285714284,1640,-1375,2040.0
615000.0,3,2.5,1910,3427,2.0,3,8,1910,0.0,2001,2240,3720,7736 days 16:47:18.681833,198,1.2,0.0,-330,-293,1910.0
250000.0,4,2.0,2120,8701,1.5,4,7,2120,0.0,1960,1720,8527,22712 days 16:47:18.681833,155,2.0,0.0,400,174,2120.0
530000.0,4,2.5,3020,6788,2.0,3,7,3020,0.0,2002,2640,5325,7371 days 16:47:18.681833,259,1.6,0.0,380,1463,3020.0
474950.0,3,2.0,2250,222156,1.0,3,7,2250,0.0,1987,2110,121968,12850 days 16:47:18.681833,027,1.5,0.0,140,100188,2250.0
490000.0,4,2.0,1650,6480,2.0,5,7,1650,0.0,1947,1650,6350,27460 days 16:47:18.681833,053,2.0,0.0,0,130,1650.0
210000.0,2,1.5,880,1157,2.0,3,7,880,0.0,2007,1070,1203,5545 days 16:47:18.681833,148,1.3333333333333333,0.0,-190,-46,880.0
265500.0,3,1.0,1860,9225,1.0,3,7,1860,0.0,1957,1740,12204,23807 days 16:47:18.681833,318,3.0,0.0,120,-2979,1860.0
1460000.0,5,3.25,3840,4800,3.0,3,1,2750,1090.0,2008,2060,4800,5180 days 16:47:18.681833,171,1.5384615384615385,2.522935779816514,1780,0,1660.0
310000.0,4,2.25,2192,12128,2.0,3,8,2192,0.0,2006,1914,4649,5910 days 16:47:18.681833,156,1.7777777777777777,0.0,278,7479,2192.0
324500.0,3,2.5,1590,4108,2.0,3,7,1590,0.0,2003,2160,3912,7006 days 16:47:18.681833,099,1.2,0.0,-570,196,1590.0
599000.0,4,4.75,3700,11000,1.0,4,7,1840,1860.0,1962,1720,11564,21981 days 16:47:18.681833,272,0.8421052631578947,0.989247311827957,1980,-564,-20.0
525000.0,4,2.5,3670,9958,2.0,3,1,3670,0.0,2005,3300,10679,6275 days 16:47:18.681833,190,1.6,0.0,370,-721,3670.0
400000.0,3,1.0,1630,10304,1.0,5,7,1630,0.0,1953,1480,8515,25268 days 16:47:18.681833,135,3.0,0.0,150,1789,1630.0
887500.0,3,3.0,4230,54977,2.0,3,9,3780,450.0,1951,2880,27201,25999 days 16:47:18.681833,357,1.0,8.4,1350,27776,3330.0
344000.0,2,1.0,1060,3325,1.5,4,6,770,290.0,1932,1820,4275,32939 days 16:47:18.681833,204,2.0,2.6551724137931036,-760,-950,480.0
525000.0,3,2.5,2700,7434,2.0,3,9,2700,0.0,1991,2660,8405,11389 days 16:47:18.681833,135,1.2,0.0,40,-971,2700.0
385000.0,3,2.25,2110,8000,2.0,3,8,2110,0.0,1975,1740,7270,17233 days 16:47:18.681833,234,1.3333333333333333,0.0,370,730,2110.0
820000.0,4,2.5,3720,8633,2.0,3,1,3720,0.0,1999,3515,9660,8467 days 16:47:18.681833,351,1.6,0.0,205,-1027,3720.0
1310000.0,4,3.5,3440,5000,2.0,3,1,2560,880.0,2006,3090,10241,5910 days 16:47:18.681833,117,1.1428571428571428,2.909090909090909,350,-5241,1680.0
549000.0,4,2.25,2420,59800,1.0,4,8,1350,1070.0,1985,2160,17598,13580 days 16:47:18.681833,210,1.7777777777777777,1.2616822429906542,260,42202,280.0
180000.0,3,1.0,1090,6771,1.5,3,7,1090,0.0,1929,1230,4662,34034 days 16:47:18.681833,056,3.0,0.0,-140,2109,1090.0
589000.0,4,2.5,2910,5776,2.0,3,8,2910,0.0,1998,2550,6750,8832 days 16:47:18.681833,141,1.6,0.0,360,-974,2910.0
350000.0,3,1.0,1050,5518,1.0,3,7,1050,0.0,1948,1490,4269,27095 days 16:47:18.681833,027,3.0,0.0,-440,1249,1050.0
197400.0,3,2.0,1610,7575,1.0,4,7,1110,500.0,1965,1920,8400,20885 days 16:47:18.681833,099,1.5,2.22,-310,-825,610.0
267000.0,3,2.5,1760,6477,2.0,4,8,1760,0.0,1986,1890,6800,13215 days 16:47:18.681833,218,1.2,0.0,-130,-323,1760.0
480000.0,3,1.5,1540,20281,1.0,3,7,1540,0.0,1977,1710,21090,16502 days 16:47:18.681833,358,2.0,0.0,-170,-809,1540.0
650000.0,4,2.5,2580,9450,1.0,4,8,1660,920.0,1959,2060,9450,23077 days 16:47:18.681833,286,1.6,1.8043478260869565,520,0,740.0
600000.0,2,1.0,1370,5000,1.5,3,7,1370,0.0,1905,1500,5000,42800 days 16:47:18.681833,044,2.0,0.0,-130,0,1370.0
490000.0,2,1.75,1440,6265,1.0,3,8,1440,0.0,2005,1810,5209,6275 days 16:47:18.681833,120,1.1428571428571428,0.0,-370,1056,1440.0
225000.0,3,1.0,1410,7700,1.0,3,7,980,430.0,1962,1510,7700,21981 days 16:47:18.681833,325,3.0,2.2790697674418605,-100,0,550.0
640000.0,3,2.25,1980,10115,1.0,3,8,1980,0.0,1959,2800,10143,23077 days 16:47:18.681833,184,1.3333333333333333,0.0,-820,-28,1980.0
710000.0,3,3.5,2440,3427,2.0,3,7,1990,450.0,2000,2440,2601,8102 days 16:47:18.681833,161,0.8571428571428571,4.4222222222222225,0,826,1540.0
325000.0,3,2.0,1350,11805,1.0,3,7,1350,0.0,1986,1350,14200,13215 days 16:47:18.681833,160,1.5,0.0,0,-2395,1350.0
595000.0,3,3.25,3130,28001,1.0,3,9,2210,920.0,1985,2710,34999,13580 days 16:47:18.681833,206,0.9230769230769231,2.402173913043478,420,-6998,1290.0
128750.0,3,1.0,880,7004,1.0,3,5,880,0.0,1950,880,7828,26364 days 16:47:18.681833,199,3.0,0.0,0,-824,880.0
465000.0,3,2.25,1920,7300,1.0,3,7,1240,680.0,1961,1920,7700,22346 days 16:47:18.681833,290,1.3333333333333333,1.8235294117647058,0,-400,560.0
710000.0,4,1.75,2700,7625,1.0,4,8,1450,1250.0,1937,1760,3300,31112 days 16:47:18.681833,207,2.2857142857142856,1.16,940,4325,200.0
605000.0,4,2.75,1670,6000,1.0,5,7,840,830.0,1917,1100,6000,38417 days 16:47:18.681833,065,1.4545454545454546,1.0120481927710843,570,0,10.0
994000.0,4,2.5,3470,20445,2.0,4,1,3470,0.0,1963,3360,21950,21616 days 16:47:18.681833,220,1.6,0.0,110,-1505,3470.0
489950.0,3,2.25,1820,7326,2.0,3,8,1820,0.0,1983,2430,7696,14311 days 16:47:18.681833,170,1.3333333333333333,0.0,-610,-370,1820.0
365000.0,3,1.5,1310,8160,1.0,3,7,1310,0.0,1950,1090,7560,26364 days 16:47:18.681833,126,2.0,0.0,220,600,1310.0
359950.0,3,2.0,1790,7212,1.0,4,8,1790,0.0,1998,2330,7212,8832 days 16:47:18.681833,033,1.5,0.0,-540,0,1790.0
495000.0,4,2.5,2460,4774,2.0,3,8,2460,0.0,2006,2510,4399,5910 days 16:47:18.681833,272,1.6,0.0,-50,375,2460.0
255000.0,3,1.5,1060,9039,1.0,3,7,1060,0.0,1973,1410,9515,17963 days 16:47:18.681833,141,2.0,0.0,-350,-476,1060.0
330000.0,3,1.75,1340,10276,1.0,4,7,1340,0.0,1961,2950,7987,22346 days 16:47:18.681833,224,1.7142857142857142,0.0,-1610,2289,1340.0
450000.0,3,1.75,1480,8394,1.0,4,8,1480,0.0,1971,1920,9184,18694 days 16:47:18.681833,188,1.7142857142857142,0.0,-440,-790,1480.0
655000.0,4,2.5,3500,11306,2.0,3,9,3500,0.0,2005,3180,8028,6275 days 16:47:18.681833,077,1.6,0.0,320,3278,3500.0
485000.0,4,2.75,2910,16362,1.0,4,9,2120,790.0,1969,2850,14904,19424 days 16:47:18.681833,111,1.4545454545454546,2.6835443037974684,60,1458,1330.0
375000.0,4,1.75,1940,15909,1.0,3,8,970,970.0,1974,1940,15120,17598 days 16:47:18.681833,224,2.2857142857142856,1.0,0,789,0.0
570000.0,4,2.5,2280,4534,2.0,3,8,2280,0.0,2003,2246,4534,7006 days 16:47:18.681833,290,1.6,0.0,34,0,2280.0
350000.0,3,2.25,1190,1022,3.0,3,8,1190,0.0,1998,1210,1171,8832 days 16:47:18.681833,113,1.3333333333333333,0.0,-20,-149,1190.0
550000.0,3,1.0,1260,6000,1.0,3,7,1260,0.0,1951,2020,6600,25999 days 16:47:18.681833,056,3.0,0.0,-760,-600,1260.0
513000.0,5,2.0,2270,8652,1.0,3,7,1150,1120.0,1965,1950,8050,20885 days 16:47:18.681833,212,2.5,1.0267857142857142,320,602,30.0
450000.0,4,2.25,1990,7320,1.0,4,7,1030,960.0,1965,1320,7320,20885 days 16:47:18.681833,339,1.7777777777777777,1.0729166666666667,670,0,70.0
432500.0,4,1.75,1500,1856,1.0,5,7,750,750.0,1901,1220,1739,44261 days 16:47:18.681833,040,2.2857142857142856,1.0,280,117,0.0
432000.0,5,2.75,2060,329903,1.5,5,7,2060,0.0,1989,2240,220232,12119 days 16:47:18.681833,044,1.8181818181818181,0.0,-180,109671,2060.0
480000.0,3,2.25,1950,8892,2.0,3,8,1950,0.0,1983,1900,8750,14311 days 16:47:18.681833,023,1.3333333333333333,0.0,50,142,1950.0
402200.0,3,1.75,1790,6980,1.0,3,7,1330,460.0,1980,1770,8081,15407 days 16:47:18.681833,209,1.7142857142857142,2.891304347826087,20,-1101,870.0
650000.0,3,1.0,1520,10227,1.0,4,6,1520,0.0,1951,2710,10912,25999 days 16:47:18.681833,103,3.0,0.0,-1190,-685,1520.0
1200000.0,4,2.5,3240,13044,2.0,4,9,3240,0.0,1984,2920,13044,13946 days 16:47:18.681833,114,1.6,0.0,320,0,3240.0
312000.0,3,2.0,2440,13250,1.0,4,8,1440,1000.0,1977,2400,10650,16502 days 16:47:18.681833,209,1.5,1.44,40,2600,440.0
610000.0,4,2.0,2220,5821,1.5,4,7,1380,840.0,1916,1850,5000,38783 days 16:47:18.681833,092,2.0,1.6428571428571428,370,821,540.0
823000.0,5,1.75,2640,7722,1.5,4,7,1650,990.0,1915,1750,4000,39148 days 16:47:18.681833,082,2.857142857142857,1.6666666666666667,890,3722,660.0
471000.0,4,1.75,1450,3750,1.0,4,7,950,500.0,1925,1850,4000,35495 days 16:47:18.681833,317,2.2857142857142856,1.9,-400,-250,450.0
481015.0,3,2.25,1550,5511,2.0,3,8,1550,0.0,1987,1620,5511,12850 days 16:47:18.681833,183,1.3333333333333333,0.0,-70,0,1550.0
1960000.0,5,4.5,6200,23373,3.0,4,1,5050,1150.0,1988,3700,14486,12485 days 16:47:18.681833,288,1.1111111111111112,4.391304347826087,2500,8887,3900.0
624000.0,4,3.25,2810,11250,1.0,3,8,1680,1130.0,1980,2110,11250,15407 days 16:47:18.681833,266,1.2307692307692308,1.4867256637168142,700,0,550.0
480000.0,4,2.5,2080,7966,1.0,3,7,1200,880.0,1970,1920,7500,19059 days 16:47:18.681833,079,1.6,1.3636363636363635,160,466,320.0
815000.0,3,1.5,1370,8671,1.0,3,7,1370,0.0,1955,1580,8671,24538 days 16:47:18.681833,196,2.0,0.0,-210,0,1370.0
1650000.0,4,2.25,2920,20400,1.0,4,1,2920,0.0,1966,3080,20400,20520 days 16:47:18.681833,241,1.7777777777777777,0.0,-160,0,2920.0
180000.0,3,1.0,1000,18513,1.0,3,6,1000,0.0,1940,1280,8113,30017 days 16:47:18.681833,136,3.0,0.0,-280,10400,1000.0
156601.0,2,1.75,1210,9750,1.0,3,7,1210,0.0,1984,1650,9750,13946 days 16:47:18.681833,048,1.1428571428571428,0.0,-440,0,1210.0
374950.0,4,2.5,2790,4650,2.0,3,8,2790,0.0,2004,2850,4650,6641 days 16:47:18.681833,200,1.6,0.0,-60,0,2790.0
368000.0,2,1.5,1660,4680,1.0,5,6,830,830.0,1908,1930,5400,41705 days 16:47:18.681833,139,1.3333333333333333,1.0,-270,-720,0.0
550000.0,3,2.0,1650,3952,2.0,3,7,1650,0.0,1950,1210,4560,26364 days 16:47:18.681833,336,1.5,0.0,440,-608,1650.0
198000.0,3,1.75,1300,6318,1.0,3,7,1300,0.0,1980,1150,8002,15407 days 16:47:18.681833,198,1.7142857142857142,0.0,150,-1684,1300.0
345000.0,3,1.75,1090,7200,1.0,3,7,1090,0.0,1968,1240,7200,19790 days 16:47:18.681833,133,1.7142857142857142,0.0,-150,0,1090.0
1710000.0,5,2.5,2660,6572,1.0,5,9,1960,700.0,1959,3960,14595,23077 days 16:47:18.681833,068,2.0,2.8,-1300,-8023,1260.0
185900.0,3,1.0,940,10890,1.0,4,5,940,0.0,1909,1370,10255,41339 days 16:47:18.681833,030,3.0,0.0,-430,635,940.0
950000.0,3,2.75,2750,18029,1.0,5,9,1810,940.0,1978,2850,10021,16137 days 16:47:18.681833,168,1.0909090909090908,1.925531914893617,-100,8008,870.0
995000.0,4,4.5,3850,13551,2.0,3,1,3000,850.0,1998,3480,10737,8832 days 16:47:18.681833,171,0.8888888888888888,3.5294117647058822,370,2814,2150.0
345000.0,2,1.0,860,8250,1.0,3,7,860,0.0,1940,1780,11200,30017 days 16:47:18.681833,214,2.0,0.0,-920,-2950,860.0
741000.0,4,2.75,2070,10125,1.0,3,7,1390,680.0,1962,1850,10125,21981 days 16:47:18.681833,309,1.4545454545454546,2.0441176470588234,220,0,710.0
737000.0,2,2.25,2290,9772,1.0,3,8,2290,0.0,2007,1810,6077,5545 days 16:47:18.681833,190,0.8888888888888888,0.0,480,3695,2290.0
668750.0,4,2.5,2340,6420,1.0,3,8,1590,750.0,1964,2110,10856,21251 days 16:47:18.681833,141,1.6,2.12,230,-4436,840.0
575000.0,3,1.75,2680,8625,1.0,5,8,1590,1090.0,1974,2620,14275,17598 days 16:47:18.681833,183,1.7142857142857142,1.4587155963302751,60,-5650,500.0
280000.0,4,2.0,1710,5440,1.0,5,8,1030,680.0,1976,1620,6696,16868 days 16:47:18.681833,290,2.0,1.5147058823529411,90,-1256,350.0
583000.0,3,1.5,1800,10050,1.0,3,7,1800,0.0,1955,1610,10050,24538 days 16:47:18.681833,216,2.0,0.0,190,0,1800.0
196000.0,3,2.25,1510,9600,1.0,1,7,1090,420.0,1966,1870,10681,20520 days 16:47:18.681833,028,1.3333333333333333,2.5952380952380953,-360,-1081,670.0
349950.0,3,2.5,1700,7496,2.0,3,8,1700,0.0,1994,2280,7496,10293 days 16:47:18.681833,135,1.2,0.0,-580,0,1700.0
429000.0,4,1.0,1350,3333,1.5,3,7,1350,0.0,1912,1530,5000,40244 days 16:47:18.681833,345,4.0,0.0,-180,-1667,1350.0
270000.0,5,2.5,2140,10320,1.0,4,7,1330,810.0,1967,2050,8964,20155 days 16:47:18.681833,051,2.0,1.6419753086419753,90,1356,520.0
385000.0,6,4.0,2700,7416,1.0,3,7,1350,1350.0,1969,2260,5324,19424 days 16:47:18.681833,252,1.5,1.0,440,2092,0.0
535000.0,1,1.0,920,5000,1.0,4,7,920,0.0,1906,1890,5000,42435 days 16:47:18.681833,265,1.0,0.0,-970,0,920.0
352500.0,3,1.75,1500,10269,1.0,3,7,1030,470.0,1958,2090,10269,23442 days 16:47:18.681833,110,1.7142857142857142,2.1914893617021276,-590,0,560.0
624000.0,3,1.75,1510,5200,1.0,4,7,860,650.0,1922,1650,4160,36591 days 16:47:18.681833,060,1.7142857142857142,1.323076923076923,-140,1040,210.0
215000.0,5,1.5,1980,7958,1.5,3,7,1980,0.0,1962,1510,8438,21981 days 16:47:18.681833,351,3.3333333333333335,0.0,470,-480,1980.0
870000.0,4,3.0,4500,21780,2.0,3,9,3040,1460.0,1980,3540,20473,15407 days 16:47:18.681833,153,1.3333333333333333,2.0821917808219177,960,1307,1580.0
440000.0,4,2.5,3220,8256,2.0,3,8,2610,610.0,2006,2500,9472,5910 days 16:47:18.681833,210,1.6,4.278688524590164,720,-1216,2000.0
518000.0,2,1.5,1140,1149,2.0,3,7,940,200.0,2001,1460,1149,7736 days 16:47:18.681833,125,1.3333333333333333,4.7,-320,0,740.0
259500.0,3,2.25,1490,7589,2.0,3,7,1490,0.0,1993,1510,6603,10658 days 16:47:18.681833,084,1.3333333333333333,0.0,-20,986,1490.0
795127.0,4,3.25,4360,91158,1.0,3,1,3360,1000.0,1993,3540,90940,10658 days 16:47:18.681833,302,1.2307692307692308,3.36,820,218,2360.0
290000.0,3,1.0,960,9000,1.0,4,7,960,0.0,1955,1520,9000,24538 days 16:47:18.681833,230,3.0,0.0,-560,0,960.0
385000.0,4,3.0,2253,7700,2.0,3,7,2253,0.0,1957,1786,9052,23807 days 16:47:18.681833,113,1.3333333333333333,0.0,467,-1352,2253.0
259950.0,2,1.0,770,6542,1.0,3,6,770,0.0,1948,1120,8149,27095 days 16:47:18.681833,280,2.0,0.0,-350,-1607,770.0
330000.0,2,2.5,1310,2915,2.0,3,8,1310,0.0,1999,1310,3425,8467 days 16:47:18.681833,119,0.8,0.0,0,-510,1310.0
280000.0,3,1.0,980,7480,1.0,3,6,830,150.0,1948,1140,7480,27095 days 16:47:18.681833,353,3.0,5.533333333333333,-160,0,680.0
595000.0,4,2.5,1820,20011,2.0,3,8,1820,0.0,1987,2710,33915,12850 days 16:47:18.681833,182,1.6,0.0,-890,-13904,1820.0
925900.0,4,3.75,3980,7828,2.0,3,1,3980,0.0,2001,3980,8910,7736 days 16:47:18.681833,321,1.0666666666666667,0.0,0,-1082,3980.0
499000.0,3,2.25,3010,9600,2.0,3,8,2410,600.0,1978,2620,9660,16137 days 16:47:18.681833,220,1.3333333333333333,4.016666666666667,390,-60,1810.0
325000.0,4,2.5,1830,7762,2.0,3,8,1830,0.0,1993,2109,8966,10658 days 16:47:18.681833,093,1.6,0.0,-279,-1204,1830.0
895000.0,5,2.5,2550,20875,1.0,4,9,1610,940.0,1953,2510,21673,25268 days 16:47:18.681833,161,2.0,1.7127659574468086,40,-798,670.0
162248.0,2,1.0,800,8960,1.0,4,6,800,0.0,1944,850,8082,28556 days 16:47:18.681833,119,2.0,0.0,-50,878,800.0
1070000.0,3,2.25,2890,21480,2.0,3,8,1790,1100.0,1941,2110,8107,29651 days 16:47:18.681833,288,1.3333333333333333,1.6272727272727272,780,13373,690.0
430000.0,3,1.5,1810,5080,1.0,3,7,1030,780.0,1958,1780,7620,23442 days 16:47:18.681833,184,2.0,1.3205128205128205,30,-2540,250.0
615500.0,3,1.5,1810,5080,1.0,3,7,1030,780.0,1958,1780,7620,23442 days 16:47:18.681833,029,2.0,1.3205128205128205,30,-2540,250.0
260000.0,3,1.0,940,5650,1.0,3,6,940,0.0,1949,1180,5276,26729 days 16:47:18.681833,106,3.0,0.0,-240,374,940.0
295000.0,4,2.0,1810,42981,1.0,4,7,1810,0.0,1973,1980,113691,17963 days 16:47:18.681833,321,2.0,0.0,-170,-70710,1810.0
1190000.0,3,1.75,2550,6117,2.0,3,9,1650,900.0,1951,2100,4967,25999 days 16:47:18.681833,267,1.7142857142857142,1.8333333333333333,450,1150,750.0
749950.0,4,2.5,2370,2971,2.0,3,9,2080,290.0,2008,2970,7500,5180 days 16:47:18.681833,324,1.6,7.172413793103448,-600,-4529,1790.0
175000.0,6,1.0,1370,5080,1.5,3,6,1120,250.0,1931,1020,5080,33304 days 16:47:18.681833,169,6.0,4.48,350,0,870.0
415000.0,6,1.0,1370,5080,1.5,3,6,1120,250.0,1931,1020,5080,33304 days 16:47:18.681833,020,6.0,4.48,350,0,870.0
190000.0,3,1.0,1200,8316,1.0,4,6,1200,0.0,1953,1250,8316,25268 days 16:47:18.681833,323,3.0,0.0,-50,0,1200.0
625000.0,3,1.75,2100,3264,1.5,5,7,1350,750.0,1912,1720,3750,40244 days 16:47:18.681833,107,1.7142857142857142,1.8,380,-486,600.0
420000.0,3,2.25,2020,21010,2.0,3,7,2020,0.0,1995,1850,18151,9928 days 16:47:18.681833,238,1.3333333333333333,0.0,170,2859,2020.0
339900.0,4,1.5,1570,9210,1.0,3,7,1400,170.0,1965,2326,9210,20885 days 16:47:18.681833,106,2.6666666666666665,8.235294117647058,-756,0,1230.0
160000.0,2,1.0,1140,23030,1.0,3,8,1140,0.0,1980,1850,14260,15407 days 16:47:18.681833,117,2.0,0.0,-710,8770,1140.0
353000.0,4,2.5,1830,5331,2.0,3,7,1830,0.0,2002,1830,5175,7371 days 16:47:18.681833,349,1.6,0.0,0,156,1830.0
390000.0,3,2.0,1010,14183,1.0,3,8,1010,0.0,1982,1750,11700,14676 days 16:47:18.681833,037,1.5,0.0,-740,2483,1010.0
675000.0,4,2.5,1770,9858,1.0,3,8,1770,0.0,1971,2470,9858,18694 days 16:47:18.681833,064,1.6,0.0,-700,0,1770.0
400000.0,3,2.5,2120,3757,2.0,3,7,2120,0.0,2006,2230,4103,5910 days 16:47:18.681833,072,1.2,0.0,-110,-346,2120.0
1340000.0,4,3.5,3190,5040,2.0,3,1,2160,1030.0,2003,2390,4800,7006 days 16:47:18.681833,177,1.1428571428571428,2.0970873786407767,800,240,1130.0
1650000.0,4,2.5,2780,11904,1.0,5,8,1730,1050.0,1951,3590,13860,25999 days 16:47:18.681833,040,1.6,1.6476190476190475,-810,-1956,680.0
1000000.0,5,3.0,3350,9450,2.0,5,8,2180,1170.0,1912,2660,4500,40244 days 16:47:18.681833,237,1.6666666666666667,1.8632478632478633,690,4950,1010.0
850000.0,5,3.5,3450,28324,1.0,5,8,2350,1100.0,1972,2640,14978,18329 days 16:47:18.681833,169,1.4285714285714286,2.1363636363636362,810,13346,1250.0
275000.0,3,1.5,1060,6954,1.0,4,6,1060,0.0,1983,1560,6954,14311 days 16:47:18.681833,196,2.0,0.0,-500,0,1060.0
450000.0,3,2.5,1670,2589,2.0,3,8,1670,0.0,2000,1670,2897,8102 days 16:47:18.681833,225,1.2,0.0,0,-308,1670.0
305000.0,4,1.75,2251,12731,1.0,4,8,1390,861.0,1957,2520,12539,23807 days 16:47:18.681833,317,2.2857142857142856,1.6144018583042974,-269,192,529.0
643002.0,3,2.5,1770,3744,1.5,3,7,1270,500.0,1929,1400,4680,34034 days 16:47:18.681833,245,1.2,2.54,370,-936,770.0
468000.0,2,1.75,1510,4500,1.0,3,8,1510,0.0,1978,1740,6000,16137 days 16:47:18.681833,103,1.1428571428571428,0.0,-230,-1500,1510.0
324950.0,4,2.5,1770,5000,2.0,3,7,1770,0.0,2004,2080,5100,6641 days 16:47:18.681833,051,1.6,0.0,-310,-100,1770.0
290000.0,3,2.0,1260,7346,1.0,3,7,1260,0.0,1987,1460,7363,12850 days 16:47:18.681833,085,1.5,0.0,-200,-17,1260.0
488500.0,3,2.0,1710,10959,1.0,4,7,1030,680.0,1981,1710,10498,15041 days 16:47:18.681833,119,1.5,1.5147058823529411,0,461,350.0
367950.0,3,1.75,2290,8234,1.0,4,7,1250,1040.0,1950,1660,7200,26364 days 16:47:18.681833,225,1.7142857142857142,1.2019230769230769,630,1034,210.0
285000.0,2,1.0,790,6555,1.0,2,6,790,0.0,1956,1440,7601,24173 days 16:47:18.681833,051,2.0,0.0,-650,-1046,790.0
417000.0,3,2.75,1820,52889,2.0,3,8,1820,0.0,1991,1820,45528,11389 days 16:47:18.681833,100,1.0909090909090908,0.0,0,7361,1820.0
1120000.0,4,2.5,3180,31931,1.0,4,1,2390,790.0,1978,3180,35007,16137 days 16:47:18.681833,189,1.6,3.0253164556962027,0,-3076,1600.0
1550000.0,4,4.0,5280,17677,2.0,3,1,3220,2060.0,1978,3470,17474,16137 days 16:47:18.681833,112,1.0,1.5631067961165048,1810,203,1160.0
604000.0,3,2.5,3240,33151,2.0,3,1,3240,0.0,1995,4050,24967,9928 days 16:47:18.681833,122,1.2,0.0,-810,8184,3240.0
380000.0,3,2.5,2390,8102,2.0,4,8,2390,0.0,1986,2310,8606,13215 days 16:47:18.681833,118,1.2,0.0,80,-504,2390.0
336500.0,4,2.5,2500,5264,2.0,3,7,2500,0.0,2003,1960,5250,7006 days 16:47:18.681833,320,1.6,0.0,540,14,2500.0
685000.0,4,2.0,2290,6000,1.5,5,7,2290,0.0,1900,2000,3150,44626 days 16:47:18.681833,049,2.0,0.0,290,2850,2290.0
4210000.0,5,6.0,7440,21540,2.0,3,1,5550,1890.0,2003,4740,19329,7006 days 16:47:18.681833,126,0.8333333333333334,2.9365079365079363,2700,2211,3660.0
670000.0,3,1.0,1600,16868,1.0,3,7,990,610.0,1946,2600,12735,27825 days 16:47:18.681833,345,3.0,1.6229508196721312,-1000,4133,380.0
524000.0,2,1.0,1120,2000,1.5,3,7,1120,0.0,1910,1500,4000,40974 days 16:47:18.681833,167,2.0,0.0,-380,-2000,1120.0
680000.0,6,2.0,1670,3000,1.0,5,7,900,770.0,1911,1330,1099,40609 days 16:47:18.681833,170,3.0,1.1688311688311688,340,1901,130.0
357000.0,4,2.75,2700,49428,1.0,4,9,2700,0.0,1988,2728,85905,12485 days 16:47:18.681833,339,1.4545454545454546,0.0,-28,-36477,2700.0
107000.0,3,1.5,910,5120,1.0,3,6,910,0.0,1973,1410,5132,17963 days 16:47:18.681833,240,2.0,0.0,-500,-12,910.0
232900.0,3,1.5,910,5120,1.0,3,6,910,0.0,1973,1410,5132,17963 days 16:47:18.681833,336,2.0,0.0,-500,-12,910.0
800000.0,4,3.5,2370,3302,2.0,3,8,1610,760.0,1926,2170,3800,35130 days 16:47:18.681833,012,1.1428571428571428,2.1184210526315788,200,-498,850.0
248500.0,2,1.5,880,1498,2.0,3,7,880,0.0,1999,880,5060,8467 days 16:47:18.681833,086,1.3333333333333333,0.0,0,-3562,880.0
670000.0,3,2.5,2050,6420,1.0,3,8,1730,320.0,1956,2370,7620,24173 days 16:47:18.681833,163,1.2,5.40625,-320,-1200,1410.0
207000.0,3,1.75,1180,21275,1.0,4,6,1180,0.0,1958,1490,35100,23442 days 16:47:18.681833,058,1.7142857142857142,0.0,-310,-13825,1180.0
164000.0,3,1.0,1070,8250,1.0,3,7,1070,0.0,1961,1190,8250,22346 days 16:47:18.681833,307,3.0,0.0,-120,0,1070.0
570500.0,2,1.0,1380,1800,2.0,3,7,1080,300.0,1954,1600,3600,24903 days 16:47:18.681833,048,2.0,3.6,-220,-1800,780.0
599990.0,3,2.25,2680,9162,1.0,3,8,1570,1110.0,1978,2480,8261,16137 days 16:47:18.681833,176,1.3333333333333333,1.4144144144144144,200,901,460.0
395000.0,5,1.75,2100,9599,1.0,3,7,1060,1040.0,1961,1680,10712,22346 days 16:47:18.681833,279,2.857142857142857,1.0192307692307692,420,-1113,20.0
979500.0,4,3.75,4133,361548,2.0,3,1,4133,0.0,2000,1970,291416,8102 days 16:47:18.681833,239,1.0666666666666667,0.0,2163,70132,4133.0
237000.0,3,1.0,920,5546,1.0,2,6,920,0.0,1928,1300,5546,34400 days 16:47:18.681833,012,3.0,0.0,-380,0,920.0
650100.0,2,1.0,1750,60872,1.0,4,7,1180,570.0,1973,2480,5425,17963 days 16:47:18.681833,100,2.0,2.0701754385964914,-730,55447,610.0
385000.0,4,2.5,1950,7350,1.0,3,7,1150,800.0,1963,2050,9068,21616 days 16:47:18.681833,335,1.6,1.4375,-100,-1718,350.0
335000.0,2,1.75,1660,11437,2.0,3,7,1660,0.0,1958,1290,7860,23442 days 16:47:18.681833,225,1.1428571428571428,0.0,370,3577,1660.0
347000.0,4,1.5,2670,10026,2.0,3,8,2670,0.0,1996,2420,11900,9563 days 16:47:18.681833,144,2.6666666666666665,0.0,250,-1874,2670.0
204000.0,3,1.0,980,8000,1.0,4,6,980,0.0,1954,1240,8000,24903 days 16:47:18.681833,085,3.0,0.0,-260,0,980.0
615000.0,4,2.25,1780,10260,2.0,3,8,1780,0.0,1971,2360,10080,18694 days 16:47:18.681833,127,1.7777777777777777,0.0,-580,180,1780.0
943500.0,3,2.25,2370,10890,2.0,4,7,2370,0.0,1980,2370,9514,15407 days 16:47:18.681833,301,1.3333333333333333,0.0,0,1376,2370.0
560000.0,3,2.0,1640,7333,1.0,4,7,1020,620.0,1941,2130,4933,29651 days 16:47:18.681833,113,1.5,1.6451612903225807,-490,2400,400.0
547500.0,4,2.5,2610,7254,1.0,2,8,1610,1000.0,1975,2250,7407,17233 days 16:47:18.681833,097,1.6,1.61,360,-153,610.0
359500.0,4,1.75,2030,7210,1.0,3,7,1450,580.0,1968,1750,8387,19790 days 16:47:18.681833,283,2.2857142857142856,2.5,280,-1177,870.0
660000.0,3,2.5,2590,35640,1.0,3,9,2590,0.0,1987,2590,31200,12850 days 16:47:18.681833,091,1.2,0.0,0,4440,2590.0
258000.0,3,1.75,1620,7540,1.0,3,7,1310,310.0,1988,1580,7540,12485 days 16:47:18.681833,143,1.7142857142857142,4.225806451612903,40,0,1000.0
355000.0,3,1.75,2040,22693,1.0,4,8,2040,0.0,1980,1950,6280,15407 days 16:47:18.681833,178,1.7142857142857142,0.0,90,16413,2040.0
253500.0,2,1.0,810,4800,1.0,3,7,810,0.0,1948,1240,7740,27095 days 16:47:18.681833,157,2.0,0.0,-430,-2940,810.0
422500.0,3,1.0,1270,8920,1.0,5,7,1270,0.0,1969,1590,8589,19424 days 16:47:18.681833,105,3.0,0.0,-320,331,1270.0
239000.0,2,2.0,1470,2052,1.5,3,7,1470,0.0,1986,1470,2052,13215 days 16:47:18.681833,317,1.0,0.0,0,0,1470.0
628000.0,3,2.25,1720,8521,1.0,4,7,1140,580.0,1984,1530,8692,13946 days 16:47:18.681833,093,1.3333333333333333,1.9655172413793103,190,-171,560.0
352000.0,2,2.5,1320,1957,1.0,3,8,660,660.0,2004,1420,2198,6641 days 16:47:18.681833,069,0.8,1.0,-100,-241,0.0
311600.0,3,2.25,1358,1196,3.0,3,7,1358,0.0,2007,1358,1196,5545 days 16:47:18.681833,034,1.3333333333333333,0.0,0,0,1358.0
235000.0,4,1.5,2070,7245,1.0,4,7,1060,1010.0,1964,1450,7350,21251 days 16:47:18.681833,282,2.6666666666666665,1.0495049504950495,620,-105,50.0
870000.0,5,2.25,2910,9525,2.0,4,9,2910,0.0,1968,2740,9525,19790 days 16:47:18.681833,223,2.2222222222222223,0.0,170,0,2910.0
190848.0,4,1.5,1370,7904,1.0,3,7,900,470.0,1970,1370,7900,19059 days 16:47:18.681833,078,2.6666666666666665,1.9148936170212767,0,4,430.0
570000.0,4,1.75,2340,5080,1.0,5,7,1170,1170.0,1924,1270,3270,35861 days 16:47:18.681833,274,2.2857142857142856,1.0,1070,1810,0.0
661254.0,4,4.0,2290,6250,1.5,5,7,1690,600.0,1940,1920,4335,30017 days 16:47:18.681833,143,1.0,2.816666666666667,370,1915,1090.0
575000.0,4,2.0,1650,5000,1.0,3,7,1650,0.0,1955,1690,2276,24538 days 16:47:18.681833,127,2.0,0.0,-40,2724,1650.0
230000.0,2,0.75,650,5360,1.0,4,5,650,0.0,1931,1110,6700,33304 days 16:47:18.681833,133,2.6666666666666665,0.0,-460,-1340,650.0
680000.0,3,2.25,2300,9914,2.0,4,8,2300,0.0,1980,2240,9032,15407 days 16:47:18.681833,092,1.3333333333333333,0.0,60,882,2300.0
148000.0,1,1.0,620,8261,1.0,3,5,620,0.0,1939,1180,8244,30382 days 16:47:18.681833,162,1.0,0.0,-560,17,620.0
244900.0,1,1.0,620,8261,1.0,3,5,620,0.0,1939,1180,8244,30382 days 16:47:18.681833,342,1.0,0.0,-560,17,620.0
214950.0,3,1.0,1400,6600,1.0,3,6,1280,120.0,1954,1730,6600,24903 days 16:47:18.681833,303,3.0,10.666666666666666,-330,0,1160.0
580000.0,3,1.5,1800,6250,1.0,3,8,1420,380.0,1947,1800,5625,27460 days 16:47:18.681833,303,2.0,3.736842105263158,0,625,1040.0
263000.0,3,1.5,1300,7885,1.0,3,7,1300,0.0,1968,1840,7600,19790 days 16:47:18.681833,240,2.0,0.0,-540,285,1300.0
317000.0,5,2.5,2360,11375,1.0,4,7,1180,1180.0,1962,1160,7800,21981 days 16:47:18.681833,175,2.0,1.0,1200,3575,0.0
302000.0,4,3.0,3320,13500,1.0,3,7,1750,1570.0,1963,1830,13800,21616 days 16:47:18.681833,295,1.3333333333333333,1.1146496815286624,1490,-300,180.0
899000.0,3,1.0,1480,6978,2.0,4,8,1480,0.0,1949,2660,13062,26729 days 16:47:18.681833,174,3.0,0.0,-1180,-6084,1480.0
1290000.0,3,2.5,2190,11394,1.0,3,8,1550,640.0,1956,2190,9540,24173 days 16:47:18.681833,174,1.2,2.421875,0,1854,910.0
710000.0,3,3.25,3740,136915,2.5,3,1,3100,640.0,1990,2400,16104,11754 days 16:47:18.681833,177,0.9230769230769231,4.84375,1340,120811,2460.0
230000.0,3,1.0,1360,9310,1.0,4,7,1020,340.0,1980,1480,8330,15407 days 16:47:18.681833,311,3.0,3.0,-120,980,680.0
430000.0,3,1.0,1210,5200,1.0,3,6,1210,0.0,1941,890,5200,29651 days 16:47:18.681833,124,3.0,0.0,320,0,1210.0
1170000.0,5,4.25,4610,13252,2.0,3,1,4610,0.0,2004,4400,15154,6641 days 16:47:18.681833,230,1.1764705882352942,0.0,210,-1902,4610.0
397000.0,3,1.0,860,6380,1.5,4,7,860,0.0,1927,1250,6380,34765 days 16:47:18.681833,287,3.0,0.0,-390,0,860.0
595000.0,3,2.5,2250,8300,2.0,3,8,2250,0.0,2003,1790,7626,7006 days 16:47:18.681833,056,1.2,0.0,460,674,2250.0
485000.0,3,1.75,2030,10089,1.0,4,8,1330,700.0,1976,2030,9827,16868 days 16:47:18.681833,069,1.7142857142857142,1.9,0,262,630.0
755000.0,5,2.5,3260,24300,1.5,4,8,2310,950.0,1950,2390,32057,26364 days 16:47:18.681833,178,2.0,2.431578947368421,870,-7757,1360.0
185000.0,3,1.0,1840,8100,1.0,4,7,920,920.0,1953,1250,8100,25268 days 16:47:18.681833,157,3.0,1.0,590,0,0.0
340000.0,3,1.0,1840,8100,1.0,4,7,920,920.0,1953,1250,8100,25268 days 16:47:18.681833,050,3.0,1.0,590,0,0.0
236000.0,4,2.75,2000,5827,2.0,3,7,2000,0.0,1997,1710,6929,9197 days 16:47:18.681833,175,1.4545454545454546,0.0,290,-1102,2000.0
550000.0,4,2.5,2810,7549,2.0,3,9,2810,0.0,1992,2750,7642,11024 days 16:47:18.681833,262,1.6,0.0,60,-93,2810.0
680000.0,3,2.0,1780,5720,1.0,5,7,980,800.0,1925,1620,5050,35495 days 16:47:18.681833,190,1.5,1.225,160,670,180.0
630000.0,4,2.5,2540,8706,2.0,3,9,2540,0.0,1997,2540,6239,9197 days 16:47:18.681833,111,1.6,0.0,0,2467,2540.0
560000.0,3,2.0,2340,3477,1.0,5,7,1170,1170.0,1971,2110,6300,18694 days 16:47:18.681833,168,1.5,1.0,230,-2823,0.0
385000.0,3,2.0,1480,6600,1.0,3,7,740,740.0,1943,1250,7300,28921 days 16:47:18.681833,133,1.5,1.0,230,-700,0.0
280000.0,3,2.25,1358,1141,3.0,3,7,1358,0.0,2007,1358,1196,5545 days 16:47:18.681833,295,1.3333333333333333,0.0,0,-55,1358.0
225000.0,3,2.5,1750,7490,1.0,4,7,1180,570.0,1979,1570,7490,15772 days 16:47:18.681833,237,1.2,2.0701754385964914,180,0,610.0
610000.0,4,1.75,1830,29110,2.0,3,8,1230,600.0,1990,3630,16488,11754 days 16:47:18.681833,156,2.2857142857142856,2.05,-1800,12622,630.0
592500.0,3,2.0,1170,6750,1.0,5,7,800,370.0,1947,1330,6750,27460 days 16:47:18.681833,343,1.5,2.1621621621621623,-160,0,430.0
750000.0,4,2.75,3170,7634,2.0,3,1,3170,0.0,1992,2940,7846,11024 days 16:47:18.681833,282,1.4545454545454546,0.0,230,-212,3170.0
164000.0,4,1.0,1530,4875,2.0,3,7,1530,0.0,1977,1470,4875,16502 days 16:47:18.681833,296,4.0,0.0,60,0,1530.0
320000.0,2,1.0,1100,8281,1.0,4,7,1100,0.0,1947,1510,8281,27460 days 16:47:18.681833,163,2.0,0.0,-410,0,1100.0
544000.0,4,2.5,2030,3974,2.0,3,8,2030,0.0,1994,1780,3953,10293 days 16:47:18.681833,176,1.6,0.0,250,21,2030.0
344950.0,3,1.75,1870,7500,1.0,5,8,1320,550.0,1978,1870,7275,16137 days 16:47:18.681833,252,1.7142857142857142,2.4,0,225,770.0
539500.0,3,2.5,3080,12476,2.0,3,1,3080,0.0,1990,3130,13631,11754 days 16:47:18.681833,157,1.2,0.0,-50,-1155,3080.0
420000.0,4,1.75,2480,60548,1.0,4,7,1600,880.0,1968,2390,90169,19790 days 16:47:18.681833,107,2.2857142857142856,1.8181818181818181,90,-29621,720.0
305000.0,2,1.0,910,22725,1.0,1,6,910,0.0,1926,2000,14566,35130 days 16:47:18.681833,092,2.0,0.0,-1090,8159,910.0
229000.0,2,1.0,810,5100,1.0,3,6,810,0.0,1955,1500,5100,24538 days 16:47:18.681833,335,2.0,0.0,-690,0,810.0
1070000.0,5,3.5,3990,9938,2.0,3,1,3990,0.0,2001,3490,11734,7736 days 16:47:18.681833,170,1.4285714285714286,0.0,500,-1796,3990.0
397500.0,3,2.25,1430,1383,3.0,3,8,1430,0.0,2005,1430,1347,6275 days 16:47:18.681833,220,1.3333333333333333,0.0,0,36,1430.0
540000.0,4,2.0,2190,8402,2.0,4,6,2190,0.0,1928,2210,7802,34400 days 16:47:18.681833,091,2.0,0.0,-20,600,2190.0
650000.0,4,2.5,2290,10186,2.0,3,8,2290,0.0,1985,2150,10186,13580 days 16:47:18.681833,266,1.6,0.0,140,0,2290.0
1900000.0,6,4.0,3020,13237,2.0,3,8,2840,180.0,1942,3680,12620,29286 days 16:47:18.681833,205,1.5,15.777777777777779,-660,617,2660.0
649000.0,2,1.75,2260,280962,2.0,3,9,1890,370.0,2005,2860,219542,6275 days 16:47:18.681833,174,1.1428571428571428,5.108108108108108,-600,61420,1520.0
287500.0,5,2.0,2020,67953,1.5,4,7,1620,400.0,1936,1270,13198,31478 days 16:47:18.681833,084,2.5,4.05,750,54755,1220.0
815000.0,4,2.75,2620,4743,1.0,4,8,1310,1310.0,1949,1900,4764,26729 days 16:47:18.681833,177,1.4545454545454546,1.0,720,-21,0.0
795000.0,2,2.5,2830,8630,2.0,3,1,2830,0.0,2001,3190,7515,7736 days 16:47:18.681833,343,0.8,0.0,-360,1115,2830.0
502775.0,3,1.75,1700,9840,1.0,4,8,1200,500.0,1976,2040,14169,16868 days 16:47:18.681833,030,1.7142857142857142,2.4,-340,-4329,700.0
222900.0,2,1.0,1110,6411,1.0,3,6,1110,0.0,1944,1150,6504,28556 days 16:47:18.681833,012,2.0,0.0,-40,-93,1110.0
399950.0,4,3.0,2150,64694,1.0,3,8,1450,700.0,1969,2430,59612,19424 days 16:47:18.681833,337,1.3333333333333333,2.0714285714285716,-280,5082,750.0
728000.0,4,2.5,2650,13684,2.0,3,9,2650,0.0,1994,2650,12032,10293 days 16:47:18.681833,235,1.6,0.0,0,1652,2650.0
850000.0,5,3.5,3870,65556,2.0,3,1,3870,0.0,1994,4290,67019,10293 days 16:47:18.681833,272,1.4285714285714286,0.0,-420,-1463,3870.0
525000.0,4,2.75,2530,17856,2.0,3,8,2530,0.0,1998,2530,14640,8832 days 16:47:18.681833,275,1.4545454545454546,0.0,0,3216,2530.0
433500.0,3,2.5,2200,3360,2.0,3,8,2200,0.0,2009,2130,3423,4814 days 16:47:18.681833,139,1.2,0.0,70,-63,2200.0
314950.0,4,1.75,1890,9623,1.0,4,7,1290,600.0,1969,1510,9711,19424 days 16:47:18.681833,113,2.2857142857142856,2.15,380,-88,690.0
500000.0,3,1.75,1530,14633,1.0,3,7,1100,430.0,1977,1780,8100,16502 days 16:47:18.681833,265,1.7142857142857142,2.558139534883721,-250,6533,670.0
300000.0,3,1.5,1590,8911,1.0,3,7,1590,0.0,1956,1590,9625,24173 days 16:47:18.681833,178,2.0,0.0,0,-714,1590.0
645000.0,4,2.5,2690,18653,2.0,3,8,2690,0.0,1985,2230,9744,13580 days 16:47:18.681833,188,1.6,0.0,460,8909,2690.0
222500.0,3,1.0,990,10125,1.0,3,7,990,0.0,1972,1360,10125,18329 days 16:47:18.681833,275,3.0,0.0,-370,0,990.0
275000.0,3,1.75,1300,8099,1.0,4,7,1080,220.0,1976,1270,8099,16868 days 16:47:18.681833,196,1.7142857142857142,4.909090909090909,30,0,860.0
498000.0,3,1.5,1720,6570,1.5,4,8,1720,0.0,1909,1360,6000,41339 days 16:47:18.681833,106,2.0,0.0,360,570,1720.0
800000.0,3,1.75,2080,75794,1.0,3,7,2080,0.0,1958,1870,11020,23442 days 16:47:18.681833,177,1.7142857142857142,0.0,210,64774,2080.0
297000.0,3,2.5,1840,8234,2.0,3,8,1840,0.0,1994,1940,7601,10293 days 16:47:18.681833,226,1.2,0.0,-100,633,1840.0
625000.0,5,3.5,4010,6000,2.0,3,9,2560,1450.0,1997,2440,6000,9197 days 16:47:18.681833,132,1.4285714285714286,1.7655172413793103,1570,0,1110.0
770000.0,4,2.5,3560,6187,2.0,3,9,3560,0.0,2003,3190,6981,7006 days 16:47:18.681833,303,1.6,0.0,370,-794,3560.0
517000.0,3,2.25,1640,4635,1.5,3,8,1540,100.0,1930,1530,4635,33669 days 16:47:18.681833,260,1.3333333333333333,15.4,110,0,1440.0
238000.0,1,1.0,530,6350,1.0,5,5,530,0.0,1941,1200,6350,29651 days 16:47:18.681833,241,1.0,0.0,-670,0,530.0
234550.0,3,1.0,1990,15375,1.0,3,7,1140,850.0,1946,1160,10236,27825 days 16:47:18.682830,294,3.0,1.3411764705882352,830,5139,290.0
230500.0,3,2.25,1690,7245,1.0,3,7,1160,530.0,1973,1690,6720,17963 days 16:47:18.682830,272,1.3333333333333333,2.188679245283019,0,525,630.0
585000.0,5,2.5,2670,16777,1.5,4,7,1620,1050.0,1920,1610,8227,37322 days 16:47:18.682830,179,2.0,1.542857142857143,1060,8550,570.0
733000.0,4,1.75,1930,3876,1.5,5,7,1450,480.0,1924,1280,3825,35861 days 16:47:18.682830,234,2.2857142857142856,3.0208333333333335,650,51,970.0
357950.0,2,1.0,810,3880,1.0,3,7,810,0.0,1952,900,4365,25634 days 16:47:18.682830,318,2.0,0.0,-90,-485,810.0
530000.0,3,1.75,1550,3680,1.0,3,7,1050,500.0,1927,1560,4000,34765 days 16:47:18.682830,162,1.7142857142857142,2.1,-10,-320,550.0
377500.0,4,2.5,2640,10720,2.0,3,8,2640,0.0,1999,1680,10018,8467 days 16:47:18.682830,363,1.6,0.0,960,702,2640.0
475000.0,4,2.5,2320,10046,2.0,3,7,2320,0.0,2006,2320,5253,5910 days 16:47:18.682830,037,1.6,0.0,0,4793,2320.0
399000.0,3,1.75,2170,73616,1.0,3,7,2170,0.0,2008,1710,297514,5180 days 16:47:18.682830,128,1.7142857142857142,0.0,460,-223898,2170.0
400000.0,5,2.25,2070,10488,1.0,4,7,1080,990.0,1958,1740,9225,23442 days 16:47:18.682830,280,2.2222222222222223,1.0909090909090908,330,1263,90.0
440000.0,2,1.0,800,4850,1.0,4,7,800,0.0,1944,1150,4365,28556 days 16:47:18.682830,122,2.0,0.0,-350,485,800.0
366400.0,4,2.25,2040,14383,1.0,4,8,1270,770.0,1977,2030,11500,16502 days 16:47:18.682830,037,1.7777777777777777,1.6493506493506493,10,2883,500.0
627250.0,4,2.5,2830,10677,2.0,3,9,2830,0.0,1993,2970,9619,10658 days 16:47:18.682830,079,1.6,0.0,-140,1058,2830.0
375950.0,3,1.75,1480,7560,1.0,3,6,1100,380.0,1920,1510,7250,37322 days 16:47:18.682830,211,1.7142857142857142,2.8947368421052633,-30,310,720.0
162000.0,3,2.25,1810,6750,1.0,3,7,1280,530.0,1978,1690,7770,16137 days 16:47:18.682830,049,1.3333333333333333,2.4150943396226414,120,-1020,750.0
780000.0,3,2.75,1970,2600,2.5,3,8,1970,0.0,1924,1680,3120,35861 days 16:47:18.682830,205,1.0909090909090908,0.0,290,-520,1970.0
705000.0,4,2.5,2650,4316,1.5,3,8,1520,1130.0,1905,1690,5625,42800 days 16:47:18.682830,127,1.6,1.345132743362832,960,-1309,390.0
450000.0,4,2.5,2820,15233,1.0,4,9,1820,1000.0,1972,2560,11998,18329 days 16:47:18.682830,357,1.6,1.82,260,3235,820.0
311000.0,3,2.75,1400,7880,1.0,3,7,1000,400.0,1981,1400,7279,15041 days 16:47:18.682830,321,1.0909090909090908,2.5,0,601,600.0
485000.0,3,2.5,1580,6065,2.0,3,8,1580,0.0,1985,1770,6700,13580 days 16:47:18.682830,164,1.2,0.0,-190,-635,1580.0
485000.0,3,2.5,1800,11034,2.0,4,8,1800,0.0,1987,1940,8900,12850 days 16:47:18.682830,197,1.2,0.0,-140,2134,1800.0
725000.0,5,3.75,3360,6000,2.0,3,8,2640,720.0,1963,1930,6000,21616 days 16:47:18.682830,283,1.3333333333333333,3.6666666666666665,1430,0,1920.0
1890000.0,4,4.25,4285,9345,2.0,3,1,4285,0.0,2013,1570,8994,3353 days 16:47:18.682830,335,0.9411764705882353,0.0,2715,351,4285.0
260000.0,3,2.25,1610,7423,2.0,4,7,1610,0.0,1990,1530,8102,11754 days 16:47:18.682830,128,1.3333333333333333,0.0,80,-679,1610.0
356000.0,4,2.5,2470,5074,2.0,3,8,2470,0.0,2004,2470,5078,6641 days 16:47:18.682830,120,1.6,0.0,0,-4,2470.0
225205.0,3,1.0,1200,7220,1.0,3,6,1200,0.0,1977,1200,7200,16502 days 16:47:18.682830,078,3.0,0.0,0,20,1200.0
445000.0,3,1.0,1260,8910,1.0,4,7,1260,0.0,1949,1560,8910,26729 days 16:47:18.682830,363,3.0,0.0,-300,0,1260.0
356000.0,2,1.0,920,4095,1.0,4,6,920,0.0,1914,1460,4945,39513 days 16:47:18.682830,156,2.0,0.0,-540,-850,920.0
760250.0,5,2.75,2540,8250,1.0,4,7,1440,1100.0,1953,2540,11000,25268 days 16:47:18.682830,283,1.8181818181818181,1.309090909090909,0,-2750,340.0
572000.0,2,2.0,1870,5143,1.0,3,8,1870,0.0,2005,1810,5143,6275 days 16:47:18.682830,120,1.0,0.0,60,0,1870.0
970000.0,3,2.25,3060,9950,1.5,4,9,1810,1250.0,1930,4950,10655,33669 days 16:47:18.682830,175,1.3333333333333333,1.448,-1890,-705,560.0
348450.0,4,2.5,1950,8628,2.0,3,8,1950,0.0,1994,2210,9019,10293 days 16:47:18.682830,243,1.6,0.0,-260,-391,1950.0
535500.0,3,1.5,1730,40250,2.0,4,8,1730,0.0,1983,1730,36250,14311 days 16:47:18.682830,157,2.0,0.0,0,4000,1730.0
710000.0,5,2.5,2570,9600,1.0,3,8,1620,950.0,1956,2680,9900,24173 days 16:47:18.682830,286,2.0,1.7052631578947368,-110,-300,670.0
745000.0,3,1.75,1490,9800,1.0,4,7,1140,350.0,1947,2310,9800,27460 days 16:47:18.682830,148,1.7142857142857142,3.257142857142857,-820,0,790.0
355000.0,4,2.5,2040,8265,2.0,3,7,2040,0.0,1996,2160,8265,9563 days 16:47:18.682830,171,1.6,0.0,-120,0,2040.0
333000.0,4,2.5,2690,5505,2.0,3,8,2690,0.0,2004,2690,5505,6641 days 16:47:18.682830,082,1.6,0.0,0,0,2690.0
282000.0,3,2.5,1610,6000,2.0,4,7,1610,0.0,1993,1570,6000,10658 days 16:47:18.682830,238,1.2,0.0,40,0,1610.0
840500.0,3,2.0,2520,5400,1.5,4,8,1410,1110.0,1906,1960,5400,42435 days 16:47:18.682830,148,1.5,1.2702702702702702,560,0,300.0
432000.0,3,1.75,1550,8134,1.0,4,7,1550,0.0,1959,1360,8000,23077 days 16:47:18.682830,097,1.7142857142857142,0.0,190,134,1550.0
625000.0,3,1.0,1800,4800,1.0,4,9,900,900.0,1927,1400,4800,34765 days 16:47:18.682830,302,3.0,1.0,400,0,0.0
209977.0,3,1.0,1170,6134,1.0,4,7,1170,0.0,1948,1440,9823,27095 days 16:47:18.682830,253,3.0,0.0,-270,-3689,1170.0
174000.0,2,1.0,900,13531,1.0,3,6,900,0.0,1979,1767,8308,15772 days 16:47:18.682830,182,2.0,0.0,-867,5223,900.0
740000.0,4,2.0,2800,8540,1.0,4,8,1730,1070.0,1977,2470,9400,16502 days 16:47:18.682830,112,2.0,1.6168224299065421,330,-860,660.0
518000.0,3,1.75,1830,4500,1.5,4,7,1830,0.0,1909,1830,4080,41339 days 16:47:18.682830,260,1.7142857142857142,0.0,0,420,1830.0
539000.0,3,1.75,1380,3225,1.0,4,7,940,440.0,1915,1250,3750,39148 days 16:47:18.682830,064,1.7142857142857142,2.1363636363636362,130,-525,500.0
575000.0,3,2.75,1990,9600,1.0,3,8,1530,460.0,1978,2170,10400,16137 days 16:47:18.682830,119,1.0909090909090908,3.3260869565217392,-180,-800,1070.0
530000.0,2,1.75,1170,976,2.0,3,9,780,390.0,2010,1280,1183,4449 days 16:47:18.682830,040,1.1428571428571428,2.0,-110,-207,390.0
242025.0,4,1.75,1400,54014,1.5,4,7,1400,0.0,1935,1910,8523,31843 days 16:47:18.682830,197,2.2857142857142856,0.0,-510,45491,1400.0
1030000.0,4,2.5,2620,11200,1.0,4,8,1770,850.0,1962,2360,11200,21981 days 16:47:18.682830,065,1.6,2.0823529411764707,260,0,920.0
230000.0,3,1.0,880,7500,1.0,3,7,880,0.0,1978,880,7500,16137 days 16:47:18.682830,238,3.0,0.0,0,0,880.0
350000.0,4,2.5,2260,7500,1.0,3,8,1460,800.0,1965,2260,7500,20885 days 16:47:18.682830,007,1.6,1.825,0,0,660.0
595000.0,3,1.0,1300,11520,1.0,3,6,1300,0.0,1958,1440,8064,23442 days 16:47:18.682830,119,3.0,0.0,-140,3456,1300.0
440000.0,3,1.75,1450,6829,1.0,3,8,1450,0.0,1983,1950,7622,14311 days 16:47:18.682830,192,1.7142857142857142,0.0,-500,-793,1450.0
550000.0,3,1.0,1110,6000,1.0,3,7,1110,0.0,1904,1460,6000,43166 days 16:47:18.682830,051,3.0,0.0,-350,0,1110.0
940000.0,4,2.25,1890,5940,1.0,3,9,1470,420.0,1963,2430,5940,21616 days 16:47:18.682830,127,1.7777777777777777,3.5,-540,0,1050.0
375000.0,3,1.5,1100,1751,2.0,3,8,940,160.0,2007,1380,1751,5545 days 16:47:18.682830,136,2.0,5.875,-280,0,780.0
567500.0,2,1.5,1350,4592,1.0,3,7,1070,280.0,1939,1610,5102,30382 days 16:47:18.682830,339,1.3333333333333333,3.8214285714285716,-260,-510,790.0
735000.0,3,2.5,3020,50800,1.0,5,8,1510,1510.0,1968,2400,27135,19790 days 16:47:18.682830,259,1.2,1.0,620,23665,0.0
114000.0,2,1.0,730,5200,1.0,3,6,730,0.0,1928,1220,6240,34400 days 16:47:18.682830,290,2.0,0.0,-490,-1040,730.0
608000.0,2,1.0,1390,3600,1.0,4,7,1010,380.0,1913,1590,3600,39878 days 16:47:18.682830,237,2.0,2.6578947368421053,-200,0,630.0
442500.0,3,1.5,2710,47419,1.5,3,7,2170,540.0,1980,2130,48144,15407 days 16:47:18.682830,311,2.0,4.018518518518518,580,-725,1630.0
381800.0,4,2.0,1530,5250,1.0,3,7,1110,420.0,1981,1100,5250,15041 days 16:47:18.682830,289,2.0,2.642857142857143,430,0,690.0
90000.0,2,1.0,790,2640,1.0,3,7,790,0.0,1973,1310,2064,17963 days 16:47:18.682830,133,2.0,0.0,-520,576,790.0
312000.0,2,1.75,1160,8625,1.0,4,6,1160,0.0,1941,960,5750,29651 days 16:47:18.682830,205,1.1428571428571428,0.0,200,2875,1160.0
339000.0,3,1.0,1080,8100,1.0,4,7,1080,0.0,1955,1080,8100,24538 days 16:47:18.682830,132,3.0,0.0,0,0,1080.0
313000.0,3,1.75,2190,8000,1.0,4,8,2190,0.0,1967,1980,8000,20155 days 16:47:18.682830,127,1.7142857142857142,0.0,210,0,2190.0
618080.0,3,2.5,2030,6500,2.0,3,8,2030,0.0,1988,2030,8485,12485 days 16:47:18.682830,127,1.2,0.0,0,-1985,2030.0
325000.0,3,2.25,2480,8755,2.0,3,8,2480,0.0,1979,2280,9940,15772 days 16:47:18.682830,279,1.3333333333333333,0.0,200,-1185,2480.0
242000.0,4,1.0,2240,7620,1.0,3,7,1120,1120.0,1966,1080,7620,20520 days 16:47:18.682830,196,4.0,1.0,1160,0,0.0
364000.0,2,1.5,1650,7311,1.0,3,7,860,790.0,1978,1660,7255,16137 days 16:47:18.682830,352,1.3333333333333333,1.0886075949367089,-10,56,70.0
545000.0,3,1.75,1700,5750,1.5,5,7,1450,250.0,1925,1700,5750,35495 days 16:47:18.682830,227,1.7142857142857142,5.8,0,0,1200.0
445000.0,3,2.5,2790,16173,2.0,3,1,2790,0.0,1988,2890,11632,12485 days 16:47:18.682830,357,1.2,0.0,-100,4541,2790.0
1090000.0,4,2.75,3010,10830,2.0,4,9,3010,0.0,1980,3010,10650,15407 days 16:47:18.682830,209,1.4545454545454546,0.0,0,180,3010.0
660000.0,4,2.5,2550,10000,1.0,3,8,1290,1260.0,1964,2270,8640,21251 days 16:47:18.682830,132,1.6,1.0238095238095237,280,1360,30.0
845000.0,4,2.5,2880,35610,1.0,3,1,2880,0.0,1989,3460,35610,12119 days 16:47:18.682830,301,1.6,0.0,-580,0,2880.0
417000.0,4,2.0,2090,4000,1.0,3,6,1060,1030.0,1907,1590,4000,42070 days 16:47:18.682830,266,2.0,1.029126213592233,500,0,30.0
213800.0,2,1.0,740,5200,1.0,4,5,740,0.0,1952,750,5200,25634 days 16:47:18.682830,118,2.0,0.0,-10,0,740.0
400000.0,2,1.75,960,6200,1.0,4,7,960,0.0,1946,1000,6000,27825 days 16:47:18.682830,301,1.1428571428571428,0.0,-40,200,960.0
759950.0,4,3.5,2100,7560,2.0,5,8,2100,0.0,2005,1250,7560,6275 days 16:47:18.682830,064,1.1428571428571428,0.0,850,0,2100.0
990000.0,4,2.5,2540,5930,2.0,3,9,2540,0.0,2003,1400,4000,7006 days 16:47:18.682830,113,1.6,0.0,1140,1930,2540.0
710000.0,3,1.75,1650,10250,1.0,5,8,1650,0.0,1963,2400,10250,21616 days 16:47:18.682830,232,1.7142857142857142,0.0,-750,0,1650.0
315000.0,1,0.75,770,4600,1.0,4,6,770,0.0,1910,1550,4600,40974 days 16:47:18.682830,289,1.3333333333333333,0.0,-780,0,770.0
515000.0,4,2.5,2280,14810,1.0,5,8,1500,780.0,1977,2690,12196,16502 days 16:47:18.682830,245,1.6,1.9230769230769231,-410,2614,720.0
638000.0,3,2.0,1660,3729,1.0,5,7,970,690.0,1922,1560,3729,36591 days 16:47:18.682830,177,1.5,1.4057971014492754,100,0,280.0
370000.0,4,2.0,2020,8100,1.5,4,7,1160,860.0,1946,1840,8680,27825 days 16:47:18.682830,049,2.0,1.3488372093023255,180,-580,300.0
583800.0,3,2.5,2480,6600,2.0,3,8,2480,0.0,2002,2310,6656,7371 days 16:47:18.682830,209,1.2,0.0,170,-56,2480.0
309500.0,3,1.0,1250,7320,1.0,3,7,1250,0.0,1968,1770,7320,19790 days 16:47:18.682830,301,3.0,0.0,-520,0,1250.0
1960000.0,4,4.0,4430,31353,2.0,3,1,4430,0.0,1998,3900,35237,8832 days 16:47:18.682830,112,1.0,0.0,530,-3884,4430.0
410000.0,4,2.0,1970,10500,1.0,3,8,1820,150.0,1961,2090,12300,22346 days 16:47:18.682830,169,2.0,12.133333333333333,-120,-1800,1670.0
478000.0,2,1.0,820,6000,1.0,3,7,820,0.0,1939,1630,6000,30382 days 16:47:18.682830,303,2.0,0.0,-810,0,820.0
431000.0,2,1.0,1000,6500,1.0,4,7,1000,0.0,1918,1280,6500,38052 days 16:47:18.682830,253,2.0,0.0,-280,0,1000.0
635000.0,4,2.5,3080,35430,2.0,3,9,3080,0.0,1997,2640,28972,9197 days 16:47:18.682830,190,1.6,0.0,440,6458,3080.0
648000.0,5,2.25,2410,12000,2.0,4,8,2410,0.0,1973,2080,12000,17963 days 16:47:18.682830,098,2.2222222222222223,0.0,330,0,2410.0
640000.0,3,2.5,2370,11172,2.0,3,9,2370,0.0,1993,2550,11558,10658 days 16:47:18.682830,154,1.2,0.0,-180,-386,2370.0
932808.0,5,4.5,4690,6705,2.0,3,1,3450,1240.0,1995,4070,11505,9928 days 16:47:18.682830,349,1.1111111111111112,2.782258064516129,620,-4800,2210.0
835000.0,2,2.0,2280,6815,1.0,3,8,2280,0.0,2002,2280,6750,7371 days 16:47:18.682830,157,1.0,0.0,0,65,2280.0
469775.0,2,1.75,1530,7020,1.0,3,7,1030,500.0,1942,2090,6600,29286 days 16:47:18.682830,209,1.1428571428571428,2.06,-560,420,530.0
587000.0,5,3.5,3610,52595,2.0,4,7,3610,0.0,1989,1620,60112,12119 days 16:47:18.682830,198,1.4285714285714286,0.0,1990,-7517,3610.0
677915.0,3,2.0,1740,3600,1.0,5,7,990,750.0,1923,1250,3600,36226 days 16:47:18.682830,202,1.5,1.32,490,0,240.0
1080000.0,4,3.0,3600,9200,1.0,4,9,2100,1500.0,1976,2700,9775,16868 days 16:47:18.682830,142,1.3333333333333333,1.4,900,-575,600.0
671000.0,4,3.0,3130,5700,1.5,3,7,1750,1380.0,1953,2080,5700,25268 days 16:47:18.682830,186,1.3333333333333333,1.2681159420289856,1050,0,370.0
695000.0,5,3.25,3940,9780,2.0,3,9,3940,0.0,2007,3550,8468,5545 days 16:47:18.682830,246,1.5384615384615385,0.0,390,1312,3940.0
205000.0,4,2.0,2200,13320,1.0,3,6,1100,1100.0,1944,1330,6099,28556 days 16:47:18.682830,210,2.0,1.0,870,7221,0.0
350000.0,4,1.0,1510,7200,1.5,4,7,1510,0.0,1955,1950,10656,24538 days 16:47:18.682830,120,4.0,0.0,-440,-3456,1510.0
360000.0,3,1.75,1560,7930,2.0,4,7,1560,0.0,1980,1720,8073,15407 days 16:47:18.682830,216,1.7142857142857142,0.0,-160,-143,1560.0
313999.0,4,2.25,1870,4198,2.0,3,7,1870,0.0,2008,1870,4184,5180 days 16:47:18.682830,312,1.7777777777777777,0.0,0,14,1870.0
300000.0,3,2.25,2070,7225,1.0,3,8,1690,380.0,1979,2070,7400,15772 days 16:47:18.682830,111,1.3333333333333333,4.447368421052632,0,-175,1310.0
452000.0,2,1.75,1660,11747,1.0,3,7,830,830.0,1981,1900,19850,15041 days 16:47:18.682830,113,1.1428571428571428,1.0,-240,-8103,0.0
495500.0,3,2.5,2010,57934,1.0,3,7,2010,0.0,1978,2040,55527,16137 days 16:47:18.682830,084,1.2,0.0,-30,2407,2010.0
288000.0,3,1.0,1410,40500,1.0,4,7,1410,0.0,1961,1570,40500,22346 days 16:47:18.682830,352,3.0,0.0,-160,0,1410.0
227490.0,3,1.75,1820,7194,1.0,4,7,1820,0.0,1967,1420,7560,20155 days 16:47:18.682830,048,1.7142857142857142,0.0,400,-366,1820.0
470950.0,3,2.5,2560,16420,2.0,4,8,2560,0.0,1989,2120,16298,12119 days 16:47:18.682830,311,1.2,0.0,440,122,2560.0
735000.0,4,2.75,2450,4187,2.0,3,8,2450,0.0,2010,2320,4187,4449 days 16:47:18.682830,165,1.4545454545454546,0.0,130,0,2450.0
730000.0,7,2.75,3110,4400,1.5,5,7,2010,1100.0,1914,1240,4280,39513 days 16:47:18.682830,288,2.5454545454545454,1.8272727272727274,1870,120,910.0
412000.0,3,2.5,2210,7000,2.0,4,8,2210,0.0,1985,2260,7224,13580 days 16:47:18.682830,337,1.2,0.0,-50,-224,2210.0
589500.0,4,2.5,2630,6326,2.0,3,9,2630,0.0,2008,3240,6229,5180 days 16:47:18.682830,157,1.6,0.0,-610,97,2630.0
291000.0,7,1.0,2350,8636,1.0,3,7,1550,800.0,1962,1500,7366,21981 days 16:47:18.682830,308,7.0,1.9375,850,1270,750.0
1300000.0,5,3.75,4450,7680,2.0,3,9,3460,990.0,2010,2550,6400,4449 days 16:47:18.682830,092,1.3333333333333333,3.494949494949495,1900,1280,2470.0
190000.0,3,1.0,1200,10458,1.0,4,6,1200,0.0,1961,1160,9000,22346 days 16:47:18.682830,293,3.0,0.0,40,1458,1200.0
456200.0,2,1.75,1210,7733,1.0,3,6,1210,0.0,1904,1670,7733,43166 days 16:47:18.682830,112,1.1428571428571428,0.0,-460,0,1210.0
225000.0,3,1.0,1290,8470,1.0,4,7,970,320.0,1966,1300,7350,20520 days 16:47:18.682830,262,3.0,3.03125,-10,1120,650.0
2000000.0,3,2.5,3490,21064,1.0,3,1,2290,1200.0,1968,1780,15244,19790 days 16:47:18.682830,112,1.2,1.9083333333333334,1710,5820,1090.0
740000.0,4,2.5,3360,15091,2.0,3,9,3360,0.0,1997,1930,9936,9197 days 16:47:18.682830,190,1.6,0.0,1430,5155,3360.0
467000.0,3,1.75,2660,5511,1.0,3,8,1330,1330.0,1948,2030,6111,27095 days 16:47:18.682830,335,1.7142857142857142,1.0,630,-600,0.0
385000.0,2,1.0,770,7554,1.0,3,6,770,0.0,1946,1390,7500,27825 days 16:47:18.682830,281,2.0,0.0,-620,54,770.0
670000.0,3,2.5,1800,4763,2.0,3,7,1240,560.0,1985,1790,4763,13580 days 16:47:18.682830,293,1.2,2.2142857142857144,10,0,680.0
500000.0,4,2.5,2900,5760,1.0,4,8,1660,1240.0,1959,2250,6098,23077 days 16:47:18.682830,112,1.6,1.3387096774193548,650,-338,420.0
669888.0,4,2.75,2550,7591,2.0,3,9,2550,0.0,1989,2670,7796,12119 days 16:47:18.682830,301,1.4545454545454546,0.0,-120,-205,2550.0
405000.0,3,2.75,1310,7300,1.0,3,7,1310,0.0,1957,1310,7030,23807 days 16:47:18.682830,175,1.0909090909090908,0.0,0,270,1310.0
518000.0,3,1.5,1430,8000,1.0,4,7,1430,0.0,1956,1450,8000,24173 days 16:47:18.682830,126,2.0,0.0,-20,0,1430.0
280000.0,4,1.0,1880,6288,1.0,3,7,1120,760.0,1974,1880,6334,17598 days 16:47:18.682830,274,4.0,1.4736842105263157,0,-46,360.0
435000.0,3,2.5,1600,2375,2.0,3,7,1600,0.0,2005,1830,2375,6275 days 16:47:18.682830,199,1.2,0.0,-230,0,1600.0
314950.0,3,2.0,1760,9732,1.0,3,7,1760,0.0,1996,1910,9231,9563 days 16:47:18.682830,127,1.5,0.0,-150,501,1760.0
209900.0,2,2.0,1180,3003,2.0,3,6,1180,0.0,2005,1310,3003,6275 days 16:47:18.682830,055,1.0,0.0,-130,0,1180.0
630000.0,4,2.5,2330,31705,2.0,4,8,2330,0.0,1980,2460,36600,15407 days 16:47:18.682830,106,1.6,0.0,-130,-4895,2330.0
442000.0,4,1.5,1960,12688,1.5,4,7,1960,0.0,1962,2050,9375,21981 days 16:47:18.682830,199,2.6666666666666665,0.0,-90,3313,1960.0
340000.0,4,1.0,1140,13440,1.0,2,5,1140,0.0,1944,1450,7560,28556 days 16:47:18.682830,092,4.0,0.0,-310,5880,1140.0
230000.0,3,1.75,1400,6956,1.0,4,7,1400,0.0,1957,1400,9375,23807 days 16:47:18.682830,167,1.7142857142857142,0.0,0,-2419,1400.0
495200.0,5,2.25,2710,22120,1.0,3,7,1410,1300.0,1955,2850,12224,24538 days 16:47:18.682830,339,2.2222222222222223,1.0846153846153845,-140,9896,110.0
900000.0,4,2.5,3510,6745,2.0,3,1,3510,0.0,1998,3320,8370,8832 days 16:47:18.682830,090,1.6,0.0,190,-1625,3510.0
265000.0,2,1.0,910,4600,1.0,3,5,910,0.0,1917,1020,4600,38417 days 16:47:18.682830,072,2.0,0.0,-110,0,910.0
489500.0,3,1.75,2090,65558,1.0,3,8,1330,760.0,1977,2450,47178,16502 days 16:47:18.682830,002,1.7142857142857142,1.75,-360,18380,570.0
335000.0,3,2.0,1410,44866,1.0,4,7,1410,0.0,1985,2950,29152,13580 days 16:47:18.682830,134,1.5,0.0,-1540,15714,1410.0
585000.0,3,3.25,3050,12700,2.0,3,8,2240,810.0,1990,3050,12386,11754 days 16:47:18.682830,339,0.9230769230769231,2.765432098765432,0,314,1430.0
800000.0,4,2.25,2010,7200,1.0,4,8,1010,1000.0,1950,2010,7200,26364 days 16:47:18.682830,290,1.7777777777777777,1.01,0,0,10.0
379500.0,4,2.25,2120,53578,2.0,4,7,2120,0.0,1985,2120,53578,13580 days 16:47:18.682830,251,1.7777777777777777,0.0,0,0,2120.0
475000.0,3,1.0,1270,8000,1.0,4,6,1270,0.0,1959,1210,7875,23077 days 16:47:18.682830,224,3.0,0.0,60,125,1270.0
520000.0,3,2.0,1670,8800,1.0,4,7,1150,520.0,1961,2020,8250,22346 days 16:47:18.682830,328,1.5,2.2115384615384617,-350,550,630.0
515000.0,4,2.5,1800,4338,2.0,3,8,1800,0.0,2001,1800,4507,7736 days 16:47:18.682830,028,1.6,0.0,0,-169,1800.0
577500.0,2,1.0,1640,5515,1.0,4,7,940,700.0,1926,2054,5515,35130 days 16:47:18.682830,123,2.0,1.3428571428571427,-414,0,240.0
269900.0,3,2.25,1740,9672,1.0,4,7,1110,630.0,1963,1640,9600,21616 days 16:47:18.682830,197,1.3333333333333333,1.7619047619047619,100,72,480.0
329000.0,3,1.0,1600,5952,1.0,4,7,1150,450.0,1964,1460,6200,21251 days 16:47:18.682830,147,3.0,2.5555555555555554,140,-248,700.0
458500.0,3,1.5,1280,1920,1.5,3,7,1280,0.0,1905,1280,3150,42800 days 16:47:18.682830,114,2.0,0.0,0,-1230,1280.0
890000.0,4,2.0,1480,11171,1.5,4,6,1480,0.0,1947,2790,20680,27460 days 16:47:18.682830,072,2.0,0.0,-1310,-9509,1480.0
361500.0,4,2.5,1980,7334,2.0,3,7,1980,0.0,2003,1850,7134,7006 days 16:47:18.682830,091,1.6,0.0,130,200,1980.0
2540000.0,5,3.25,3730,10626,1.0,4,1,3730,0.0,1963,4180,19110,21616 days 16:47:18.682830,199,1.5384615384615385,0.0,-450,-8484,3730.0
325000.0,2,1.0,900,8374,1.0,3,7,900,0.0,1984,1580,8965,13946 days 16:47:18.682830,234,2.0,0.0,-680,-591,900.0
1850000.0,4,3.25,3480,6000,3.0,3,8,3480,0.0,2014,2200,4080,2988 days 16:47:18.682830,309,1.2307692307692308,0.0,1280,1920,3480.0
945000.0,4,2.0,2840,13367,1.0,3,7,1420,1420.0,1952,2840,12744,25634 days 16:47:18.682830,143,2.0,1.0,0,623,0.0
370000.0,3,2.5,2490,4244,2.0,3,9,2490,0.0,2005,2490,4748,6275 days 16:47:18.682830,240,1.2,0.0,0,-504,2490.0
450000.0,2,2.0,1510,4908,1.0,3,8,1510,0.0,2006,1440,3921,5910 days 16:47:18.682830,258,1.0,0.0,70,987,1510.0
800000.0,4,2.5,2900,18303,2.0,4,1,2900,0.0,1994,2900,18303,10293 days 16:47:18.682830,114,1.6,0.0,0,0,2900.0
676000.0,3,2.5,2240,3825,2.0,3,7,2240,0.0,1995,1460,5100,9928 days 16:47:18.682830,345,1.2,0.0,780,-1275,2240.0
1270000.0,4,1.75,2040,5000,2.0,4,9,2040,0.0,1921,3220,5600,36956 days 16:47:18.682830,092,2.2857142857142856,0.0,-1180,-600,2040.0
290000.0,3,1.75,1460,7980,1.0,3,7,1460,0.0,1972,1920,7980,18329 days 16:47:18.682830,301,1.7142857142857142,0.0,-460,0,1460.0
158000.0,3,1.5,990,8925,1.0,4,7,990,0.0,1962,1360,8625,21981 days 16:47:18.682830,322,2.0,0.0,-370,300,990.0
379950.0,4,1.75,1970,9389,1.0,5,7,1140,830.0,1960,1820,8135,22712 days 16:47:18.682830,125,2.2857142857142856,1.3734939759036144,150,1254,310.0
583000.0,4,2.5,2660,4000,2.0,3,8,2660,0.0,2001,2330,4517,7736 days 16:47:18.682830,129,1.6,0.0,330,-517,2660.0
150000.0,2,1.0,870,5700,1.0,4,6,870,0.0,1957,1020,5700,23807 days 16:47:18.682830,364,2.0,0.0,-150,0,870.0
261500.0,3,2.5,1740,6992,2.0,3,7,1740,0.0,1990,1260,6825,11754 days 16:47:18.682830,202,1.2,0.0,480,167,1740.0
555000.0,4,2.75,2170,7140,1.0,3,8,1290,880.0,1977,2120,7820,16502 days 16:47:18.682830,266,1.4545454545454546,1.4659090909090908,50,-680,410.0
355000.0,3,1.75,2040,8173,1.0,3,7,1470,570.0,1958,1900,8172,23442 days 16:47:18.682830,239,1.7142857142857142,2.5789473684210527,140,1,900.0
375000.0,4,1.5,1770,6650,1.0,3,7,1770,0.0,1958,1600,7000,23442 days 16:47:18.682830,260,2.6666666666666665,0.0,170,-350,1770.0
227000.0,3,1.75,2380,12681,1.0,1,6,1380,1000.0,1918,1720,6377,38052 days 16:47:18.682830,210,1.7142857142857142,1.38,660,6304,380.0
335000.0,4,2.0,2030,103672,1.0,4,7,2030,0.0,1969,1560,325393,19424 days 16:47:18.682830,170,2.0,0.0,470,-221721,2030.0
680000.0,3,2.25,2270,23900,1.0,3,9,1820,450.0,1975,2520,28300,17233 days 16:47:18.682830,157,1.3333333333333333,4.044444444444444,-250,-4400,1370.0
686500.0,2,1.75,1390,5025,1.5,4,8,1390,0.0,1928,2160,5000,34400 days 16:47:18.682830,036,1.1428571428571428,0.0,-770,25,1390.0
410000.0,3,1.75,1530,26642,1.0,3,7,1180,350.0,1988,1550,13566,12485 days 16:47:18.682830,328,1.7142857142857142,3.3714285714285714,-20,13076,830.0
425000.0,2,1.0,1430,13300,1.5,3,6,1230,200.0,1921,1950,11421,36956 days 16:47:18.682830,238,2.0,6.15,-520,1879,1030.0
562500.0,3,2.5,2030,7549,1.0,3,8,2030,0.0,1988,2040,7130,12485 days 16:47:18.682830,069,1.2,0.0,-10,419,2030.0
345000.0,4,2.5,2390,6976,2.0,3,7,2390,0.0,2003,2390,6346,7006 days 16:47:18.682830,287,1.6,0.0,0,630,2390.0
627500.0,4,2.5,2540,11500,1.0,4,8,1640,900.0,1979,2820,9800,15772 days 16:47:18.682830,104,1.6,1.8222222222222222,-280,1700,740.0
355000.0,3,1.0,1890,36300,1.0,3,7,1890,0.0,1962,1746,54014,21981 days 16:47:18.682830,072,3.0,0.0,144,-17714,1890.0
335000.0,3,2.25,1870,5876,2.0,3,7,1870,0.0,1986,1670,6203,13215 days 16:47:18.682830,121,1.3333333333333333,0.0,200,-327,1870.0
350000.0,4,3.0,1780,4228,1.0,3,7,1780,0.0,1953,1730,5304,25268 days 16:47:18.682830,070,1.3333333333333333,0.0,50,-1076,1780.0
590000.0,3,1.0,1610,58370,1.0,3,7,1610,0.0,1978,2510,58127,16137 days 16:47:18.682830,077,3.0,0.0,-900,243,1610.0
252000.0,3,2.0,1420,6788,2.0,3,7,1420,0.0,1990,1790,6607,11754 days 16:47:18.682830,198,1.5,0.0,-370,181,1420.0
1300000.0,5,4.0,4440,9270,1.0,5,1,2220,2220.0,1968,2720,9614,19790 days 16:47:18.682830,111,1.25,1.0,1720,-344,0.0
705000.0,4,2.0,1820,5001,2.0,3,7,1820,0.0,1947,1440,5408,27460 days 16:47:18.682830,323,2.0,0.0,380,-407,1820.0
498000.0,3,2.0,1620,8400,1.0,3,7,1180,440.0,1968,2120,8424,19790 days 16:47:18.682830,195,1.5,2.6818181818181817,-500,-24,740.0
312500.0,2,1.0,870,7227,1.0,3,7,870,0.0,1948,1250,7252,27095 days 16:47:18.682830,264,2.0,0.0,-380,-25,870.0
260000.0,4,1.75,1830,5375,1.0,2,7,1060,770.0,1962,1040,7500,21981 days 16:47:18.682830,328,2.2857142857142856,1.3766233766233766,790,-2125,290.0
209950.0,3,1.5,2290,9600,1.0,4,7,2290,0.0,1967,1310,9600,20155 days 16:47:18.682830,077,2.0,0.0,980,0,2290.0
610000.0,3,1.75,1110,10402,1.0,4,7,1110,0.0,1967,2050,9660,20155 days 16:47:18.682830,041,1.7142857142857142,0.0,-940,742,1110.0
500000.0,4,1.0,1440,7100,1.5,3,7,1440,0.0,1906,1490,5000,42435 days 16:47:18.682830,178,4.0,0.0,-50,2100,1440.0
850000.0,3,3.5,3070,7050,1.0,3,8,1570,1500.0,1928,2350,5881,34400 days 16:47:18.682830,055,0.8571428571428571,1.0466666666666666,720,1169,70.0
689000.0,4,2.5,2440,11700,1.0,5,8,1480,960.0,1961,2140,10807,22346 days 16:47:18.682830,050,1.6,1.5416666666666667,300,893,520.0
470000.0,4,2.0,2410,4680,2.0,3,9,2410,0.0,1974,1910,4611,17598 days 16:47:18.682830,314,2.0,0.0,500,69,2410.0
640000.0,3,3.0,2270,5175,2.0,3,9,2130,140.0,2002,2850,5661,7371 days 16:47:18.682830,127,1.0,15.214285714285714,-580,-486,1990.0
290000.0,4,1.75,2340,7200,1.0,3,8,1590,750.0,1960,1970,7800,22712 days 16:47:18.682830,224,2.2857142857142856,2.12,370,-600,840.0
258500.0,3,2.5,1800,9000,2.0,3,7,1800,0.0,1983,1670,8486,14311 days 16:47:18.682830,352,1.2,0.0,130,514,1800.0
1100000.0,4,3.5,2210,7597,1.0,4,9,1550,660.0,1977,2370,8811,16502 days 16:47:18.682830,195,1.1428571428571428,2.3484848484848486,-160,-1214,890.0
420000.0,3,1.75,1820,22320,1.0,3,7,1250,570.0,1977,2030,22320,16502 days 16:47:18.682830,148,1.7142857142857142,2.192982456140351,-210,0,680.0
230000.0,3,1.0,1190,9083,1.0,3,7,1190,0.0,1955,1190,9450,24538 days 16:47:18.682830,259,3.0,0.0,0,-367,1190.0
252000.0,3,1.5,1400,6865,1.0,4,7,1400,0.0,1986,1480,8125,13215 days 16:47:18.682830,092,2.0,0.0,-80,-1260,1400.0
515000.0,3,2.5,2600,4506,2.0,3,8,2600,0.0,2003,2600,4658,7006 days 16:47:18.682830,181,1.2,0.0,0,-152,2600.0
425000.0,2,1.0,910,4635,1.0,4,6,910,0.0,1905,1740,5000,42800 days 16:47:18.682830,160,2.0,0.0,-830,-365,910.0
575000.0,3,2.5,1760,2320,2.0,3,8,1760,0.0,1994,1760,4698,10293 days 16:47:18.682830,025,1.2,0.0,0,-2378,1760.0
390000.0,2,1.0,860,5160,1.0,4,7,860,0.0,1909,1090,5356,41339 days 16:47:18.682830,299,2.0,0.0,-230,-196,860.0
561500.0,4,2.25,2310,9800,1.0,3,8,1780,530.0,1968,2310,9800,19790 days 16:47:18.682830,260,1.7777777777777777,3.358490566037736,0,0,1250.0
1350000.0,4,1.75,2000,3728,1.5,4,9,1820,180.0,1926,1950,3728,35130 days 16:47:18.682830,127,2.2857142857142856,10.11111111111111,50,0,1640.0
835000.0,5,2.75,2460,7830,1.0,5,9,1490,970.0,1955,2050,7830,24538 days 16:47:18.682830,268,1.8181818181818181,1.5360824742268042,410,0,520.0
245000.0,2,1.0,1020,15000,1.5,3,6,1020,0.0,1933,1480,14519,32573 days 16:47:18.682830,049,2.0,0.0,-460,481,1020.0
475200.0,3,2.5,1670,3980,2.0,3,8,1670,0.0,2000,1670,2897,8102 days 16:47:18.682830,223,1.2,0.0,0,1083,1670.0
425000.0,2,1.0,790,5024,1.0,4,7,790,0.0,1941,1330,5024,29651 days 16:47:18.682830,317,2.0,0.0,-540,0,790.0
218000.0,2,1.5,2010,7755,2.0,3,7,2010,0.0,1952,1360,8037,25634 days 16:47:18.682830,033,1.3333333333333333,0.0,650,-282,2010.0
600000.0,4,2.5,2600,6536,2.0,3,9,2600,0.0,1999,2640,6185,8467 days 16:47:18.682830,234,1.6,0.0,-40,351,2600.0
545000.0,4,2.25,1890,7210,1.0,3,8,1890,0.0,1967,1920,7210,20155 days 16:47:18.682830,100,1.7777777777777777,0.0,-30,0,1890.0
2410000.0,5,2.5,4600,23250,1.5,3,9,3600,1000.0,1918,5500,20066,38052 days 16:47:18.682830,118,2.0,3.6,-900,3184,2600.0
460000.0,5,3.0,2008,5050,1.0,3,7,1216,792.0,1992,2040,5297,11024 days 16:47:18.682830,126,1.6666666666666667,1.5353535353535352,-32,-247,424.0
425000.0,2,1.0,880,6413,1.0,3,7,880,0.0,1950,1360,6413,26364 days 16:47:18.682830,174,2.0,0.0,-480,0,880.0
455000.0,3,1.75,1700,8360,1.0,4,7,850,850.0,1955,1520,8360,24538 days 16:47:18.682830,294,1.7142857142857142,1.0,180,0,0.0
313100.0,3,2.0,1730,12821,1.0,3,8,1730,0.0,1994,1980,11336,10293 days 16:47:18.682830,111,1.5,0.0,-250,1485,1730.0
780000.0,4,3.5,3910,59863,2.0,4,1,2490,1420.0,1987,2830,37674,12850 days 16:47:18.682830,174,1.1428571428571428,1.7535211267605635,1080,22189,1070.0
345500.0,4,2.5,2160,9682,2.0,3,8,2160,0.0,1999,1770,9600,8467 days 16:47:18.682830,357,1.6,0.0,390,82,2160.0
243000.0,3,1.75,1200,8034,1.0,5,7,1200,0.0,1975,1270,7600,17233 days 16:47:18.682830,019,1.7142857142857142,0.0,-70,434,1200.0
670000.0,5,3.5,3860,9600,1.0,4,8,2660,1200.0,1973,2440,9600,17963 days 16:47:18.682830,342,1.4285714285714286,2.216666666666667,1420,0,1460.0
325000.0,3,1.5,1320,7560,1.0,3,6,840,480.0,1983,1210,7560,14311 days 16:47:18.682830,042,2.0,1.75,110,0,360.0
281000.0,2,1.0,1280,12500,1.0,3,7,1060,220.0,1951,1460,17771,25999 days 16:47:18.682830,336,2.0,4.818181818181818,-180,-5271,840.0
130000.0,3,1.0,1100,5100,1.0,4,7,1100,0.0,1913,1450,5100,39878 days 16:47:18.682830,064,3.0,0.0,-350,0,1100.0
340000.0,3,2.5,2170,9798,2.0,3,7,2170,0.0,1995,2020,8121,9928 days 16:47:18.682830,211,1.2,0.0,150,1677,2170.0
485000.0,4,2.75,2720,51396,2.0,4,8,2720,0.0,1977,1960,51366,16502 days 16:47:18.682830,040,1.4545454545454546,0.0,760,30,2720.0
642860.0,4,2.75,2520,6398,2.0,3,8,2520,0.0,2014,2520,6398,2988 days 16:47:18.682830,351,1.4545454545454546,0.0,0,0,2520.0
747000.0,3,1.75,2560,4800,1.0,3,7,1280,1280.0,1911,1620,4800,40609 days 16:47:18.682830,276,1.7142857142857142,1.0,940,0,0.0
559950.0,4,2.5,2650,7200,2.0,3,8,2250,400.0,1979,2110,7269,15772 days 16:47:18.682830,210,1.6,5.625,540,-69,1850.0
577288.0,4,2.75,2870,7200,2.0,3,9,2870,0.0,2008,2030,5400,5180 days 16:47:18.682830,321,1.4545454545454546,0.0,840,1800,2870.0
575000.0,2,1.0,1230,2726,1.5,3,7,880,350.0,1920,1710,3750,37322 days 16:47:18.682830,267,2.0,2.5142857142857142,-480,-1024,530.0
287000.0,3,1.0,1450,6000,1.0,4,7,1450,0.0,1953,1170,6464,25268 days 16:47:18.682830,125,3.0,0.0,280,-464,1450.0
1150000.0,4,3.75,3180,9889,2.0,3,9,2500,680.0,2012,2910,8558,3719 days 16:47:18.682830,314,1.0666666666666667,3.676470588235294,270,1331,1820.0
335000.0,2,1.0,1800,8900,1.0,3,6,900,900.0,1945,2040,10450,28190 days 16:47:18.682830,114,2.0,1.0,-240,-1550,0.0
375000.0,4,2.25,2020,12500,2.0,2,8,2020,0.0,1966,1800,13175,20520 days 16:47:18.682830,006,1.7777777777777777,0.0,220,-675,2020.0
325000.0,2,1.0,620,14823,1.0,3,6,620,0.0,1926,1400,7930,35130 days 16:47:18.682830,006,2.0,0.0,-780,6893,620.0
530000.0,3,2.25,2190,220414,1.0,4,7,1330,860.0,1976,2550,175982,16868 days 16:47:18.682830,113,1.3333333333333333,1.5465116279069768,-360,44432,470.0
287000.0,4,2.25,1980,7081,1.0,3,7,1470,510.0,1977,1980,7081,16502 days 16:47:18.682830,012,1.7777777777777777,2.8823529411764706,0,0,960.0
320000.0,5,3.0,2970,7000,1.0,3,8,1810,1160.0,1979,2630,8062,15772 days 16:47:18.682830,057,1.6666666666666667,1.5603448275862069,340,-1062,650.0
425000.0,4,2.5,2270,4400,2.0,3,7,2270,0.0,2006,2090,4400,5910 days 16:47:18.682830,234,1.6,0.0,180,0,2270.0
550000.0,3,1.0,1630,6009,1.0,4,8,1630,0.0,1954,2120,6009,24903 days 16:47:18.682830,218,3.0,0.0,-490,0,1630.0
135000.0,3,1.0,1520,8450,1.0,2,6,1120,400.0,1961,1320,8450,22346 days 16:47:18.682830,336,3.0,2.8,200,0,720.0
695000.0,3,1.75,2080,5687,1.5,4,8,2080,0.0,1924,2300,5995,35861 days 16:47:18.682830,198,1.7142857142857142,0.0,-220,-308,2080.0
975000.0,5,2.5,3020,9648,1.0,4,9,1980,1040.0,1977,2890,12598,16502 days 16:47:18.682830,126,2.0,1.9038461538461537,130,-2950,940.0
210000.0,4,1.75,2180,28710,1.0,3,8,1180,1000.0,1950,2180,28710,26364 days 16:47:18.682830,140,2.2857142857142856,1.18,0,0,180.0
518000.0,4,1.75,1780,8768,1.0,4,7,1050,730.0,1951,1590,8100,25999 days 16:47:18.682830,365,2.2857142857142856,1.4383561643835616,190,668,320.0
335500.0,3,1.0,1370,6780,2.0,3,6,1370,0.0,1930,1450,7214,33669 days 16:47:18.682830,190,3.0,0.0,-80,-434,1370.0
750000.0,4,3.5,3050,7020,2.0,3,9,2050,1000.0,1984,2170,5900,13946 days 16:47:18.682830,330,1.1428571428571428,2.05,880,1120,1050.0
515000.0,3,1.75,1490,12000,1.0,4,7,1490,0.0,1956,1630,12000,24173 days 16:47:18.682830,357,1.7142857142857142,0.0,-140,0,1490.0
344500.0,4,2.75,1800,5453,1.0,3,7,1050,750.0,2002,1820,6900,7371 days 16:47:18.682830,141,1.4545454545454546,1.4,-20,-1447,300.0
470000.0,3,1.5,1760,6723,1.0,3,7,1160,600.0,1958,2080,8965,23442 days 16:47:18.682830,167,2.0,1.9333333333333333,-320,-2242,560.0
606150.0,4,1.75,1770,9848,1.0,3,8,1370,400.0,1967,2040,9587,20155 days 16:47:18.682830,247,2.2857142857142856,3.425,-270,261,970.0
292000.0,4,2.75,2910,7712,1.0,3,7,1600,1310.0,1998,2220,6649,8832 days 16:47:18.682830,324,1.4545454545454546,1.2213740458015268,690,1063,290.0
450000.0,3,2.5,2880,426452,2.0,3,7,2880,0.0,1979,1460,320890,15772 days 16:47:18.682830,127,1.2,0.0,1420,105562,2880.0
429000.0,3,1.75,2520,5043,1.0,3,8,1260,1260.0,1957,1360,4920,23807 days 16:47:18.682830,231,1.7142857142857142,1.0,1160,123,0.0
765000.0,4,2.5,3190,38119,2.0,3,9,3190,0.0,1988,2560,36280,12485 days 16:47:18.682830,232,1.6,0.0,630,1839,3190.0
425000.0,2,1.0,540,2500,1.0,3,5,540,0.0,1905,1290,5000,42800 days 16:47:18.682830,105,2.0,0.0,-750,-2500,540.0
505000.0,4,2.5,3170,5340,2.0,3,7,3170,0.0,2000,3010,5340,8102 days 16:47:18.682830,043,1.6,0.0,160,0,3170.0
544950.0,3,1.75,1830,7371,1.0,3,7,1830,0.0,1957,1600,7700,23807 days 16:47:18.682830,076,1.7142857142857142,0.0,230,-329,1830.0
382000.0,3,2.0,1360,4840,1.5,3,8,1360,0.0,1936,1450,4840,31478 days 16:47:18.682830,267,1.5,0.0,-90,0,1360.0
475000.0,3,1.75,1870,25157,2.0,3,7,1870,0.0,1978,1870,15391,16137 days 16:47:18.682830,240,1.7142857142857142,0.0,0,9766,1870.0
355000.0,3,1.5,1370,4790,2.0,4,7,1370,0.0,1982,1370,3799,14676 days 16:47:18.682830,107,2.0,0.0,0,991,1370.0
410000.0,4,2.5,1700,9000,1.0,5,7,1700,0.0,1972,1370,7592,18329 days 16:47:18.682830,184,1.6,0.0,330,1408,1700.0
450000.0,4,2.0,1960,5008,1.0,3,6,980,980.0,1900,1175,2315,44626 days 16:47:18.682830,034,2.0,1.0,785,2693,0.0
565000.0,7,4.5,4140,9066,1.0,3,7,2070,2070.0,1978,1440,1865,16137 days 16:47:18.682830,148,1.5555555555555556,1.0,2700,7201,0.0
529100.0,2,1.0,1290,6528,1.5,4,7,1290,0.0,1941,1670,5712,29651 days 16:47:18.682830,104,2.0,0.0,-380,816,1290.0
452500.0,4,2.5,2460,6454,2.0,3,7,2460,0.0,2006,2320,4578,5910 days 16:47:18.682830,043,1.6,0.0,140,1876,2460.0
245000.0,4,2.0,1580,8000,1.0,3,7,1040,540.0,1967,1550,8000,20155 days 16:47:18.682830,142,2.0,1.9259259259259258,30,0,500.0
415000.0,1,1.0,700,2550,1.0,3,6,700,0.0,1954,1330,4110,24903 days 16:47:18.682830,089,1.0,0.0,-630,-1560,700.0
610000.0,4,2.5,2410,15899,2.0,3,9,2410,0.0,1990,2360,11412,11754 days 16:47:18.682830,205,1.6,0.0,50,4487,2410.0
363500.0,4,1.75,2180,9702,1.0,5,7,1090,1090.0,1962,2020,9792,21981 days 16:47:18.682830,289,2.2857142857142856,1.0,160,-90,0.0
650000.0,4,2.5,2630,28298,2.0,3,8,2630,0.0,1996,2840,26071,9563 days 16:47:18.682830,084,1.6,0.0,-210,2227,2630.0
290000.0,4,2.5,2050,9015,2.0,4,7,2050,0.0,1973,1780,8820,17963 days 16:47:18.682830,014,1.6,0.0,270,195,2050.0
170000.0,3,1.0,790,6750,1.0,2,6,790,0.0,1944,960,6298,28556 days 16:47:18.682830,077,3.0,0.0,-170,452,790.0
510000.0,2,1.0,1070,5280,1.0,3,6,1070,0.0,1900,1380,2370,44626 days 16:47:18.682830,089,2.0,0.0,-310,2910,1070.0
2280000.0,7,8.0,13540,307752,3.0,3,1,9410,4130.0,1999,4850,217800,8467 days 16:47:18.682830,125,0.875,2.278450363196126,8690,89952,5280.0
316000.0,4,2.5,2320,7379,2.0,3,8,2320,0.0,1987,2230,7614,12850 days 16:47:18.682830,265,1.6,0.0,90,-235,2320.0
199950.0,2,1.0,700,5200,1.0,5,5,700,0.0,1952,970,5200,25634 days 16:47:18.682830,220,2.0,0.0,-270,0,700.0
207000.0,3,1.0,860,7740,1.0,3,6,860,0.0,1960,980,7200,22712 days 16:47:18.682830,225,3.0,0.0,-120,540,860.0
449950.0,4,2.25,3490,8400,1.5,4,8,3490,0.0,1976,2320,8723,16868 days 16:47:18.682830,106,1.7777777777777777,0.0,1170,-323,3490.0
361550.0,3,1.75,1160,257875,1.0,2,7,1160,0.0,1980,1420,15450,15407 days 16:47:18.682830,077,1.7142857142857142,0.0,-260,242425,1160.0
824000.0,4,3.5,3650,57538,2.0,3,1,3650,0.0,1996,3730,56257,9563 days 16:47:18.682830,267,1.1428571428571428,0.0,-80,1281,3650.0
537000.0,3,1.75,1550,10050,1.0,5,7,1550,0.0,1957,1720,10050,23807 days 16:47:18.682830,006,1.7142857142857142,0.0,-170,0,1550.0
838400.0,4,2.5,2620,9525,2.5,4,9,2620,0.0,1974,2580,9525,17598 days 16:47:18.682830,217,1.6,0.0,40,0,2620.0
225000.0,2,1.0,720,4758,1.0,3,6,720,0.0,1947,990,4920,27460 days 16:47:18.682830,254,2.0,0.0,-270,-162,720.0
329900.0,3,2.0,1380,5198,1.0,4,7,1380,0.0,1982,1320,6827,14676 days 16:47:18.682830,113,1.5,0.0,60,-1629,1380.0
282500.0,4,1.0,1170,34925,1.0,4,6,1170,0.0,1942,1610,28108,29286 days 16:47:18.682830,006,4.0,0.0,-440,6817,1170.0
229950.0,3,1.75,1170,11960,1.0,4,7,1170,0.0,1969,1230,9800,19424 days 16:47:18.682830,096,1.7142857142857142,0.0,-60,2160,1170.0
500000.0,2,1.0,1630,12059,1.0,3,7,1270,360.0,1947,1660,8800,27460 days 16:47:18.682830,090,2.0,3.5277777777777777,-30,3259,910.0
495000.0,3,1.75,1890,6557,1.0,3,8,1890,0.0,1967,1920,6793,20155 days 16:47:18.682830,308,1.7142857142857142,0.0,-30,-236,1890.0
149500.0,3,1.0,1010,9450,1.0,4,7,1010,0.0,1959,1240,9450,23077 days 16:47:18.682830,161,3.0,0.0,-230,0,1010.0
726000.0,3,2.5,2040,10033,1.0,4,8,1420,620.0,1974,2260,10115,17598 days 16:47:18.682830,230,1.2,2.2903225806451615,-220,-82,800.0
899000.0,4,2.5,4080,10295,2.0,3,1,4080,0.0,1998,3470,10295,8832 days 16:47:18.682830,099,1.6,0.0,610,0,4080.0
317000.0,3,1.0,1270,8925,1.0,5,7,1270,0.0,1955,1270,8996,24538 days 16:47:18.682830,074,3.0,0.0,0,-71,1270.0
395000.0,1,1.0,790,3000,1.0,3,6,790,0.0,1953,1110,4100,25268 days 16:47:18.682830,085,1.0,0.0,-320,-1100,790.0
360000.0,4,3.0,2580,6740,2.0,3,8,2580,0.0,1999,2010,6740,8467 days 16:47:18.682830,033,1.3333333333333333,0.0,570,0,2580.0
570000.0,4,2.5,2290,6738,2.0,3,8,2290,0.0,1996,2100,6261,9563 days 16:47:18.682830,169,1.6,0.0,190,477,2290.0
320000.0,4,2.5,3490,5000,2.0,3,8,3490,0.0,2003,2910,5025,7006 days 16:47:18.682830,170,1.6,0.0,580,-25,3490.0
320000.0,3,1.75,1510,30185,1.5,3,7,1510,0.0,1976,1470,12465,16868 days 16:47:18.682830,268,1.7142857142857142,0.0,40,17720,1510.0
268000.0,5,2.5,2400,4564,2.0,3,7,2400,0.0,2004,1880,4109,6641 days 16:47:18.682830,071,2.0,0.0,520,455,2400.0
191000.0,2,1.0,900,3400,1.0,5,6,900,0.0,1905,940,6000,42800 days 16:47:18.682830,178,2.0,0.0,-40,-2600,900.0
400000.0,2,1.0,1270,7440,1.0,4,7,910,360.0,1949,1040,7500,26729 days 16:47:18.682830,216,2.0,2.5277777777777777,230,-60,550.0
515000.0,2,1.0,1050,5000,1.0,5,7,1050,0.0,1907,1340,5000,42070 days 16:47:18.682830,182,2.0,0.0,-290,0,1050.0
610000.0,4,2.5,2950,9010,2.0,3,9,2950,0.0,2004,3160,8813,6641 days 16:47:18.682830,106,1.6,0.0,-210,197,2950.0
538000.0,2,1.75,1850,3060,1.0,3,7,1060,790.0,1929,1850,4080,34034 days 16:47:18.682830,297,1.1428571428571428,1.3417721518987342,0,-1020,270.0
335000.0,4,2.25,2400,8592,2.0,3,8,2400,0.0,1978,2180,8100,16137 days 16:47:18.682830,027,1.7777777777777777,0.0,220,492,2400.0
302000.0,5,1.75,2360,8642,1.5,5,7,2060,300.0,1926,1950,8491,35130 days 16:47:18.682830,051,2.857142857142857,6.866666666666666,410,151,1760.0
787500.0,4,1.75,1580,9382,1.0,3,7,1080,500.0,1963,2010,9382,21616 days 16:47:18.682830,216,2.2857142857142856,2.16,-430,0,580.0
420000.0,3,1.0,1790,7055,1.0,5,8,1520,270.0,1937,1710,7055,31112 days 16:47:18.682830,352,3.0,5.62962962962963,80,0,1250.0
560000.0,3,2.5,2840,216493,2.0,3,9,2840,0.0,1991,2820,175111,11389 days 16:47:18.682830,261,1.2,0.0,20,41382,2840.0
535000.0,3,2.5,1970,6634,2.0,3,8,1970,0.0,1989,2090,6176,12119 days 16:47:18.682830,113,1.2,0.0,-120,458,1970.0
310000.0,3,2.5,1780,6771,1.0,3,7,1230,550.0,1990,1780,6771,11754 days 16:47:18.682830,161,1.2,2.2363636363636363,0,0,680.0
760000.0,5,2.0,3920,5250,1.5,5,7,2560,1360.0,1910,1830,4240,40974 days 16:47:18.682830,342,2.5,1.8823529411764706,2090,1010,1200.0
242500.0,3,1.75,1550,1905,2.0,3,7,1550,0.0,2005,1550,1866,6275 days 16:47:18.682830,265,1.7142857142857142,0.0,0,39,1550.0
1310000.0,6,3.0,2980,7200,1.5,3,8,2980,0.0,1911,1720,3600,40609 days 16:47:18.682830,051,2.0,0.0,1260,3600,2980.0
235000.0,3,1.0,1270,7153,1.0,5,6,1270,0.0,1949,1650,7153,26729 days 16:47:18.682830,289,3.0,0.0,-380,0,1270.0
598780.0,4,2.25,3040,12160,1.0,4,7,1520,1520.0,1963,2560,12090,21616 days 16:47:18.682830,054,1.7777777777777777,1.0,480,70,0.0
343000.0,2,1.0,1110,9920,1.0,5,6,700,410.0,1942,2830,10091,29286 days 16:47:18.682830,131,2.0,1.7073170731707317,-1720,-171,290.0
145000.0,2,1.0,800,8125,1.0,3,6,800,0.0,1964,2390,8125,21251 days 16:47:18.682830,314,2.0,0.0,-1590,0,800.0
291970.0,1,1.0,680,21727,1.0,3,5,680,0.0,1952,1470,19406,25634 days 16:47:18.682830,016,1.0,0.0,-790,2321,680.0
599950.0,3,1.0,1680,7910,1.0,3,7,1680,0.0,1949,1330,7910,26729 days 16:47:18.682830,077,3.0,0.0,350,0,1680.0
1750000.0,4,2.5,3910,22710,1.5,3,8,3910,0.0,1908,2920,16544,41705 days 16:47:18.682830,206,1.6,0.0,990,6166,3910.0
870000.0,4,1.75,2780,11000,1.0,3,9,1560,1220.0,1964,2350,11700,21251 days 16:47:18.682830,078,2.2857142857142856,1.278688524590164,430,-700,340.0
323000.0,4,2.75,2000,9083,2.0,4,7,2000,0.0,1992,1690,7735,11024 days 16:47:18.682830,128,1.4545454545454546,0.0,310,1348,2000.0
727000.0,4,3.0,3150,9703,2.0,3,9,3150,0.0,2001,3150,8819,7736 days 16:47:18.682830,237,1.3333333333333333,0.0,0,884,3150.0
166000.0,1,1.0,1120,17332,1.0,3,7,1120,0.0,1988,1280,17334,12485 days 16:47:18.682830,296,1.0,0.0,-160,-2,1120.0
450000.0,4,1.75,1740,12204,1.0,3,7,1270,470.0,1961,2190,12204,22346 days 16:47:18.682830,120,2.2857142857142856,2.702127659574468,-450,0,800.0
400000.0,3,2.5,2970,23100,1.0,3,7,1510,1460.0,1967,2390,20300,20155 days 16:47:18.682830,175,1.2,1.0342465753424657,580,2800,50.0
599000.0,3,2.5,2970,23100,1.0,3,7,1510,1460.0,1967,2390,20300,20155 days 16:47:18.682830,041,1.2,1.0342465753424657,580,2800,50.0
165000.0,3,1.0,1150,19200,1.0,4,5,1150,0.0,1908,1290,19200,41705 days 16:47:18.682830,156,3.0,0.0,-140,0,1150.0
229000.0,2,1.0,1190,7408,1.0,3,6,830,360.0,1941,1140,7408,29651 days 16:47:18.682830,156,2.0,2.3055555555555554,50,0,470.0
305000.0,1,1.0,900,7500,1.0,3,5,900,0.0,1946,1470,7500,27825 days 16:47:18.682830,286,1.0,0.0,-570,0,900.0
930000.0,3,3.25,2950,4446,2.0,3,9,2450,500.0,2001,1930,4255,7736 days 16:47:18.682830,258,0.9230769230769231,4.9,1020,191,1950.0
542000.0,3,2.5,1990,15985,1.0,3,8,1540,450.0,1964,2470,10125,21251 days 16:47:18.682830,266,1.2,3.422222222222222,-480,5860,1090.0
214000.0,3,1.0,1020,9147,1.0,4,6,1020,0.0,1900,1600,9700,44626 days 16:47:18.682830,252,3.0,0.0,-580,-553,1020.0
718000.0,3,2.5,2070,7200,2.0,3,8,2070,0.0,2001,1650,8877,7736 days 16:47:18.682830,252,1.2,0.0,420,-1677,2070.0
349000.0,3,2.5,1430,1002,3.0,3,8,1430,0.0,2002,1430,1530,7371 days 16:47:18.682830,162,1.2,0.0,0,-528,1430.0
305000.0,3,2.5,2030,8000,2.0,3,7,2030,0.0,1997,2290,7945,9197 days 16:47:18.682830,125,1.2,0.0,-260,55,2030.0
498000.0,3,2.5,1620,2640,2.0,4,7,1620,0.0,1900,1370,3840,44626 days 16:47:18.682830,196,1.2,0.0,250,-1200,1620.0
799950.0,4,3.5,4220,196817,2.0,3,1,4220,0.0,1993,2500,195395,10658 days 16:47:18.682830,143,1.1428571428571428,0.0,1720,1422,4220.0
737000.0,3,2.5,2300,7800,2.0,3,9,2300,0.0,1997,2300,8187,9197 days 16:47:18.682830,125,1.2,0.0,0,-387,2300.0
860000.0,4,3.25,3830,10005,2.0,3,1,3830,0.0,2001,2555,5204,7736 days 16:47:18.682830,360,1.2307692307692308,0.0,1275,4801,3830.0
339950.0,3,2.5,2390,34041,1.0,3,8,1840,550.0,1984,2460,35686,13946 days 16:47:18.682830,183,1.2,3.3454545454545452,-70,-1645,1290.0
249000.0,3,2.25,1440,7673,1.0,3,7,940,500.0,1982,1440,8418,14676 days 16:47:18.682830,136,1.3333333333333333,1.88,0,-745,440.0
370000.0,2,1.0,910,5525,1.0,2,6,910,0.0,1910,1620,5525,40974 days 16:47:18.682830,127,2.0,0.0,-710,0,910.0
725000.0,3,2.0,1550,12262,1.0,4,7,1550,0.0,1964,2900,12372,21251 days 16:47:18.682830,286,1.5,0.0,-1350,-110,1550.0
529000.0,5,2.5,2380,91476,1.0,4,8,1580,800.0,1976,1880,12870,16868 days 16:47:18.682830,339,2.0,1.975,500,78606,780.0
310000.0,4,2.75,2060,8100,1.0,4,7,1310,750.0,1988,1540,8100,12485 days 16:47:18.682830,076,1.4545454545454546,1.7466666666666666,520,0,560.0
315000.0,4,2.25,1880,9163,2.0,3,8,1880,0.0,1981,1900,7980,15041 days 16:47:18.682830,300,1.7777777777777777,0.0,-20,1183,1880.0
1300000.0,4,2.5,3470,4160,2.0,3,9,2480,990.0,1927,2280,5440,34765 days 16:47:18.682830,275,1.6,2.505050505050505,1190,-1280,1490.0
435000.0,3,2.0,2360,12744,2.0,5,7,2360,0.0,1964,1650,8625,21251 days 16:47:18.682830,309,1.5,0.0,710,4119,2360.0
350000.0,3,1.75,1970,10800,1.0,4,7,1300,670.0,1979,1970,8768,15772 days 16:47:18.682830,197,1.7142857142857142,1.9402985074626866,0,2032,630.0
240000.0,3,1.0,1040,7800,1.0,3,7,1040,0.0,1948,1780,8400,27095 days 16:47:18.682830,251,3.0,0.0,-740,-600,1040.0
410000.0,3,2.25,1420,3750,2.0,3,7,1420,0.0,1987,1430,4664,12850 days 16:47:18.682830,118,1.3333333333333333,0.0,-10,-914,1420.0
430000.0,4,2.75,2290,5249,2.0,3,7,2290,0.0,2003,2270,4348,7006 days 16:47:18.682830,266,1.4545454545454546,0.0,20,901,2290.0
446000.0,4,2.5,1530,8375,1.0,3,7,1020,510.0,1974,1650,9794,17598 days 16:47:18.682830,230,1.6,2.0,-120,-1419,510.0
240000.0,3,1.5,1360,9760,1.5,5,7,1360,0.0,1984,1310,11456,13946 days 16:47:18.682830,162,2.0,0.0,50,-1696,1360.0
595000.0,4,3.0,3680,35736,1.5,4,8,2320,1360.0,1970,3210,39512,19059 days 16:47:18.682830,008,1.3333333333333333,1.7058823529411764,470,-3776,960.0
215150.0,3,1.0,920,4770,1.0,4,6,920,0.0,1969,920,4770,19424 days 16:47:18.682830,065,3.0,0.0,0,0,920.0
319950.0,2,1.0,1070,5824,1.0,5,7,1070,0.0,1949,2090,7980,26729 days 16:47:18.682830,142,2.0,0.0,-1020,-2156,1070.0
385000.0,3,2.0,1590,9912,2.0,3,8,1590,0.0,2000,1670,9912,8102 days 16:47:18.682830,167,1.5,0.0,-80,0,1590.0
280000.0,3,2.5,1600,6700,2.0,3,8,1600,0.0,1991,1790,7577,11389 days 16:47:18.682830,084,1.2,0.0,-190,-877,1600.0
399950.0,3,2.5,1510,7300,1.0,3,7,1040,470.0,1974,1360,7300,17598 days 16:47:18.682830,131,1.2,2.2127659574468086,150,0,570.0
132500.0,3,1.0,1080,10500,1.0,3,7,1080,0.0,1967,1200,9607,20155 days 16:47:18.682830,143,3.0,0.0,-120,893,1080.0
399950.0,2,0.75,1330,2856,1.0,4,7,930,400.0,1916,1330,2856,38783 days 16:47:18.682830,113,2.6666666666666665,2.325,0,0,530.0
290000.0,2,1.0,850,6800,1.0,3,7,850,0.0,1948,870,6800,27095 days 16:47:18.682830,202,2.0,0.0,-20,0,850.0
860000.0,5,2.25,1960,8592,1.0,4,8,1290,670.0,1958,1720,8592,23442 days 16:47:18.682830,132,2.2222222222222223,1.9253731343283582,240,0,620.0
3100000.0,6,4.25,6980,15682,3.0,4,1,5330,1650.0,1999,3930,18367,8467 days 16:47:18.682830,149,1.411764705882353,3.2303030303030305,3050,-2685,3680.0
245000.0,4,1.0,1530,7200,1.5,3,7,1400,130.0,1948,1530,7200,27095 days 16:47:18.682830,136,4.0,10.76923076923077,0,0,1270.0
255000.0,3,1.5,1320,7980,1.0,3,7,1320,0.0,1956,2000,7700,24173 days 16:47:18.682830,349,2.0,0.0,-680,280,1320.0
310000.0,4,3.0,2320,7200,2.0,3,7,2320,0.0,1976,2050,10000,16868 days 16:47:18.682830,317,1.3333333333333333,0.0,270,-2800,2320.0
299000.0,3,1.0,960,8100,1.0,3,7,960,0.0,1955,1080,8100,24538 days 16:47:18.682830,225,3.0,0.0,-120,0,960.0
575000.0,4,2.5,2040,5508,2.0,4,8,2040,0.0,1996,2130,5496,9563 days 16:47:18.682830,314,1.6,0.0,-90,12,2040.0
284000.0,3,1.0,1080,8214,1.0,3,7,1080,0.0,1944,1850,13560,28556 days 16:47:18.682830,318,3.0,0.0,-770,-5346,1080.0
840000.0,3,1.75,2020,4800,1.0,4,8,1090,930.0,1926,1680,4800,35130 days 16:47:18.682830,097,1.7142857142857142,1.1720430107526882,340,0,160.0
442573.0,3,1.75,1780,7567,1.0,3,7,1290,490.0,1980,1910,8645,15407 days 16:47:18.682830,225,1.7142857142857142,2.63265306122449,-130,-1078,800.0
560000.0,3,1.0,1140,7028,1.0,3,8,1140,0.0,1931,1350,6923,33304 days 16:47:18.682830,281,3.0,0.0,-210,105,1140.0
485000.0,3,2.0,1610,4160,1.0,4,7,1010,600.0,1917,1040,4400,38417 days 16:47:18.682830,127,1.5,1.6833333333333333,570,-240,410.0
472500.0,4,1.75,1440,8536,1.0,4,7,1440,0.0,1961,1720,9748,22346 days 16:47:18.682830,077,2.2857142857142856,0.0,-280,-1212,1440.0
1610000.0,4,2.75,4270,25807,2.0,3,1,4270,0.0,1996,3860,20723,9563 days 16:47:18.682830,330,1.4545454545454546,0.0,410,5084,4270.0
808000.0,8,3.75,3460,4600,2.0,3,7,2860,600.0,1987,2170,3750,12850 days 16:47:18.682830,353,2.1333333333333333,4.766666666666667,1290,850,2260.0
398000.0,3,1.75,1890,16001,1.5,4,7,1890,0.0,1950,1820,11450,26364 days 16:47:18.682830,295,1.7142857142857142,0.0,70,4551,1890.0
340000.0,3,2.5,2240,6000,2.0,3,8,2240,0.0,2003,2400,6000,7006 days 16:47:18.682830,048,1.2,0.0,-160,0,2240.0
380000.0,2,1.0,760,4000,1.5,3,6,760,0.0,1910,1130,4000,40974 days 16:47:18.682830,133,2.0,0.0,-370,0,760.0
235000.0,3,1.0,1020,6173,1.0,3,6,780,240.0,1948,1330,5909,27095 days 16:47:18.682830,255,3.0,3.25,-310,264,540.0
400000.0,3,1.5,1330,9900,1.0,3,7,1330,0.0,1956,1940,9900,24173 days 16:47:18.682830,300,2.0,0.0,-610,0,1330.0
582000.0,5,2.5,2780,12335,1.0,4,8,1590,1190.0,1968,2750,9930,19790 days 16:47:18.682830,192,2.0,1.3361344537815125,30,2405,400.0
209000.0,2,1.0,1070,6120,1.0,3,6,1070,0.0,1962,1130,6120,21981 days 16:47:18.682830,365,2.0,0.0,-60,0,1070.0
335000.0,5,3.0,2660,7700,1.5,4,7,1670,990.0,1962,1610,7700,21981 days 16:47:18.682830,093,1.6666666666666667,1.6868686868686869,1050,0,680.0
285950.0,2,1.0,710,7120,1.0,5,6,710,0.0,1942,1100,7020,29286 days 16:47:18.682830,346,2.0,0.0,-390,100,710.0
645000.0,5,2.25,3340,52476,2.0,4,8,3340,0.0,1975,2460,48351,17233 days 16:47:18.682830,311,2.2222222222222223,0.0,880,4125,3340.0
312000.0,2,1.0,1160,7500,1.5,4,7,1160,0.0,1916,1110,7500,38783 days 16:47:18.682830,357,2.0,0.0,50,0,1160.0
663000.0,3,2.25,2840,59677,1.0,3,7,1580,1260.0,1967,2220,31688,20155 days 16:47:18.682830,283,1.3333333333333333,1.253968253968254,620,27989,320.0
443950.0,3,1.75,2000,36000,1.0,3,6,2000,0.0,1946,2100,9681,27825 days 16:47:18.682830,293,1.7142857142857142,0.0,-100,26319,2000.0
315000.0,3,2.0,1060,5750,1.0,3,7,1060,0.0,1981,1080,5750,15041 days 16:47:18.682830,150,1.5,0.0,-20,0,1060.0
302200.0,4,1.5,1730,10396,1.0,3,7,1730,0.0,1964,1510,10396,21251 days 16:47:18.682830,082,2.6666666666666665,0.0,220,0,1730.0
770000.0,3,2.5,2190,2658,2.0,4,9,2190,0.0,1979,2315,2538,15772 days 16:47:18.682830,008,1.2,0.0,-125,120,2190.0
374950.0,4,1.75,1660,8160,1.0,3,8,1660,0.0,1974,1800,7684,17598 days 16:47:18.682830,022,2.2857142857142856,0.0,-140,476,1660.0
330000.0,3,2.5,2210,7557,2.0,3,9,2210,0.0,1989,2440,8641,12119 days 16:47:18.682830,162,1.2,0.0,-230,-1084,2210.0
230000.0,2,1.0,870,7020,1.0,4,6,570,300.0,1942,1730,7020,29286 days 16:47:18.682830,293,2.0,1.9,-860,0,270.0
967000.0,4,2.5,3100,7250,2.0,3,9,3100,0.0,2010,1240,6670,4449 days 16:47:18.682830,117,1.6,0.0,1860,580,3100.0
315000.0,6,4.0,3120,4240,2.0,4,7,2090,1030.0,1993,1460,4240,10658 days 16:47:18.682830,178,1.5,2.029126213592233,1660,0,1060.0
626000.0,3,1.0,1040,4240,1.0,4,7,860,180.0,1924,1170,4240,35861 days 16:47:18.682830,197,3.0,4.777777777777778,-130,0,680.0
334009.0,4,2.0,1650,9305,1.0,4,6,1650,0.0,1960,1860,7486,22712 days 16:47:18.682830,199,2.0,0.0,-210,1819,1650.0
429000.0,2,1.0,1010,5000,1.0,2,7,1010,0.0,1924,1410,5000,35861 days 16:47:18.682830,029,2.0,0.0,-400,0,1010.0
818000.0,4,2.5,4020,44431,2.0,3,1,4020,0.0,1987,3440,52900,12850 days 16:47:18.682830,036,1.6,0.0,580,-8469,4020.0
326000.0,5,2.75,2166,6342,2.0,3,8,2166,0.0,2013,2474,5948,3353 days 16:47:18.682830,240,1.8181818181818181,0.0,-308,394,2166.0
310000.0,5,3.0,1880,5000,1.0,3,7,1100,780.0,1997,1640,5000,9197 days 16:47:18.682830,163,1.6666666666666667,1.4102564102564104,240,0,320.0
525000.0,4,2.0,2260,7680,1.0,4,7,1130,1130.0,1947,1800,7680,27460 days 16:47:18.682830,111,2.0,1.0,460,0,0.0
350000.0,3,2.25,2010,4400,1.5,3,7,2010,0.0,1986,1720,4187,13215 days 16:47:18.682830,093,1.3333333333333333,0.0,290,213,2010.0
936000.0,4,2.5,3330,8897,2.0,3,1,3330,0.0,2001,3150,7515,7736 days 16:47:18.682830,092,1.6,0.0,180,1382,3330.0
226000.0,3,1.0,1520,7200,1.0,3,7,1030,490.0,1954,1530,7201,24903 days 16:47:18.682830,333,3.0,2.1020408163265305,-10,-1,540.0
1250000.0,5,3.5,3510,4798,2.0,3,1,2700,810.0,2008,1460,1684,5180 days 16:47:18.682830,121,1.4285714285714286,3.3333333333333335,2050,3114,1890.0
428000.0,3,1.75,1580,507038,1.0,4,7,1580,0.0,1985,2040,210394,13580 days 16:47:18.682830,231,1.7142857142857142,0.0,-460,296644,1580.0
329932.0,3,1.5,1460,5040,1.0,3,7,1100,360.0,1971,2330,7560,18694 days 16:47:18.682830,149,2.0,3.0555555555555554,-870,-2520,740.0
539000.0,3,1.5,1460,5040,1.0,3,7,1100,360.0,1971,2330,7560,18694 days 16:47:18.682830,020,2.0,3.0555555555555554,-870,-2520,740.0
275000.0,3,1.75,1650,7700,1.0,4,8,1650,0.0,1977,2020,7700,16502 days 16:47:18.682830,069,1.7142857142857142,0.0,-370,0,1650.0
590000.0,4,2.5,2660,35010,2.0,3,9,2660,0.0,1993,2330,35448,10658 days 16:47:18.682830,253,1.6,0.0,330,-438,2660.0
782000.0,4,2.5,3510,24604,2.0,3,1,3510,0.0,1997,3530,26673,9197 days 16:47:18.682830,023,1.6,0.0,-20,-2069,3510.0
575000.0,4,2.5,2120,9603,2.0,3,8,2120,0.0,1985,1990,9611,13580 days 16:47:18.682830,167,1.6,0.0,130,-8,2120.0
509000.0,3,2.25,1780,9315,2.0,3,7,1780,0.0,1996,1780,8545,9563 days 16:47:18.682830,014,1.3333333333333333,0.0,0,770,1780.0
290000.0,4,2.5,2000,13300,1.0,4,7,1200,800.0,1968,1800,9810,19790 days 16:47:18.682830,129,1.6,1.5,200,3490,400.0
305240.0,3,1.0,1300,9000,1.0,3,7,1300,0.0,1956,1500,9600,24173 days 16:47:18.682830,209,3.0,0.0,-200,-600,1300.0
555000.0,3,2.0,2180,4976,1.5,4,8,1680,500.0,1930,1850,5000,33669 days 16:47:18.682830,161,1.5,3.36,330,-24,1180.0
317000.0,3,2.0,1790,8228,1.0,3,7,1390,400.0,1980,1880,8228,15407 days 16:47:18.682830,206,1.5,3.475,-90,0,990.0
430000.0,3,2.0,1910,5040,1.5,3,8,1910,0.0,1971,1980,4275,18694 days 16:47:18.682830,164,1.5,0.0,-70,765,1910.0
850000.0,2,1.5,1800,4144,1.0,4,7,900,900.0,1962,2090,4173,21981 days 16:47:18.682830,055,1.3333333333333333,1.0,-290,-29,0.0
469000.0,3,2.25,2620,10659,1.0,3,7,1660,960.0,1976,1820,12071,16868 days 16:47:18.682830,330,1.3333333333333333,1.7291666666666667,800,-1412,700.0
327200.0,2,2.0,1440,8425,1.0,4,6,1440,0.0,1942,1430,12037,29286 days 16:47:18.682830,211,1.0,0.0,10,-3612,1440.0
835000.0,3,3.0,2790,12523,2.0,4,8,1600,1190.0,1977,2990,11476,16502 days 16:47:18.682830,163,1.0,1.3445378151260505,-200,1047,410.0
360000.0,4,2.5,2340,13445,2.0,3,8,2340,0.0,1990,2340,11188,11754 days 16:47:18.682830,246,1.6,0.0,0,2257,2340.0
372000.0,4,2.5,2070,8658,2.0,3,8,2070,0.0,1999,2010,7215,8467 days 16:47:18.682830,345,1.6,0.0,60,1443,2070.0
453000.0,3,1.0,2160,11484,1.5,4,7,2160,0.0,1968,2270,10080,19790 days 16:47:18.682830,085,3.0,0.0,-110,1404,2160.0
275000.0,2,1.75,2090,11317,1.0,5,7,1090,1000.0,1931,1940,11317,33304 days 16:47:18.682830,225,1.1428571428571428,1.09,150,0,90.0
475000.0,4,2.5,2040,7260,2.0,4,7,2040,0.0,1963,2040,7360,21616 days 16:47:18.682830,183,1.6,0.0,0,-100,2040.0
310000.0,4,2.75,1950,9720,1.0,3,7,1400,550.0,1986,2300,10530,13215 days 16:47:18.682830,044,1.4545454545454546,2.5454545454545454,-350,-810,850.0
173000.0,4,2.0,1200,8460,1.0,5,7,1200,0.0,1957,1350,8623,23807 days 16:47:18.682830,041,2.0,0.0,-150,-163,1200.0
313500.0,5,3.0,2240,94960,1.0,3,6,2240,0.0,1985,1780,43400,13580 days 16:47:18.682830,093,1.6666666666666667,0.0,460,51560,2240.0
345000.0,3,2.5,1360,1489,2.0,3,8,1360,0.0,2007,1360,1688,5545 days 16:47:18.682830,210,1.2,0.0,0,-199,1360.0
436000.0,3,1.5,1500,10200,1.0,3,8,1300,200.0,1955,1950,9500,24538 days 16:47:18.682830,075,2.0,6.5,-450,700,1100.0
206000.0,3,1.75,1140,9800,1.0,4,7,1140,0.0,1968,1370,9800,19790 days 16:47:18.682830,192,1.7142857142857142,0.0,-230,0,1140.0
890000.0,4,2.5,2930,9158,2.0,3,9,2930,0.0,2005,3590,8065,6275 days 16:47:18.682830,111,1.6,0.0,-660,1093,2930.0
329950.0,4,2.25,2140,8874,2.0,3,8,2140,0.0,1986,2140,8789,13215 days 16:47:18.682830,022,1.7777777777777777,0.0,0,85,2140.0
250000.0,3,1.75,1628,286355,1.0,3,7,1628,0.0,1996,1490,216344,9563 days 16:47:18.682830,048,1.7142857142857142,0.0,138,70011,1628.0
246000.0,3,2.0,1990,203861,1.0,3,7,1990,0.0,1949,2760,217800,26729 days 16:47:18.682830,300,1.5,0.0,-770,-13939,1990.0
440000.0,3,1.75,1950,19747,1.0,3,7,1150,800.0,1979,2560,9674,15772 days 16:47:18.682830,197,1.7142857142857142,1.4375,-610,10073,350.0
395000.0,4,1.75,1910,8117,1.0,3,7,1460,450.0,1975,1810,8100,17233 days 16:47:18.682830,267,2.2857142857142856,3.2444444444444445,100,17,1010.0
305000.0,3,1.0,820,5150,1.0,5,6,820,0.0,1918,1100,5150,38052 days 16:47:18.682830,269,3.0,0.0,-280,0,820.0
160000.0,3,2.25,1470,8682,1.0,3,7,1160,310.0,1985,1670,8359,13580 days 16:47:18.682830,266,1.3333333333333333,3.7419354838709675,-200,323,850.0
269000.0,3,2.25,1470,8682,1.0,3,7,1160,310.0,1985,1670,8359,13580 days 16:47:18.682830,057,1.3333333333333333,3.7419354838709675,-200,323,850.0
169500.0,3,1.0,1060,10023,1.0,3,6,1060,0.0,1962,1060,10023,21981 days 16:47:18.682830,223,3.0,0.0,0,0,1060.0
690500.0,4,2.75,3130,8920,2.0,3,8,3130,0.0,2014,1450,9183,2988 days 16:47:18.682830,339,1.4545454545454546,0.0,1680,-263,3130.0
245560.0,2,1.5,1260,9693,1.0,3,7,1260,0.0,1957,1800,9693,23807 days 16:47:18.682830,337,1.3333333333333333,0.0,-540,0,1260.0
345000.0,4,2.75,2200,13498,2.0,3,8,2200,0.0,1987,2190,11850,12850 days 16:47:18.682830,070,1.4545454545454546,0.0,10,1648,2200.0
383000.0,4,1.75,2580,19607,1.0,4,8,1290,1290.0,1958,1970,9569,23442 days 16:47:18.682830,288,2.2857142857142856,1.0,610,10038,0.0
388500.0,3,2.25,1350,944,2.0,3,8,1050,300.0,2007,1350,1245,5545 days 16:47:18.682830,239,1.3333333333333333,3.5,0,-301,750.0
250000.0,3,1.75,1350,8548,1.0,3,7,1350,0.0,1985,1660,8538,13580 days 16:47:18.682830,261,1.7142857142857142,0.0,-310,10,1350.0
455500.0,3,1.75,2290,19000,1.0,4,9,1650,640.0,1973,2900,13034,17963 days 16:47:18.682830,034,1.7142857142857142,2.578125,-610,5966,1010.0
672000.0,3,1.0,1220,8573,1.0,4,7,1220,0.0,1954,1390,8573,24903 days 16:47:18.682830,335,3.0,0.0,-170,0,1220.0
550000.0,4,1.5,2750,128502,1.0,2,7,1500,1250.0,1958,1470,11514,23442 days 16:47:18.682830,181,2.6666666666666665,1.2,1280,116988,250.0
487000.0,3,1.75,1430,12632,1.0,3,7,1430,0.0,1959,1750,10350,23077 days 16:47:18.682830,126,1.7142857142857142,0.0,-320,2282,1430.0
291375.0,4,2.5,2220,6233,2.0,3,7,2220,0.0,2001,2220,5352,7736 days 16:47:18.682830,232,1.6,0.0,0,881,2220.0
225000.0,3,1.0,1490,15850,1.0,3,7,1490,0.0,1946,1950,13228,27825 days 16:47:18.682830,063,3.0,0.0,-460,2622,1490.0
519950.0,5,3.5,2440,10200,2.0,4,7,2440,0.0,1974,2000,10568,17598 days 16:47:18.682830,315,1.4285714285714286,0.0,440,-368,2440.0
250000.0,3,2.5,2070,8400,2.0,4,8,2070,0.0,1990,2070,9239,11754 days 16:47:18.682830,238,1.2,0.0,0,-839,2070.0
614950.0,3,1.0,1500,2400,1.5,5,7,1500,0.0,1900,1780,3600,44626 days 16:47:18.682830,261,3.0,0.0,-280,-1200,1500.0
599500.0,4,2.25,2020,10260,2.0,4,7,2020,0.0,1984,2020,10311,13946 days 16:47:18.682830,014,1.7777777777777777,0.0,0,-51,2020.0
625000.0,4,1.5,2190,13660,1.0,3,8,2190,0.0,1952,2520,20500,25634 days 16:47:18.682830,267,2.6666666666666665,0.0,-330,-6840,2190.0
248500.0,2,1.0,780,10064,1.0,4,7,780,0.0,1958,1090,14750,23442 days 16:47:18.682830,126,2.0,0.0,-310,-4686,780.0
469950.0,5,2.0,1220,4200,1.0,4,6,1090,130.0,1921,1790,4200,36956 days 16:47:18.682830,273,2.5,8.384615384615385,-570,0,960.0
525000.0,3,1.5,1840,10956,1.0,4,8,1840,0.0,1970,1680,10950,19059 days 16:47:18.682830,112,2.0,0.0,160,6,1840.0
787500.0,2,2.5,2390,6928,2.0,4,8,1810,580.0,1949,2390,12852,26729 days 16:47:18.682830,245,0.8,3.1206896551724137,0,-5924,1230.0
485000.0,4,2.5,3710,15935,1.0,3,1,2130,1580.0,2005,3674,17913,6275 days 16:47:18.682830,106,1.6,1.3481012658227849,36,-1978,550.0
310000.0,2,1.0,750,5379,1.0,3,6,750,0.0,1919,1030,5511,37687 days 16:47:18.682830,097,2.0,0.0,-280,-132,750.0
280000.0,5,2.0,2110,7919,1.0,3,7,1110,1000.0,1966,1590,5250,20520 days 16:47:18.682830,283,2.5,1.11,520,2669,110.0
200000.0,4,1.0,1020,42966,1.5,4,6,1020,0.0,1922,2250,37680,36591 days 16:47:18.682830,092,4.0,0.0,-1230,5286,1020.0
490000.0,3,2.5,3080,7363,2.0,3,9,3080,0.0,2006,2860,5273,5910 days 16:47:18.682830,283,1.2,0.0,220,2090,3080.0
146000.0,3,1.0,900,4770,1.0,3,6,900,0.0,1969,900,3480,19424 days 16:47:18.682830,365,3.0,0.0,0,1290,900.0
500000.0,5,3.0,3720,25474,2.0,3,9,2090,1630.0,1986,1870,14547,13215 days 16:47:18.682830,324,1.6666666666666667,1.2822085889570551,1850,10927,460.0
242500.0,3,1.0,940,7380,1.0,3,6,940,0.0,1959,1210,8095,23077 days 16:47:18.682830,253,3.0,0.0,-270,-715,940.0
324950.0,3,1.0,1040,7288,1.0,3,7,1040,0.0,1959,1160,7287,23077 days 16:47:18.682830,279,3.0,0.0,-120,1,1040.0
231500.0,2,1.0,1000,7615,1.0,4,6,1000,0.0,1943,1060,8000,28921 days 16:47:18.682830,106,2.0,0.0,-60,-385,1000.0
300000.0,3,2.5,2080,9827,2.0,3,8,2080,0.0,1989,2660,9861,12119 days 16:47:18.682830,149,1.2,0.0,-580,-34,2080.0
545000.0,4,2.5,2500,50595,2.0,3,9,2500,0.0,1997,2765,33720,9197 days 16:47:18.682830,336,1.6,0.0,-265,16875,2500.0
350000.0,3,1.0,1050,8583,1.0,5,6,1050,0.0,1955,1460,7351,24538 days 16:47:18.682830,048,3.0,0.0,-410,1232,1050.0
467100.0,3,1.75,1620,8645,1.0,3,7,1190,430.0,1973,2010,8645,17963 days 16:47:18.682830,143,1.7142857142857142,2.7674418604651163,-390,0,760.0
180000.0,3,1.0,1610,8500,1.5,3,7,1610,0.0,1959,1070,8750,23077 days 16:47:18.682830,098,3.0,0.0,540,-250,1610.0
749000.0,4,1.5,2130,5000,2.0,4,8,2130,0.0,1920,2560,5000,37322 days 16:47:18.682830,191,2.6666666666666665,0.0,-430,0,2130.0
245000.0,3,2.5,1460,11593,2.0,3,7,1460,0.0,1989,1640,9703,12119 days 16:47:18.682830,282,1.2,0.0,-180,1890,1460.0
260000.0,5,1.0,1600,7350,1.0,5,7,1600,0.0,1962,1600,7725,21981 days 16:47:18.682830,231,5.0,0.0,0,-375,1600.0
490000.0,3,3.0,1730,2940,3.0,3,7,1730,0.0,1985,1690,4410,13580 days 16:47:18.682830,158,1.0,0.0,40,-1470,1730.0
565000.0,4,2.5,2280,4602,2.0,3,8,2280,0.0,2003,2280,4193,7006 days 16:47:18.682830,239,1.6,0.0,0,409,2280.0
330000.0,4,2.25,2430,7490,2.0,3,8,2430,0.0,1983,2070,7469,14311 days 16:47:18.682830,237,1.7777777777777777,0.0,360,21,2430.0
295000.0,3,1.0,1380,7575,1.0,4,7,1380,0.0,1963,1320,7600,21616 days 16:47:18.682830,308,3.0,0.0,60,-25,1380.0
725000.0,3,1.5,1790,6000,1.5,4,7,1790,0.0,1903,1290,3500,43531 days 16:47:18.682830,282,2.0,0.0,500,2500,1790.0
1140000.0,4,2.5,3370,10602,2.0,3,1,3370,0.0,1999,2950,9949,8467 days 16:47:18.682830,246,1.6,0.0,420,653,3370.0
680000.0,3,2.25,2920,6300,1.0,3,8,1710,1210.0,1956,1940,6300,24173 days 16:47:18.682830,216,1.3333333333333333,1.4132231404958677,980,0,500.0
490000.0,2,1.0,2180,9300,1.0,4,7,1090,1090.0,1947,1830,7378,27460 days 16:47:18.682830,303,2.0,1.0,350,1922,0.0
635000.0,3,1.75,1480,6985,1.5,4,7,1200,280.0,1926,1480,5588,35130 days 16:47:18.682830,117,1.7142857142857142,4.285714285714286,0,1397,920.0
750000.0,3,2.5,2350,715690,1.5,4,9,2350,0.0,1979,1280,325393,15772 days 16:47:18.682830,096,1.2,0.0,1070,390297,2350.0
330000.0,4,2.25,2440,8098,2.0,3,8,2440,0.0,1983,2110,7911,14311 days 16:47:18.682830,343,1.7777777777777777,0.0,330,187,2440.0
270000.0,3,2.5,1350,1189,2.0,3,7,1080,270.0,2007,1300,1182,5545 days 16:47:18.682830,083,1.2,4.0,50,7,810.0
340000.0,3,2.25,1970,3716,2.0,3,7,1970,0.0,1997,1780,3716,9197 days 16:47:18.682830,134,1.3333333333333333,0.0,190,0,1970.0
413252.0,3,0.75,1110,3960,1.0,3,7,1110,0.0,1951,1610,5530,25999 days 16:47:18.682830,063,4.0,0.0,-500,-1570,1110.0
600000.0,4,2.75,2950,5803,2.0,3,9,2950,0.0,2007,2940,5803,5545 days 16:47:18.682830,041,1.4545454545454546,0.0,10,0,2950.0
726888.0,5,3.0,2970,7261,2.0,3,9,2970,0.0,1999,2970,8437,8467 days 16:47:18.682830,105,1.6666666666666667,0.0,0,-1176,2970.0
285000.0,2,1.0,720,6400,1.0,4,6,720,0.0,1943,1030,6400,28921 days 16:47:18.682830,340,2.0,0.0,-310,0,720.0
365000.0,2,1.0,770,5680,1.0,4,6,770,0.0,1929,1170,5514,34034 days 16:47:18.682830,037,2.0,0.0,-400,166,770.0
295000.0,4,2.0,1650,7200,1.0,3,7,1650,0.0,1964,1410,7200,21251 days 16:47:18.682830,068,2.0,0.0,240,0,1650.0
460000.0,3,2.25,1620,7350,1.0,3,7,1170,450.0,1969,1800,7350,19424 days 16:47:18.682830,077,1.3333333333333333,2.6,-180,0,720.0
230000.0,3,1.5,1510,10588,1.5,3,7,1510,0.0,1947,1360,2873,27460 days 16:47:18.682830,268,2.0,0.0,150,7715,1510.0
337000.0,3,1.0,1070,6109,1.0,5,7,1070,0.0,1951,1170,7200,25999 days 16:47:18.682830,142,3.0,0.0,-100,-1091,1070.0
300000.0,3,1.0,1010,6300,1.0,3,7,1010,0.0,1957,1480,7480,23807 days 16:47:18.682830,251,3.0,0.0,-470,-1180,1010.0
2300000.0,4,2.5,3370,8402,1.0,5,1,2240,1130.0,1962,3190,8700,21981 days 16:47:18.682830,030,1.6,1.9823008849557522,180,-298,1110.0
360000.0,4,2.5,2000,5500,2.0,3,8,2000,0.0,2003,2000,5512,7006 days 16:47:18.682830,344,1.6,0.0,0,-12,2000.0
585000.0,3,2.5,2060,10839,2.0,3,8,2060,0.0,1987,2180,8126,12850 days 16:47:18.682830,075,1.2,0.0,-120,2713,2060.0
182700.0,3,2.25,1740,6650,1.0,3,7,1240,500.0,1978,1740,7000,16137 days 16:47:18.682830,281,1.3333333333333333,2.48,0,-350,740.0
305000.0,3,2.25,1740,6650,1.0,3,7,1240,500.0,1978,1740,7000,16137 days 16:47:18.682830,118,1.3333333333333333,2.48,0,-350,740.0
309950.0,3,2.5,1880,7838,2.0,3,7,1880,0.0,1994,1810,7915,10293 days 16:47:18.682830,125,1.2,0.0,70,-77,1880.0
550000.0,3,1.0,960,12527,1.0,3,7,960,0.0,1972,1220,7579,18329 days 16:47:18.682830,075,3.0,0.0,-260,4948,960.0
825000.0,3,2.5,3280,26413,1.0,3,1,2670,610.0,1985,3280,25211,13580 days 16:47:18.682830,315,1.2,4.377049180327869,0,1202,2060.0
998500.0,2,1.0,1570,4400,1.5,4,8,1570,0.0,1914,1850,4400,39513 days 16:47:18.682830,274,2.0,0.0,-280,0,1570.0
644500.0,4,2.5,2990,5342,2.0,3,8,2990,0.0,2004,2990,5936,6641 days 16:47:18.682830,305,1.6,0.0,0,-594,2990.0
320000.0,3,2.0,1250,8636,1.0,5,7,1250,0.0,1968,1620,7653,19790 days 16:47:18.682830,012,1.5,0.0,-370,983,1250.0
266950.0,3,2.5,1920,4803,2.0,3,7,1920,0.0,2005,2240,5231,6275 days 16:47:18.682830,288,1.2,0.0,-320,-428,1920.0
633100.0,4,2.5,2470,33305,2.0,3,9,2470,0.0,1993,2440,33305,10658 days 16:47:18.682830,134,1.6,0.0,30,0,2470.0
395000.0,2,1.0,960,6700,1.0,3,7,960,0.0,1951,1350,6700,25999 days 16:47:18.682830,217,2.0,0.0,-390,0,960.0
259250.0,3,1.0,940,5904,1.0,3,6,940,0.0,1947,870,5728,27460 days 16:47:18.682830,075,3.0,0.0,70,176,940.0
300000.0,3,1.0,1260,5000,1.0,4,6,1260,0.0,1968,1180,7500,19790 days 16:47:18.682830,310,3.0,0.0,80,-2500,1260.0
413000.0,3,1.75,2280,139392,1.0,3,8,2280,0.0,1977,2280,117176,16502 days 16:47:18.682830,051,1.7142857142857142,0.0,0,22216,2280.0
435000.0,3,2.25,1740,8491,1.0,3,8,1240,500.0,1958,2080,8494,23442 days 16:47:18.682830,213,1.3333333333333333,2.48,-340,-3,740.0
500000.0,4,2.75,2630,15000,1.0,4,7,1690,940.0,1976,1800,16500,16868 days 16:47:18.682830,276,1.4545454545454546,1.797872340425532,830,-1500,750.0
402000.0,4,1.75,2430,5481,1.0,3,8,1430,1000.0,1953,2050,5508,25268 days 16:47:18.682830,213,2.2857142857142856,1.43,380,-27,430.0
777700.0,3,2.5,2260,251460,1.5,3,1,2260,0.0,1995,1610,244372,9928 days 16:47:18.682830,121,1.2,0.0,650,7088,2260.0
580000.0,2,1.5,1220,5000,1.0,4,7,1220,0.0,1938,2090,3850,30747 days 16:47:18.682830,082,1.3333333333333333,0.0,-870,1150,1220.0
570000.0,3,1.75,2580,40392,1.0,3,9,1390,1190.0,1986,2460,46173,13215 days 16:47:18.682830,251,1.7142857142857142,1.1680672268907564,120,-5781,200.0
174950.0,2,1.0,730,6000,1.0,3,6,730,0.0,1950,1750,7200,26364 days 16:47:18.682830,342,2.0,0.0,-1020,-1200,730.0
300000.0,2,1.0,760,3001,1.0,3,6,760,0.0,1913,1750,5000,39878 days 16:47:18.682830,127,2.0,0.0,-990,-1999,760.0
435000.0,3,1.5,1740,6988,1.0,3,7,1600,140.0,1950,1650,7500,26364 days 16:47:18.682830,266,2.0,11.428571428571429,90,-512,1460.0
469000.0,5,2.5,2240,7543,1.0,3,7,1140,1100.0,1966,2110,7408,20520 days 16:47:18.682830,169,2.0,1.0363636363636364,130,135,40.0
870000.0,4,1.75,1920,3600,2.0,4,8,1920,0.0,1907,1920,3600,42070 days 16:47:18.682830,316,2.2857142857142856,0.0,0,0,1920.0
532000.0,4,1.75,2020,7029,1.0,4,7,1430,590.0,1979,1780,7200,15772 days 16:47:18.682830,155,2.2857142857142856,2.4237288135593222,240,-171,840.0
455000.0,4,1.5,1880,11400,1.0,3,7,1280,600.0,1955,1880,11400,24538 days 16:47:18.682830,085,2.6666666666666665,2.1333333333333333,0,0,680.0
201000.0,3,1.0,1010,25277,1.0,5,5,1010,0.0,1961,1570,213879,22346 days 16:47:18.682830,212,3.0,0.0,-560,-188602,1010.0
649000.0,5,3.25,3990,13087,2.0,3,9,2400,1590.0,1991,2580,13633,11389 days 16:47:18.682830,266,1.5384615384615385,1.509433962264151,1410,-546,810.0
445500.0,2,1.75,1390,6670,1.0,3,6,720,670.0,1941,920,6380,29651 days 16:47:18.682830,144,1.1428571428571428,1.0746268656716418,470,290,50.0
475000.0,3,2.0,1230,11502,1.0,4,7,1230,0.0,1984,1660,11727,13946 days 16:47:18.682830,147,1.5,0.0,-430,-225,1230.0
590000.0,4,2.5,2940,29013,2.0,3,1,2940,0.0,1992,3010,34071,11024 days 16:47:18.682830,120,1.6,0.0,-70,-5058,2940.0
565000.0,4,1.5,2190,8296,2.0,3,7,2190,0.0,1935,1160,8160,31843 days 16:47:18.682830,055,2.6666666666666665,0.0,1030,136,2190.0
110000.0,1,1.0,640,10280,1.0,2,5,640,0.0,1920,1090,9000,37322 days 16:47:18.682830,258,1.0,0.0,-450,1280,640.0
375000.0,3,2.5,1670,7740,1.0,3,7,1130,540.0,1974,1220,7740,17598 days 16:47:18.682830,353,1.2,2.0925925925925926,450,0,590.0
255000.0,3,1.5,1240,8528,1.0,4,7,1240,0.0,1967,1570,8064,20155 days 16:47:18.682830,199,2.0,0.0,-330,464,1240.0
315000.0,5,1.75,1850,14800,1.5,3,6,1760,90.0,1937,1250,14800,31112 days 16:47:18.682830,119,2.857142857142857,19.555555555555557,600,0,1670.0
496600.0,4,2.25,2020,8400,1.0,4,8,1350,670.0,1961,2060,8400,22346 days 16:47:18.682830,324,1.7777777777777777,2.014925373134328,-40,0,680.0
380000.0,3,1.0,1020,4800,1.0,3,7,1020,0.0,1944,1400,5465,28556 days 16:47:18.682830,195,3.0,0.0,-380,-665,1020.0
338950.0,3,1.75,1610,22496,1.0,4,7,1610,0.0,1974,2050,35772,17598 days 16:47:18.682830,314,1.7142857142857142,0.0,-440,-13276,1610.0
542500.0,5,3.5,2730,42500,1.0,3,8,1530,1200.0,1989,3180,37970,12119 days 16:47:18.682830,292,1.4285714285714286,1.275,-450,4530,330.0
739000.0,5,2.5,2840,5000,1.0,4,7,1620,1220.0,1913,2200,5000,39878 days 16:47:18.682830,228,2.0,1.3278688524590163,640,0,400.0
549000.0,4,1.75,1290,3060,2.0,4,7,1290,0.0,1906,1510,4080,42435 days 16:47:18.682830,170,2.2857142857142856,0.0,-220,-1020,1290.0
252000.0,3,2.25,1670,7881,1.0,4,7,1190,480.0,1977,1870,7820,16502 days 16:47:18.682830,175,1.3333333333333333,2.4791666666666665,-200,61,710.0
1700000.0,4,4.5,3860,15246,2.0,3,1,2940,920.0,2004,3750,14790,6641 days 16:47:18.682830,265,0.8888888888888888,3.1956521739130435,110,456,2020.0
735000.0,4,1.75,2460,5100,1.5,5,7,1450,1010.0,1909,1560,5100,41339 days 16:47:18.682830,162,2.2857142857142856,1.4356435643564356,900,0,440.0
270000.0,4,2.5,1660,8063,1.0,4,7,1660,0.0,1978,1060,8437,16137 days 16:47:18.682830,190,1.6,0.0,600,-374,1660.0
2250000.0,3,2.5,3420,8700,1.0,3,9,2890,530.0,1951,3370,8700,25999 days 16:47:18.682830,035,1.2,5.452830188679245,50,0,2360.0
155000.0,2,1.0,1010,43056,1.5,3,5,1010,0.0,1990,830,18297,11754 days 16:47:18.682830,283,2.0,0.0,180,24759,1010.0
469000.0,4,2.5,2240,5624,1.0,3,7,1520,720.0,1961,2240,7495,22346 days 16:47:18.682830,061,1.6,2.111111111111111,0,-1871,800.0
305000.0,4,2.25,2340,5250,2.0,5,7,2340,0.0,1965,1540,5250,20885 days 16:47:18.682830,008,1.7777777777777777,0.0,800,0,2340.0
675000.0,3,1.75,1920,4500,1.0,5,7,960,960.0,1924,1190,4000,35861 days 16:47:18.682830,191,1.7142857142857142,1.0,730,500,0.0
931000.0,3,2.5,2460,6600,1.5,4,8,1560,900.0,1929,2090,3400,34034 days 16:47:18.682830,365,1.2,1.7333333333333334,370,3200,660.0
385000.0,3,1.0,1470,11398,1.0,3,8,1470,0.0,1950,1710,11407,26364 days 16:47:18.682830,036,3.0,0.0,-240,-9,1470.0
815000.0,3,2.5,3400,12442,2.0,3,9,3400,0.0,2001,3250,8635,7736 days 16:47:18.682830,045,1.2,0.0,150,3807,3400.0
531000.0,3,2.25,1910,8390,1.0,3,7,1910,0.0,1979,2410,8390,15772 days 16:47:18.682830,089,1.3333333333333333,0.0,-500,0,1910.0
386500.0,4,1.0,1400,3600,1.0,4,6,700,700.0,1901,1690,3600,44261 days 16:47:18.682830,082,4.0,1.0,-290,0,0.0
475580.0,3,1.75,1520,11085,1.0,3,8,1520,0.0,1983,2310,9647,14311 days 16:47:18.682830,177,1.7142857142857142,0.0,-790,1438,1520.0
358000.0,2,1.0,930,5077,1.0,3,6,930,0.0,1939,1080,5803,30382 days 16:47:18.682830,232,2.0,0.0,-150,-726,930.0
677500.0,5,1.0,2340,4730,2.0,3,8,1810,530.0,1918,2100,4970,38052 days 16:47:18.682830,295,5.0,3.4150943396226414,240,-240,1280.0
868500.0,3,2.5,2920,3942,3.0,3,1,2920,0.0,2008,2920,3942,5180 days 16:47:18.682830,128,1.2,0.0,0,0,2920.0
599380.0,3,1.75,1270,7350,1.0,4,7,1270,0.0,1967,1880,7350,20155 days 16:47:18.682830,040,1.7142857142857142,0.0,-610,0,1270.0
712000.0,4,2.25,2450,11960,1.0,3,1,2450,0.0,1979,2600,11960,15772 days 16:47:18.682830,281,1.7777777777777777,0.0,-150,0,2450.0
350000.0,5,1.75,1380,7620,1.0,3,7,1180,200.0,1955,1990,7620,24538 days 16:47:18.682830,120,2.857142857142857,5.9,-610,0,980.0
875000.0,4,2.0,2520,6000,1.0,3,8,1400,1120.0,1921,1580,3720,36956 days 16:47:18.682830,130,2.0,1.25,940,2280,280.0
365000.0,3,2.25,2290,7350,2.0,3,8,2290,0.0,1988,2170,7529,12485 days 16:47:18.682830,063,1.3333333333333333,0.0,120,-179,2290.0
452000.0,4,2.0,1660,6150,1.0,3,6,850,810.0,1945,1110,6250,28190 days 16:47:18.682830,141,2.0,1.0493827160493827,550,-100,40.0
915000.0,3,2.75,2800,9750,1.0,5,7,1400,1400.0,1957,2800,9530,23807 days 16:47:18.682830,048,1.0909090909090908,1.0,0,220,0.0
482500.0,3,2.5,1690,3068,2.0,3,7,1690,0.0,2005,1690,3260,6275 days 16:47:18.682830,005,1.2,0.0,0,-192,1690.0
425000.0,3,1.0,1180,7200,1.5,4,7,1180,0.0,1949,2240,7875,26729 days 16:47:18.682830,287,3.0,0.0,-1060,-675,1180.0
460000.0,2,1.75,1390,4160,1.0,5,6,790,600.0,1916,1090,4160,38783 days 16:47:18.682830,345,1.1428571428571428,1.3166666666666667,300,0,190.0
666570.0,4,2.0,2320,7400,1.5,5,7,1620,700.0,1913,1740,4000,39878 days 16:47:18.682830,201,2.0,2.3142857142857145,580,3400,920.0
390000.0,3,2.25,2270,32112,1.0,4,8,1740,530.0,1980,2310,41606,15407 days 16:47:18.682830,287,1.3333333333333333,3.2830188679245285,-40,-9494,1210.0
650000.0,4,1.75,2640,8215,1.0,4,7,1500,1140.0,1966,2070,7875,20520 days 16:47:18.682830,282,2.2857142857142856,1.3157894736842106,570,340,360.0
305000.0,3,2.0,1680,8487,1.0,3,7,1680,0.0,1993,2080,8560,10658 days 16:47:18.682830,274,1.5,0.0,-400,-73,1680.0
250000.0,3,1.0,990,8100,1.0,3,6,990,0.0,1949,1210,8100,26729 days 16:47:18.682830,217,3.0,0.0,-220,0,990.0
438800.0,4,2.5,2770,4432,2.0,3,9,2770,0.0,2004,2770,5423,6641 days 16:47:18.682830,096,1.6,0.0,0,-991,2770.0
290000.0,2,1.0,950,5650,1.0,5,6,950,0.0,1943,1250,5650,28921 days 16:47:18.682830,349,2.0,0.0,-300,0,950.0
324950.0,4,2.0,2160,4800,2.0,4,7,1290,870.0,1929,1570,4800,34034 days 16:47:18.682830,121,2.0,1.4827586206896552,590,0,420.0
453000.0,3,2.5,1650,1838,2.0,4,7,1270,380.0,1991,1550,1558,11389 days 16:47:18.682830,335,1.2,3.3421052631578947,100,280,890.0
556000.0,3,1.0,1800,4005,1.5,4,7,1160,640.0,1929,1240,4005,34034 days 16:47:18.682830,262,3.0,1.8125,560,0,520.0
315000.0,3,2.0,1660,11135,1.0,3,8,1660,0.0,1971,1660,11560,18694 days 16:47:18.682830,322,1.5,0.0,0,-425,1660.0
445830.0,3,2.5,1870,5449,2.0,3,8,1870,0.0,2003,2000,7687,7006 days 16:47:18.682830,147,1.2,0.0,-130,-2238,1870.0
1260000.0,3,3.5,3220,3960,2.0,3,1,2760,460.0,1991,3080,4444,11389 days 16:47:18.682830,283,0.8571428571428571,6.0,140,-484,2300.0
287200.0,3,3.0,1850,19966,1.0,4,7,1090,760.0,1992,1410,6715,11024 days 16:47:18.682830,122,1.0,1.4342105263157894,440,13251,330.0
525000.0,4,1.5,1580,6360,1.5,3,7,1290,290.0,1945,1690,6360,28190 days 16:47:18.682830,266,2.6666666666666665,4.448275862068965,-110,0,1000.0
1140000.0,4,4.25,4590,17621,2.0,3,1,3160,1430.0,2003,3800,12268,7006 days 16:47:18.682830,360,0.9411764705882353,2.2097902097902096,790,5353,1730.0
381000.0,3,1.75,2700,18246,1.0,4,7,1510,1190.0,1967,1620,16986,20155 days 16:47:18.682830,283,1.7142857142857142,1.26890756302521,1080,1260,320.0
360000.0,3,1.75,1020,7020,1.5,4,7,1020,0.0,1953,1020,5871,25268 days 16:47:18.682830,157,1.7142857142857142,0.0,0,1149,1020.0
619000.0,5,3.5,2950,2932,3.0,3,8,2950,0.0,2004,1580,2047,6641 days 16:47:18.682830,124,1.4285714285714286,0.0,1370,885,2950.0
535000.0,2,1.75,1780,224769,1.0,4,8,1780,0.0,1976,2060,71560,16868 days 16:47:18.682830,050,1.1428571428571428,0.0,-280,153209,1780.0
402000.0,2,1.0,710,5100,1.0,5,7,710,0.0,1905,1530,5100,42800 days 16:47:18.682830,282,2.0,0.0,-820,0,710.0
600000.0,4,3.5,4300,70407,2.0,3,1,2710,1590.0,1992,3520,26727,11024 days 16:47:18.682830,314,1.1428571428571428,1.7044025157232705,780,43680,1120.0
549950.0,3,2.5,2080,8690,1.0,3,8,1430,650.0,1974,2400,9625,17598 days 16:47:18.682830,253,1.2,2.2,-320,-935,780.0
300000.0,4,2.0,2360,7440,1.0,3,7,1180,1180.0,1955,1680,7800,24538 days 16:47:18.682830,232,2.0,1.0,680,-360,0.0
360000.0,6,2.0,2210,9870,2.0,4,7,2210,0.0,1969,1390,9912,19424 days 16:47:18.682830,084,3.0,0.0,820,-42,2210.0
419000.0,7,3.25,4340,8521,2.0,3,7,2550,1790.0,1986,1890,8951,13215 days 16:47:18.682830,253,2.1538461538461537,1.4245810055865922,2450,-430,760.0
510000.0,3,3.0,1320,1012,3.0,3,8,1320,0.0,2009,1320,1536,4814 days 16:47:18.682830,097,1.0,0.0,0,-524,1320.0
319950.0,3,2.5,1980,9907,2.0,3,8,1980,0.0,1991,2050,9907,11389 days 16:47:18.682830,259,1.2,0.0,-70,0,1980.0
1180000.0,5,5.0,3960,94089,2.0,3,1,3960,0.0,1998,2240,64468,8832 days 16:47:18.682830,280,1.0,0.0,1720,29621,3960.0
381000.0,4,2.5,2130,6003,2.0,3,8,2130,0.0,2003,1940,4529,7006 days 16:47:18.682830,276,1.6,0.0,190,1474,2130.0
256900.0,3,2.5,1720,3951,2.0,3,7,1720,0.0,1992,1720,3605,11024 days 16:47:18.682830,125,1.2,0.0,0,346,1720.0
346000.0,5,1.0,1790,30456,1.0,4,7,1350,440.0,1964,2420,35647,21251 days 16:47:18.682830,050,5.0,3.0681818181818183,-630,-5191,910.0
465000.0,2,2.25,1390,1222,3.0,3,7,1340,50.0,2009,1480,1369,4814 days 16:47:18.682830,342,0.8888888888888888,26.8,-90,-147,1290.0
545000.0,3,2.0,1900,9975,1.0,3,8,1500,400.0,1973,2140,9825,17963 days 16:47:18.682830,126,1.5,3.75,-240,150,1100.0
516000.0,2,1.75,1640,3090,1.0,4,7,910,730.0,1925,1510,4120,35495 days 16:47:18.682830,211,1.1428571428571428,1.2465753424657535,130,-1030,180.0
550000.0,4,2.5,2700,5100,1.0,4,8,1440,1260.0,1968,1880,5100,19790 days 16:47:18.682830,160,1.6,1.1428571428571428,820,0,180.0
339950.0,4,2.25,2200,7150,2.0,4,7,2200,0.0,1990,1740,7150,11754 days 16:47:18.682830,125,1.7777777777777777,0.0,460,0,2200.0
417000.0,3,1.0,1310,8514,1.0,4,7,1310,0.0,1953,1310,8514,25268 days 16:47:18.682830,084,3.0,0.0,0,0,1310.0
906000.0,4,2.5,2480,5000,1.0,3,8,1480,1000.0,1951,2240,6071,25999 days 16:47:18.682830,056,1.6,1.48,240,-1071,480.0
980000.0,4,2.25,3010,9800,2.0,4,9,3010,0.0,1973,2510,9800,17963 days 16:47:18.682830,316,1.7777777777777777,0.0,500,0,3010.0
555000.0,4,2.5,2450,5079,2.0,3,9,2450,0.0,2001,2690,6675,7736 days 16:47:18.682830,103,1.6,0.0,-240,-1596,2450.0
468000.0,2,1.75,1250,7029,1.0,4,7,1250,0.0,1986,1680,8470,13215 days 16:47:18.682830,314,1.1428571428571428,0.0,-430,-1441,1250.0
378000.0,3,1.75,2610,117176,1.0,3,7,1390,1220.0,1981,2140,142005,15041 days 16:47:18.682830,293,1.7142857142857142,1.139344262295082,470,-24829,170.0
430000.0,4,2.5,2010,16020,1.5,5,8,2010,0.0,1962,1420,16020,21981 days 16:47:18.682830,350,1.6,0.0,590,0,2010.0
730100.0,4,2.5,3120,14300,2.0,3,9,3120,0.0,2003,2580,10005,7006 days 16:47:18.682830,136,1.6,0.0,540,4295,3120.0
219000.0,4,1.5,1370,7944,1.5,3,7,1370,0.0,1961,1370,9181,22346 days 16:47:18.682830,247,2.6666666666666665,0.0,0,-1237,1370.0
570000.0,3,2.5,2420,11953,1.0,3,9,2420,0.0,1990,2420,12215,11754 days 16:47:18.682830,325,1.2,0.0,0,-262,2420.0
262500.0,4,2.75,1500,7036,1.0,3,7,1060,440.0,1979,1620,7200,15772 days 16:47:18.682830,323,1.4545454545454546,2.409090909090909,-120,-164,620.0
525000.0,5,2.5,2630,9216,2.0,3,8,2630,0.0,2003,2020,4980,7006 days 16:47:18.682830,149,2.0,0.0,610,4236,2630.0
520000.0,2,1.0,950,3880,1.0,4,6,950,0.0,1919,1660,3880,37687 days 16:47:18.682830,092,2.0,0.0,-710,0,950.0
417400.0,3,3.0,2680,12285,1.0,4,8,2680,0.0,1970,2610,9558,19059 days 16:47:18.682830,343,1.0,0.0,70,2727,2680.0
788000.0,4,3.25,3680,5759,2.0,3,9,2840,840.0,2003,3620,6006,7006 days 16:47:18.682830,132,1.2307692307692308,3.380952380952381,60,-247,2000.0
320000.0,3,1.0,1270,7400,1.0,4,7,1270,0.0,1956,1800,7400,24173 days 16:47:18.682830,358,3.0,0.0,-530,0,1270.0
950000.0,6,1.0,2330,5000,1.5,4,7,2330,0.0,1920,1570,5000,37322 days 16:47:18.682830,248,6.0,0.0,760,0,2330.0
255000.0,3,1.0,960,8100,1.0,3,7,960,0.0,1955,1120,8100,24538 days 16:47:18.682830,147,3.0,0.0,-160,0,960.0
260000.0,4,2.5,1990,6671,2.0,3,7,1990,0.0,1989,1862,6566,12119 days 16:47:18.682830,140,1.6,0.0,128,105,1990.0
394000.0,3,1.0,1450,7930,1.0,4,6,1150,300.0,1923,1040,7740,36226 days 16:47:18.682830,071,3.0,3.8333333333333335,410,190,850.0
575000.0,4,2.5,2280,27441,2.0,3,8,2280,0.0,1996,2350,35020,9563 days 16:47:18.682830,365,1.6,0.0,-70,-7579,2280.0
1250000.0,4,2.25,1830,7200,2.0,3,8,1750,80.0,1923,3100,7200,36226 days 16:47:18.682830,078,1.7777777777777777,21.875,-1270,0,1670.0
385000.0,3,2.25,1650,7800,1.0,3,7,1260,390.0,1969,1760,8268,19424 days 16:47:18.682830,216,1.3333333333333333,3.230769230769231,-110,-468,870.0
456000.0,5,2.75,2720,193406,1.0,4,7,1700,1020.0,1968,2820,248292,19790 days 16:47:18.682830,311,1.8181818181818181,1.6666666666666667,-100,-54886,680.0
637000.0,4,2.5,1710,5000,1.0,3,8,1110,600.0,1979,1750,5304,15772 days 16:47:18.682830,126,1.6,1.85,-40,-304,510.0
485000.0,5,1.5,1420,9900,1.0,3,7,1050,370.0,1964,1580,8075,21251 days 16:47:18.682830,314,3.3333333333333335,2.8378378378378377,-160,1825,680.0
315275.0,3,1.75,1440,8040,1.0,3,7,960,480.0,1951,1500,8040,25999 days 16:47:18.682830,132,1.7142857142857142,2.0,-60,0,480.0
252500.0,2,1.5,1280,8710,1.0,3,7,1280,0.0,1967,1520,9375,20155 days 16:47:18.682830,266,1.3333333333333333,0.0,-240,-665,1280.0
240000.0,2,1.0,1320,24319,1.0,3,7,1320,0.0,1966,1430,98445,20520 days 16:47:18.682830,082,2.0,0.0,-110,-74126,1320.0
790000.0,4,2.5,2560,12760,1.0,4,7,1760,800.0,1949,1760,6384,26729 days 16:47:18.682830,316,1.6,2.2,800,6376,960.0
310000.0,3,1.0,1480,7830,1.0,3,7,1480,0.0,1952,1450,7830,25634 days 16:47:18.682830,134,3.0,0.0,30,0,1480.0
1250000.0,4,2.5,2960,20240,2.0,4,1,2960,0.0,1985,2500,14960,13580 days 16:47:18.682830,346,1.6,0.0,460,5280,2960.0
425000.0,2,1.0,1160,5038,1.0,5,7,740,420.0,1942,1160,5076,29286 days 16:47:18.682830,028,2.0,1.7619047619047619,0,-38,320.0
548000.0,3,2.5,2110,4099,2.0,3,8,2110,0.0,2001,2110,4871,7736 days 16:47:18.682830,154,1.2,0.0,0,-772,2110.0
379880.0,3,2.5,1650,14054,1.0,4,7,1130,520.0,1986,1940,87555,13215 days 16:47:18.682830,123,1.2,2.173076923076923,-290,-73501,610.0
530000.0,3,2.5,1950,9906,2.0,3,8,1950,0.0,1988,1860,7689,12485 days 16:47:18.682830,150,1.2,0.0,90,2217,1950.0
695000.0,3,2.25,2600,220300,1.5,5,8,2120,480.0,1977,2760,215600,16502 days 16:47:18.682830,110,1.3333333333333333,4.416666666666667,-160,4700,1640.0
435000.0,3,1.0,1270,4000,1.5,3,7,1270,0.0,1928,1560,4000,34400 days 16:47:18.682830,147,3.0,0.0,-290,0,1270.0
540000.0,3,1.75,1300,62290,1.0,3,7,1300,0.0,1983,1850,52272,14311 days 16:47:18.682830,141,1.7142857142857142,0.0,-550,10018,1300.0
425000.0,3,2.25,1790,10209,1.0,3,7,1290,500.0,1967,1840,9900,20155 days 16:47:18.682830,171,1.3333333333333333,2.58,-50,309,790.0
490000.0,3,2.5,1930,7266,2.0,3,8,1930,0.0,2005,1930,7266,6275 days 16:47:18.682830,196,1.2,0.0,0,0,1930.0
220000.0,4,1.0,1200,6000,1.5,3,6,1200,0.0,1923,950,4000,36226 days 16:47:18.682830,184,4.0,0.0,250,2000,1200.0
540000.0,4,2.5,2050,3784,2.0,3,8,2050,0.0,2001,2050,3366,7736 days 16:47:18.682830,007,1.6,0.0,0,418,2050.0
670000.0,3,1.0,1710,6195,1.0,3,7,1410,300.0,1946,1610,6195,27825 days 16:47:18.682830,356,3.0,4.7,100,0,1110.0
667500.0,3,1.75,2130,20423,1.0,3,9,2130,0.0,1953,2370,20875,25268 days 16:47:18.682830,323,1.7142857142857142,0.0,-240,-452,2130.0
585000.0,3,3.5,1700,2197,2.0,3,8,1260,440.0,2010,1360,1418,4449 days 16:47:18.682830,259,0.8571428571428571,2.8636363636363638,340,779,820.0
225000.0,3,1.5,1390,12500,1.0,4,6,1390,0.0,1976,1390,9000,16868 days 16:47:18.682830,322,2.0,0.0,0,3500,1390.0
375000.0,3,1.0,1230,9877,1.0,3,7,1230,0.0,1954,1240,9965,24903 days 16:47:18.682830,231,3.0,0.0,-10,-88,1230.0
335000.0,3,2.0,1490,8847,1.0,4,7,1490,0.0,1967,1640,7572,20155 days 16:47:18.682830,328,1.5,0.0,-150,1275,1490.0
680000.0,5,3.25,2440,15815,2.0,3,8,1990,450.0,2014,2500,14201,2988 days 16:47:18.682830,070,1.5384615384615385,4.4222222222222225,-60,1614,1540.0
600000.0,3,1.0,970,4800,1.0,3,6,970,0.0,1950,1500,2042,26364 days 16:47:18.682830,023,3.0,0.0,-530,2758,970.0
161000.0,4,2.0,1700,8043,1.0,3,7,850,850.0,1954,1540,13260,24903 days 16:47:18.682830,217,2.0,1.0,160,-5217,0.0
220000.0,4,2.0,1700,8043,1.0,3,7,850,850.0,1954,1540,13260,24903 days 16:47:18.682830,014,2.0,1.0,160,-5217,0.0
420000.0,3,1.75,1720,5000,1.5,3,8,1720,0.0,1932,1410,8300,32939 days 16:47:18.682830,338,1.7142857142857142,0.0,310,-3300,1720.0
710000.0,3,1.0,1400,2250,1.5,3,7,1400,0.0,1909,1630,3600,41339 days 16:47:18.682830,086,3.0,0.0,-230,-1350,1400.0
626000.0,4,2.5,2570,7221,1.0,4,8,1570,1000.0,1958,2440,7274,23442 days 16:47:18.682830,022,1.6,1.57,130,-53,570.0
279500.0,3,1.5,1200,8040,1.0,4,7,1200,0.0,1959,1450,9315,23077 days 16:47:18.682830,203,2.0,0.0,-250,-1275,1200.0
1610000.0,4,3.5,4390,11600,2.0,3,1,3060,1330.0,1990,3240,12000,11754 days 16:47:18.682830,143,1.1428571428571428,2.300751879699248,1150,-400,1730.0
325000.0,2,1.0,1080,5000,1.0,3,7,1080,0.0,1954,1010,5000,24903 days 16:47:18.682830,213,2.0,0.0,70,0,1080.0
380000.0,4,2.25,1860,7980,1.0,4,8,1860,0.0,1966,1860,8814,20520 days 16:47:18.682830,198,1.7777777777777777,0.0,0,-834,1860.0
470000.0,4,2.75,2150,9820,1.0,4,8,1220,930.0,1979,2060,9830,15772 days 16:47:18.682830,238,1.4545454545454546,1.3118279569892473,90,-10,290.0
363000.0,4,3.0,2250,12142,2.0,3,8,2250,0.0,1986,2300,9003,13215 days 16:47:18.682830,339,1.3333333333333333,0.0,-50,3139,2250.0
245000.0,4,2.25,2050,7700,2.0,3,7,2050,0.0,1977,1780,7700,16502 days 16:47:18.683827,050,1.7777777777777777,0.0,270,0,2050.0
525000.0,3,1.0,1010,3520,1.0,3,7,1010,0.0,1902,1300,1233,43896 days 16:47:18.683827,057,3.0,0.0,-290,2287,1010.0
1700000.0,5,3.5,5850,22885,2.0,4,1,4670,1180.0,1978,3240,19020,16137 days 16:47:18.683827,176,1.4285714285714286,3.957627118644068,2610,3865,3490.0
658500.0,4,2.25,1900,5000,1.0,3,7,1400,500.0,1963,1710,4994,21616 days 16:47:18.683827,124,1.7777777777777777,2.8,190,6,900.0
680000.0,2,1.0,1020,8442,1.0,4,7,920,100.0,1941,2550,10323,29651 days 16:47:18.683827,114,2.0,9.2,-1530,-1881,820.0
835000.0,4,2.0,3390,16025,2.0,4,1,3390,0.0,1987,3950,15277,12850 days 16:47:18.683827,056,2.0,0.0,-560,748,3390.0
595000.0,4,2.5,1990,2175,2.0,3,8,1680,310.0,2005,1560,2087,6275 days 16:47:18.683827,157,1.6,5.419354838709677,430,88,1370.0
419000.0,4,2.5,3190,4980,2.0,3,9,3190,0.0,2005,2830,6720,6275 days 16:47:18.683827,106,1.6,0.0,360,-1740,3190.0
198900.0,2,1.0,1210,18700,1.0,4,7,1210,0.0,1940,2250,10048,30017 days 16:47:18.683827,258,2.0,0.0,-1040,8652,1210.0
1090000.0,4,3.25,3740,12080,1.0,3,1,2000,1740.0,1988,4210,15277,12485 days 16:47:18.683827,135,1.2307692307692308,1.1494252873563218,-470,-3197,260.0
500000.0,3,3.5,2150,4368,2.0,3,8,1610,540.0,1998,2390,16630,8832 days 16:47:18.683827,113,0.8571428571428571,2.9814814814814814,-240,-12262,1070.0
575000.0,4,1.75,2440,8100,1.0,4,9,1620,820.0,1960,2030,8100,22712 days 16:47:18.683827,192,2.2857142857142856,1.975609756097561,410,0,800.0
324950.0,2,1.5,1230,1516,3.0,3,8,1230,0.0,2000,1352,1411,8102 days 16:47:18.683827,092,1.3333333333333333,0.0,-122,105,1230.0
259000.0,3,2.5,2740,7980,2.0,4,7,2740,0.0,1964,1470,8611,21251 days 16:47:18.683827,057,1.2,0.0,1270,-631,2740.0
551000.0,2,2.0,2260,9604,1.0,3,9,2260,0.0,1990,2260,10747,11754 days 16:47:18.683827,136,1.0,0.0,0,-1143,2260.0
488000.0,2,1.5,1000,5125,1.0,3,7,1000,0.0,1942,1090,5100,29286 days 16:47:18.683827,220,1.3333333333333333,0.0,-90,25,1000.0
635000.0,4,2.25,2350,46173,2.0,4,8,2350,0.0,1980,2390,36567,15407 days 16:47:18.683827,064,1.7777777777777777,0.0,-40,9606,2350.0
395000.0,3,2.5,2300,8938,2.0,3,9,2300,0.0,1989,2570,9694,12119 days 16:47:18.683827,070,1.2,0.0,-270,-756,2300.0
370000.0,3,1.0,1440,8287,1.5,4,7,1440,0.0,1928,1330,8285,34400 days 16:47:18.683827,230,3.0,0.0,110,2,1440.0
675000.0,4,3.0,2780,5000,1.5,5,7,1710,1070.0,1919,1150,5000,37687 days 16:47:18.683827,297,1.3333333333333333,1.5981308411214954,1630,0,640.0
402000.0,3,1.0,1200,6825,1.0,3,7,1200,0.0,1954,1470,8100,24903 days 16:47:18.683827,092,3.0,0.0,-270,-1275,1200.0
825000.0,3,2.75,3040,24192,2.0,4,1,3040,0.0,1987,2770,5728,12850 days 16:47:18.683827,225,1.0909090909090908,0.0,270,18464,3040.0
579000.0,3,2.75,2660,223027,1.0,3,8,1330,1330.0,1962,1560,222591,21981 days 16:47:18.683827,048,1.0909090909090908,1.0,1100,436,0.0
455000.0,5,2.0,1510,3000,2.0,3,6,1510,0.0,1983,1610,3600,14311 days 16:47:18.683827,056,2.5,0.0,-100,-600,1510.0
265000.0,3,2.5,1780,6527,2.0,3,8,1780,0.0,1989,2040,8840,12119 days 16:47:18.683827,203,1.2,0.0,-260,-2313,1780.0
713500.0,5,2.75,2920,9163,1.0,4,8,1520,1400.0,1976,2250,9163,16868 days 16:47:18.683827,335,1.8181818181818181,1.0857142857142856,670,0,120.0
240000.0,3,1.0,1550,12670,1.0,4,7,1550,0.0,1962,1550,8880,21981 days 16:47:18.683827,006,3.0,0.0,0,3790,1550.0
570000.0,4,3.0,2710,217800,2.5,3,9,2710,0.0,2006,2710,217800,5910 days 16:47:18.683827,254,1.3333333333333333,0.0,0,0,2710.0
543000.0,2,1.0,940,3864,1.0,4,8,940,0.0,1918,1440,3956,38052 days 16:47:18.683827,346,2.0,0.0,-500,-92,940.0
1010000.0,3,2.25,2160,7500,2.0,3,1,2160,0.0,1982,1550,3839,14676 days 16:47:18.683827,281,1.3333333333333333,0.0,610,3661,2160.0
625000.0,4,2.25,2470,17008,2.0,4,8,2470,0.0,1979,2470,31798,15772 days 16:47:18.683827,202,1.7777777777777777,0.0,0,-14790,2470.0
459950.0,4,2.5,2800,6567,2.0,3,9,2800,0.0,2006,3400,5900,5910 days 16:47:18.683827,268,1.6,0.0,-600,667,2800.0
370000.0,4,2.75,2420,39704,1.0,3,9,2420,0.0,1985,2760,36303,13580 days 16:47:18.683827,304,1.4545454545454546,0.0,-340,3401,2420.0
150000.0,4,2.0,1460,7254,1.0,3,6,1460,0.0,1959,1460,7236,23077 days 16:47:18.683827,304,2.0,0.0,0,18,1460.0
683500.0,3,1.5,1820,5756,1.5,3,7,1640,180.0,1946,1760,6169,27825 days 16:47:18.683827,175,2.0,9.11111111111111,60,-413,1460.0
499950.0,3,2.5,1520,2208,2.0,3,8,1040,480.0,2007,1610,1618,5545 days 16:47:18.683827,155,1.2,2.1666666666666665,-90,590,560.0
255000.0,2,1.0,1320,9967,1.0,3,6,940,380.0,1919,1970,7587,37687 days 16:47:18.683827,181,2.0,2.473684210526316,-650,2380,560.0
279000.0,3,2.5,1920,7779,2.0,3,7,1920,0.0,1989,1960,7536,12119 days 16:47:18.683827,085,1.2,0.0,-40,243,1920.0
910000.0,5,3.0,2640,5096,2.0,3,1,2640,0.0,2009,1610,5217,4814 days 16:47:18.683827,335,1.6666666666666667,0.0,1030,-121,2640.0
699000.0,4,2.5,2650,7945,2.0,3,9,2650,0.0,2006,1200,7920,5910 days 16:47:18.683827,140,1.6,0.0,1450,25,2650.0
1650000.0,4,3.25,3640,13530,1.0,3,9,2570,1070.0,1924,2760,15000,35861 days 16:47:18.683827,098,1.2307692307692308,2.4018691588785046,880,-1470,1500.0
248000.0,3,1.0,1420,8800,1.0,4,6,1090,330.0,1981,1480,8000,15041 days 16:47:18.683827,084,3.0,3.303030303030303,-60,800,760.0
429000.0,3,1.0,1540,37950,1.0,4,7,1090,450.0,1959,1820,24375,23077 days 16:47:18.683827,311,3.0,2.422222222222222,-280,13575,640.0
685000.0,4,1.0,1550,15239,1.5,3,6,1370,180.0,1930,1790,22047,33669 days 16:47:18.683827,300,4.0,7.611111111111111,-240,-6808,1190.0
316000.0,2,1.0,730,5040,1.0,3,6,730,0.0,1927,790,5040,34765 days 16:47:18.683827,212,2.0,0.0,-60,0,730.0
410000.0,2,1.0,2020,7540,1.0,3,7,1010,1010.0,1921,1270,4652,36956 days 16:47:18.683827,069,2.0,1.0,750,2888,0.0
299000.0,3,1.0,1200,15843,1.0,3,7,1200,0.0,1955,1410,15843,24538 days 16:47:18.683827,220,3.0,0.0,-210,0,1200.0
559000.0,2,1.0,1240,6400,1.0,4,7,1060,180.0,1938,1240,6400,30747 days 16:47:18.683827,169,2.0,5.888888888888889,0,0,880.0
575000.0,3,2.25,2680,100188,2.0,4,8,1580,1100.0,1978,2540,60548,16137 days 16:47:18.683827,204,1.3333333333333333,1.4363636363636363,140,39640,480.0
602000.0,3,2.5,1640,3804,2.0,3,8,1640,0.0,1998,1440,3230,8832 days 16:47:18.683827,195,1.2,0.0,200,574,1640.0
492000.0,4,2.0,1640,5000,2.0,3,7,1640,0.0,1907,1240,5000,42070 days 16:47:18.683827,142,2.0,0.0,400,0,1640.0
293500.0,3,2.5,1610,5024,2.0,3,7,1610,0.0,2004,1790,3717,6641 days 16:47:18.683827,086,1.2,0.0,-180,1307,1610.0
481000.0,3,2.75,2290,14810,1.0,5,7,1400,890.0,1967,2540,8640,20155 days 16:47:18.683827,203,1.0909090909090908,1.5730337078651686,-250,6170,510.0
311100.0,4,2.25,2130,8078,1.0,4,7,1380,750.0,1977,2300,8112,16502 days 16:47:18.683827,129,1.7777777777777777,1.84,-170,-34,630.0
375000.0,3,1.75,2140,13598,1.5,4,7,1620,520.0,1970,930,10150,19059 days 16:47:18.683827,107,1.7142857142857142,3.1153846153846154,1210,3448,1100.0
1080000.0,3,3.0,4020,435600,1.5,3,1,4020,0.0,1999,2590,283140,8467 days 16:47:18.683827,041,1.0,0.0,1430,152460,4020.0
500000.0,5,2.5,2030,8400,1.0,3,7,1330,700.0,1968,1920,8400,19790 days 16:47:18.683827,118,2.0,1.9,110,0,630.0
553000.0,3,1.0,1380,6250,1.0,4,7,1380,0.0,1918,2270,6250,38052 days 16:47:18.683827,091,3.0,0.0,-890,0,1380.0
760000.0,3,2.0,1780,1750,1.0,3,8,1400,380.0,1927,1780,3750,34765 days 16:47:18.683827,340,1.5,3.6842105263157894,0,-2000,1020.0
589500.0,4,1.5,1440,3200,1.0,4,7,960,480.0,1960,1650,6400,22712 days 16:47:18.683827,129,2.6666666666666665,2.0,-210,-3200,480.0
840000.0,5,2.75,2790,20824,1.0,3,9,1680,1110.0,1959,2380,10465,23077 days 16:47:18.683827,318,1.8181818181818181,1.5135135135135136,410,10359,570.0
2550000.0,4,3.0,4190,8805,2.5,5,9,3490,700.0,1928,3780,8558,34400 days 16:47:18.683827,213,1.3333333333333333,4.985714285714286,410,247,2790.0
1280000.0,3,2.5,3870,46609,2.0,3,9,3870,0.0,1997,4030,17880,9197 days 16:47:18.683827,188,1.2,0.0,-160,28729,3870.0
260000.0,3,2.5,1850,7875,1.0,3,7,1250,600.0,1968,1930,8062,19790 days 16:47:18.683827,335,1.2,2.0833333333333335,-80,-187,650.0
430000.0,3,2.25,1550,1469,3.0,3,8,1550,0.0,2004,1520,1465,6641 days 16:47:18.683827,197,1.3333333333333333,0.0,30,4,1550.0
781000.0,3,2.5,1920,1896,3.0,3,8,1920,0.0,2000,1670,2994,8102 days 16:47:18.683827,063,1.2,0.0,250,-1098,1920.0
392000.0,5,2.25,3740,32481,1.5,3,8,2240,1500.0,1958,2040,11398,23442 days 16:47:18.683827,182,2.2222222222222223,1.4933333333333334,1700,21083,740.0
466200.0,3,1.5,1340,8856,1.0,4,7,1340,0.0,1959,1850,8740,23077 days 16:47:18.683827,041,2.0,0.0,-510,116,1340.0
641000.0,3,1.75,1620,3975,1.0,5,7,940,680.0,1926,1320,3922,35130 days 16:47:18.683827,143,1.7142857142857142,1.3823529411764706,300,53,260.0
350000.0,3,1.0,1680,8010,1.0,3,7,840,840.0,1951,1890,8778,25999 days 16:47:18.683827,083,3.0,1.0,-210,-768,0.0
450000.0,3,2.0,1610,4364,2.0,3,8,1610,0.0,1996,2010,4364,9563 days 16:47:18.683827,035,1.5,0.0,-400,0,1610.0
1800000.0,4,3.5,4460,16953,1.0,3,9,2550,1910.0,1962,1980,13370,21981 days 16:47:18.683827,140,1.1428571428571428,1.3350785340314135,2480,3583,640.0
185000.0,3,1.5,1200,1848,2.0,3,8,1200,0.0,1966,1270,1848,20520 days 16:47:18.683827,068,2.0,0.0,-70,0,1200.0
290000.0,2,1.0,1250,12507,1.0,5,7,1250,0.0,1958,1250,12498,23442 days 16:47:18.683827,023,2.0,0.0,0,9,1250.0
964000.0,3,2.5,3630,9475,2.0,3,1,3630,0.0,1999,3250,11605,8467 days 16:47:18.683827,120,1.2,0.0,380,-2130,3630.0
2000000.0,4,3.0,4260,18000,2.0,3,1,4260,0.0,2000,3540,17015,8102 days 16:47:18.683827,148,1.3333333333333333,0.0,720,985,4260.0
545000.0,3,2.5,2180,15693,1.0,4,8,1850,330.0,1979,2270,24000,15772 days 16:47:18.683827,162,1.2,5.606060606060606,-90,-8307,1520.0
609950.0,3,2.25,1760,10350,1.0,4,7,1330,430.0,1979,2210,11337,15772 days 16:47:18.683827,071,1.3333333333333333,3.0930232558139537,-450,-987,900.0
605000.0,4,2.0,1820,7626,1.0,5,7,990,830.0,1941,1390,5904,29651 days 16:47:18.683827,216,2.0,1.1927710843373494,430,1722,160.0
550000.0,4,2.5,2120,9163,1.0,4,8,1450,670.0,1961,2120,9166,22346 days 16:47:18.683827,251,1.6,2.1641791044776117,0,-3,780.0
905000.0,4,2.75,2730,4268,2.0,3,9,2730,0.0,2009,2340,5000,4814 days 16:47:18.683827,020,1.4545454545454546,0.0,390,-732,2730.0
384200.0,3,2.5,2430,7613,2.0,4,8,2430,0.0,1986,2440,8342,13215 days 16:47:18.683827,296,1.2,0.0,-10,-729,2430.0
370000.0,3,1.0,1170,1105,1.0,3,7,1170,0.0,1965,1380,1399,20885 days 16:47:18.683827,192,3.0,0.0,-210,-294,1170.0
717500.0,3,1.0,2090,4000,1.5,3,8,1890,200.0,1931,2090,4000,33304 days 16:47:18.683827,338,3.0,9.45,0,0,1690.0
2000000.0,4,3.25,3910,7500,2.0,4,1,2550,1360.0,1933,3070,7500,32573 days 16:47:18.683827,121,1.2307692307692308,1.875,840,0,1190.0
365500.0,2,1.0,1140,15624,1.0,4,6,1140,0.0,1909,2110,15493,41339 days 16:47:18.683827,337,2.0,0.0,-970,131,1140.0
580000.0,2,1.5,1460,5700,1.5,3,7,1460,0.0,1912,1780,3800,40244 days 16:47:18.683827,028,1.3333333333333333,0.0,-320,1900,1460.0
415000.0,4,1.5,2700,14760,1.5,5,9,2700,0.0,1940,1670,7200,30017 days 16:47:18.683827,311,2.6666666666666665,0.0,1030,7560,2700.0
272000.0,2,1.0,670,6300,1.0,4,6,670,0.0,1942,740,6300,29286 days 16:47:18.683827,013,2.0,0.0,-70,0,670.0
600000.0,3,1.75,1880,6360,1.0,4,7,1040,840.0,1945,1770,6175,28190 days 16:47:18.683827,125,1.7142857142857142,1.2380952380952381,110,185,200.0
744000.0,4,3.0,1980,5352,2.5,3,8,1980,0.0,1941,1680,5352,29651 days 16:47:18.683827,135,1.3333333333333333,0.0,300,0,1980.0
830000.0,3,3.0,2080,10521,1.5,3,9,2080,0.0,2004,3730,11840,6641 days 16:47:18.683827,154,1.0,0.0,-1650,-1319,2080.0
322000.0,3,3.25,1380,1225,3.0,3,7,1380,0.0,2000,1380,1704,8102 days 16:47:18.683827,302,0.9230769230769231,0.0,0,-479,1380.0
270000.0,3,2.5,1808,19200,1.0,3,8,1808,0.0,2005,1450,14400,6275 days 16:47:18.683827,260,1.2,0.0,358,4800,1808.0
272450.0,3,1.0,1350,7973,1.5,3,7,1350,0.0,1954,1310,7491,24903 days 16:47:18.683827,065,3.0,0.0,40,482,1350.0
510000.0,3,1.75,1950,8325,1.0,4,7,1950,0.0,1962,1950,8325,21981 days 16:47:18.683827,131,1.7142857142857142,0.0,0,0,1950.0
1130000.0,4,3.5,3170,4000,2.0,3,1,2340,830.0,1999,1770,4000,8467 days 16:47:18.683827,113,1.1428571428571428,2.819277108433735,1400,0,1510.0
1690000.0,4,2.5,3000,7500,2.0,3,9,3000,0.0,1937,2580,5000,31112 days 16:47:18.683827,163,1.6,0.0,420,2500,3000.0
162000.0,4,1.0,1460,16638,1.0,4,6,1460,0.0,1975,1460,16638,17233 days 16:47:18.683827,007,4.0,0.0,0,0,1460.0
337500.0,3,1.75,1350,5850,1.0,4,7,1050,300.0,1973,1710,7757,17963 days 16:47:18.683827,126,1.7142857142857142,3.5,-360,-1907,750.0
312000.0,3,2.25,1470,7857,1.0,4,7,1180,290.0,1973,1900,7600,17963 days 16:47:18.683827,090,1.3333333333333333,4.068965517241379,-430,257,890.0
740000.0,4,3.0,3350,199253,2.0,3,1,3350,0.0,2004,3350,183897,6641 days 16:47:18.683827,225,1.3333333333333333,0.0,0,15356,3350.0
700000.0,4,3.0,3350,199253,2.0,3,1,3350,0.0,2004,3350,183897,6641 days 16:47:18.683827,064,1.3333333333333333,0.0,0,15356,3350.0
328000.0,4,1.0,1360,8136,1.0,3,7,1360,0.0,1948,1570,8132,27095 days 16:47:18.683827,268,4.0,0.0,-210,4,1360.0
241000.0,3,1.0,1020,7538,1.0,3,7,1020,0.0,1981,1650,7201,15041 days 16:47:18.683827,044,3.0,0.0,-630,337,1020.0
265000.0,3,2.25,1840,6750,1.0,4,7,1270,570.0,1980,1750,7004,15407 days 16:47:18.683827,212,1.3333333333333333,2.2280701754385963,90,-254,700.0
246000.0,5,1.75,2030,10200,1.0,4,7,2030,0.0,1958,1760,11550,23442 days 16:47:18.683827,086,2.857142857142857,0.0,270,-1350,2030.0
271000.0,4,1.75,1490,9112,1.0,3,6,970,520.0,1940,1650,8411,30017 days 16:47:18.683827,273,2.2857142857142856,1.8653846153846154,-160,701,450.0
270000.0,2,1.0,2060,8398,1.0,3,7,1260,800.0,1962,1690,13495,21981 days 16:47:18.683827,176,2.0,1.575,370,-5097,460.0
395000.0,4,2.0,2240,7085,1.5,3,7,2240,0.0,1944,1440,7085,28556 days 16:47:18.683827,321,2.0,0.0,800,0,2240.0
340000.0,3,2.0,1460,5715,1.0,3,7,1460,0.0,1957,1400,5715,23807 days 16:47:18.683827,212,1.5,0.0,60,0,1460.0
340000.0,3,1.75,2140,13260,1.0,3,7,1240,900.0,1948,1640,13260,27095 days 16:47:18.683827,289,1.7142857142857142,1.3777777777777778,500,0,340.0
335000.0,2,2.25,1420,1246,2.0,3,8,1420,0.0,2007,1420,1826,5545 days 16:47:18.683827,065,0.8888888888888888,0.0,0,-580,1420.0
435000.0,2,1.0,1060,3036,1.5,4,6,1060,0.0,1943,1730,5535,28921 days 16:47:18.683827,176,2.0,0.0,-670,-2499,1060.0
527950.0,4,1.75,1760,3600,1.0,5,7,880,880.0,1926,1500,5580,35130 days 16:47:18.683827,282,2.2857142857142856,1.0,260,-1980,0.0
1150000.0,10,5.25,4590,10920,1.0,3,9,2500,2090.0,2008,2730,10400,5180 days 16:47:18.683827,226,1.9047619047619047,1.1961722488038278,1860,520,410.0
417000.0,3,2.5,2040,11211,2.0,3,8,2040,0.0,2000,1830,11964,8102 days 16:47:18.683827,098,1.2,0.0,210,-753,2040.0
451000.0,4,1.75,1260,7250,1.0,3,6,1260,0.0,1943,1880,7250,28921 days 16:47:18.683827,069,2.2857142857142856,0.0,-620,0,1260.0
580000.0,2,1.0,1650,9780,1.0,3,7,950,700.0,1943,1650,5458,28921 days 16:47:18.683827,049,2.0,1.3571428571428572,0,4322,250.0
570000.0,4,2.25,2380,36446,2.0,4,8,2380,0.0,1977,2790,40005,16502 days 16:47:18.683827,351,1.7777777777777777,0.0,-410,-3559,2380.0
750000.0,5,3.25,2750,7500,2.0,3,7,2150,600.0,1937,2750,7500,31112 days 16:47:18.683827,161,1.5384615384615385,3.5833333333333335,0,0,1550.0
275000.0,3,2.0,1340,9764,1.0,3,7,1340,0.0,1944,1310,9764,28556 days 16:47:18.683827,360,1.5,0.0,30,0,1340.0
739888.0,3,2.5,2420,43177,2.0,4,8,1690,730.0,1989,3740,8717,12119 days 16:47:18.683827,169,1.2,2.315068493150685,-1320,34460,960.0
715000.0,2,2.5,2160,5581,1.0,3,8,2160,0.0,2002,2315,5652,7371 days 16:47:18.683827,147,0.8,0.0,-155,-71,2160.0
800000.0,4,2.0,2450,4400,1.0,3,7,1450,1000.0,1913,1890,1386,39878 days 16:47:18.683827,084,2.0,1.45,560,3014,450.0
350000.0,3,1.5,1870,9000,1.0,3,7,1120,750.0,1923,1850,6000,36226 days 16:47:18.683827,328,2.0,1.4933333333333334,20,3000,370.0
220000.0,3,1.0,1000,223462,1.0,4,6,1000,0.0,1933,1710,105850,32573 days 16:47:18.683827,328,3.0,0.0,-710,117612,1000.0
452500.0,3,2.5,2240,7791,2.0,3,7,2240,0.0,2002,2480,5018,7371 days 16:47:18.683827,282,1.2,0.0,-240,2773,2240.0
280000.0,4,2.5,2200,5893,2.0,3,7,2200,0.0,2008,2200,5757,5180 days 16:47:18.683827,075,1.6,0.0,0,136,2200.0
248000.0,1,1.0,790,12000,1.0,3,6,790,0.0,1918,1900,6000,38052 days 16:47:18.683827,296,1.0,0.0,-1110,6000,790.0
305000.0,2,1.0,890,7200,1.0,3,7,740,150.0,1949,1290,7200,26729 days 16:47:18.683827,107,2.0,4.933333333333334,-400,0,590.0
435010.0,3,1.0,1270,4000,1.0,3,7,1120,150.0,1954,1220,4600,24903 days 16:47:18.683827,071,3.0,7.466666666666667,50,-600,970.0
678100.0,3,1.75,1850,2860,1.5,5,8,1210,640.0,1931,1660,3120,33304 days 16:47:18.683827,199,1.7142857142857142,1.890625,190,-260,570.0
325000.0,3,2.25,1352,1694,3.0,3,8,1352,0.0,2007,1439,1387,5545 days 16:47:18.683827,129,1.3333333333333333,0.0,-87,307,1352.0
529950.0,3,2.0,1540,8400,1.0,3,7,1180,360.0,1968,1550,8760,19790 days 16:47:18.683827,195,1.5,3.2777777777777777,-10,-360,820.0
440000.0,3,1.75,1640,8529,1.0,5,7,1640,0.0,1951,1730,7769,25999 days 16:47:18.683827,357,1.7142857142857142,0.0,-90,760,1640.0
585000.0,3,1.0,1350,4800,1.5,3,7,1350,0.0,1928,1360,4800,34400 days 16:47:18.683827,075,3.0,0.0,-10,0,1350.0
462608.0,3,2.5,2010,2778,2.0,3,8,1390,620.0,2014,1540,1689,2988 days 16:47:18.683827,232,1.2,2.2419354838709675,470,1089,770.0
350500.0,3,1.75,2080,5200,1.0,3,7,1040,1040.0,1974,1410,6550,17598 days 16:47:18.683827,097,1.7142857142857142,1.0,670,-1350,0.0
210000.0,3,1.0,1040,8125,1.0,3,7,1040,0.0,1956,1200,9375,24173 days 16:47:18.683827,314,3.0,0.0,-160,-1250,1040.0
510000.0,3,2.5,1890,5929,2.0,3,8,1890,0.0,1993,2060,5775,10658 days 16:47:18.683827,037,1.2,0.0,-170,154,1890.0
280000.0,3,2.25,1810,7630,1.0,4,7,1810,0.0,1959,1830,7594,23077 days 16:47:18.683827,126,1.3333333333333333,0.0,-20,36,1810.0
385000.0,3,1.75,1930,14389,1.0,3,7,1130,800.0,1963,1730,14378,21616 days 16:47:18.683827,062,1.7142857142857142,1.4125,200,11,330.0
349000.0,3,1.0,1010,8184,1.0,4,6,1010,0.0,1947,1010,8184,27460 days 16:47:18.683827,176,3.0,0.0,0,0,1010.0
252000.0,3,2.25,1740,10836,1.0,3,7,910,830.0,1981,2090,7500,15041 days 16:47:18.683827,238,1.3333333333333333,1.0963855421686748,-350,3336,80.0
1100000.0,4,2.5,2910,8881,2.0,3,1,1940,970.0,1932,2540,5250,32939 days 16:47:18.683827,303,1.6,2.0,370,3631,970.0
375000.0,3,2.25,1330,8004,2.0,3,7,1330,0.0,1985,1300,7971,13580 days 16:47:18.683827,345,1.3333333333333333,0.0,30,33,1330.0
336000.0,4,2.25,2210,11700,2.0,4,8,2210,0.0,1967,2040,9000,20155 days 16:47:18.683827,195,1.7777777777777777,0.0,170,2700,2210.0
732000.0,3,3.75,2670,6517,2.5,4,8,2020,650.0,1977,2010,6073,16502 days 16:47:18.683827,183,0.8,3.1076923076923078,660,444,1370.0
200000.0,2,1.0,1000,6227,1.0,3,6,1000,0.0,1949,1240,6250,26729 days 16:47:18.683827,218,2.0,0.0,-240,-23,1000.0
681716.0,4,2.5,3150,7277,2.0,3,9,3150,0.0,2006,3030,8643,5910 days 16:47:18.683827,148,1.6,0.0,120,-1366,3150.0
235000.0,3,1.75,1520,12246,1.0,4,6,1520,0.0,1971,1460,12246,18694 days 16:47:18.683827,056,1.7142857142857142,0.0,60,0,1520.0
257500.0,3,1.0,1690,13825,1.0,3,7,1210,480.0,1955,1190,9450,24538 days 16:47:18.683827,282,3.0,2.5208333333333335,500,4375,730.0
315000.0,3,1.0,1070,9497,1.0,3,7,1070,0.0,1955,1710,9561,24538 days 16:47:18.683827,272,3.0,0.0,-640,-64,1070.0
299950.0,3,1.0,910,8000,1.0,4,6,740,170.0,1950,2090,9007,26364 days 16:47:18.683827,140,3.0,4.352941176470588,-1180,-1007,570.0
530000.0,4,2.25,2130,8640,1.0,3,7,1430,700.0,1969,2120,8826,19424 days 16:47:18.683827,192,1.7777777777777777,2.0428571428571427,10,-186,730.0
766500.0,2,1.75,2230,6930,1.0,4,8,1530,700.0,1947,1970,6930,27460 days 16:47:18.683827,258,1.1428571428571428,2.1857142857142855,260,0,830.0
860000.0,4,2.5,3560,11119,1.0,3,1,2290,1270.0,1986,3290,11385,13215 days 16:47:18.683827,133,1.6,1.8031496062992125,270,-266,1020.0
690000.0,3,2.5,2590,4961,2.0,3,9,2590,0.0,1944,1230,4961,28556 days 16:47:18.683827,031,1.2,0.0,1360,0,2590.0
551000.0,4,1.75,2040,6348,1.0,3,7,1020,1020.0,1962,1770,5047,21981 days 16:47:18.683827,077,2.2857142857142856,1.0,270,1301,0.0
530000.0,3,2.75,2100,20150,1.0,4,7,2100,0.0,1955,2100,15500,24538 days 16:47:18.683827,325,1.0909090909090908,0.0,0,4650,2100.0
568000.0,3,1.0,1340,7260,1.5,3,7,1340,0.0,1953,1830,6822,25268 days 16:47:18.683827,110,3.0,0.0,-490,438,1340.0
749950.0,3,2.5,2770,10773,2.0,3,9,2770,0.0,1992,2530,10423,11024 days 16:47:18.683827,140,1.2,0.0,240,350,2770.0
535000.0,3,2.5,2400,12546,1.0,3,9,2400,0.0,1983,2940,12150,14311 days 16:47:18.683827,279,1.2,0.0,-540,396,2400.0
234300.0,3,1.0,1140,9779,1.0,3,7,1140,0.0,1963,1520,9814,21616 days 16:47:18.683827,099,3.0,0.0,-380,-35,1140.0
190000.0,2,1.0,930,11450,1.0,3,6,930,0.0,1946,1150,11450,27825 days 16:47:18.683827,233,2.0,0.0,-220,0,930.0
525000.0,4,1.75,1820,6600,1.0,5,7,1820,0.0,1960,1430,8800,22712 days 16:47:18.683827,283,2.2857142857142856,0.0,390,-2200,1820.0
610000.0,4,1.0,1390,3708,1.5,4,7,1390,0.0,1926,1430,3708,35130 days 16:47:18.683827,310,4.0,0.0,-40,0,1390.0
520000.0,3,2.5,1480,1165,3.0,3,8,1480,0.0,2006,1480,1231,5910 days 16:47:18.683827,276,1.2,0.0,0,-66,1480.0
375000.0,2,1.0,760,6000,1.0,3,6,760,0.0,1942,1360,6000,29286 days 16:47:18.683827,112,2.0,0.0,-600,0,760.0
600000.0,3,1.75,1580,7416,1.0,3,7,1150,430.0,1967,1730,7416,20155 days 16:47:18.683827,148,1.7142857142857142,2.6744186046511627,-150,0,720.0
664000.0,4,2.5,1870,16200,1.0,5,8,1250,620.0,1974,2000,11250,17598 days 16:47:18.683827,296,1.6,2.0161290322580645,-130,4950,630.0
698000.0,2,1.0,1510,4080,1.0,3,7,1010,500.0,1923,1660,4080,36226 days 16:47:18.683827,124,2.0,2.02,-150,0,510.0
418000.0,3,2.0,1250,1306,3.0,3,7,1250,0.0,2001,1320,1250,7736 days 16:47:18.683827,239,1.5,0.0,-70,56,1250.0
271675.0,3,1.75,2140,13068,1.0,4,7,1460,680.0,1974,2090,17424,17598 days 16:47:18.683827,230,1.7142857142857142,2.1470588235294117,50,-4356,780.0
450000.0,3,1.0,1540,9028,1.0,4,6,1540,0.0,1968,1450,9028,19790 days 16:47:18.683827,127,3.0,0.0,90,0,1540.0
759000.0,3,2.25,2950,78843,1.5,3,9,2950,0.0,2006,3880,78843,5910 days 16:47:18.683827,129,1.3333333333333333,0.0,-930,0,2950.0
599950.0,6,3.0,2020,4129,1.0,3,7,1230,790.0,1994,2080,4080,10293 days 16:47:18.683827,015,2.0,1.5569620253164558,-60,49,440.0
810000.0,4,2.75,2820,5000,1.5,3,8,2170,650.0,1927,1740,5000,34765 days 16:47:18.683827,022,1.4545454545454546,3.3384615384615386,1080,0,1520.0
331292.0,3,1.75,1660,10000,1.0,3,7,1660,0.0,1972,1770,10000,18329 days 16:47:18.683827,210,1.7142857142857142,0.0,-110,0,1660.0
348000.0,3,1.75,1830,2417,1.0,3,7,930,900.0,1919,1320,3200,37687 days 16:47:18.683827,096,1.7142857142857142,1.0333333333333334,510,-783,30.0
435000.0,2,1.0,720,5600,1.0,4,7,720,0.0,1920,1330,5600,37322 days 16:47:18.683827,262,2.0,0.0,-610,0,720.0
530000.0,3,2.5,2160,9063,2.0,3,8,2160,0.0,1992,2160,9063,11024 days 16:47:18.683827,050,1.2,0.0,0,0,2160.0
227000.0,3,1.75,1510,9837,2.0,3,7,1510,0.0,1989,1470,8054,12119 days 16:47:18.683827,265,1.7142857142857142,0.0,40,1783,1510.0
285000.0,3,1.5,1870,42070,1.0,3,7,1870,0.0,1953,1870,19965,25268 days 16:47:18.683827,276,2.0,0.0,0,22105,1870.0
740000.0,4,2.25,2860,26136,1.0,3,8,1640,1220.0,1977,2670,25040,16502 days 16:47:18.683827,076,1.7777777777777777,1.3442622950819672,190,1096,420.0
246000.0,3,1.0,990,9145,1.5,4,6,990,0.0,1939,1640,8320,30382 days 16:47:18.683827,070,3.0,0.0,-650,825,990.0
260000.0,3,1.0,1910,8710,1.0,3,7,1080,830.0,1954,1460,8944,24903 days 16:47:18.683827,048,3.0,1.3012048192771084,450,-234,250.0
366000.0,3,2.0,1350,10200,1.0,3,7,1350,0.0,1977,1820,9600,16502 days 16:47:18.683827,223,1.5,0.0,-470,600,1350.0
594950.0,4,3.25,2557,9480,2.0,3,7,2557,0.0,1948,2220,8340,27095 days 16:47:18.683827,299,1.2307692307692308,0.0,337,1140,2557.0
608000.0,3,2.75,2610,5000,2.0,4,7,1710,900.0,1946,1500,5000,27825 days 16:47:18.683827,086,1.0909090909090908,1.9,1110,0,810.0
313100.0,3,2.0,1720,11875,1.0,5,6,1720,0.0,1905,1860,7500,42800 days 16:47:18.683827,098,1.5,0.0,-140,4375,1720.0
185000.0,3,1.75,1170,9085,1.0,3,7,1170,0.0,1967,1230,9085,20155 days 16:47:18.683827,276,1.7142857142857142,0.0,-60,0,1170.0
455000.0,2,1.0,1140,11480,1.0,3,6,1140,0.0,1907,1550,8150,42070 days 16:47:18.683827,124,2.0,0.0,-410,3330,1140.0
235000.0,3,2.5,2350,9051,1.0,4,8,1570,780.0,1966,2270,8748,20520 days 16:47:18.683827,192,1.2,2.0128205128205128,80,303,790.0
230000.0,3,1.0,1020,12289,1.0,4,7,1020,0.0,1967,1300,9894,20155 days 16:47:18.683827,303,3.0,0.0,-280,2395,1020.0
770000.0,4,2.25,2730,5000,1.0,5,7,1460,1270.0,1955,2010,5000,24538 days 16:47:18.683827,324,1.7777777777777777,1.1496062992125984,720,0,190.0
240000.0,4,2.25,1830,7614,2.0,3,7,1830,0.0,1991,1860,6930,11389 days 16:47:18.683827,275,1.7777777777777777,0.0,-30,684,1830.0
461000.0,3,2.5,1690,3026,2.0,3,7,1690,0.0,2002,1650,3161,7371 days 16:47:18.683827,050,1.2,0.0,40,-135,1690.0
1580000.0,4,2.5,2900,10500,1.0,5,8,1450,1450.0,1963,2900,9201,21616 days 16:47:18.683827,086,1.6,1.0,0,1299,0.0
1820000.0,4,4.5,6380,88714,2.0,3,1,6380,0.0,2006,3040,7113,5910 days 16:47:18.683827,282,0.8888888888888888,0.0,3340,81601,6380.0
452000.0,3,2.5,1690,4000,2.0,3,7,1690,0.0,2004,1690,4000,6641 days 16:47:18.683827,327,1.2,0.0,0,0,1690.0
765000.0,4,2.5,2660,5043,2.0,3,9,2660,0.0,2003,3010,5500,7006 days 16:47:18.683827,276,1.6,0.0,-350,-457,2660.0
1050000.0,4,4.0,4550,54013,1.0,4,9,2300,2250.0,1989,3540,39634,12119 days 16:47:18.683827,112,1.0,1.0222222222222221,1010,14379,50.0
546000.0,3,3.0,1530,9999,1.0,4,7,1150,380.0,1983,1530,8556,14311 days 16:47:18.683827,125,1.0,3.026315789473684,0,1443,770.0
781000.0,3,2.5,2070,4463,1.5,5,8,1780,290.0,1931,2070,5000,33304 days 16:47:18.683827,022,1.2,6.137931034482759,0,-537,1490.0
538000.0,4,1.75,1880,7953,1.0,4,7,1880,0.0,1965,1750,8591,20885 days 16:47:18.683827,020,2.2857142857142856,0.0,130,-638,1880.0
790000.0,4,2.5,2240,8664,1.0,5,8,1470,770.0,1975,2210,8860,17233 days 16:47:18.683827,231,1.6,1.9090909090909092,30,-196,700.0
696500.0,4,2.75,2540,4400,1.5,5,7,1630,910.0,1925,1560,3920,35495 days 16:47:18.683827,294,1.4545454545454546,1.7912087912087913,980,480,720.0
276000.0,3,2.0,1370,8137,1.0,4,7,1370,0.0,1988,1660,8840,12485 days 16:47:18.683827,120,1.5,0.0,-290,-703,1370.0
269000.0,2,1.0,770,8612,1.0,3,6,770,0.0,1953,1290,8407,25268 days 16:47:18.683827,245,2.0,0.0,-520,205,770.0
2420000.0,5,4.75,7880,24250,2.0,3,1,7880,0.0,1996,2740,10761,9563 days 16:47:18.683827,030,1.0526315789473684,0.0,5140,13489,7880.0
829000.0,4,2.75,2970,59677,1.0,4,8,1610,1360.0,1973,2930,42489,17963 days 16:47:18.683827,002,1.4545454545454546,1.1838235294117647,40,17188,250.0
122000.0,2,1.0,740,6840,1.0,3,6,740,0.0,1942,740,6840,29286 days 16:47:18.683827,065,2.0,0.0,0,0,740.0
352500.0,3,1.5,1360,7680,1.0,3,7,1360,0.0,1955,1630,7679,24538 days 16:47:18.683827,233,2.0,0.0,-270,1,1360.0
249000.0,4,2.0,1280,7560,1.0,5,6,1280,0.0,1959,1250,7690,23077 days 16:47:18.683827,294,2.0,0.0,30,-130,1280.0
360000.0,4,2.0,1920,7803,1.0,3,7,1080,840.0,1962,1940,8147,21981 days 16:47:18.683827,342,2.0,1.2857142857142858,-20,-344,240.0
629500.0,3,2.0,2020,10584,1.0,3,1,2020,0.0,1994,3030,9870,10293 days 16:47:18.683827,124,1.5,0.0,-1010,714,2020.0
1140000.0,4,2.25,3310,127631,2.0,5,9,3310,0.0,1924,3830,43959,35861 days 16:47:18.683827,176,1.7777777777777777,0.0,-520,83672,3310.0
1550000.0,2,2.25,2950,15593,1.0,4,8,1560,1390.0,1942,2060,19855,29286 days 16:47:18.683827,290,0.8888888888888888,1.1223021582733812,890,-4262,170.0
275000.0,3,1.5,1320,7695,1.0,4,7,1320,0.0,1959,1370,8295,23077 days 16:47:18.683827,199,2.0,0.0,-50,-600,1320.0
697000.0,4,2.5,3160,6961,2.0,3,8,3160,0.0,2005,3110,5058,6275 days 16:47:18.683827,252,1.6,0.0,50,1903,3160.0
379500.0,2,1.0,1640,17335,1.0,3,7,840,800.0,1978,2440,17850,16137 days 16:47:18.683827,127,2.0,1.05,-800,-515,40.0
720000.0,3,2.75,2440,76531,1.0,3,1,1640,800.0,1980,1890,10042,15407 days 16:47:18.683827,314,1.0909090909090908,2.05,550,66489,840.0
675000.0,4,2.5,3000,5548,2.0,3,9,3000,0.0,2006,2870,5000,5910 days 16:47:18.683827,133,1.6,0.0,130,548,3000.0
1170000.0,5,2.5,2810,6000,2.5,3,9,2810,0.0,1907,2240,4800,42070 days 16:47:18.683827,302,2.0,0.0,570,1200,2810.0
1100000.0,3,2.0,2390,6888,2.0,5,8,2390,0.0,1939,2390,7920,30382 days 16:47:18.683827,140,1.5,0.0,0,-1032,2390.0
520000.0,4,1.0,2080,3500,1.5,5,7,1260,820.0,1926,1380,5900,35130 days 16:47:18.683827,163,4.0,1.5365853658536586,700,-2400,440.0
415000.0,3,1.75,2650,7500,1.5,4,7,1590,1060.0,1962,1340,7500,21981 days 16:47:18.683827,276,1.7142857142857142,1.5,1310,0,530.0
415000.0,3,2.5,1060,1536,2.0,3,8,1060,0.0,2000,1220,1316,8102 days 16:47:18.683827,178,1.2,0.0,-160,220,1060.0
450000.0,3,2.25,1940,8312,1.0,4,7,1220,720.0,1963,2060,9503,21616 days 16:47:18.683827,097,1.3333333333333333,1.6944444444444444,-120,-1191,500.0
485000.0,2,1.0,1080,4080,1.0,3,8,1080,0.0,1948,1890,4080,27095 days 16:47:18.683827,117,2.0,0.0,-810,0,1080.0
294000.0,3,2.25,1700,9600,2.0,3,7,1700,0.0,1984,1930,9600,13946 days 16:47:18.683827,117,1.3333333333333333,0.0,-230,0,1700.0
1040000.0,4,3.5,4440,10660,2.0,3,1,4440,0.0,2003,4390,9976,7006 days 16:47:18.683827,190,1.1428571428571428,0.0,50,684,4440.0
690000.0,3,1.0,1580,4000,2.0,3,8,1580,0.0,1905,2190,4000,42800 days 16:47:18.683827,209,3.0,0.0,-610,0,1580.0
716500.0,5,2.75,3630,38461,2.0,3,1,3630,0.0,2000,4440,50378,8102 days 16:47:18.683827,282,1.8181818181818181,0.0,-810,-11917,3630.0
481000.0,2,2.25,1290,1137,3.0,3,8,1290,0.0,2007,1290,1332,5545 days 16:47:18.683827,246,0.8888888888888888,0.0,0,-195,1290.0
575000.0,4,2.75,1960,4635,1.0,4,7,1000,960.0,1968,1830,6180,19790 days 16:47:18.683827,109,1.4545454545454546,1.0416666666666667,130,-1545,40.0
785000.0,3,2.0,2090,5015,1.5,5,7,2090,0.0,1920,1930,4250,37322 days 16:47:18.683827,227,1.5,0.0,160,765,2090.0
480000.0,3,1.75,1960,43995,1.0,3,7,1960,0.0,1970,1960,42253,19059 days 16:47:18.683827,084,1.7142857142857142,0.0,0,1742,1960.0
720000.0,3,2.25,2120,9297,2.0,4,8,2120,0.0,1981,2620,10352,15041 days 16:47:18.683827,231,1.3333333333333333,0.0,-500,-1055,2120.0
536000.0,3,2.75,2290,34548,2.0,4,7,2290,0.0,1984,399,275299,13946 days 16:47:18.683827,132,1.0909090909090908,0.0,1891,-240751,2290.0
324900.0,4,2.5,1880,7965,2.0,3,7,1880,0.0,2000,1570,7584,8102 days 16:47:18.683827,164,1.6,0.0,310,381,1880.0
265000.0,2,1.0,770,5160,1.0,3,6,770,0.0,1943,920,5160,28921 days 16:47:18.683827,227,2.0,0.0,-150,0,770.0
545000.0,3,2.5,1530,3210,1.5,5,7,1010,520.0,1928,1330,4410,34400 days 16:47:18.683827,182,1.2,1.9423076923076923,200,-1200,490.0
465000.0,2,1.5,1450,27075,1.0,3,7,1450,0.0,1940,1890,10599,30017 days 16:47:18.683827,015,1.3333333333333333,0.0,-440,16476,1450.0
292500.0,3,2.25,1690,7320,2.0,3,7,1690,0.0,1987,1520,7450,12850 days 16:47:18.683827,009,1.3333333333333333,0.0,170,-130,1690.0
860000.0,4,1.75,1880,3720,1.5,4,7,1880,0.0,1924,2090,4095,35861 days 16:47:18.683827,183,2.2857142857142856,0.0,-210,-375,1880.0
1050000.0,4,3.25,4160,47480,2.0,3,1,4160,0.0,1995,3400,40428,9928 days 16:47:18.683827,350,1.2307692307692308,0.0,760,7052,4160.0
495000.0,4,2.5,2140,7245,2.0,3,7,2140,0.0,2003,2080,7875,7006 days 16:47:18.683827,163,1.6,0.0,60,-630,2140.0
342000.0,2,2.0,1320,1462,3.0,3,7,1320,0.0,1997,1430,1650,9197 days 16:47:18.683827,127,1.0,0.0,-110,-188,1320.0
320000.0,4,2.5,2000,10051,2.0,3,7,2000,0.0,1997,2000,6686,9197 days 16:47:18.683827,176,1.6,0.0,0,3365,2000.0
444000.0,3,2.0,1460,2610,2.0,3,8,1460,0.0,1987,1320,3000,12850 days 16:47:18.683827,267,1.5,0.0,140,-390,1460.0
804100.0,4,2.5,3070,8086,2.0,3,1,3070,0.0,2005,3320,10738,6275 days 16:47:18.683827,176,1.6,0.0,-250,-2652,3070.0
432000.0,3,2.5,1660,15000,1.0,4,7,1660,0.0,1970,2060,15015,19059 days 16:47:18.683827,262,1.2,0.0,-400,-15,1660.0
230000.0,6,1.5,1810,4838,1.5,4,5,1050,760.0,1905,1300,4838,42800 days 16:47:18.683827,364,4.0,1.381578947368421,510,0,290.0
935000.0,4,3.5,3510,11200,2.0,3,1,3510,0.0,2001,3600,12124,7736 days 16:47:18.683827,239,1.1428571428571428,0.0,-90,-924,3510.0
634950.0,3,3.0,2180,2650,1.5,5,8,1410,770.0,1930,1570,4820,33669 days 16:47:18.683827,219,1.0,1.8311688311688312,610,-2170,640.0
780000.0,6,4.0,3300,5720,1.0,3,8,1960,1340.0,1963,2030,4080,21616 days 16:47:18.683827,012,1.5,1.462686567164179,1270,1640,620.0
611000.0,4,2.5,2460,4200,2.0,3,8,2460,0.0,1998,2330,4200,8832 days 16:47:18.683827,139,1.6,0.0,130,0,2460.0
475999.0,4,1.75,1880,4175,1.5,3,7,1090,790.0,1944,1700,3758,28556 days 16:47:18.683827,325,2.2857142857142856,1.379746835443038,180,417,300.0
565000.0,3,2.0,2290,9450,1.0,3,9,1670,620.0,1979,2750,11700,15772 days 16:47:18.683827,350,1.5,2.693548387096774,-460,-2250,1050.0
630000.0,4,2.5,2290,26720,2.0,3,8,2290,0.0,1977,2290,26720,16502 days 16:47:18.683827,220,1.6,0.0,0,0,2290.0
840000.0,4,3.5,3860,18334,2.0,3,1,3120,740.0,1996,3550,18334,9563 days 16:47:18.683827,168,1.1428571428571428,4.216216216216216,310,0,2380.0
790000.0,3,2.5,2640,432036,1.5,3,1,2640,0.0,1996,1500,560617,9563 days 16:47:18.683827,311,1.2,0.0,1140,-128581,2640.0
1270000.0,4,3.25,3020,4000,1.5,5,8,1920,1100.0,1927,2400,4000,34765 days 16:47:18.683827,357,1.2307692307692308,1.7454545454545454,620,0,820.0
520000.0,3,2.0,1510,3760,1.0,5,7,930,580.0,1925,1510,3760,35495 days 16:47:18.683827,112,1.5,1.603448275862069,0,0,350.0
446800.0,4,2.0,2410,8712,1.0,3,7,1260,1150.0,1958,2220,6038,23442 days 16:47:18.683827,290,2.0,1.0956521739130434,190,2674,110.0
652000.0,3,1.0,1470,6122,1.0,3,8,1200,270.0,1948,2200,6122,27095 days 16:47:18.683827,029,3.0,4.444444444444445,-730,0,930.0
1170000.0,3,2.75,2890,12130,2.0,4,1,2830,60.0,1987,2415,11538,12850 days 16:47:18.683827,142,1.0909090909090908,47.166666666666664,475,592,2770.0
745000.0,4,3.25,3490,7024,2.0,3,1,3490,0.0,2006,3450,6866,5910 days 16:47:18.683827,161,1.2307692307692308,0.0,40,158,3490.0
594000.0,3,2.25,1270,1406,2.0,3,8,1060,210.0,2014,1160,1327,2988 days 16:47:18.683827,176,1.3333333333333333,5.0476190476190474,110,79,850.0
257000.0,2,1.0,1000,3700,1.0,3,6,800,200.0,1929,1270,5000,34034 days 16:47:18.683827,069,2.0,4.0,-270,-1300,600.0
485000.0,4,1.75,1430,4096,2.0,3,7,1430,0.0,1900,1640,3377,44626 days 16:47:18.683827,182,2.2857142857142856,0.0,-210,719,1430.0
330000.0,3,1.0,1060,20040,1.0,3,6,1060,0.0,1943,1768,10800,28921 days 16:47:18.683827,126,3.0,0.0,-708,9240,1060.0
381000.0,3,2.0,1680,8946,1.0,3,6,940,740.0,1996,1550,11625,9563 days 16:47:18.683827,212,1.5,1.2702702702702702,130,-2679,200.0
849900.0,2,2.0,2280,641203,2.0,3,9,2280,0.0,1990,2030,224334,11754 days 16:47:18.683827,164,1.0,0.0,250,416869,2280.0
793000.0,4,2.5,2450,4080,1.5,4,8,1490,960.0,1930,2000,4080,33669 days 16:47:18.683827,092,1.6,1.5520833333333333,450,0,530.0
920000.0,3,2.25,3650,5353,2.0,4,7,2200,1450.0,1947,1950,4970,27460 days 16:47:18.683827,209,1.3333333333333333,1.5172413793103448,1700,383,750.0
455000.0,2,1.0,830,4000,1.0,4,6,830,0.0,1947,1420,4000,27460 days 16:47:18.683827,112,2.0,0.0,-590,0,830.0
975000.0,4,2.5,3490,7494,2.0,3,1,3490,0.0,2000,3260,8437,8102 days 16:47:18.683827,133,1.6,0.0,230,-943,3490.0
375000.0,2,1.5,1050,1046,2.0,3,8,960,90.0,2007,1470,1768,5545 days 16:47:18.683827,337,1.3333333333333333,10.666666666666666,-420,-722,870.0
400000.0,2,2.5,1170,1811,2.0,3,8,1170,0.0,2001,1250,3146,7736 days 16:47:18.683827,070,0.8,0.0,-80,-1335,1170.0
447000.0,3,1.0,1220,7200,1.0,4,7,1220,0.0,1965,1320,7200,20885 days 16:47:18.683827,042,3.0,0.0,-100,0,1220.0
470000.0,3,1.75,1310,8600,1.0,4,7,1310,0.0,1987,2510,8515,12850 days 16:47:18.683827,304,1.7142857142857142,0.0,-1200,85,1310.0
665000.0,4,2.5,3130,7582,2.0,3,8,3130,0.0,2004,2990,6441,6641 days 16:47:18.683827,288,1.6,0.0,140,1141,3130.0
295500.0,3,1.75,1590,41550,1.5,3,6,1290,300.0,1933,2990,6464,32573 days 16:47:18.683827,246,1.7142857142857142,4.3,-1400,35086,990.0
200000.0,4,2.5,1720,8638,2.0,3,8,1720,0.0,1994,1870,7455,10293 days 16:47:18.683827,015,1.6,0.0,-150,1183,1720.0
620000.0,3,2.25,2520,212137,2.0,3,9,1590,930.0,2005,2000,212137,6275 days 16:47:18.683827,254,1.3333333333333333,1.7096774193548387,520,0,660.0
434900.0,3,2.0,1520,11067,1.0,3,7,1140,380.0,1983,1280,11371,14311 days 16:47:18.683827,241,1.5,3.0,240,-304,760.0
1330000.0,4,2.25,3260,4640,2.0,5,9,2360,900.0,1907,3240,5800,42070 days 16:47:18.683827,083,1.7777777777777777,2.6222222222222222,20,-1160,1460.0
1650000.0,4,3.25,3910,7500,2.0,3,1,3910,0.0,2006,2600,9235,5910 days 16:47:18.683827,009,1.2307692307692308,0.0,1310,-1735,3910.0
852500.0,4,2.5,3480,6315,2.0,3,9,2360,1120.0,2000,3620,5233,8102 days 16:47:18.683827,248,1.6,2.107142857142857,-140,1082,1240.0
790000.0,3,2.5,3040,34670,2.0,4,1,3040,0.0,1983,3480,35001,14311 days 16:47:18.683827,343,1.2,0.0,-440,-331,3040.0
565000.0,4,1.75,2030,7350,1.0,3,8,2030,0.0,1966,2000,7998,20520 days 16:47:18.683827,072,2.2857142857142856,0.0,30,-648,2030.0
1130000.0,6,3.25,3870,24700,2.0,3,1,2520,1350.0,1989,2360,30030,12119 days 16:47:18.683827,084,1.8461538461538463,1.8666666666666667,1510,-5330,1170.0
289950.0,3,2.5,1870,1436,2.0,3,7,1870,0.0,2004,1720,1852,6641 days 16:47:18.683827,356,1.2,0.0,150,-416,1870.0
850000.0,2,2.0,2640,13939,1.0,5,8,1640,1000.0,1963,2880,14810,21616 days 16:47:18.683827,309,1.0,1.64,-240,-871,640.0
505000.0,4,1.75,1940,4800,1.0,5,7,1030,910.0,1922,1450,4800,36591 days 16:47:18.683827,132,2.2857142857142856,1.1318681318681318,490,0,120.0
372000.0,3,2.5,1710,5633,2.0,3,7,1710,0.0,1981,1540,5000,15041 days 16:47:18.683827,301,1.2,0.0,170,633,1710.0
207000.0,4,2.0,1690,7728,1.5,4,7,1690,0.0,1967,1480,8009,20155 days 16:47:18.683827,296,2.0,0.0,210,-281,1690.0
780000.0,3,1.75,2340,10495,1.0,4,8,2340,0.0,1967,3120,11068,20155 days 16:47:18.683827,133,1.7142857142857142,0.0,-780,-573,2340.0
400000.0,4,1.75,1700,20283,1.5,3,7,1340,360.0,1965,1680,21369,20885 days 16:47:18.683827,174,2.2857142857142856,3.7222222222222223,20,-1086,980.0
440250.0,3,1.5,1850,8124,1.0,4,7,1850,0.0,1948,1530,8123,27095 days 16:47:18.683827,054,2.0,0.0,320,1,1850.0
585000.0,2,2.0,1370,7920,1.0,3,8,950,420.0,1949,1370,4680,26729 days 16:47:18.683827,062,1.0,2.261904761904762,0,3240,530.0
850000.0,4,2.5,2900,9972,2.0,3,9,2900,0.0,1993,2901,8567,10658 days 16:47:18.683827,261,1.6,0.0,-1,1405,2900.0
570000.0,3,3.0,2400,3192,2.0,3,7,2400,0.0,1991,1360,3192,11389 days 16:47:18.683827,268,1.0,0.0,1040,0,2400.0
869000.0,4,3.0,3740,30884,2.0,3,9,3060,680.0,1988,3240,37031,12485 days 16:47:18.683827,171,1.3333333333333333,4.5,500,-6147,2380.0
551000.0,4,2.75,2170,5988,2.0,3,8,2170,0.0,2014,1170,8147,2988 days 16:47:18.683827,267,1.4545454545454546,0.0,1000,-2159,2170.0
172380.0,3,1.0,970,8378,1.0,4,6,970,0.0,1962,1050,8563,21981 days 16:47:18.683827,072,3.0,0.0,-80,-185,970.0
355000.0,3,2.5,2620,78843,1.0,4,7,1310,1310.0,1964,2330,130244,21251 days 16:47:18.683827,085,1.2,1.0,290,-51401,0.0
728935.0,4,2.5,2980,10194,2.0,3,9,2980,0.0,1993,2980,10053,10658 days 16:47:18.683827,056,1.6,0.0,0,141,2980.0
850000.0,3,2.5,2340,1919,2.0,4,9,2340,0.0,1981,2415,2166,15041 days 16:47:18.683827,065,1.2,0.0,-75,-247,2340.0
515000.0,5,1.75,1880,48787,2.0,3,6,1880,0.0,1922,1690,8401,36591 days 16:47:18.683827,357,2.857142857142857,0.0,190,40386,1880.0
215000.0,2,1.0,1480,5325,1.0,4,7,1120,360.0,1925,1670,5800,35495 days 16:47:18.683827,339,2.0,3.111111111111111,-190,-475,760.0
220000.0,4,2.5,2240,9826,1.0,4,7,1370,870.0,1988,1980,9826,12485 days 16:47:18.683827,167,1.6,1.5747126436781609,260,0,500.0
845000.0,4,2.5,2940,7675,2.0,3,9,2940,0.0,2004,3120,6574,6641 days 16:47:18.683827,205,1.6,0.0,-180,1101,2940.0
390000.0,1,1.0,710,4000,1.0,4,6,610,100.0,1928,1440,4500,34400 days 16:47:18.683827,054,1.0,6.1,-730,-500,510.0
135000.0,4,1.0,1460,18599,1.5,3,5,1460,0.0,1940,1320,8100,30017 days 16:47:18.683827,072,4.0,0.0,140,10499,1460.0
439000.0,3,1.0,1530,19007,1.0,4,8,1290,240.0,1949,2090,20962,26729 days 16:47:18.683827,091,3.0,5.375,-560,-1955,1050.0
585000.0,4,2.5,2630,6185,2.0,3,9,2630,0.0,1999,2720,6185,8467 days 16:47:18.683827,189,1.6,0.0,-90,0,2630.0
620000.0,5,1.0,2230,16800,1.5,4,7,1700,530.0,1923,2730,18400,36226 days 16:47:18.683827,068,5.0,3.207547169811321,-500,-1600,1170.0
477000.0,3,1.0,960,3600,1.0,4,7,960,0.0,1906,1580,5000,42435 days 16:47:18.683827,245,3.0,0.0,-620,-1400,960.0
500000.0,2,1.0,1760,27332,1.0,4,7,1300,460.0,1951,2590,16630,25999 days 16:47:18.683827,270,2.0,2.8260869565217392,-830,10702,840.0
432500.0,3,2.5,1340,8867,2.0,3,8,1340,0.0,1984,1630,7287,13946 days 16:47:18.683827,252,1.2,0.0,-290,1580,1340.0
940000.0,4,2.25,2800,18673,1.0,5,9,1650,1150.0,1965,2800,15300,20885 days 16:47:18.683827,301,1.7777777777777777,1.434782608695652,0,3373,500.0
3170000.0,5,3.5,4330,11979,1.0,3,1,2090,2240.0,2008,4320,12000,5180 days 16:47:18.683827,240,1.4285714285714286,0.9330357142857143,10,-21,-150.0
1080000.0,3,2.5,3720,11610,2.0,3,1,3720,0.0,1982,3530,11877,14676 days 16:47:18.683827,132,1.2,0.0,190,-267,3720.0
229999.0,4,2.0,1670,5200,1.0,4,7,1030,640.0,1977,1500,5200,16502 days 16:47:18.683827,227,2.0,1.609375,170,0,390.0
233000.0,3,1.0,1100,7657,1.0,3,7,1100,0.0,1955,1300,8000,24538 days 16:47:18.683827,223,3.0,0.0,-200,-343,1100.0
600000.0,3,2.5,3240,8016,2.0,3,8,2910,330.0,2004,2990,7561,6641 days 16:47:18.683827,177,1.2,8.818181818181818,250,455,2580.0
334000.0,4,1.5,1680,7620,1.0,4,7,1180,500.0,1965,1460,7620,20885 days 16:47:18.683827,128,2.6666666666666665,2.36,220,0,680.0
332500.0,3,1.0,1030,8164,1.0,4,7,1030,0.0,1950,1340,8164,26364 days 16:47:18.683827,197,3.0,0.0,-310,0,1030.0
249900.0,3,2.5,1630,7700,1.0,3,7,1120,510.0,1978,1640,8160,16137 days 16:47:18.683827,177,1.2,2.196078431372549,-10,-460,610.0
310000.0,3,2.0,2610,12180,1.0,3,7,1670,940.0,1918,1520,12180,38052 days 16:47:18.683827,296,1.5,1.7765957446808511,1090,0,730.0
200000.0,2,1.0,1250,8520,1.0,3,6,1250,0.0,1928,1040,8520,34400 days 16:47:18.683827,309,2.0,0.0,210,0,1250.0
310000.0,4,1.75,1480,11200,1.0,4,7,1480,0.0,1969,1480,20310,19424 days 16:47:18.683827,206,2.2857142857142856,0.0,0,-9110,1480.0
230000.0,3,1.0,1390,6000,1.0,3,5,1390,0.0,1954,1170,6000,24903 days 16:47:18.683827,188,3.0,0.0,220,0,1390.0
420000.0,4,2.5,1940,5414,2.0,3,8,1940,0.0,1997,2050,6307,9197 days 16:47:18.683827,293,1.6,0.0,-110,-893,1940.0
785000.0,4,2.5,2960,4750,2.0,3,9,2960,0.0,2005,2960,4750,6275 days 16:47:18.683827,285,1.6,0.0,0,0,2960.0
1780000.0,3,2.25,4320,19225,1.0,4,1,2160,2160.0,1972,3430,18469,18329 days 16:47:18.683827,287,1.3333333333333333,1.0,890,756,0.0
265000.0,5,1.5,1500,7112,1.0,5,6,760,740.0,1920,1200,7112,37322 days 16:47:18.683827,127,3.3333333333333335,1.027027027027027,300,0,20.0
295000.0,2,1.0,840,10465,1.0,3,6,840,0.0,1951,1320,8515,25999 days 16:47:18.683827,266,2.0,0.0,-480,1950,840.0
896000.0,4,2.5,3560,46644,2.0,3,1,3560,0.0,1992,3520,50261,11024 days 16:47:18.683827,049,1.6,0.0,40,-3617,3560.0
415000.0,4,2.75,2390,9968,1.0,4,9,1390,1000.0,1989,2560,12385,12119 days 16:47:18.683827,012,1.4545454545454546,1.39,-170,-2417,390.0
250000.0,3,1.75,1200,5478,1.0,5,6,1200,0.0,1955,1270,6855,24538 days 16:47:18.683827,043,1.7142857142857142,0.0,-70,-1377,1200.0
1480000.0,3,2.5,2570,5000,2.0,3,1,2570,0.0,1984,1570,5000,13946 days 16:47:18.683827,111,1.2,0.0,1000,0,2570.0
635000.0,5,2.25,2180,6000,1.0,4,8,1430,750.0,1966,2160,8800,20520 days 16:47:18.683827,097,2.2222222222222223,1.9066666666666667,20,-2800,680.0
905000.0,3,2.5,3450,48787,2.0,3,1,3450,0.0,1987,2810,41040,12850 days 16:47:18.683827,091,1.2,0.0,640,7747,3450.0
528000.0,3,2.5,2020,5613,2.0,3,7,2020,0.0,2003,2020,4609,7006 days 16:47:18.683827,202,1.2,0.0,0,1004,2020.0
530000.0,3,2.5,2480,7480,2.0,3,9,2480,0.0,1992,2480,7480,11024 days 16:47:18.683827,237,1.2,0.0,0,0,2480.0
310000.0,3,1.5,1140,3104,2.0,3,7,1140,0.0,1988,1150,2981,12485 days 16:47:18.683827,219,2.0,0.0,-10,123,1140.0
252000.0,3,1.0,1530,9465,1.0,4,7,1530,0.0,1960,1530,9465,22712 days 16:47:18.683827,026,3.0,0.0,0,0,1530.0
334500.0,3,2.0,1700,8160,1.0,3,7,1120,580.0,1961,1740,8181,22346 days 16:47:18.683827,223,1.5,1.9310344827586208,-40,-21,540.0
370000.0,3,1.0,2150,8480,1.0,3,8,1610,540.0,1951,1620,5203,25999 days 16:47:18.683827,126,3.0,2.9814814814814814,530,3277,1070.0
311000.0,3,2.0,1190,7840,1.5,4,6,1190,0.0,1918,1460,3240,38052 days 16:47:18.683827,353,1.5,0.0,-270,4600,1190.0
260000.0,3,2.75,1730,4131,2.0,3,7,1480,250.0,1975,1570,4120,17233 days 16:47:18.683827,104,1.0909090909090908,5.92,160,11,1230.0
217500.0,3,1.75,1400,9546,1.0,4,7,1400,0.0,1984,1660,8550,13946 days 16:47:18.683827,182,1.7142857142857142,0.0,-260,996,1400.0
290000.0,3,2.5,2200,4240,2.0,3,7,2200,0.0,2003,2200,4311,7006 days 16:47:18.683827,049,1.2,0.0,0,-71,2200.0
500000.0,3,1.5,960,4600,1.0,3,6,960,0.0,1944,2230,9350,28556 days 16:47:18.683827,280,2.0,0.0,-1270,-4750,960.0
423500.0,3,2.0,1770,6000,1.0,3,7,1100,670.0,1984,1300,3000,13946 days 16:47:18.683827,110,1.5,1.6417910447761195,470,3000,430.0
715000.0,4,2.5,2970,5722,2.0,3,9,2970,0.0,2005,3940,4848,6275 days 16:47:18.683827,358,1.6,0.0,-970,874,2970.0
299000.0,3,2.5,1590,3121,2.0,3,7,1590,0.0,1994,1090,4900,10293 days 16:47:18.683827,209,1.2,0.0,500,-1779,1590.0
635000.0,3,2.5,3350,4007,2.0,3,8,2550,800.0,2005,2340,4167,6275 days 16:47:18.683827,181,1.2,3.1875,1010,-160,1750.0
806000.0,4,2.5,3370,9629,2.0,3,1,3370,0.0,1999,3360,10335,8467 days 16:47:18.683827,238,1.6,0.0,10,-706,3370.0
289950.0,3,2.5,1960,3480,2.0,3,7,1960,0.0,2004,2560,3500,6641 days 16:47:18.683827,151,1.2,0.0,-600,-20,1960.0
280000.0,3,1.75,1360,6603,1.0,4,7,1360,0.0,1981,1770,7107,15041 days 16:47:18.683827,283,1.7142857142857142,0.0,-410,-504,1360.0
479950.0,3,2.5,2780,6000,2.0,3,9,2780,0.0,2004,1940,3466,6641 days 16:47:18.683827,089,1.2,0.0,840,2534,2780.0
394000.0,4,2.5,3000,9793,2.0,3,7,3000,0.0,2002,1890,7557,7371 days 16:47:18.683827,178,1.6,0.0,1110,2236,3000.0
682000.0,4,2.5,3600,203425,2.0,3,9,3400,200.0,1979,3150,202989,15772 days 16:47:18.683827,029,1.6,17.0,450,436,3200.0
409950.0,2,1.0,990,3000,1.0,4,6,990,0.0,1918,1120,3000,38052 days 16:47:18.683827,205,2.0,0.0,-130,0,990.0
1000000.0,4,3.5,2990,4200,2.0,5,9,2000,990.0,1925,2390,4200,35495 days 16:47:18.683827,254,1.1428571428571428,2.0202020202020203,600,0,1010.0
436000.0,4,1.0,1200,6600,1.5,3,7,1200,0.0,1908,1810,6600,41705 days 16:47:18.683827,020,4.0,0.0,-610,0,1200.0
279000.0,3,1.0,1530,15975,1.0,3,7,970,560.0,1952,1540,15975,25634 days 16:47:18.683827,252,3.0,1.7321428571428572,-10,0,410.0
390000.0,1,1.75,1440,4920,1.0,3,7,720,720.0,1923,1440,4920,36226 days 16:47:18.683827,196,0.5714285714285714,1.0,0,0,0.0
635000.0,3,1.75,1940,167125,1.0,4,7,1480,460.0,1955,1910,127195,24538 days 16:47:18.683827,350,1.7142857142857142,3.217391304347826,30,39930,1020.0
304400.0,4,2.75,2140,8100,2.0,4,7,2140,0.0,1990,1960,7002,11754 days 16:47:18.683827,199,1.4545454545454546,0.0,180,1098,2140.0
780000.0,5,1.75,2330,3800,1.5,3,7,1360,970.0,1927,2100,3800,34765 days 16:47:18.683827,084,2.857142857142857,1.402061855670103,230,0,390.0
520000.0,4,3.5,2734,210201,2.0,5,8,2734,0.0,1974,2270,187308,17598 days 16:47:18.683827,274,1.1428571428571428,0.0,464,22893,2734.0
580000.0,3,1.75,1950,10633,1.0,3,7,1250,700.0,1978,1290,6380,16137 days 16:47:18.683827,078,1.7142857142857142,1.7857142857142858,660,4253,550.0
274000.0,3,1.75,1440,7198,1.0,3,7,990,450.0,1981,1550,7156,15041 days 16:47:18.683827,251,1.7142857142857142,2.2,-110,42,540.0
315000.0,3,2.25,1530,7906,1.0,3,7,1150,380.0,1980,1460,7875,15407 days 16:47:18.683827,040,1.3333333333333333,3.026315789473684,70,31,770.0
390000.0,4,1.75,1910,77574,1.0,4,8,1910,0.0,1971,2130,37026,18694 days 16:47:18.683827,218,2.2857142857142856,0.0,-220,40548,1910.0
340000.0,5,2.0,1750,8220,1.0,3,7,1750,0.0,1956,1210,6760,24173 days 16:47:18.683827,254,2.5,0.0,540,1460,1750.0
502000.0,3,2.25,1600,45613,2.0,4,8,1600,0.0,1983,2320,43005,14311 days 16:47:18.683827,182,1.3333333333333333,0.0,-720,2608,1600.0
260000.0,3,1.75,1750,11180,1.0,3,8,1750,0.0,1968,1730,11180,19790 days 16:47:18.683827,218,1.7142857142857142,0.0,20,0,1750.0
399000.0,2,1.0,940,4800,1.0,4,6,940,0.0,1911,980,5900,40609 days 16:47:18.683827,150,2.0,0.0,-40,-1100,940.0
312500.0,2,1.0,880,6345,1.0,3,7,880,0.0,1919,1440,6345,37687 days 16:47:18.683827,135,2.0,0.0,-560,0,880.0
370000.0,3,1.75,1650,8254,1.0,5,7,1060,590.0,1951,2280,9450,25999 days 16:47:18.683827,133,1.7142857142857142,1.7966101694915255,-630,-1196,470.0
1240000.0,4,3.5,3820,13224,2.0,3,1,3280,540.0,1990,3340,9700,11754 days 16:47:18.683827,170,1.1428571428571428,6.074074074074074,480,3524,2740.0
230000.0,3,1.5,1900,9630,1.0,3,8,1900,0.0,1967,2010,9630,20155 days 16:47:18.683827,051,2.0,0.0,-110,0,1900.0
1280000.0,4,1.75,3720,8448,1.0,4,9,1960,1760.0,1947,2540,7064,27460 days 16:47:18.683827,276,2.2857142857142856,1.1136363636363635,1180,1384,200.0
294350.0,3,1.0,1410,5120,1.5,3,6,1210,200.0,1925,1330,5120,35495 days 16:47:18.683827,232,3.0,6.05,80,0,1010.0
208950.0,3,1.0,960,5700,1.0,4,5,960,0.0,1956,960,5700,24173 days 16:47:18.683827,286,3.0,0.0,0,0,960.0
515000.0,2,1.75,1930,5570,1.0,3,8,1930,0.0,2005,1810,5178,6275 days 16:47:18.683827,310,1.1428571428571428,0.0,120,392,1930.0
965000.0,4,2.5,3420,9575,2.0,3,1,3420,0.0,1994,3310,8192,10293 days 16:47:18.683827,098,1.6,0.0,110,1383,3420.0
925000.0,4,2.75,3010,3400,2.0,3,9,2240,770.0,1923,1940,5080,36226 days 16:47:18.683827,085,1.4545454545454546,2.909090909090909,1070,-1680,1470.0
654500.0,4,1.0,1780,5000,1.5,3,8,1780,0.0,1947,2030,5000,27460 days 16:47:18.683827,077,4.0,0.0,-250,0,1780.0
364000.0,4,2.5,2080,11050,1.0,4,8,2080,0.0,1969,1850,11050,19424 days 16:47:18.683827,226,1.6,0.0,230,0,2080.0
150000.0,2,1.0,1250,5208,1.0,3,7,1050,200.0,1951,1030,5354,25999 days 16:47:18.683827,083,2.0,5.25,220,-146,850.0
585000.0,3,1.5,1670,5000,1.5,4,7,1670,0.0,1912,1750,5000,40244 days 16:47:18.683827,237,2.0,0.0,-80,0,1670.0
801501.0,4,2.25,2250,13500,2.0,4,9,2250,0.0,1980,2730,13500,15407 days 16:47:18.683827,076,1.7777777777777777,0.0,-480,0,2250.0
610000.0,3,1.75,1650,221720,1.0,3,7,1650,0.0,1992,2520,221284,11024 days 16:47:18.683827,283,1.7142857142857142,0.0,-870,436,1650.0
382000.0,5,2.25,2880,11965,2.0,4,8,2880,0.0,1990,2370,10715,11754 days 16:47:18.683827,141,2.2222222222222223,0.0,510,1250,2880.0
495000.0,4,3.0,3620,403693,2.0,3,9,3620,0.0,1980,2230,148811,15407 days 16:47:18.683827,335,1.3333333333333333,0.0,1390,254882,3620.0
447500.0,3,1.75,1950,6504,1.0,3,8,1530,420.0,1953,1660,6552,25268 days 16:47:18.683827,307,1.7142857142857142,3.642857142857143,290,-48,1110.0
575000.0,4,2.5,2280,9491,1.0,4,7,1290,990.0,1966,1560,8050,20520 days 16:47:18.683827,051,1.6,1.303030303030303,720,1441,300.0
565000.0,2,1.75,1740,4736,1.5,4,7,1040,700.0,1907,2020,4215,42070 days 16:47:18.683827,280,1.1428571428571428,1.4857142857142858,-280,521,340.0
348580.0,3,1.0,1220,7876,1.0,3,7,1220,0.0,1966,1340,7876,20520 days 16:47:18.683827,142,3.0,0.0,-120,0,1220.0
459000.0,4,1.75,2260,9703,1.0,2,8,1660,600.0,1978,2390,8455,16137 days 16:47:18.683827,289,2.2857142857142856,2.7666666666666666,-130,1248,1060.0
375000.0,4,2.0,1790,61419,2.0,2,7,1790,0.0,1988,1790,62290,12485 days 16:47:18.683827,092,2.0,0.0,0,-871,1790.0
310000.0,4,2.5,2440,7093,2.0,3,7,2440,0.0,1999,1860,6072,8467 days 16:47:18.683827,247,1.6,0.0,580,1021,2440.0
210000.0,3,1.5,1400,9600,1.0,4,7,1400,0.0,1964,2210,15000,21251 days 16:47:18.683827,322,2.0,0.0,-810,-5400,1400.0
384205.0,3,2.75,1810,3292,2.0,3,8,1810,0.0,2014,1810,2769,2988 days 16:47:18.683827,254,1.0909090909090908,0.0,0,523,1810.0
180000.0,2,1.0,1400,4500,1.0,3,7,900,500.0,1922,1400,5500,36591 days 16:47:18.683827,142,2.0,1.8,0,-1000,400.0
310000.0,2,1.0,1400,4500,1.0,3,7,900,500.0,1922,1400,5500,36591 days 16:47:18.683827,358,2.0,1.8,0,-1000,400.0
427500.0,4,2.5,2010,6294,2.0,3,7,2010,0.0,2000,1870,4394,8102 days 16:47:18.683827,034,1.6,0.0,140,1900,2010.0
780000.0,3,3.0,2520,2152,1.5,3,8,1560,960.0,1925,1140,2152,35495 days 16:47:18.683827,147,1.0,1.625,1380,0,600.0
1760000.0,3,2.25,3060,16000,2.0,3,1,3060,0.0,1988,3510,13162,12485 days 16:47:18.683827,233,1.3333333333333333,0.0,-450,2838,3060.0
339950.0,4,2.5,2150,4000,2.0,3,7,2150,0.0,2010,1610,4000,4449 days 16:47:18.683827,062,1.6,0.0,540,0,2150.0
820000.0,3,2.25,2880,9750,2.0,3,1,2880,0.0,1989,2920,11090,12119 days 16:47:18.683827,182,1.3333333333333333,0.0,-40,-1340,2880.0
398000.0,2,2.0,1300,3865,1.0,3,8,1300,0.0,2006,1350,4199,5910 days 16:47:18.683827,267,1.0,0.0,-50,-334,1300.0
492000.0,3,1.75,2770,39927,1.0,4,8,1580,1190.0,1978,2420,36384,16137 days 16:47:18.683827,153,1.7142857142857142,1.3277310924369747,350,3543,390.0
240000.0,4,1.5,1780,14810,1.0,4,8,1180,600.0,1950,1450,6728,26364 days 16:47:18.683827,008,2.6666666666666665,1.9666666666666666,330,8082,580.0
599950.0,4,3.5,3730,15029,2.0,3,1,2440,1290.0,1991,3440,14280,11389 days 16:47:18.683827,160,1.1428571428571428,1.8914728682170543,290,749,1150.0
105500.0,2,1.0,930,7740,1.0,1,5,930,0.0,1932,1620,8584,32939 days 16:47:18.683827,197,2.0,0.0,-690,-844,930.0
445000.0,2,1.0,930,7740,1.0,1,5,930,0.0,1932,1620,8584,32939 days 16:47:18.683827,075,2.0,0.0,-690,-844,930.0
390500.0,2,1.75,1460,426450,1.0,5,7,960,500.0,1966,1810,17350,20520 days 16:47:18.683827,254,1.1428571428571428,1.92,-350,409100,460.0
255000.0,3,2.0,1310,8454,1.0,3,7,1310,0.0,1994,1310,8454,10293 days 16:47:18.683827,055,1.5,0.0,0,0,1310.0
675750.0,4,2.5,2770,10274,2.0,3,9,2770,0.0,1989,2270,7210,12119 days 16:47:18.683827,177,1.6,0.0,500,3064,2770.0
1640000.0,3,3.25,3140,5445,2.0,4,1,2240,900.0,1913,2950,5250,39878 days 16:47:18.683827,182,0.9230769230769231,2.488888888888889,190,195,1340.0
353500.0,4,2.5,1770,9239,2.0,3,7,1770,0.0,2004,2150,5450,6641 days 16:47:18.683827,273,1.6,0.0,-380,3789,1770.0
765000.0,3,1.0,1220,7585,1.0,4,7,1220,0.0,1954,1380,8918,24903 days 16:47:18.683827,293,3.0,0.0,-160,-1333,1220.0
563500.0,4,2.5,2190,4944,2.0,3,8,2190,0.0,1999,2190,5108,8467 days 16:47:18.683827,062,1.6,0.0,0,-164,2190.0
439000.0,4,2.0,1800,5465,1.0,3,7,900,900.0,1942,1400,5400,29286 days 16:47:18.683827,021,2.0,1.0,400,65,0.0
975000.0,5,2.75,3100,10014,1.0,4,9,1660,1440.0,1973,3230,10279,17963 days 16:47:18.683827,164,1.8181818181818181,1.1527777777777777,-130,-265,220.0
469900.0,3,2.5,2270,4399,2.0,3,7,2270,0.0,2007,2060,4399,5545 days 16:47:18.683827,096,1.2,0.0,210,0,2270.0
252000.0,3,1.0,1300,8184,2.0,3,6,1300,0.0,1947,1120,8184,27460 days 16:47:18.683827,113,3.0,0.0,180,0,1300.0
495000.0,3,2.0,1769,9300,1.0,4,7,1769,0.0,1955,1870,10226,24538 days 16:47:18.683827,163,1.5,0.0,-101,-926,1769.0
570000.0,6,2.5,3370,15625,1.0,3,8,1770,1600.0,1964,2790,15681,21251 days 16:47:18.683827,336,2.4,1.10625,580,-56,170.0
327000.0,4,2.5,1630,5361,2.0,3,7,1630,0.0,1999,1920,5046,8467 days 16:47:18.683827,224,1.6,0.0,-290,315,1630.0
898000.0,2,2.25,2470,7658,1.0,4,8,1480,990.0,1954,2070,7270,24903 days 16:47:18.683827,287,0.8888888888888888,1.494949494949495,400,388,490.0
300000.0,4,2.5,2600,8572,2.0,3,8,2600,0.0,2003,2170,5288,7006 days 16:47:18.683827,009,1.6,0.0,430,3284,2600.0
418500.0,3,2.0,1800,12440,1.0,3,8,1220,580.0,1978,2460,12352,16137 days 16:47:18.683827,103,1.5,2.103448275862069,-660,88,640.0
450000.0,4,2.5,2240,4616,2.0,3,7,1840,400.0,2001,2260,5200,7736 days 16:47:18.683827,084,1.6,4.6,-20,-584,1440.0
403000.0,3,2.0,1960,13100,1.0,5,8,1650,310.0,1957,1960,10518,23807 days 16:47:18.683827,122,1.5,5.32258064516129,0,2582,1340.0
440000.0,3,1.0,1710,6556,1.5,4,7,1200,510.0,1926,1410,6563,35130 days 16:47:18.683827,163,3.0,2.3529411764705883,300,-7,690.0
350000.0,4,1.75,2140,4959,1.0,3,7,1080,1060.0,1965,1590,5250,20885 days 16:47:18.683827,119,2.2857142857142856,1.0188679245283019,550,-291,20.0
240000.0,3,2.0,1400,6200,1.0,3,6,700,700.0,1948,1410,7564,27095 days 16:47:18.683827,135,1.5,1.0,-10,-1364,0.0
460000.0,2,1.0,890,2100,1.0,4,6,760,130.0,1919,1600,4250,37687 days 16:47:18.683827,167,2.0,5.846153846153846,-710,-2150,630.0
825000.0,4,1.0,1820,4000,2.0,3,8,1820,0.0,1923,2050,4000,36226 days 16:47:18.683827,262,4.0,0.0,-230,0,1820.0
267500.0,3,2.25,1860,12000,1.0,4,7,1860,0.0,1976,1815,9604,16868 days 16:47:18.683827,057,1.3333333333333333,0.0,45,2396,1860.0
201000.0,3,1.0,1220,22443,1.0,4,7,1220,0.0,1972,1260,19950,18329 days 16:47:18.683827,247,3.0,0.0,-40,2493,1220.0
479500.0,3,2.75,2300,4637,2.0,3,8,2300,0.0,2008,2420,5699,5180 days 16:47:18.683827,168,1.0909090909090908,0.0,-120,-1062,2300.0
210000.0,2,1.0,1520,4700,2.0,4,7,1520,0.0,1978,1140,3906,16137 days 16:47:18.683827,092,2.0,0.0,380,794,1520.0
445000.0,2,1.0,1440,3225,1.0,3,7,960,480.0,1915,1160,3630,39148 days 16:47:18.683827,159,2.0,2.0,280,-405,480.0
265000.0,3,1.75,1170,8148,1.0,3,7,1170,0.0,1952,1200,8147,25634 days 16:47:18.683827,195,1.7142857142857142,0.0,-30,1,1170.0
399000.0,3,1.75,1170,8148,1.0,3,7,1170,0.0,1952,1200,8147,25634 days 16:47:18.683827,315,1.7142857142857142,0.0,-30,1,1170.0
785000.0,4,2.25,3200,53357,2.0,4,9,3200,0.0,1972,2650,54014,18329 days 16:47:18.683827,283,1.7777777777777777,0.0,550,-657,3200.0
831500.0,5,2.5,4470,35124,2.5,3,1,4470,0.0,1984,4050,34118,13946 days 16:47:18.683827,174,2.0,0.0,420,1006,4470.0
360000.0,4,2.5,2570,4557,2.0,3,7,2570,0.0,2009,2200,4500,4814 days 16:47:18.683827,093,1.6,0.0,370,57,2570.0
655000.0,3,2.5,2370,7916,2.0,3,9,2370,0.0,1990,2500,8221,11754 days 16:47:18.683827,113,1.2,0.0,-130,-305,2370.0
449950.0,4,1.5,1800,10150,1.5,4,7,1800,0.0,1958,1630,10660,23442 days 16:47:18.683827,124,2.6666666666666665,0.0,170,-510,1800.0
612000.0,5,2.5,2300,7000,1.0,3,8,1290,1010.0,1975,2080,7280,17233 days 16:47:18.683827,119,2.0,1.2772277227722773,220,-280,280.0
575000.0,3,2.5,3240,33661,2.0,3,8,3240,0.0,2001,1870,43560,7736 days 16:47:18.683827,210,1.2,0.0,1370,-9899,3240.0
557000.0,3,2.5,2280,18241,1.0,3,9,960,1320.0,1995,3100,12465,9928 days 16:47:18.683827,043,1.2,0.7272727272727273,-820,5776,-360.0
375000.0,4,1.75,1870,12500,1.0,5,6,1030,840.0,1943,2060,14141,28921 days 16:47:18.683827,028,2.2857142857142856,1.2261904761904763,-190,-1641,190.0
369000.0,3,2.25,1820,99752,1.0,4,7,1820,0.0,1969,1850,117612,19424 days 16:47:18.683827,058,1.3333333333333333,0.0,-30,-17860,1820.0
330000.0,5,2.75,2390,6282,1.0,4,7,1290,1100.0,1966,1690,5202,20520 days 16:47:18.683827,110,1.8181818181818181,1.1727272727272726,700,1080,190.0
1030000.0,4,1.75,2110,6708,1.0,3,8,1410,700.0,1941,2140,7006,29651 days 16:47:18.683827,117,2.2857142857142856,2.0142857142857142,-30,-298,710.0
550000.0,2,1.0,980,4800,1.0,4,7,980,0.0,1910,1570,2640,40974 days 16:47:18.683827,085,2.0,0.0,-590,2160,980.0
338000.0,3,1.75,1250,7710,1.0,4,7,1250,0.0,1947,1340,7710,27460 days 16:47:18.683827,314,1.7142857142857142,0.0,-90,0,1250.0
1900000.0,4,2.5,3680,13351,2.0,5,9,3680,0.0,1946,3410,11700,27825 days 16:47:18.683827,212,1.6,0.0,270,1651,3680.0
235000.0,3,1.0,2230,8163,1.0,3,7,1230,1000.0,1966,2380,6874,20520 days 16:47:18.683827,232,3.0,1.23,-150,1289,230.0
349950.0,1,1.0,1230,9300,1.5,4,6,1230,0.0,1918,1190,6820,38052 days 16:47:18.683827,329,1.0,0.0,40,2480,1230.0
300000.0,5,2.5,2093,10350,1.5,5,7,2093,0.0,1963,1520,10350,21616 days 16:47:18.683827,210,2.0,0.0,573,0,2093.0
431000.0,3,1.75,1660,12865,1.0,5,7,1660,0.0,1967,1610,12400,20155 days 16:47:18.683827,307,1.7142857142857142,0.0,50,465,1660.0
280000.0,5,2.5,1630,20750,1.0,4,7,1100,530.0,1975,1630,8640,17233 days 16:47:18.683827,101,2.0,2.0754716981132075,0,12110,570.0
295000.0,4,2.5,1677,7209,2.0,3,7,1677,0.0,2011,2236,7209,4084 days 16:47:18.683827,085,1.6,0.0,-559,0,1677.0
445000.0,4,2.5,2990,6383,2.0,3,7,2990,0.0,2003,2640,6454,7006 days 16:47:18.683827,113,1.6,0.0,350,-71,2990.0
550000.0,5,1.0,2150,262231,1.5,3,7,2150,0.0,1900,1460,46609,44626 days 16:47:18.683827,238,5.0,0.0,690,215622,2150.0
515000.0,4,2.5,2890,15067,2.0,3,9,2890,0.0,2003,3090,15398,7006 days 16:47:18.683827,238,1.6,0.0,-200,-331,2890.0
555000.0,3,2.5,3050,158558,1.0,4,9,3050,0.0,1987,2960,31050,12850 days 16:47:18.683827,140,1.2,0.0,90,127508,3050.0
597000.0,4,2.5,2280,2432,2.0,5,8,1520,760.0,1921,1690,2099,36956 days 16:47:18.683827,267,1.6,2.0,590,333,760.0
661000.0,2,1.0,1260,5800,1.0,4,7,1260,0.0,1939,1830,5800,30382 days 16:47:18.683827,227,2.0,0.0,-570,0,1260.0
362764.0,3,2.0,1460,4350,2.0,3,7,1460,0.0,2008,1740,4622,5180 days 16:47:18.683827,196,1.5,0.0,-280,-272,1460.0
427000.0,4,2.5,1600,14000,1.0,3,8,1310,290.0,1950,1600,10200,26364 days 16:47:18.683827,233,1.6,4.517241379310345,0,3800,1020.0
405000.0,3,1.75,2020,8531,1.0,3,7,2020,0.0,1965,1950,8449,20885 days 16:47:18.683827,339,1.7142857142857142,0.0,70,82,2020.0
157000.0,3,1.5,1170,11530,1.0,3,7,1170,0.0,1960,1550,8605,22712 days 16:47:18.683827,358,2.0,0.0,-380,2925,1170.0
246500.0,3,1.5,1170,11530,1.0,3,7,1170,0.0,1960,1550,8605,22712 days 16:47:18.683827,078,2.0,0.0,-380,2925,1170.0
386500.0,2,1.5,1280,11071,1.0,3,7,850,430.0,1984,1280,10879,13946 days 16:47:18.683827,008,1.3333333333333333,1.9767441860465116,0,192,420.0
300000.0,4,2.5,2680,15508,2.0,3,8,2680,0.0,1999,1960,15586,8467 days 16:47:18.683827,157,1.6,0.0,720,-78,2680.0
240000.0,3,1.75,1770,8571,1.0,3,8,1270,500.0,1978,2120,7711,16137 days 16:47:18.683827,311,1.7142857142857142,2.54,-350,860,770.0
818500.0,5,3.5,4790,12957,2.0,3,9,3110,1680.0,2005,2620,13538,6275 days 16:47:18.683827,252,1.4285714285714286,1.8511904761904763,2170,-581,1430.0
249000.0,3,1.75,1300,8500,1.0,4,7,1300,0.0,1964,1410,7800,21251 days 16:47:18.683827,221,1.7142857142857142,0.0,-110,700,1300.0
580000.0,4,2.25,2610,7700,1.0,3,8,1700,910.0,1977,2260,8266,16502 days 16:47:18.683827,272,1.7777777777777777,1.8681318681318682,350,-566,790.0
2340000.0,4,2.5,4500,35200,1.0,3,1,4500,0.0,1988,4760,35200,12485 days 16:47:18.683827,110,1.6,0.0,-260,0,4500.0
333000.0,4,2.5,2100,7366,2.0,3,8,2100,0.0,1997,2060,7324,9197 days 16:47:18.683827,269,1.6,0.0,40,42,2100.0
230000.0,2,2.0,1340,7605,1.0,3,7,1340,0.0,1992,1670,7136,11024 days 16:47:18.683827,235,1.0,0.0,-330,469,1340.0
360500.0,3,1.0,970,6180,1.0,3,6,970,0.0,1974,1120,4500,17598 days 16:47:18.683827,044,3.0,0.0,-150,1680,970.0
265000.0,3,1.75,2200,7200,1.0,3,8,1270,930.0,1962,1800,8000,21981 days 16:47:18.683827,203,1.7142857142857142,1.3655913978494623,400,-800,340.0
490000.0,2,1.0,990,5000,1.0,3,7,990,0.0,1941,2250,6032,29651 days 16:47:18.683827,298,2.0,0.0,-1260,-1032,990.0
600000.0,2,1.75,1180,5000,1.0,2,7,880,300.0,1925,1470,5000,35495 days 16:47:18.683827,126,1.1428571428571428,2.933333333333333,-290,0,580.0
307500.0,3,1.0,980,6530,1.0,3,7,980,0.0,1969,1220,6723,19424 days 16:47:18.683827,258,3.0,0.0,-240,-193,980.0
670000.0,4,2.25,2370,9636,1.0,3,8,1660,710.0,1976,2350,9588,16868 days 16:47:18.683827,351,1.7777777777777777,2.3380281690140845,20,48,950.0
247200.0,3,1.5,1910,10583,1.5,4,7,1910,0.0,1922,1770,9068,36591 days 16:47:18.683827,294,2.0,0.0,140,1515,1910.0
2600000.0,4,4.5,5270,12195,2.0,3,1,3400,1870.0,1979,3390,9905,15772 days 16:47:18.683827,350,0.8888888888888888,1.8181818181818181,1880,2290,1530.0
440000.0,3,1.75,1430,8400,1.0,4,7,1430,0.0,1961,1570,7800,22346 days 16:47:18.683827,232,1.7142857142857142,0.0,-140,600,1430.0
700000.0,4,2.5,2490,7694,2.0,3,8,2490,0.0,1987,2140,8126,12850 days 16:47:18.683827,126,1.6,0.0,350,-432,2490.0
756100.0,4,2.0,2000,8317,1.5,4,8,2000,0.0,1917,1390,6001,38417 days 16:47:18.683827,070,2.0,0.0,610,2316,2000.0
555000.0,4,2.75,2600,19275,1.0,3,8,1620,980.0,1978,2230,10119,16137 days 16:47:18.683827,293,1.4545454545454546,1.653061224489796,370,9156,640.0
830000.0,5,3.5,2880,3750,2.0,3,8,2270,610.0,2001,2060,4000,7736 days 16:47:18.683827,114,1.4285714285714286,3.721311475409836,820,-250,1660.0
180000.0,3,1.0,1010,8863,1.0,4,6,1010,0.0,1990,1090,8410,11754 days 16:47:18.683827,346,3.0,0.0,-80,453,1010.0
775000.0,5,3.5,3290,5600,2.0,3,9,2670,620.0,2004,3130,5600,6641 days 16:47:18.683827,279,1.4285714285714286,4.306451612903226,160,0,2050.0
220000.0,4,1.75,1530,18400,1.5,4,6,1530,0.0,1938,1620,13535,30747 days 16:47:18.683827,217,2.2857142857142856,0.0,-90,4865,1530.0
650000.0,4,2.75,2020,15810,1.0,4,9,1620,400.0,1967,2210,10160,20155 days 16:47:18.683827,205,1.4545454545454546,4.05,-190,5650,1220.0
410000.0,3,1.75,1340,9975,1.0,4,7,1340,0.0,1961,1340,10050,22346 days 16:47:18.683827,358,1.7142857142857142,0.0,0,-75,1340.0
339995.0,4,2.5,2180,5367,2.0,3,7,2180,0.0,2000,2180,5130,8102 days 16:47:18.683827,294,1.6,0.0,0,237,2180.0
1160000.0,5,1.75,2870,9680,1.0,5,9,1440,1430.0,1966,2940,9729,20520 days 16:47:18.683827,050,2.857142857142857,1.006993006993007,-70,-49,10.0
440000.0,3,2.75,2070,9697,2.0,4,7,1330,740.0,1929,2000,14436,34034 days 16:47:18.683827,204,1.0909090909090908,1.7972972972972974,70,-4739,590.0
275000.0,2,1.75,930,7080,1.0,3,6,930,0.0,1923,1100,7680,36226 days 16:47:18.683827,211,1.1428571428571428,0.0,-170,-600,930.0
231500.0,3,2.25,1630,7900,1.0,4,7,1130,500.0,1973,1630,8200,17963 days 16:47:18.683827,191,1.3333333333333333,2.26,0,-300,630.0
472000.0,3,2.0,2770,89298,2.0,3,9,2770,0.0,2004,2040,109771,6641 days 16:47:18.683827,363,1.5,0.0,730,-20473,2770.0
1330000.0,4,2.5,4010,37076,2.0,4,1,4010,0.0,1990,4280,35326,11754 days 16:47:18.683827,220,1.6,0.0,-270,1750,4010.0
265000.0,4,1.75,1970,8390,1.0,3,7,1140,830.0,1955,1710,10890,24538 days 16:47:18.683827,065,2.2857142857142856,1.3734939759036144,260,-2500,310.0
325000.0,2,1.0,790,6000,1.0,3,7,790,0.0,1948,960,6000,27095 days 16:47:18.683827,317,2.0,0.0,-170,0,790.0
364500.0,3,1.75,1740,8424,1.0,5,7,1040,700.0,1954,1370,8424,24903 days 16:47:18.683827,210,1.7142857142857142,1.4857142857142858,370,0,340.0
322500.0,2,1.0,1130,8184,1.0,3,6,1130,0.0,1947,1010,8184,27460 days 16:47:18.683827,029,2.0,0.0,120,0,1130.0
338900.0,3,1.75,1180,4000,1.0,3,7,1040,140.0,1929,1430,4000,34034 days 16:47:18.683827,106,1.7142857142857142,7.428571428571429,-250,0,900.0
910000.0,5,2.5,2350,4000,2.0,3,9,2350,0.0,1993,1840,4000,10658 days 16:47:18.683827,164,2.0,0.0,510,0,2350.0
1020000.0,5,2.5,2350,4000,2.0,3,9,2350,0.0,1993,1840,4000,10658 days 16:47:18.683827,114,2.0,0.0,510,0,2350.0
459950.0,3,1.75,1850,6869,1.0,5,6,1100,750.0,1919,1850,10096,37687 days 16:47:18.683827,164,1.7142857142857142,1.4666666666666666,0,-3227,350.0
584950.0,4,3.0,3220,6224,1.5,3,9,3220,0.0,2009,2950,6224,4814 days 16:47:18.683827,287,1.3333333333333333,0.0,270,0,3220.0
252000.0,3,1.75,2050,11313,1.0,3,7,1520,530.0,1987,1620,8065,12850 days 16:47:18.683827,357,1.7142857142857142,2.8679245283018866,430,3248,990.0
270000.0,3,2.5,1430,8470,1.0,3,7,1190,240.0,1992,1670,8418,11024 days 16:47:18.683827,119,1.2,4.958333333333333,-240,52,950.0
750000.0,4,2.5,3210,8938,2.0,3,1,3210,0.0,2005,3740,8108,6275 days 16:47:18.683827,303,1.6,0.0,-530,830,3210.0
775000.0,3,1.75,3520,12350,1.0,4,8,1530,1990.0,1960,2140,7800,22712 days 16:47:18.683827,335,1.7142857142857142,0.7688442211055276,1380,4550,-460.0
325000.0,3,2.5,2260,8120,2.0,3,8,2260,0.0,2004,2250,7784,6641 days 16:47:18.683827,049,1.2,0.0,10,336,2260.0
810000.0,5,3.25,3290,6422,2.0,3,9,3290,0.0,2012,3210,6891,3719 days 16:47:18.683827,299,1.5384615384615385,0.0,80,-469,3290.0
409000.0,2,2.25,1640,2128,2.0,4,8,1640,0.0,1974,1640,2128,17598 days 16:47:18.683827,196,0.8888888888888888,0.0,0,0,1640.0
400000.0,4,1.75,1580,5340,1.0,3,7,1130,450.0,1947,830,980,27460 days 16:47:18.683827,167,2.2857142857142856,2.511111111111111,750,4360,680.0
530000.0,4,2.25,1940,8270,2.0,5,7,1940,0.0,1962,1800,7743,21981 days 16:47:18.683827,132,1.7777777777777777,0.0,140,527,1940.0
580000.0,3,2.25,1580,8506,2.0,3,7,1580,0.0,1987,2253,8515,12850 days 16:47:18.683827,072,1.3333333333333333,0.0,-673,-9,1580.0
491300.0,3,1.75,1750,11340,1.0,4,7,1300,450.0,1987,2310,11340,12850 days 16:47:18.683827,129,1.7142857142857142,2.888888888888889,-560,0,850.0
272000.0,4,2.75,1810,7350,1.0,4,7,1200,610.0,1980,1750,7350,15407 days 16:47:18.683827,365,1.4545454545454546,1.9672131147540983,60,0,590.0
599950.0,3,2.5,1970,106722,1.0,3,9,1970,0.0,1985,2910,101494,13580 days 16:47:18.683827,091,1.2,0.0,-940,5228,1970.0
464000.0,3,2.5,1770,5146,2.0,3,8,1770,0.0,1992,1870,5146,11024 days 16:47:18.683827,057,1.2,0.0,-100,0,1770.0
471001.0,3,1.75,1800,6000,1.0,5,7,900,900.0,1905,1800,3000,42800 days 16:47:18.683827,174,1.7142857142857142,1.0,0,3000,0.0
230000.0,3,1.5,1500,11616,1.0,3,7,1100,400.0,1980,1830,8288,15407 days 16:47:18.683827,321,2.0,2.75,-330,3328,700.0
358000.0,3,1.0,940,6695,1.0,4,6,940,0.0,1959,1230,7400,23077 days 16:47:18.683827,195,3.0,0.0,-290,-705,940.0
510000.0,3,2.25,2340,6183,1.0,3,7,1210,1130.0,1929,1970,6183,34034 days 16:47:18.683827,232,1.3333333333333333,1.0707964601769913,370,0,80.0
86500.0,3,1.0,840,9480,1.0,3,6,840,0.0,1960,840,9420,22712 days 16:47:18.683827,203,3.0,0.0,0,60,840.0
199950.0,3,1.0,840,9480,1.0,3,6,840,0.0,1960,840,9420,22712 days 16:47:18.683827,093,3.0,0.0,0,60,840.0
1710000.0,3,3.25,2940,5432,3.0,4,1,2440,500.0,1978,4400,5500,16137 days 16:47:18.683827,167,0.9230769230769231,4.88,-1460,-68,1940.0
850000.0,3,2.75,3180,3680,2.0,4,9,2190,990.0,1918,2000,3680,38052 days 16:47:18.683827,072,1.0909090909090908,2.212121212121212,1180,0,1200.0
542000.0,4,2.5,2020,3440,1.5,4,7,1480,540.0,1928,1520,5080,34400 days 16:47:18.683827,266,1.6,2.740740740740741,500,-1640,940.0
718000.0,3,1.75,4060,136290,1.0,3,8,2810,1250.0,1995,1300,51836,9928 days 16:47:18.683827,091,1.7142857142857142,2.248,2760,84454,1560.0
625000.0,4,2.25,2660,22194,1.0,4,8,2180,480.0,1977,2660,18135,16502 days 16:47:18.683827,356,1.7777777777777777,4.541666666666667,0,4059,1700.0
350000.0,3,1.0,1010,11244,1.0,4,7,1010,0.0,1947,1220,11242,27460 days 16:47:18.683827,143,3.0,0.0,-210,2,1010.0
216000.0,2,1.0,710,5120,1.0,3,6,710,0.0,1918,1150,1252,38052 days 16:47:18.683827,040,2.0,0.0,-440,3868,710.0
340000.0,3,1.0,980,7228,1.5,3,7,980,0.0,1946,1070,7228,27825 days 16:47:18.683827,248,3.0,0.0,-90,0,980.0
505000.0,3,1.0,1100,5400,1.5,3,7,1100,0.0,1908,1770,4400,41705 days 16:47:18.683827,318,3.0,0.0,-670,1000,1100.0
372000.0,5,2.5,2840,6010,2.0,3,8,2840,0.0,2003,2740,5509,7006 days 16:47:18.683827,133,2.0,0.0,100,501,2840.0
263850.0,4,2.25,2300,7524,2.0,4,8,2300,0.0,1978,2270,8025,16137 days 16:47:18.683827,247,1.7777777777777777,0.0,30,-501,2300.0
1350000.0,4,3.25,5370,20388,2.0,4,1,5370,0.0,1990,2770,22270,11754 days 16:47:18.683827,246,1.2307692307692308,0.0,2600,-1882,5370.0
289000.0,2,1.0,1010,7740,1.0,3,6,890,120.0,1924,1030,6000,35861 days 16:47:18.683827,300,2.0,7.416666666666667,-20,1740,770.0
364000.0,3,2.25,1420,6600,1.0,3,7,1160,260.0,1987,1920,7902,12850 days 16:47:18.683827,057,1.3333333333333333,4.461538461538462,-500,-1302,900.0
610000.0,4,2.5,2100,8800,1.0,5,8,1250,850.0,1980,2100,9000,15407 days 16:47:18.683827,234,1.6,1.4705882352941178,0,-200,400.0
531500.0,4,2.75,3110,49765,1.0,4,8,3110,0.0,1958,1880,19709,23442 days 16:47:18.683827,176,1.4545454545454546,0.0,1230,30056,3110.0
402500.0,3,2.25,2160,9540,2.0,3,8,2160,0.0,1979,1720,12593,15772 days 16:47:18.683827,120,1.3333333333333333,0.0,440,-3053,2160.0
375000.0,2,1.0,820,6250,1.0,4,5,820,0.0,1922,1300,6250,36591 days 16:47:18.683827,155,2.0,0.0,-480,0,820.0
537500.0,5,2.5,4340,9108,1.0,5,8,2170,2170.0,1979,2030,6812,15772 days 16:47:18.683827,026,2.0,1.0,2310,2296,0.0
375000.0,3,1.75,2100,9066,1.0,3,8,1440,660.0,1962,2000,9132,21981 days 16:47:18.683827,212,1.7142857142857142,2.1818181818181817,100,-66,780.0
293550.0,4,1.75,1250,8840,1.0,4,7,910,340.0,1979,1410,8378,15772 days 16:47:18.683827,232,2.2857142857142856,2.676470588235294,-160,462,570.0
585000.0,6,3.0,3870,43787,2.0,3,8,2700,1170.0,1976,2600,35381,16868 days 16:47:18.683827,020,2.0,2.3076923076923075,1270,8406,1530.0
225000.0,2,2.5,1360,2693,2.0,3,6,1360,0.0,2003,1360,2693,7006 days 16:47:18.683827,224,0.8,0.0,0,0,1360.0
185000.0,4,1.0,1400,8684,1.5,3,7,1400,0.0,1957,1520,8712,23807 days 16:47:18.683827,008,4.0,0.0,-120,-28,1400.0
402000.0,3,1.5,1450,7375,1.0,3,7,1010,440.0,1968,1350,7440,19790 days 16:47:18.683827,168,2.0,2.2954545454545454,100,-65,570.0
585000.0,5,1.75,1880,16617,1.0,3,7,960,920.0,1963,1720,8400,21616 days 16:47:18.683827,099,2.857142857142857,1.0434782608695652,160,8217,40.0
549000.0,2,2.5,1380,953,3.0,3,9,1380,0.0,2006,1430,3400,5910 days 16:47:18.683827,168,0.8,0.0,-50,-2447,1380.0
1810000.0,3,2.25,2910,15626,1.5,4,9,2510,400.0,1923,2370,6519,36226 days 16:47:18.683827,104,1.3333333333333333,6.275,540,9107,2110.0
345000.0,3,1.75,1380,10529,1.0,3,7,1380,0.0,1967,1670,5694,20155 days 16:47:18.683827,096,1.7142857142857142,0.0,-290,4835,1380.0
302500.0,3,2.25,3100,11985,1.0,4,7,1790,1310.0,1963,1770,7954,21616 days 16:47:18.683827,321,1.3333333333333333,1.366412213740458,1330,4031,480.0
218500.0,4,1.75,1400,25500,1.0,4,7,1400,0.0,1964,2170,25500,21251 days 16:47:18.683827,287,2.2857142857142856,0.0,-770,0,1400.0
705000.0,2,2.0,1650,6840,1.5,5,7,1650,0.0,1916,1700,4560,38783 days 16:47:18.683827,274,1.0,0.0,-50,2280,1650.0
191000.0,3,1.0,840,5525,1.0,5,6,840,0.0,1969,920,5330,19424 days 16:47:18.683827,118,3.0,0.0,-80,195,840.0
695000.0,3,2.5,2550,45254,2.0,3,9,2550,0.0,2001,2190,49222,7736 days 16:47:18.683827,161,1.2,0.0,360,-3968,2550.0
350000.0,2,2.75,2820,11770,2.0,3,7,1630,1190.0,1947,1690,12500,27460 days 16:47:18.683827,092,0.7272727272727273,1.3697478991596639,1130,-730,440.0
480000.0,3,1.75,1710,4080,1.0,4,7,1130,580.0,1979,1200,4080,15772 days 16:47:18.683827,219,1.7142857142857142,1.9482758620689655,510,0,550.0
220000.0,3,1.0,820,5200,1.0,4,6,820,0.0,1977,1120,5200,16502 days 16:47:18.683827,061,3.0,0.0,-300,0,820.0
535000.0,4,2.25,2620,33578,2.0,3,7,2620,0.0,1977,2520,35160,16502 days 16:47:18.683827,302,1.7777777777777777,0.0,100,-1582,2620.0
1000000.0,2,1.75,2430,23400,1.0,3,1,2430,0.0,1951,3150,23600,25999 days 16:47:18.683827,139,1.1428571428571428,0.0,-720,-200,2430.0
775000.0,4,2.5,3060,6826,2.0,3,9,3060,0.0,2004,3110,6932,6641 days 16:47:18.683827,328,1.6,0.0,-50,-106,3060.0
320000.0,3,2.5,1680,4584,2.0,3,7,1680,0.0,2003,2160,4621,7006 days 16:47:18.683827,260,1.2,0.0,-480,-37,1680.0
760000.0,3,3.25,3320,15022,2.0,3,1,3320,0.0,1989,3430,15018,12119 days 16:47:18.683827,076,0.9230769230769231,0.0,-110,4,3320.0
640000.0,3,2.5,2390,8315,2.0,4,9,2390,0.0,1990,2370,7816,11754 days 16:47:18.683827,203,1.2,0.0,20,499,2390.0
253200.0,3,1.0,1360,5840,1.0,4,5,1360,0.0,1953,1250,6708,25268 days 16:47:18.683827,122,3.0,0.0,110,-868,1360.0
228000.0,2,1.0,1800,9236,1.0,3,7,1800,0.0,1954,1730,5701,24903 days 16:47:18.683827,197,2.0,0.0,70,3535,1800.0
325000.0,3,1.0,1160,9525,1.0,4,7,1160,0.0,1968,1160,10640,19790 days 16:47:18.683827,308,3.0,0.0,0,-1115,1160.0
530000.0,4,3.25,4160,35654,2.0,3,8,2760,1400.0,1973,2500,35675,17963 days 16:47:18.683827,156,1.2307692307692308,1.9714285714285715,1660,-21,1360.0
300000.0,4,2.25,1660,3200,2.0,3,7,1660,0.0,2011,1960,3558,4084 days 16:47:18.683827,042,1.7777777777777777,0.0,-300,-358,1660.0
418000.0,3,2.0,1410,6030,1.5,4,7,1410,0.0,1930,1410,6300,33669 days 16:47:18.683827,125,1.5,0.0,0,-270,1410.0
415000.0,4,1.75,2230,9625,1.0,3,8,1180,1050.0,1955,2300,8211,24538 days 16:47:18.683827,351,2.2857142857142856,1.1238095238095238,-70,1414,130.0
384000.0,3,2.5,1700,4000,2.0,3,7,1700,0.0,2003,1700,4417,7006 days 16:47:18.683827,140,1.2,0.0,0,-417,1700.0
325000.0,3,2.5,2070,8337,2.0,3,8,2070,0.0,1997,2030,7248,9197 days 16:47:18.683827,164,1.2,0.0,40,1089,2070.0
600000.0,3,1.75,2300,12682,1.0,3,8,2300,0.0,1955,2720,14643,24538 days 16:47:18.683827,356,1.7142857142857142,0.0,-420,-1961,2300.0
760000.0,4,2.25,3040,9690,1.0,4,9,1940,1100.0,1978,2430,9690,16137 days 16:47:18.683827,283,1.7777777777777777,1.7636363636363637,610,0,840.0
168000.0,2,1.5,1220,3568,1.5,4,8,1220,0.0,1976,1180,3678,16868 days 16:47:18.683827,150,1.3333333333333333,0.0,40,-110,1220.0
405000.0,3,1.0,960,3960,1.0,3,7,960,0.0,1943,1550,6050,28921 days 16:47:18.683827,293,3.0,0.0,-590,-2090,960.0
479000.0,3,1.0,1480,10094,1.0,4,7,1480,0.0,1956,1430,10083,24173 days 16:47:18.683827,124,3.0,0.0,50,11,1480.0
549000.0,3,2.0,1560,5130,1.0,5,7,1150,410.0,1915,1560,4500,39148 days 16:47:18.683827,238,1.5,2.8048780487804876,0,630,740.0
215000.0,3,1.5,1100,33600,1.0,3,7,1100,0.0,1967,1570,32700,20155 days 16:47:18.683827,343,2.0,0.0,-470,900,1100.0
550000.0,2,1.5,900,5750,1.0,3,7,900,0.0,1940,1300,1413,30017 days 16:47:18.683827,029,1.3333333333333333,0.0,-400,4337,900.0
389000.0,4,1.75,2400,7700,1.5,4,7,1500,900.0,1927,1530,7700,34765 days 16:47:18.683827,183,2.2857142857142856,1.6666666666666667,870,0,600.0
447500.0,3,2.5,2320,15024,2.0,3,8,2320,0.0,1990,2300,15145,11754 days 16:47:18.683827,203,1.2,0.0,20,-121,2320.0
273500.0,4,2.75,1300,9638,1.0,2,7,1300,0.0,1983,1670,9638,14311 days 16:47:18.683827,118,1.4545454545454546,0.0,-370,0,1300.0
257000.0,5,2.75,2930,10148,2.0,3,9,2930,0.0,2002,2930,8425,7371 days 16:47:18.683827,290,1.8181818181818181,0.0,0,1723,2930.0
199000.0,2,1.0,720,7200,1.0,5,6,720,0.0,1943,970,8027,28921 days 16:47:18.683827,144,2.0,0.0,-250,-827,720.0
339100.0,4,2.5,2350,10655,2.0,3,8,2350,0.0,1992,2210,7028,11024 days 16:47:18.683827,063,1.6,0.0,140,3627,2350.0
435000.0,4,2.5,2940,7590,2.0,3,9,2940,0.0,1991,2550,8360,11389 days 16:47:18.683827,357,1.6,0.0,390,-770,2940.0
400000.0,3,2.5,2020,3000,1.0,4,6,1010,1010.0,1910,1670,3000,40974 days 16:47:18.683827,192,1.2,1.0,350,0,0.0
356000.0,2,1.0,1430,365904,1.0,3,7,1010,420.0,1991,2300,253519,11389 days 16:47:18.683827,328,2.0,2.4047619047619047,-870,112385,590.0
395000.0,3,1.0,950,6951,1.0,4,7,950,0.0,1950,1410,7200,26364 days 16:47:18.683827,096,3.0,0.0,-460,-249,950.0
575000.0,2,1.0,1250,4320,1.0,4,7,850,400.0,1911,1520,4320,40609 days 16:47:18.683827,063,2.0,2.125,-270,0,450.0
515000.0,3,1.75,1300,5120,1.5,4,6,1300,0.0,1925,1090,5124,35495 days 16:47:18.683827,113,1.7142857142857142,0.0,210,-4,1300.0
618250.0,4,3.25,2520,3360,1.5,4,8,1550,970.0,1931,1730,3360,33304 days 16:47:18.683827,170,1.2307692307692308,1.597938144329897,790,0,580.0
245000.0,3,1.5,1330,7125,2.0,3,7,1330,0.0,1968,1570,7350,19790 days 16:47:18.683827,050,2.0,0.0,-240,-225,1330.0
690000.0,3,2.75,2480,3240,1.5,3,9,1890,590.0,1929,2160,3240,34034 days 16:47:18.683827,283,1.0909090909090908,3.2033898305084745,320,0,1300.0
465000.0,5,2.25,3020,10010,1.0,3,7,1510,1510.0,1959,1760,10878,23077 days 16:47:18.683827,310,2.2222222222222223,1.0,1260,-868,0.0
280000.0,3,1.75,1770,8240,1.0,4,7,1240,530.0,1978,2060,8250,16137 days 16:47:18.683827,324,1.7142857142857142,2.339622641509434,-290,-10,710.0
320000.0,3,2.25,1650,7047,2.0,3,7,1650,0.0,1994,2010,7763,10293 days 16:47:18.683827,075,1.3333333333333333,0.0,-360,-716,1650.0
355000.0,4,3.0,2580,9601,2.0,4,7,2130,450.0,1992,1900,10092,11024 days 16:47:18.683827,044,1.3333333333333333,4.733333333333333,680,-491,1680.0
670000.0,3,2.0,2570,10078,1.5,3,8,2570,0.0,1965,2660,8013,20885 days 16:47:18.683827,117,1.5,0.0,-90,2065,2570.0
550000.0,1,1.0,2880,7560,1.0,3,7,1440,1440.0,1925,1400,5040,35495 days 16:47:18.683827,267,1.0,1.0,1480,2520,0.0
765000.0,4,2.75,2660,4500,1.5,5,8,1860,800.0,1909,1830,4000,41339 days 16:47:18.683827,288,1.4545454545454546,2.325,830,500,1060.0
430000.0,3,1.0,1560,5225,1.5,3,7,1260,300.0,1927,1560,5322,34765 days 16:47:18.683827,303,3.0,4.2,0,-97,960.0
950000.0,3,2.5,3080,8448,2.0,3,9,3080,0.0,2000,2500,6400,8102 days 16:47:18.683827,239,1.2,0.0,580,2048,3080.0
525000.0,4,1.75,2540,7200,1.0,4,7,1270,1270.0,1947,1650,7200,27460 days 16:47:18.683827,288,2.2857142857142856,1.0,890,0,0.0
300000.0,6,2.5,3080,8163,1.0,3,7,1580,1500.0,1985,1850,8658,13580 days 16:47:18.683827,293,2.4,1.0533333333333332,1230,-495,80.0
345000.0,3,2.75,2190,7258,2.0,3,8,2190,0.0,2000,2190,8645,8102 days 16:47:18.683827,107,1.0909090909090908,0.0,0,-1387,2190.0
838000.0,3,3.75,2930,150945,2.0,3,8,2930,0.0,1972,2070,43935,18329 days 16:47:18.683827,110,0.8,0.0,860,107010,2930.0
1800000.0,5,2.75,2880,20274,1.0,4,9,1660,1220.0,1959,3750,20220,23077 days 16:47:18.683827,345,1.8181818181818181,1.360655737704918,-870,54,440.0
390000.0,3,1.75,2160,98445,2.0,3,8,2160,0.0,1978,2004,44431,16137 days 16:47:18.683827,086,1.7142857142857142,0.0,156,54014,2160.0
1150000.0,3,2.0,2110,18815,2.0,5,7,2110,0.0,1979,2690,21010,15772 days 16:47:18.683827,176,1.5,0.0,-580,-2195,2110.0
295000.0,4,2.25,1830,5720,2.0,3,7,1830,0.0,2003,1960,5754,7006 days 16:47:18.683827,204,1.7777777777777777,0.0,-130,-34,1830.0
775000.0,4,4.0,3180,7650,2.0,3,8,2530,650.0,1920,2000,4080,37322 days 16:47:18.683827,290,1.0,3.8923076923076922,1180,3570,1880.0
380000.0,3,2.5,1880,6047,2.0,3,8,1880,0.0,1993,2120,7188,10658 days 16:47:18.683827,077,1.2,0.0,-240,-1141,1880.0
550000.0,3,1.0,1140,8180,1.0,3,7,1140,0.0,1959,1510,8588,23077 days 16:47:18.683827,117,3.0,0.0,-370,-408,1140.0
199900.0,5,1.75,1798,11232,1.0,3,7,1798,0.0,1967,1300,15582,20155 days 16:47:18.683827,198,2.857142857142857,0.0,498,-4350,1798.0
329900.0,3,1.75,1670,5209,1.5,5,7,1670,0.0,1908,1990,4960,41705 days 16:47:18.683827,259,1.7142857142857142,0.0,-320,249,1670.0
898000.0,3,2.25,2580,11060,1.0,3,8,2580,0.0,1964,2580,13868,21251 days 16:47:18.683827,244,1.3333333333333333,0.0,0,-2808,2580.0
875000.0,4,2.25,3720,12384,1.0,5,8,1860,1860.0,1970,3180,15541,19059 days 16:47:18.683827,154,1.7777777777777777,1.0,540,-3157,0.0
375000.0,4,2.5,2790,7956,2.0,3,9,2790,0.0,2005,1660,8192,6275 days 16:47:18.683827,136,1.6,0.0,1130,-236,2790.0
365000.0,3,2.5,2190,5091,2.0,3,8,2190,0.0,2004,2200,5948,6641 days 16:47:18.683827,220,1.2,0.0,-10,-857,2190.0
530000.0,4,2.75,2280,2850,1.5,4,7,1540,740.0,1930,1680,3800,33669 days 16:47:18.683827,128,1.4545454545454546,2.081081081081081,600,-950,800.0
225500.0,3,1.0,1100,5200,1.0,4,6,1100,0.0,1969,920,5200,19424 days 16:47:18.683827,077,3.0,0.0,180,0,1100.0
318000.0,4,2.25,2180,7000,1.0,3,8,1680,500.0,1969,2000,8000,19424 days 16:47:18.683827,321,1.7777777777777777,3.36,180,-1000,1180.0
910000.0,4,2.5,2770,9798,2.0,4,9,2770,0.0,1986,3040,11100,13215 days 16:47:18.683827,091,1.6,0.0,-270,-1302,2770.0
207000.0,3,1.0,1980,18730,1.0,4,7,1280,700.0,1943,1356,9450,28921 days 16:47:18.683827,281,3.0,1.8285714285714285,624,9280,580.0
1890000.0,5,3.5,4180,17935,2.0,3,1,4180,0.0,2004,2950,13760,6641 days 16:47:18.683827,150,1.4285714285714286,0.0,1230,4175,4180.0
624500.0,6,3.0,3030,31920,1.0,4,8,1670,1360.0,1980,2890,35100,15407 days 16:47:18.683827,248,2.0,1.2279411764705883,140,-3180,310.0
640000.0,3,2.5,1690,1553,2.5,3,8,1690,0.0,2007,1910,1553,5545 days 16:47:18.683827,155,1.2,0.0,-220,0,1690.0
500000.0,3,2.0,1990,65340,2.0,3,8,1990,0.0,1986,2120,59241,13215 days 16:47:18.683827,100,1.5,0.0,-130,6099,1990.0
390000.0,5,1.75,2250,8970,1.0,4,7,1500,750.0,1966,1940,8710,20520 days 16:47:18.683827,063,2.857142857142857,2.0,310,260,750.0
284000.0,3,2.25,2080,2050,1.5,3,7,1550,530.0,2003,2080,2275,7006 days 16:47:18.683827,210,1.3333333333333333,2.9245283018867925,0,-225,1020.0
620000.0,3,2.0,2460,41343,1.0,4,8,2460,0.0,1988,2500,53885,12485 days 16:47:18.683827,177,1.5,0.0,-40,-12542,2460.0
306000.0,3,2.5,2588,5702,2.0,3,8,2588,0.0,2008,2403,5703,5180 days 16:47:18.683827,076,1.2,0.0,185,-1,2588.0
495000.0,4,1.75,2570,12039,1.0,3,8,1910,660.0,1978,2200,12384,16137 days 16:47:18.683827,262,2.2857142857142856,2.893939393939394,370,-345,1250.0
499950.0,3,2.5,2370,12753,2.0,3,7,2370,0.0,2001,2280,16808,7736 days 16:47:18.683827,156,1.2,0.0,90,-4055,2370.0
330000.0,3,1.0,1070,10563,1.0,3,7,1070,0.0,1969,1840,9638,19424 days 16:47:18.683827,314,3.0,0.0,-770,925,1070.0
665000.0,3,2.0,1940,5820,1.5,5,7,1150,790.0,1944,990,3880,28556 days 16:47:18.683827,133,1.5,1.4556962025316456,950,1940,360.0
850000.0,3,2.5,2650,2387,2.0,3,8,1830,820.0,1920,1870,2216,37322 days 16:47:18.683827,181,1.2,2.231707317073171,780,171,1010.0
599950.0,4,2.5,2290,6318,2.0,4,8,2290,0.0,1988,2150,7350,12485 days 16:47:18.683827,254,1.6,0.0,140,-1032,2290.0
360000.0,4,2.5,2050,9143,2.0,3,8,2050,0.0,1992,1510,9484,11024 days 16:47:18.683827,295,1.6,0.0,540,-341,2050.0
699000.0,3,2.5,2680,5497,2.0,3,9,2680,0.0,2001,2780,5497,7736 days 16:47:18.683827,239,1.2,0.0,-100,0,2680.0
475000.0,3,1.75,1520,8100,1.0,5,6,760,760.0,1945,1040,8100,28190 days 16:47:18.683827,072,1.7142857142857142,1.0,480,0,0.0
575000.0,3,2.0,2690,435600,2.0,3,8,2690,0.0,1992,1700,163350,11024 days 16:47:18.683827,337,1.5,0.0,990,272250,2690.0
345000.0,2,1.5,1180,844,2.0,3,7,990,190.0,2005,1170,1400,6275 days 16:47:18.683827,147,1.3333333333333333,5.2105263157894735,10,-556,800.0
367950.0,4,2.5,3030,9500,2.0,3,8,3030,0.0,1989,2650,9500,12119 days 16:47:18.683827,120,1.6,0.0,380,0,3030.0
374500.0,3,2.25,1400,11400,2.0,3,8,1400,0.0,1984,2180,9248,13946 days 16:47:18.683827,176,1.3333333333333333,0.0,-780,2152,1400.0
607500.0,4,2.5,3000,8100,2.0,3,8,3000,0.0,1992,1550,8100,11024 days 16:47:18.683827,216,1.6,0.0,1450,0,3000.0
374000.0,3,1.0,1200,9800,1.0,4,7,1200,0.0,1971,1220,10220,18694 days 16:47:18.683827,150,3.0,0.0,-20,-420,1200.0
390000.0,3,1.0,1000,6947,1.0,3,7,1000,0.0,1947,1000,6947,27460 days 16:47:18.683827,246,3.0,0.0,0,0,1000.0
705000.0,4,3.25,2740,5339,2.5,3,9,2740,0.0,2004,1770,4820,6641 days 16:47:18.683827,097,1.2307692307692308,0.0,970,519,2740.0
467000.0,3,2.5,1990,4978,2.0,3,8,1990,0.0,2004,2650,6816,6641 days 16:47:18.683827,302,1.2,0.0,-660,-1838,1990.0
593000.0,3,2.75,1830,1850,2.0,3,1,1690,140.0,2011,2310,2680,4084 days 16:47:18.683827,188,1.0909090909090908,12.071428571428571,-480,-830,1550.0
223000.0,3,1.0,940,7980,1.0,3,6,940,0.0,1961,1050,7980,22346 days 16:47:18.683827,318,3.0,0.0,-110,0,940.0
574000.0,4,2.5,2980,10179,2.0,3,9,2980,0.0,2003,2980,8828,7006 days 16:47:18.683827,110,1.6,0.0,0,1351,2980.0
400000.0,3,2.0,2260,11305,1.0,3,7,1130,1130.0,1986,2080,10248,13215 days 16:47:18.683827,155,1.5,1.0,180,1057,0.0
772000.0,4,2.75,3470,70131,1.0,4,8,1750,1720.0,1962,2950,43560,21981 days 16:47:18.683827,307,1.4545454545454546,1.0174418604651163,520,26571,30.0
593777.0,3,1.75,1510,10450,1.0,4,7,1510,0.0,1964,1310,9450,21251 days 16:47:18.683827,121,1.7142857142857142,0.0,200,1000,1510.0
539500.0,4,3.5,2710,5722,2.0,4,8,2040,670.0,1997,2500,5722,9197 days 16:47:18.683827,357,1.1428571428571428,3.044776119402985,210,0,1370.0
550000.0,3,2.5,2080,2625,2.0,3,8,2080,0.0,2006,1760,2772,5910 days 16:47:18.683827,091,1.2,0.0,320,-147,2080.0
265000.0,2,2.0,1860,10856,1.0,3,8,1260,600.0,1952,1250,10008,25634 days 16:47:18.683827,181,1.0,2.1,610,848,660.0
428000.0,3,1.75,2120,9350,1.0,3,7,1280,840.0,1979,2200,9000,15772 days 16:47:18.683827,275,1.7142857142857142,1.5238095238095237,-80,350,440.0
505000.0,3,2.0,1110,8375,1.0,5,7,1110,0.0,1951,1410,7734,25999 days 16:47:18.683827,118,1.5,0.0,-300,641,1110.0
925000.0,5,5.5,5190,12637,2.0,3,1,5190,0.0,2001,3840,12637,7736 days 16:47:18.684825,182,0.9090909090909091,0.0,1350,0,5190.0
230000.0,3,1.75,1520,15344,1.0,3,8,1520,0.0,1968,2270,14981,19790 days 16:47:18.684825,002,1.7142857142857142,0.0,-750,363,1520.0
695000.0,4,2.5,2650,9990,2.0,3,1,2650,0.0,1990,2710,8012,11754 days 16:47:18.684825,232,1.6,0.0,-60,1978,2650.0
700000.0,4,2.75,3350,7857,2.0,3,9,3350,0.0,2004,3870,7886,6641 days 16:47:18.684825,104,1.4545454545454546,0.0,-520,-29,3350.0
712500.0,3,1.75,1770,2800,1.5,3,7,1770,0.0,1914,1630,3254,39513 days 16:47:18.684825,115,1.7142857142857142,0.0,140,-454,1770.0
480000.0,3,2.5,2200,4692,2.0,3,8,2200,0.0,2005,2440,3833,6275 days 16:47:18.684825,093,1.2,0.0,-240,859,2200.0
470000.0,3,2.5,2000,8424,1.0,4,7,1300,700.0,1968,2110,8400,19790 days 16:47:18.684825,265,1.2,1.8571428571428572,-110,24,600.0
335000.0,3,1.75,1730,15003,1.0,3,7,1150,580.0,1980,1900,15483,15407 days 16:47:18.684825,205,1.7142857142857142,1.9827586206896552,-170,-480,570.0
270000.0,3,1.5,1300,7907,1.0,3,7,900,400.0,1970,1630,7600,19059 days 16:47:18.684825,107,2.0,2.25,-330,307,500.0
810000.0,5,3.25,2950,67475,1.0,3,8,2530,420.0,1981,2620,39820,15041 days 16:47:18.684825,083,1.5384615384615385,6.023809523809524,330,27655,2110.0
589000.0,3,3.0,1720,954,3.0,3,8,1460,260.0,2006,1720,1294,5910 days 16:47:18.684825,224,1.0,5.615384615384615,0,-340,1200.0
197000.0,4,2.25,1790,13200,1.0,3,7,1220,570.0,1979,1740,8950,15772 days 16:47:18.684825,070,1.7777777777777777,2.1403508771929824,50,4250,650.0
235500.0,3,1.5,1380,7600,1.0,4,7,790,590.0,1971,1570,7904,18694 days 16:47:18.684825,237,2.0,1.3389830508474576,-190,-304,200.0
460000.0,3,2.25,1530,1840,2.0,3,8,1240,290.0,2008,1800,3431,5180 days 16:47:18.684825,097,1.3333333333333333,4.275862068965517,-270,-1591,950.0
572500.0,5,1.75,2330,4947,1.0,4,8,1380,950.0,1955,2120,5605,24538 days 16:47:18.684825,302,2.857142857142857,1.4526315789473685,210,-658,430.0
302000.0,5,2.0,1540,9629,1.0,4,7,1540,0.0,1960,2260,9600,22712 days 16:47:18.684825,267,2.5,0.0,-720,29,1540.0
870000.0,3,2.5,3210,8630,2.0,4,1,2530,680.0,1990,2630,8630,11754 days 16:47:18.684825,225,1.2,3.7205882352941178,580,0,1850.0
240000.0,3,2.0,1460,7526,1.0,3,7,1460,0.0,1968,1580,7526,19790 days 16:47:18.684825,036,1.5,0.0,-120,0,1460.0
383000.0,3,1.75,1410,7215,1.0,3,7,1410,0.0,1967,1550,7600,20155 days 16:47:18.684825,295,1.7142857142857142,0.0,-140,-385,1410.0
750000.0,4,2.75,1750,5080,1.5,3,8,1750,0.0,1903,1700,4572,43531 days 16:47:18.684825,177,1.4545454545454546,0.0,50,508,1750.0
409950.0,2,1.75,1370,5125,1.0,5,6,1370,0.0,1944,1200,5100,28556 days 16:47:18.684825,154,1.1428571428571428,0.0,170,25,1370.0
246000.0,3,1.5,1780,23819,1.0,3,7,1780,0.0,1953,1130,14450,25268 days 16:47:18.684825,141,2.0,0.0,650,9369,1780.0
860000.0,4,1.75,1890,4500,2.0,5,7,1490,400.0,1937,1890,5000,31112 days 16:47:18.684825,093,2.2857142857142856,3.725,0,-500,1090.0
339950.0,3,2.25,1630,12295,2.0,4,7,1630,0.0,1985,1730,9948,13580 days 16:47:18.684825,127,1.3333333333333333,0.0,-100,2347,1630.0
315000.0,5,1.75,2320,8100,1.0,4,7,1160,1160.0,1956,1410,7271,24173 days 16:47:18.684825,129,2.857142857142857,1.0,910,829,0.0
698000.0,3,2.5,2580,4636,2.0,3,9,2580,0.0,2006,2480,4500,5910 days 16:47:18.684825,225,1.2,0.0,100,136,2580.0
419000.0,2,2.5,1470,2034,2.0,4,8,1470,0.0,1985,1510,2055,13580 days 16:47:18.684825,234,0.8,0.0,-40,-21,1470.0
372000.0,3,1.0,2298,10140,1.0,3,7,2298,0.0,1969,2580,24724,19424 days 16:47:18.684825,022,3.0,0.0,-282,-14584,2298.0
425000.0,3,2.5,1960,4709,2.0,3,7,1960,0.0,2003,1700,4444,7006 days 16:47:18.684825,254,1.2,0.0,260,265,1960.0
386500.0,3,2.25,2950,8036,1.5,3,8,1950,1000.0,1963,2060,7200,21616 days 16:47:18.684825,205,1.3333333333333333,1.95,890,836,950.0
348000.0,2,1.0,670,7312,1.0,3,5,670,0.0,1942,860,8242,29286 days 16:47:18.684825,321,2.0,0.0,-190,-930,670.0
754000.0,5,3.5,3020,15305,2.0,3,1,2230,790.0,1978,3680,14486,16137 days 16:47:18.684825,114,1.4285714285714286,2.8227848101265822,-660,819,1440.0
269950.0,4,3.0,2390,7309,2.0,4,7,2390,0.0,1944,930,7308,28556 days 16:47:18.684825,349,1.3333333333333333,0.0,1460,1,2390.0
891500.0,3,2.5,3090,20785,2.0,4,1,3090,0.0,1991,3400,7566,11389 days 16:47:18.684825,345,1.2,0.0,-310,13219,3090.0
349950.0,4,1.75,1780,5000,1.0,5,7,890,890.0,1903,1860,5000,43531 days 16:47:18.684825,282,2.2857142857142856,1.0,-80,0,0.0
360000.0,2,1.0,1420,81892,1.0,3,7,1180,240.0,1956,1490,1863,24173 days 16:47:18.684825,129,2.0,4.916666666666667,-70,80029,940.0
975000.0,4,2.25,2420,15482,2.0,4,8,2420,0.0,1925,2870,13905,35495 days 16:47:18.684825,343,1.7777777777777777,0.0,-450,1577,2420.0
449250.0,4,2.0,1480,3844,1.5,5,7,1480,0.0,1928,1480,3844,34400 days 16:47:18.684825,125,2.0,0.0,0,0,1480.0
350000.0,4,2.25,2190,3850,2.0,3,7,2190,0.0,2006,1900,3850,5910 days 16:47:18.684825,335,1.7777777777777777,0.0,290,0,2190.0
990000.0,3,1.75,1810,24586,1.0,4,9,930,880.0,1983,3540,14200,14311 days 16:47:18.684825,252,1.7142857142857142,1.0568181818181819,-1730,10386,50.0
834000.0,3,2.25,2550,4089,2.0,3,9,2550,0.0,1983,1680,4089,14311 days 16:47:18.684825,335,1.3333333333333333,0.0,870,0,2550.0
466950.0,3,1.0,1360,3880,1.0,3,7,1060,300.0,1963,1110,3880,21616 days 16:47:18.684825,226,3.0,3.533333333333333,250,0,760.0
262500.0,3,1.75,2259,26831,1.5,5,7,1491,768.0,1908,1980,15794,41705 days 16:47:18.684825,198,1.7142857142857142,1.94140625,279,11037,723.0
762300.0,4,2.5,3880,14550,2.0,3,1,3880,0.0,1987,3240,14045,12850 days 16:47:18.684825,126,1.6,0.0,640,505,3880.0
733000.0,6,2.75,2730,5000,1.0,3,8,1780,950.0,1962,2090,5000,21981 days 16:47:18.684825,026,2.1818181818181817,1.8736842105263158,640,0,830.0
439000.0,4,2.5,2800,17279,1.0,3,7,1560,1240.0,1957,3060,13423,23807 days 16:47:18.684825,104,1.6,1.2580645161290323,-260,3856,320.0
1160000.0,5,3.25,4290,7019,2.5,4,1,3590,700.0,1927,1920,4000,34765 days 16:47:18.684825,316,1.5384615384615385,5.128571428571429,2370,3019,2890.0
420000.0,3,2.5,1770,3993,2.0,3,8,1770,0.0,1999,1820,4046,8467 days 16:47:18.684825,281,1.2,0.0,-50,-53,1770.0
549000.0,3,2.25,1920,10961,2.0,3,8,1920,0.0,1981,2000,10706,15041 days 16:47:18.684825,199,1.3333333333333333,0.0,-80,255,1920.0
518000.0,4,2.5,2320,4000,1.5,5,8,1510,810.0,1905,1490,4500,42800 days 16:47:18.684825,238,1.6,1.8641975308641976,830,-500,700.0
695000.0,4,2.5,2961,12146,2.0,3,9,2961,0.0,1998,2620,17749,8832 days 16:47:18.684825,154,1.6,0.0,341,-5603,2961.0
485000.0,3,2.5,1680,7385,2.0,3,8,1680,0.0,1988,1970,7470,12485 days 16:47:18.684825,005,1.2,0.0,-290,-85,1680.0
280000.0,3,1.75,1590,27200,1.5,4,6,1590,0.0,1926,1820,74052,35130 days 16:47:18.684825,154,1.7142857142857142,0.0,-230,-46852,1590.0
306500.0,2,1.0,1420,16400,1.5,4,6,1420,0.0,1943,1900,16400,28921 days 16:47:18.684825,127,2.0,0.0,-480,0,1420.0
720000.0,2,1.0,1370,9460,1.0,3,6,1370,0.0,1950,1690,9930,26364 days 16:47:18.684825,080,2.0,0.0,-320,-470,1370.0
277500.0,3,2.5,2620,4558,2.0,3,7,2620,0.0,2010,1670,4558,4449 days 16:47:18.684825,322,1.2,0.0,950,0,2620.0
649000.0,3,2.0,1810,17006,2.0,3,8,1810,0.0,1913,2180,24911,39878 days 16:47:18.684825,248,1.5,0.0,-370,-7905,1810.0
3400000.0,4,3.5,4730,47870,1.0,3,1,2940,1790.0,1954,3250,49346,24903 days 16:47:18.684825,062,1.1428571428571428,1.6424581005586592,1480,-1476,1150.0
267800.0,2,1.0,700,6000,1.0,4,6,700,0.0,1949,920,6000,26729 days 16:47:18.684825,134,2.0,0.0,-220,0,700.0
625000.0,4,2.75,2390,6979,2.0,3,8,2390,0.0,1993,2090,6321,10658 days 16:47:18.684825,084,1.4545454545454546,0.0,300,658,2390.0
600000.0,4,2.5,2070,8127,1.5,3,9,1590,480.0,1924,2050,8131,35861 days 16:47:18.684825,260,1.6,3.3125,20,-4,1110.0
395000.0,4,2.0,1780,8149,1.5,4,7,1780,0.0,1948,1180,8149,27095 days 16:47:18.684825,290,2.0,0.0,600,0,1780.0
212000.0,4,2.5,1900,21780,1.5,3,7,1900,0.0,1940,1240,9166,30017 days 16:47:18.684825,117,1.6,0.0,660,12614,1900.0
425000.0,2,1.0,1040,4040,1.0,3,7,940,100.0,1928,1420,4040,34400 days 16:47:18.684825,346,2.0,9.4,-380,0,840.0
870000.0,4,1.75,2370,5000,1.5,3,8,1770,600.0,1919,2100,4550,37687 days 16:47:18.684825,131,2.2857142857142856,2.95,270,450,1170.0
420000.0,3,2.5,1970,3667,2.0,3,7,1970,0.0,2004,1970,3739,6641 days 16:47:18.684825,084,1.2,0.0,0,-72,1970.0
800000.0,4,2.25,2120,9921,2.0,3,8,2120,0.0,1981,1890,7845,15041 days 16:47:18.684825,093,1.7777777777777777,0.0,230,2076,2120.0
575000.0,3,2.5,1960,9535,2.0,3,8,1960,0.0,1989,2520,9206,12119 days 16:47:18.684825,126,1.2,0.0,-560,329,1960.0
915000.0,3,3.25,2660,4000,2.0,3,9,2170,490.0,2003,2660,4000,7006 days 16:47:18.684825,171,0.9230769230769231,4.428571428571429,0,0,1680.0
400000.0,3,2.25,1180,14258,2.0,3,7,1180,0.0,1987,1860,10390,12850 days 16:47:18.684825,246,1.3333333333333333,0.0,-680,3868,1180.0
750000.0,3,2.5,2390,6550,1.0,4,8,1440,950.0,1955,2010,6550,24538 days 16:47:18.684825,122,1.2,1.5157894736842106,380,0,490.0
235000.0,3,1.0,1250,7592,1.0,5,7,1250,0.0,1961,1250,7592,22346 days 16:47:18.684825,307,3.0,0.0,0,0,1250.0
599950.0,5,3.0,2600,13674,1.0,5,8,1300,1300.0,1967,2150,7800,20155 days 16:47:18.684825,316,1.6666666666666667,1.0,450,5874,0.0
481203.0,2,1.0,940,3800,1.0,3,7,940,0.0,1929,1680,3800,34034 days 16:47:18.684825,086,2.0,0.0,-740,0,940.0
1820000.0,5,3.0,3880,13000,2.0,3,1,3880,0.0,1972,3470,13701,18329 days 16:47:18.684825,170,1.6666666666666667,0.0,410,-701,3880.0
379000.0,3,2.5,1530,2913,2.0,4,7,1530,0.0,1986,1370,3783,13215 days 16:47:18.684825,190,1.2,0.0,160,-870,1530.0
626000.0,3,1.75,2430,5000,2.0,4,7,1760,670.0,1945,1320,4062,28190 days 16:47:18.684825,177,1.7142857142857142,2.626865671641791,1110,938,1090.0
535000.0,2,1.0,1030,4841,1.0,3,7,920,110.0,1939,1530,4944,30382 days 16:47:18.684825,141,2.0,8.363636363636363,-500,-103,810.0
1230000.0,4,2.5,2740,16007,2.0,3,9,2740,0.0,1984,2760,16008,13946 days 16:47:18.684825,160,1.6,0.0,-20,-1,2740.0
410000.0,2,1.5,1180,1034,2.0,3,7,1120,60.0,2001,1137,1034,7736 days 16:47:18.684825,205,1.3333333333333333,18.666666666666668,43,0,1060.0
940000.0,4,2.5,3090,9238,1.0,4,8,1680,1410.0,1967,2690,8500,20155 days 16:47:18.684825,041,1.6,1.1914893617021276,400,738,270.0
326250.0,3,1.0,1060,9663,1.0,3,7,1060,0.0,1967,1320,10162,20155 days 16:47:18.684825,202,3.0,0.0,-260,-499,1060.0
200000.0,2,1.0,790,5985,1.0,3,6,790,0.0,1944,1030,5985,28556 days 16:47:18.684825,248,2.0,0.0,-240,0,790.0
880000.0,4,2.5,3070,8250,1.0,5,8,2100,970.0,1958,2270,8800,23442 days 16:47:18.684825,225,1.6,2.1649484536082473,800,-550,1130.0
370000.0,2,2.0,2100,58488,2.0,3,9,2100,0.0,2005,1440,59346,6275 days 16:47:18.684825,307,1.0,0.0,660,-858,2100.0
190000.0,2,2.5,1100,1737,2.0,3,8,1100,0.0,2006,1610,2563,5910 days 16:47:18.684825,213,0.8,0.0,-510,-826,1100.0
160000.0,2,1.0,1070,4200,1.0,4,6,1070,0.0,1983,1150,4200,14311 days 16:47:18.684825,029,2.0,0.0,-80,0,1070.0
625000.0,4,3.0,2190,12825,1.0,3,9,1520,670.0,1989,3050,4673,12119 days 16:47:18.684825,235,1.3333333333333333,2.2686567164179103,-860,8152,850.0
590000.0,4,3.5,3450,6873,2.0,3,1,2750,700.0,2004,3450,6873,6641 days 16:47:18.684825,127,1.1428571428571428,3.9285714285714284,0,0,2050.0
575000.0,3,2.5,2070,3599,2.0,3,8,2070,0.0,1999,2070,6844,8467 days 16:47:18.684825,217,1.2,0.0,0,-3245,2070.0
470000.0,2,1.0,1190,5200,1.0,5,7,1190,0.0,1912,1550,5100,40244 days 16:47:18.684825,286,2.0,0.0,-360,100,1190.0
130000.0,2,1.0,600,1500,1.0,4,4,600,0.0,1900,1130,6000,44626 days 16:47:18.684825,070,2.0,0.0,-530,-4500,600.0
229000.0,3,1.0,940,8400,1.0,3,7,940,0.0,1958,1190,8400,23442 days 16:47:18.684825,111,3.0,0.0,-250,0,940.0
279900.0,3,1.0,1280,12928,1.5,3,6,1280,0.0,1942,1610,19467,29286 days 16:47:18.684825,234,3.0,0.0,-330,-6539,1280.0
307000.0,3,1.0,1370,7500,1.0,3,7,1370,0.0,1960,1160,7500,22712 days 16:47:18.684825,139,3.0,0.0,210,0,1370.0
399950.0,3,1.75,2450,15001,1.0,3,7,1980,470.0,1989,1790,15323,12119 days 16:47:18.684825,296,1.7142857142857142,4.212765957446808,660,-322,1510.0
405000.0,4,2.25,1970,15743,1.0,3,7,1370,600.0,1962,2390,11336,21981 days 16:47:18.684825,213,1.7777777777777777,2.283333333333333,-420,4407,770.0
539950.0,4,2.75,2910,9000,1.0,4,8,2130,780.0,1966,1970,9000,20520 days 16:47:18.684825,280,1.4545454545454546,2.730769230769231,940,0,1350.0
129000.0,2,1.0,760,5240,1.0,3,6,760,0.0,1949,980,5080,26729 days 16:47:18.684825,311,2.0,0.0,-220,160,760.0
340000.0,3,1.75,1270,8422,1.0,3,7,1270,0.0,1967,1470,8500,20155 days 16:47:18.684825,260,1.7142857142857142,0.0,-200,-78,1270.0
214950.0,3,1.75,1570,4875,1.0,4,7,1310,260.0,1977,1380,5200,16502 days 16:47:18.684825,162,1.7142857142857142,5.038461538461538,190,-325,1050.0
450000.0,4,2.75,2310,5650,1.0,3,8,1330,980.0,1952,2300,5650,25634 days 16:47:18.684825,176,1.4545454545454546,1.3571428571428572,10,0,350.0
515000.0,3,1.75,1900,5000,1.0,4,7,950,950.0,1925,1420,5000,35495 days 16:47:18.684825,063,1.7142857142857142,1.0,480,0,0.0
1400000.0,4,2.25,3780,5160,2.0,4,9,2510,1270.0,1907,2740,5160,42070 days 16:47:18.684825,234,1.7777777777777777,1.9763779527559056,1040,0,1240.0
230000.0,3,1.0,1060,9946,1.0,4,7,1060,0.0,1956,1310,10619,24173 days 16:47:18.684825,177,3.0,0.0,-250,-673,1060.0
681000.0,3,1.75,1880,10032,1.0,4,8,1880,0.0,1984,2430,9732,13946 days 16:47:18.684825,188,1.7142857142857142,0.0,-550,300,1880.0
580000.0,2,1.0,860,4013,1.0,3,7,860,0.0,1925,1490,4013,35495 days 16:47:18.684825,072,2.0,0.0,-630,0,860.0
295000.0,2,2.0,1590,8000,1.0,3,7,910,680.0,1984,1590,8364,13946 days 16:47:18.684825,076,1.0,1.338235294117647,0,-364,230.0
286000.0,2,1.0,1170,6543,1.0,3,7,1170,0.0,1913,1550,7225,39878 days 16:47:18.684825,211,2.0,0.0,-380,-682,1170.0
425000.0,3,1.5,1190,8100,1.0,3,7,830,360.0,1947,1256,8100,27460 days 16:47:18.684825,008,2.0,2.3055555555555554,-66,0,470.0
170000.0,2,1.0,1300,11400,1.0,3,7,1300,0.0,1961,1360,9750,22346 days 16:47:18.684825,346,2.0,0.0,-60,1650,1300.0
380000.0,3,2.0,1660,8281,1.0,3,7,1660,0.0,1949,1660,7559,26729 days 16:47:18.684825,148,1.5,0.0,0,722,1660.0
506000.0,3,2.0,1160,6120,1.0,3,7,1160,0.0,1947,1150,5100,27460 days 16:47:18.684825,126,1.5,0.0,10,1020,1160.0
315000.0,3,2.5,1950,9618,2.0,3,7,1950,0.0,1992,1890,7133,11024 days 16:47:18.684825,265,1.2,0.0,60,2485,1950.0
449950.0,4,2.5,2470,3811,2.0,3,8,2470,0.0,1999,2400,4266,8467 days 16:47:18.684825,168,1.6,0.0,70,-455,2470.0
255000.0,3,1.0,1430,12420,1.0,3,7,1430,0.0,1964,1900,10350,21251 days 16:47:18.684825,090,3.0,0.0,-470,2070,1430.0
289000.0,3,2.5,1970,9607,2.0,3,7,1090,880.0,1988,2020,9608,12485 days 16:47:18.684825,175,1.2,1.2386363636363635,-50,-1,210.0
389000.0,3,1.75,1400,10018,1.0,4,7,1400,0.0,1962,1350,9300,21981 days 16:47:18.684825,240,1.7142857142857142,0.0,50,718,1400.0
327000.0,3,1.5,1510,344124,1.0,4,7,1510,0.0,1964,1750,169884,21251 days 16:47:18.684825,202,2.0,0.0,-240,174240,1510.0
2890000.0,7,3.0,5350,14400,2.5,4,1,5020,330.0,1910,3050,7469,40974 days 16:47:18.684825,269,2.3333333333333335,15.212121212121213,2300,6931,4690.0
210000.0,3,1.0,920,6612,1.0,3,6,920,0.0,1948,1860,8424,27095 days 16:47:18.684825,195,3.0,0.0,-940,-1812,920.0
1680000.0,4,3.75,7620,29536,2.0,3,1,5980,1640.0,2005,2840,20809,6275 days 16:47:18.684825,329,1.0666666666666667,3.6463414634146343,4780,8727,4340.0
360000.0,4,2.5,2490,4751,2.0,3,7,2490,0.0,2001,2510,5233,7736 days 16:47:18.684825,363,1.6,0.0,-20,-482,2490.0
875000.0,4,2.5,3030,16000,2.0,3,1,3030,0.0,1990,3670,16641,11754 days 16:47:18.684825,117,1.6,0.0,-640,-641,3030.0
550000.0,4,2.25,1650,7200,1.0,3,8,1650,0.0,1967,2180,7950,20155 days 16:47:18.684825,308,1.7777777777777777,0.0,-530,-750,1650.0
257500.0,3,1.5,1210,12500,1.0,3,7,1210,0.0,1962,1210,12500,21981 days 16:47:18.684825,198,2.0,0.0,0,0,1210.0
1080000.0,4,2.75,2990,7389,1.5,4,8,2090,900.0,1923,2510,6157,36226 days 16:47:18.684825,344,1.4545454545454546,2.3222222222222224,480,1232,1190.0
202950.0,2,1.0,1060,5144,1.0,5,6,1060,0.0,1969,1130,5200,19424 days 16:47:18.684825,301,2.0,0.0,-70,-56,1060.0
622000.0,4,1.75,2680,6120,1.0,5,8,1340,1340.0,1959,2320,6840,23077 days 16:47:18.684825,303,2.2857142857142856,1.0,360,-720,0.0
455000.0,4,1.75,1790,45738,1.0,3,8,1410,380.0,1976,1870,47480,16868 days 16:47:18.684825,044,2.2857142857142856,3.710526315789474,-80,-1742,1030.0
805000.0,3,2.5,2690,17461,2.0,3,1,2690,0.0,1997,3610,16887,9197 days 16:47:18.684825,321,1.2,0.0,-920,574,2690.0
257000.0,2,1.0,770,9497,1.0,3,6,770,0.0,1950,1550,7532,26364 days 16:47:18.684825,251,2.0,0.0,-780,1965,770.0
744500.0,5,2.5,2700,16570,1.0,4,8,1750,950.0,1967,2570,11840,20155 days 16:47:18.684825,176,2.0,1.8421052631578947,130,4730,800.0
885000.0,4,2.5,2620,9157,2.0,3,8,2620,0.0,1996,2240,7405,9563 days 16:47:18.684825,103,1.6,0.0,380,1752,2620.0
355000.0,2,2.25,930,747,2.0,3,8,630,300.0,2007,940,6000,5545 days 16:47:18.684825,175,0.8888888888888888,2.1,-10,-5253,330.0
240000.0,3,1.0,1340,7000,1.0,4,7,1340,0.0,1978,1850,7904,16137 days 16:47:18.684825,232,3.0,0.0,-510,-904,1340.0
169000.0,3,1.5,1470,18459,2.0,4,6,1470,0.0,1916,1750,16074,38783 days 16:47:18.684825,231,2.0,0.0,-280,2385,1470.0
639900.0,3,2.5,2330,4160,2.0,4,8,2330,0.0,1992,2940,4500,11024 days 16:47:18.684825,087,1.2,0.0,-610,-340,2330.0
292000.0,3,1.75,1730,11325,1.0,5,7,1730,0.0,1972,2030,17859,18329 days 16:47:18.684825,155,1.7142857142857142,0.0,-300,-6534,1730.0
563500.0,4,2.5,2780,7838,2.0,3,9,2780,0.0,2004,3160,7848,6641 days 16:47:18.684825,265,1.6,0.0,-380,-10,2780.0
2750000.0,4,3.25,4430,21000,2.0,3,1,4430,0.0,1952,3930,20000,25634 days 16:47:18.684825,149,1.2307692307692308,0.0,500,1000,4430.0
661000.0,3,2.0,1820,4418,2.0,4,8,1820,0.0,1994,1920,13402,10293 days 16:47:18.684825,233,1.5,0.0,-100,-8984,1820.0
344000.0,2,2.0,1300,4659,1.0,3,8,1300,0.0,2005,1640,4780,6275 days 16:47:18.684825,255,1.0,0.0,-340,-121,1300.0
510000.0,1,1.0,680,6600,1.0,3,5,480,200.0,1916,1170,5500,38783 days 16:47:18.684825,112,1.0,2.4,-490,1100,280.0
289000.0,2,1.0,780,4132,1.0,3,7,780,0.0,1942,1100,5100,29286 days 16:47:18.684825,259,2.0,0.0,-320,-968,780.0
365000.0,3,2.25,2430,7614,1.5,3,8,1900,530.0,1979,1720,11250,15772 days 16:47:18.684825,239,1.3333333333333333,3.5849056603773586,710,-3636,1370.0
410000.0,3,1.5,1750,32500,1.0,4,7,1750,0.0,1966,1820,102801,20520 days 16:47:18.684825,211,2.0,0.0,-70,-70301,1750.0
535610.0,3,1.0,1610,5100,1.5,5,7,1010,600.0,1901,1270,5100,44261 days 16:47:18.684825,205,3.0,1.6833333333333333,340,0,410.0
397950.0,4,1.75,2120,7620,2.0,3,8,2120,0.0,1971,1820,7620,18694 days 16:47:18.684825,317,2.2857142857142856,0.0,300,0,2120.0
284000.0,3,1.75,1430,4850,1.0,3,7,930,500.0,1978,1430,4850,16137 days 16:47:18.684825,239,1.7142857142857142,1.86,0,0,430.0
201000.0,4,1.5,1360,8100,1.5,3,7,1360,0.0,1962,1300,8100,21981 days 16:47:18.684825,351,2.6666666666666665,0.0,60,0,1360.0
734000.0,4,2.25,2530,5000,1.5,4,7,1690,840.0,1925,1530,5000,35495 days 16:47:18.684825,349,1.7777777777777777,2.011904761904762,1000,0,850.0
357500.0,5,3.0,3270,9146,2.0,3,7,3270,0.0,2002,3200,6300,7371 days 16:47:18.684825,008,1.6666666666666667,0.0,70,2846,3270.0
550120.0,5,2.5,2620,8050,1.0,3,8,1520,1100.0,1975,2030,7676,17233 days 16:47:18.684825,288,2.0,1.3818181818181818,590,374,420.0
300000.0,3,1.5,1810,8232,1.0,3,8,1810,0.0,1988,2260,8491,12485 days 16:47:18.684825,069,2.0,0.0,-450,-259,1810.0
374950.0,3,2.5,2120,9653,2.0,3,8,2120,0.0,1992,1780,9801,11024 days 16:47:18.684825,231,1.2,0.0,340,-148,2120.0
602500.0,4,1.75,2190,41000,2.0,3,8,2190,0.0,1980,2590,35370,15407 days 16:47:18.684825,103,2.2857142857142856,0.0,-400,5630,2190.0
221000.0,3,1.0,980,7606,1.0,3,7,980,0.0,1954,980,8125,24903 days 16:47:18.684825,356,3.0,0.0,0,-519,980.0
920000.0,5,3.0,2230,4400,2.0,3,7,1730,500.0,1913,1280,1800,39878 days 16:47:18.684825,100,1.6666666666666667,3.46,950,2600,1230.0
235000.0,4,2.0,1540,9279,1.0,3,7,1540,0.0,1955,1540,5110,24538 days 16:47:18.684825,065,2.0,0.0,0,4169,1540.0
375000.0,3,1.0,980,7296,1.0,3,7,980,0.0,1967,1280,7296,20155 days 16:47:18.684825,216,3.0,0.0,-300,0,980.0
599000.0,4,2.5,2120,3640,2.0,3,8,2120,0.0,2005,2190,3640,6275 days 16:47:18.684825,239,1.6,0.0,-70,0,2120.0
562100.0,3,2.25,2090,12112,2.0,3,8,2090,0.0,1983,1760,12112,14311 days 16:47:18.684825,154,1.3333333333333333,0.0,330,0,2090.0
640000.0,3,2.5,1620,1377,2.0,3,8,1100,520.0,2009,1620,1251,4814 days 16:47:18.684825,075,1.2,2.1153846153846154,0,126,580.0
294000.0,3,2.0,1650,11256,1.0,4,7,1250,400.0,1957,1860,11256,23807 days 16:47:18.684825,324,1.5,3.125,-210,0,850.0
714000.0,4,2.5,3230,7766,2.0,3,9,3230,0.0,2005,3740,8344,6275 days 16:47:18.684825,363,1.6,0.0,-510,-578,3230.0
970000.0,4,3.25,2790,5420,1.0,3,9,1130,1660.0,1963,2530,7200,21616 days 16:47:18.684825,141,1.2307692307692308,0.6807228915662651,260,-1780,-530.0
280000.0,4,2.25,1600,7916,2.0,3,7,1600,0.0,1991,1540,7242,11389 days 16:47:18.684825,118,1.7777777777777777,0.0,60,674,1600.0
260000.0,4,2.5,1790,4358,2.0,3,7,1790,0.0,1993,1790,4305,10658 days 16:47:18.684825,316,1.6,0.0,0,53,1790.0
294000.0,3,1.5,2060,15050,1.5,4,7,2060,0.0,1938,1900,15674,30747 days 16:47:18.684825,323,2.0,0.0,160,-624,2060.0
255500.0,4,1.0,1370,41194,1.5,5,5,1370,0.0,1900,1590,84070,44626 days 16:47:18.684825,209,4.0,0.0,-220,-42876,1370.0
3300000.0,5,4.75,6200,13873,2.0,4,1,4440,1760.0,1989,2940,13525,12119 days 16:47:18.684825,247,1.0526315789473684,2.522727272727273,3260,348,2680.0
450000.0,3,2.0,1510,43560,1.0,3,7,1510,0.0,1954,2060,67756,24903 days 16:47:18.684825,128,1.5,0.0,-550,-24196,1510.0
368000.0,3,1.0,1280,9898,1.0,3,7,1280,0.0,1968,1290,9625,19790 days 16:47:18.684825,132,3.0,0.0,-10,273,1280.0
830000.0,4,2.25,2180,11056,1.0,3,8,1370,810.0,1963,2090,8747,21616 days 16:47:18.684825,314,1.7777777777777777,1.691358024691358,90,2309,560.0
282500.0,2,1.75,1440,11210,1.0,4,6,1130,310.0,1935,1250,9381,31843 days 16:47:18.684825,196,1.1428571428571428,3.6451612903225805,190,1829,820.0
335000.0,3,2.25,1580,16215,1.0,4,7,1580,0.0,1978,1450,16215,16137 days 16:47:18.684825,122,1.3333333333333333,0.0,130,0,1580.0
558000.0,2,2.0,1580,5750,1.0,5,6,790,790.0,1910,1580,5750,40974 days 16:47:18.684825,188,1.0,1.0,0,0,0.0
270000.0,4,1.5,1730,8505,1.5,4,7,1730,0.0,1961,1510,8505,22346 days 16:47:18.684825,055,2.6666666666666665,0.0,220,0,1730.0
152000.0,2,1.0,700,13500,1.0,3,4,700,0.0,1920,1600,10124,37322 days 16:47:18.684825,206,2.0,0.0,-900,3376,700.0
493000.0,4,1.75,2030,18295,1.5,4,7,2030,0.0,1975,1970,7307,17233 days 16:47:18.684825,168,2.2857142857142856,0.0,60,10988,2030.0
740000.0,4,2.5,2500,10330,2.0,3,1,2500,0.0,1992,2710,8375,11024 days 16:47:18.684825,227,1.6,0.0,-210,1955,2500.0
789800.0,3,2.5,2605,2216,2.0,3,9,2090,515.0,1979,2605,2300,15772 days 16:47:18.684825,072,1.2,4.058252427184466,0,-84,1575.0
275000.0,2,1.0,910,4191,1.0,3,6,910,0.0,1910,1480,6050,40974 days 16:47:18.684825,128,2.0,0.0,-570,-1859,910.0
1500000.0,6,2.5,3560,6480,2.5,4,1,3560,0.0,1914,2780,6480,39513 days 16:47:18.684825,127,2.4,0.0,780,0,3560.0
424000.0,3,1.75,1140,3395,1.0,5,7,620,520.0,1925,1480,3500,35495 days 16:47:18.684825,272,1.7142857142857142,1.1923076923076923,-340,-105,100.0
715000.0,2,1.0,1000,3513,1.0,4,5,1000,0.0,1914,1930,4920,39513 days 16:47:18.684825,086,2.0,0.0,-930,-1407,1000.0
600000.0,4,2.5,3010,7953,2.0,3,9,3010,0.0,2000,2670,6202,8102 days 16:47:18.684825,211,1.6,0.0,340,1751,3010.0
802000.0,2,1.75,2110,8700,1.0,4,9,1760,350.0,1960,2120,9500,22712 days 16:47:18.684825,225,1.1428571428571428,5.0285714285714285,-10,-800,1410.0
165000.0,3,1.0,910,8700,1.0,4,6,910,0.0,1943,1090,8700,28921 days 16:47:18.684825,207,3.0,0.0,-180,0,910.0
750000.0,4,3.25,2050,5000,2.0,4,8,1370,680.0,1987,1720,5000,12850 days 16:47:18.684825,160,1.2307692307692308,2.014705882352941,330,0,690.0
405000.0,2,1.0,1090,10481,1.0,2,7,780,310.0,1981,1160,10533,15041 days 16:47:18.684825,224,2.0,2.5161290322580645,-70,-52,470.0
521900.0,3,2.5,2100,12338,2.0,3,9,2100,0.0,1997,2320,6257,9197 days 16:47:18.684825,337,1.2,0.0,-220,6081,2100.0
275000.0,3,1.0,1000,8018,1.0,3,7,1000,0.0,1969,1270,8000,19424 days 16:47:18.684825,203,3.0,0.0,-270,18,1000.0
600000.0,5,3.25,4410,58157,2.0,4,9,2330,2080.0,2001,2460,42565,7736 days 16:47:18.684825,288,1.5384615384615385,1.1201923076923077,1950,15592,250.0
442500.0,3,1.75,1800,10200,1.0,3,8,1800,0.0,1967,2140,10128,20155 days 16:47:18.684825,139,1.7142857142857142,0.0,-340,72,1800.0
229950.0,2,1.0,920,7716,1.0,3,6,920,0.0,1944,1410,7128,28556 days 16:47:18.684825,252,2.0,0.0,-490,588,920.0
274950.0,3,2.0,1410,7265,1.0,4,7,1410,0.0,1983,1390,8060,14311 days 16:47:18.684825,020,1.5,0.0,20,-795,1410.0
407185.0,3,1.75,1860,48076,1.5,4,8,1860,0.0,1929,1410,23066,34034 days 16:47:18.684825,311,1.7142857142857142,0.0,450,25010,1860.0
468000.0,4,2.5,2100,8400,1.0,4,7,1240,860.0,1976,1980,8610,16868 days 16:47:18.684825,190,1.6,1.441860465116279,120,-210,380.0
450000.0,2,1.0,1030,4365,1.0,3,7,1030,0.0,1942,1420,4268,29286 days 16:47:18.684825,273,2.0,0.0,-390,97,1030.0
219950.0,2,1.0,940,8997,1.0,5,7,940,0.0,1955,1110,9126,24538 days 16:47:18.684825,296,2.0,0.0,-170,-129,940.0
275000.0,2,2.5,1340,5995,2.0,3,7,1340,0.0,1989,1540,6616,12119 days 16:47:18.684825,022,0.8,0.0,-200,-621,1340.0
229950.0,2,1.0,850,6000,1.0,3,6,850,0.0,1924,1100,6000,35861 days 16:47:18.684825,100,2.0,0.0,-250,0,850.0
675000.0,3,1.75,2130,4400,1.0,3,7,1430,700.0,1922,1710,3300,36591 days 16:47:18.684825,329,1.7142857142857142,2.0428571428571427,420,1100,730.0
412950.0,4,2.5,2430,6796,2.0,3,8,2430,0.0,1993,2450,8400,10658 days 16:47:18.684825,082,1.6,0.0,-20,-1604,2430.0
670000.0,5,2.25,2290,39000,2.0,3,8,2290,0.0,1979,2750,39900,15772 days 16:47:18.684825,119,2.2222222222222223,0.0,-460,-900,2290.0
420000.0,3,1.75,1230,10005,1.0,4,7,1230,0.0,1963,1530,8560,21616 days 16:47:18.684825,266,1.7142857142857142,0.0,-300,1445,1230.0
358000.0,3,1.5,1150,27319,1.0,4,6,1150,0.0,1976,1700,30691,16868 days 16:47:18.684825,013,2.0,0.0,-550,-3372,1150.0
680000.0,3,2.5,2120,3600,2.0,3,9,2120,0.0,2005,2540,4592,6275 days 16:47:18.684825,114,1.2,0.0,-420,-992,2120.0
380000.0,2,1.0,980,3400,1.0,3,7,980,0.0,1923,1200,3420,36226 days 16:47:18.684825,308,2.0,0.0,-220,-20,980.0
515000.0,3,2.5,2130,219978,2.0,3,8,2130,0.0,1986,3340,217800,13215 days 16:47:18.684825,339,1.2,0.0,-1210,2178,2130.0
325000.0,2,1.0,1050,4800,1.0,4,7,1050,0.0,1969,1230,4800,19424 days 16:47:18.684825,231,2.0,0.0,-180,0,1050.0
875000.0,3,2.5,1820,6848,1.0,4,7,1820,0.0,1953,2080,11700,25268 days 16:47:18.684825,338,1.2,0.0,-260,-4852,1820.0
426000.0,3,2.5,2210,5750,2.0,3,7,1710,500.0,1914,1350,5750,39513 days 16:47:18.684825,110,1.2,3.42,860,0,1210.0
868500.0,5,2.5,2490,9639,1.0,4,8,1610,880.0,1959,2290,9958,23077 days 16:47:18.684825,258,2.0,1.8295454545454546,200,-319,730.0
657500.0,4,2.75,4140,24190,2.0,3,1,4140,0.0,2002,3950,24190,7371 days 16:47:18.684825,162,1.4545454545454546,0.0,190,0,4140.0
366000.0,2,1.0,1210,3090,1.0,3,6,860,350.0,1926,1210,3348,35130 days 16:47:18.684825,261,2.0,2.4571428571428573,0,-258,510.0
300000.0,4,2.0,2050,8750,1.0,3,7,1300,750.0,1967,2050,8750,20155 days 16:47:18.684825,251,2.0,1.7333333333333334,0,0,550.0
810000.0,3,1.75,2060,3300,2.0,4,9,1500,560.0,1918,1830,3712,38052 days 16:47:18.684825,079,1.7142857142857142,2.6785714285714284,230,-412,940.0
460000.0,4,1.75,1560,7200,1.0,3,6,860,700.0,1943,1420,7200,28921 days 16:47:18.684825,107,2.2857142857142856,1.2285714285714286,140,0,160.0
260000.0,3,1.75,1460,10000,1.0,4,8,1460,0.0,1967,1930,14175,20155 days 16:47:18.684825,078,1.7142857142857142,0.0,-470,-4175,1460.0
557865.0,4,2.5,3030,6813,2.0,3,9,3030,0.0,1987,2310,8682,12850 days 16:47:18.684825,316,1.6,0.0,720,-1869,3030.0
295000.0,4,1.0,980,3000,1.5,4,7,980,0.0,1914,1525,3000,39513 days 16:47:18.684825,110,4.0,0.0,-545,0,980.0
375000.0,4,2.25,1450,7245,1.0,5,7,1450,0.0,1950,1660,7800,26364 days 16:47:18.684825,248,1.7777777777777777,0.0,-210,-555,1450.0
2110000.0,3,2.25,3230,17833,2.0,4,9,3230,0.0,1973,3690,17162,17963 days 16:47:18.684825,171,1.3333333333333333,0.0,-460,671,3230.0
307300.0,2,2.0,1520,1020,3.0,3,7,1520,0.0,1999,1500,1245,8467 days 16:47:18.684825,231,1.0,0.0,20,-225,1520.0
225000.0,4,1.0,1410,7000,1.5,3,7,1410,0.0,1963,1540,7000,21616 days 16:47:18.684825,239,4.0,0.0,-130,0,1410.0
290000.0,3,1.75,1390,13200,2.0,3,7,1390,0.0,1979,1430,10725,15772 days 16:47:18.684825,311,1.7142857142857142,0.0,-40,2475,1390.0
690000.0,4,2.0,2230,5000,1.5,4,7,1510,720.0,1922,2140,5000,36591 days 16:47:18.684825,324,2.0,2.0972222222222223,90,0,790.0
825000.0,4,2.25,2110,12653,2.0,4,8,2110,0.0,1972,2350,10980,18329 days 16:47:18.684825,186,1.7777777777777777,0.0,-240,1673,2110.0
645000.0,3,1.75,2270,11472,1.0,4,7,1370,900.0,1956,2270,8340,24173 days 16:47:18.684825,183,1.7142857142857142,1.5222222222222221,0,3132,470.0
590000.0,4,2.25,2530,10611,1.0,5,8,1320,1210.0,1977,2530,10125,16502 days 16:47:18.684825,048,1.7777777777777777,1.0909090909090908,0,486,110.0
667000.0,5,2.0,1900,5470,1.0,3,7,1180,720.0,1930,1300,3250,33669 days 16:47:18.684825,206,2.5,1.6388888888888888,600,2220,460.0
664000.0,4,2.5,2390,8432,2.0,3,9,2390,0.0,1998,2710,7417,8832 days 16:47:18.684825,268,1.6,0.0,-320,1015,2390.0
452100.0,4,2.5,3160,6540,1.0,3,8,1580,1580.0,1959,1990,7090,23077 days 16:47:18.684825,118,1.6,1.0,1170,-550,0.0
290000.0,2,1.0,900,2728,2.0,3,7,900,0.0,1998,900,2728,8832 days 16:47:18.684825,336,2.0,0.0,0,0,900.0
950000.0,3,3.0,3610,17483,2.0,4,8,3610,0.0,1954,2230,12600,24903 days 16:47:18.684825,112,1.0,0.0,1380,4883,3610.0
662500.0,3,2.0,2070,4200,1.5,4,7,1670,400.0,1906,1490,4560,42435 days 16:47:18.684825,030,1.5,4.175,580,-360,1270.0
475000.0,4,2.5,1850,5444,2.0,5,7,1850,0.0,1981,1540,5000,15041 days 16:47:18.684825,183,1.6,0.0,310,444,1850.0
450000.0,3,1.5,1440,9711,1.0,3,7,1140,300.0,1956,1590,9711,24173 days 16:47:18.684825,258,2.0,3.8,-150,0,840.0
538250.0,3,2.25,2590,15229,2.0,3,8,2590,0.0,1984,2590,15229,13946 days 16:47:18.684825,188,1.3333333333333333,0.0,0,0,2590.0
329950.0,2,1.0,1140,5250,1.5,4,6,1140,0.0,1949,1450,5250,26729 days 16:47:18.684825,125,2.0,0.0,-310,0,1140.0
1100000.0,4,3.5,2760,5040,2.0,3,9,2760,0.0,1955,2370,5760,24538 days 16:47:18.684825,022,1.1428571428571428,0.0,390,-720,2760.0
307000.0,5,1.5,1310,4800,1.5,3,6,1110,200.0,1929,960,4800,34034 days 16:47:18.684825,293,3.3333333333333335,5.55,350,0,910.0
433000.0,3,1.75,1870,7189,1.0,3,7,1270,600.0,1959,1780,6200,23077 days 16:47:18.684825,161,1.7142857142857142,2.1166666666666667,90,989,670.0
212000.0,3,2.25,1900,18000,1.0,4,7,1280,620.0,1968,1920,15000,19790 days 16:47:18.684825,014,1.3333333333333333,2.064516129032258,-20,3000,660.0
750000.0,5,2.75,2860,6000,2.5,4,8,2380,480.0,1902,2240,6000,43896 days 16:47:18.684825,251,1.8181818181818181,4.958333333333333,620,0,1900.0
279000.0,3,2.0,1640,5650,1.0,3,7,1640,0.0,2003,2250,5488,7006 days 16:47:18.684825,329,1.5,0.0,-610,162,1640.0
476000.0,3,1.0,1140,5500,1.5,4,6,1140,0.0,1908,1690,4400,41705 days 16:47:18.684825,162,3.0,0.0,-550,1100,1140.0
368000.0,5,1.75,2590,9394,1.0,4,7,1390,1200.0,1963,2580,9049,21616 days 16:47:18.684825,085,2.857142857142857,1.1583333333333334,10,345,190.0
228950.0,4,3.0,2160,5200,1.0,3,7,1320,840.0,1978,1460,5144,16137 days 16:47:18.684825,288,1.3333333333333333,1.5714285714285714,700,56,480.0
568450.0,5,3.5,3260,58806,2.0,4,8,3260,0.0,1969,1810,17927,19424 days 16:47:18.684825,169,1.4285714285714286,0.0,1450,40879,3260.0
619000.0,4,1.75,1660,3800,1.5,3,7,1660,0.0,1926,1660,3767,35130 days 16:47:18.684825,156,2.2857142857142856,0.0,0,33,1660.0
275000.0,3,2.25,1640,6044,2.0,3,7,1640,0.0,1996,1600,7418,9563 days 16:47:18.684825,210,1.3333333333333333,0.0,40,-1374,1640.0
321500.0,4,2.5,2620,5457,2.0,3,8,2620,0.0,2003,2740,5816,7006 days 16:47:18.684825,300,1.6,0.0,-120,-359,2620.0
230000.0,3,1.75,950,6000,1.0,3,6,790,160.0,1939,1360,6000,30382 days 16:47:18.684825,128,1.7142857142857142,4.9375,-410,0,630.0
179500.0,3,1.0,900,8100,1.0,4,6,900,0.0,1959,1000,7830,23077 days 16:47:18.684825,028,3.0,0.0,-100,270,900.0
460000.0,3,2.25,1650,7313,1.0,3,7,1220,430.0,1975,1690,7252,17233 days 16:47:18.684825,230,1.3333333333333333,2.8372093023255816,-40,61,790.0
286000.0,3,2.5,1800,3980,2.0,3,7,1800,0.0,2006,2580,4307,5910 days 16:47:18.684825,057,1.2,0.0,-780,-327,1800.0
427500.0,3,1.0,1480,4200,1.5,3,7,1480,0.0,1925,1460,3600,35495 days 16:47:18.684825,304,3.0,0.0,20,600,1480.0
400000.0,3,1.0,1040,6250,1.0,3,7,1040,0.0,1942,1770,6250,29286 days 16:47:18.684825,142,3.0,0.0,-730,0,1040.0
675000.0,3,3.5,2300,5611,1.0,3,8,2300,0.0,2004,2170,5926,6641 days 16:47:18.684825,175,0.8571428571428571,0.0,130,-315,2300.0
350000.0,3,1.0,2480,8906,1.0,3,7,1240,1240.0,1969,1800,8906,19424 days 16:47:18.684825,057,3.0,1.0,680,0,0.0
385000.0,4,1.75,1970,10358,1.0,3,8,1540,430.0,1977,1900,10358,16502 days 16:47:18.684825,326,2.2857142857142856,3.5813953488372094,70,0,1110.0
315000.0,2,1.0,970,18557,1.0,3,6,970,0.0,1939,1150,7200,30382 days 16:47:18.684825,021,2.0,0.0,-180,11357,970.0
820000.0,4,2.5,2920,252648,2.0,3,1,2920,0.0,2002,2180,71874,7371 days 16:47:18.684825,210,1.6,0.0,740,180774,2920.0
205000.0,3,1.0,970,7700,1.0,4,7,970,0.0,1959,1160,8250,23077 days 16:47:18.684825,105,3.0,0.0,-190,-550,970.0
500000.0,2,1.0,680,5250,1.0,4,6,680,0.0,1922,1620,5461,36591 days 16:47:18.684825,339,2.0,0.0,-940,-211,680.0
599000.0,4,2.5,2640,6738,2.0,4,8,2640,0.0,1989,2180,5782,12119 days 16:47:18.684825,234,1.6,0.0,460,956,2640.0
2230000.0,3,4.0,4200,30120,2.0,4,1,3600,600.0,1933,2760,12200,32573 days 16:47:18.684825,063,0.75,6.0,1440,17920,3000.0
299000.0,1,2.5,1980,7521,1.0,4,7,1180,800.0,1979,1980,8000,15772 days 16:47:18.684825,111,0.4,1.475,0,-479,380.0
947500.0,3,2.75,2980,27144,1.5,5,8,2180,800.0,1917,1890,12514,38417 days 16:47:18.684825,132,1.0909090909090908,2.725,1090,14630,1380.0
385000.0,3,3.25,1630,1677,3.0,3,8,1630,0.0,2007,1220,1677,5545 days 16:47:18.684825,174,0.9230769230769231,0.0,410,0,1630.0
639950.0,2,1.75,1780,4520,1.0,5,7,890,890.0,1925,1560,4520,35495 days 16:47:18.684825,223,1.1428571428571428,1.0,220,0,0.0
824000.0,2,1.0,1210,8400,1.0,3,8,780,430.0,2000,1860,6000,8102 days 16:47:18.684825,314,2.0,1.813953488372093,-650,2400,350.0
199950.0,3,1.0,1010,7245,1.0,3,7,1010,0.0,1969,1300,8236,19424 days 16:47:18.684825,153,3.0,0.0,-290,-991,1010.0
1010000.0,3,2.5,2570,5000,1.0,4,8,1480,1090.0,1940,2420,5484,30017 days 16:47:18.684825,098,1.2,1.3577981651376148,150,-484,390.0
950000.0,4,2.25,2770,5320,2.0,3,9,2440,330.0,2013,2100,6011,3353 days 16:47:18.684825,093,1.7777777777777777,7.393939393939394,670,-691,2110.0
822000.0,3,2.5,2290,9158,2.0,4,8,2290,0.0,1984,2210,9588,13946 days 16:47:18.684825,266,1.2,0.0,80,-430,2290.0
473600.0,4,1.5,1780,8400,1.0,3,7,1080,700.0,1969,1660,8400,19424 days 16:47:18.684825,310,2.6666666666666665,1.542857142857143,120,0,380.0
490000.0,5,2.0,2150,4500,1.5,3,8,2150,0.0,1938,1300,4500,30747 days 16:47:18.684825,033,2.5,0.0,850,0,2150.0
245000.0,3,1.75,1920,9306,1.0,3,7,1000,920.0,1984,1860,8458,13946 days 16:47:18.684825,125,1.7142857142857142,1.0869565217391304,60,848,80.0
199000.0,4,1.0,1220,11730,1.0,4,7,1220,0.0,1960,1270,9520,22712 days 16:47:18.684825,240,4.0,0.0,-50,2210,1220.0
1340000.0,3,3.0,2960,5500,2.0,3,1,2440,520.0,1937,2960,5876,31112 days 16:47:18.684825,127,1.0,4.6923076923076925,0,-376,1920.0
418000.0,3,1.75,1500,19113,1.0,3,7,1500,0.0,1984,1820,18151,13946 days 16:47:18.684825,290,1.7142857142857142,0.0,-320,962,1500.0
450000.0,7,3.5,2830,8625,1.0,4,8,1830,1000.0,1957,1570,8400,23807 days 16:47:18.684825,070,2.0,1.83,1260,225,830.0
280000.0,3,2.5,1580,7000,2.0,3,8,1580,0.0,1992,2110,7062,11024 days 16:47:18.684825,199,1.2,0.0,-530,-62,1580.0
273000.0,3,2.25,1230,11601,1.0,4,7,910,320.0,1992,1820,8465,11024 days 16:47:18.684825,062,1.3333333333333333,2.84375,-590,3136,590.0
549000.0,4,2.5,2910,6338,2.0,3,8,2910,0.0,2008,2500,5877,5180 days 16:47:18.684825,125,1.6,0.0,410,461,2910.0
913888.0,5,2.25,2370,15512,2.0,4,9,2370,0.0,1981,2380,15100,15041 days 16:47:18.684825,176,2.2222222222222223,0.0,-10,412,2370.0
689888.0,4,2.25,1930,3500,1.5,5,8,1540,390.0,1916,1800,5000,38783 days 16:47:18.684825,199,1.7777777777777777,3.948717948717949,130,-1500,1150.0
305000.0,4,2.0,1780,5043,1.0,3,7,870,910.0,1993,1350,5044,10658 days 16:47:18.684825,346,2.0,0.9560439560439561,430,-1,-40.0
602500.0,4,2.5,2760,6850,2.0,3,9,2760,0.0,1999,2640,9803,8467 days 16:47:18.684825,149,1.6,0.0,120,-2953,2760.0
355000.0,2,1.75,1620,3640,1.0,3,7,900,720.0,1929,1590,5538,34034 days 16:47:18.684825,114,1.1428571428571428,1.25,30,-1898,180.0
756000.0,3,2.5,2160,7525,2.0,3,9,2160,0.0,1986,2470,7941,13215 days 16:47:18.684825,233,1.2,0.0,-310,-416,2160.0
289950.0,4,2.25,2190,6906,1.0,4,7,1040,1150.0,1977,1250,6440,16502 days 16:47:18.684825,113,1.7777777777777777,0.9043478260869565,940,466,-110.0
800000.0,3,2.5,3240,7857,2.0,3,1,3240,0.0,1994,2970,7857,10293 days 16:47:18.684825,125,1.2,0.0,270,0,3240.0
403000.0,2,1.0,720,3255,1.0,4,6,720,0.0,1905,1430,3170,42800 days 16:47:18.684825,336,2.0,0.0,-710,85,720.0
350000.0,3,2.25,1410,1340,2.0,3,8,1370,40.0,1967,1730,2748,20155 days 16:47:18.684825,103,1.3333333333333333,34.25,-320,-1408,1330.0
1290000.0,5,3.5,2980,5100,2.0,3,1,2370,610.0,2015,1780,5100,2623 days 16:47:18.684825,085,1.4285714285714286,3.8852459016393444,1200,0,1760.0
525126.0,5,2.25,1950,8025,1.0,3,7,1150,800.0,1960,1780,8560,22712 days 16:47:18.684825,261,2.2222222222222223,1.4375,170,-535,350.0
241450.0,3,1.0,1100,8138,1.0,3,7,1100,0.0,1949,1440,8131,26729 days 16:47:18.684825,224,3.0,0.0,-340,7,1100.0
320000.0,3,1.5,1400,9087,1.0,3,7,1400,0.0,1954,1490,8380,24903 days 16:47:18.684825,022,2.0,0.0,-90,707,1400.0
234000.0,4,2.0,1710,7455,1.0,3,7,1030,680.0,1975,1710,7350,17233 days 16:47:18.684825,296,2.0,1.5147058823529411,0,105,350.0
441000.0,5,2.5,2000,3600,1.0,3,6,1150,850.0,1987,1410,3600,12850 days 16:47:18.684825,325,2.0,1.3529411764705883,590,0,300.0
474500.0,5,2.5,2000,3600,1.0,3,6,1150,850.0,1987,1410,3600,12850 days 16:47:18.684825,076,2.0,1.3529411764705883,590,0,300.0
705000.0,3,1.0,1440,2618,1.5,4,7,1440,0.0,1906,1850,3990,42435 days 16:47:18.684825,112,3.0,0.0,-410,-1372,1440.0
517500.0,4,2.5,1520,3370,2.0,3,8,1520,0.0,1994,1860,4486,10293 days 16:47:18.684825,099,1.6,0.0,-340,-1116,1520.0
142500.0,4,0.75,1440,13300,1.0,3,6,1440,0.0,1948,1460,11100,27095 days 16:47:18.684825,168,5.333333333333333,0.0,-20,2200,1440.0
310000.0,2,1.5,1010,10005,2.0,3,7,1010,0.0,1981,1210,7794,15041 days 16:47:18.684825,310,1.3333333333333333,0.0,-200,2211,1010.0
749500.0,4,2.5,2440,9727,2.0,3,9,2440,0.0,1987,2370,11503,12850 days 16:47:18.684825,301,1.6,0.0,70,-1776,2440.0
360000.0,5,3.0,2480,7200,1.0,3,7,1560,920.0,1999,1910,9432,8467 days 16:47:18.684825,119,1.6666666666666667,1.6956521739130435,570,-2232,640.0
267500.0,3,1.0,1090,22080,1.0,5,7,1090,0.0,1967,1590,19457,20155 days 16:47:18.684825,325,3.0,0.0,-500,2623,1090.0
290000.0,3,1.0,1480,32700,1.0,4,6,1380,100.0,1942,1500,22600,29286 days 16:47:18.684825,282,3.0,13.8,-20,10100,1280.0
850000.0,5,2.5,2800,11325,1.0,4,8,1400,1400.0,1970,2510,13700,19059 days 16:47:18.684825,309,2.0,1.0,290,-2375,0.0
815000.0,4,1.75,1820,4500,1.5,3,8,1820,0.0,1921,1870,3600,36956 days 16:47:18.684825,302,2.2857142857142856,0.0,-50,900,1820.0
2200000.0,5,4.0,5840,11652,2.0,3,1,4410,1430.0,1988,3120,13639,12485 days 16:47:18.684825,008,1.25,3.0839160839160837,2720,-1987,2980.0
1630000.0,4,3.25,2980,3600,2.0,3,9,2150,830.0,1999,2980,4800,8467 days 16:47:18.684825,184,1.2307692307692308,2.5903614457831323,0,-1200,1320.0
175000.0,3,1.5,1220,7300,1.0,3,7,1220,0.0,1973,1260,7347,17963 days 16:47:18.684825,167,2.0,0.0,-40,-47,1220.0
429950.0,3,1.75,1830,9758,1.0,3,8,1300,530.0,1977,1850,8000,16502 days 16:47:18.684825,275,1.7142857142857142,2.452830188679245,-20,1758,770.0
675000.0,4,2.5,2900,5505,2.0,3,8,2900,0.0,2002,2970,5251,7371 days 16:47:18.684825,195,1.6,0.0,-70,254,2900.0
580000.0,3,2.25,1940,5980,1.0,3,7,1520,420.0,1987,1910,6309,12850 days 16:47:18.684825,189,1.3333333333333333,3.619047619047619,30,-329,1100.0
240000.0,4,2.0,1750,7800,1.0,4,6,1750,0.0,1944,1270,7800,28556 days 16:47:18.684825,055,2.0,0.0,480,0,1750.0
374000.0,3,2.5,1850,17808,1.0,4,8,1210,640.0,1982,2260,16754,14676 days 16:47:18.684825,232,1.2,1.890625,-410,1054,570.0
862500.0,4,2.5,3220,4400,2.0,3,9,2180,1040.0,1937,3000,5000,31112 days 16:47:18.684825,346,1.6,2.0961538461538463,220,-600,1140.0
140000.0,2,1.0,1080,6052,1.0,5,6,1080,0.0,1908,1810,7830,41705 days 16:47:18.684825,021,2.0,0.0,-730,-1778,1080.0
740000.0,5,3.75,3990,18897,2.0,3,8,3090,900.0,1937,2080,9793,31112 days 16:47:18.684825,150,1.3333333333333333,3.433333333333333,1910,9104,2190.0
589000.0,3,1.75,920,3600,1.0,4,6,820,100.0,1904,1620,3600,43166 days 16:47:18.684825,055,1.7142857142857142,8.2,-700,0,720.0
275000.0,3,1.75,1290,9760,1.0,3,7,1290,0.0,1979,1410,8034,15772 days 16:47:18.684825,054,1.7142857142857142,0.0,-120,1726,1290.0
489900.0,4,2.5,2090,4196,2.0,3,8,2090,0.0,2006,2640,4503,5910 days 16:47:18.684825,192,1.6,0.0,-550,-307,2090.0
545000.0,3,2.5,1900,3366,2.0,3,9,1900,0.0,1996,2500,3954,9563 days 16:47:18.684825,225,1.2,0.0,-600,-588,1900.0
235000.0,4,1.0,1360,7132,1.5,3,6,1360,0.0,1941,1280,7175,29651 days 16:47:18.684825,084,4.0,0.0,80,-43,1360.0
230000.0,3,1.0,1000,4000,1.5,4,6,1000,0.0,1915,1040,4240,39148 days 16:47:18.684825,048,3.0,0.0,-40,-240,1000.0
655000.0,4,2.25,2170,4080,2.0,3,7,1920,250.0,1980,1890,4400,15407 days 16:47:18.684825,191,1.7777777777777777,7.68,280,-320,1670.0
185000.0,2,1.0,820,16030,1.0,4,5,820,0.0,1923,1880,14046,36226 days 16:47:18.684825,234,2.0,0.0,-1060,1984,820.0
196000.0,3,1.0,1090,7400,1.0,4,7,1090,0.0,1962,1140,8165,21981 days 16:47:18.684825,085,3.0,0.0,-50,-765,1090.0
572000.0,3,2.25,1830,7897,1.0,4,8,1290,540.0,1986,1990,8306,13215 days 16:47:18.684825,155,1.3333333333333333,2.388888888888889,-160,-409,750.0
615000.0,4,2.5,3010,6903,2.0,3,9,3010,0.0,2001,2860,6435,7736 days 16:47:18.684825,120,1.6,0.0,150,468,3010.0
1950000.0,4,3.75,4150,17424,1.0,3,9,3130,1020.0,1963,3930,21420,21616 days 16:47:18.684825,064,1.0666666666666667,3.0686274509803924,220,-3996,2110.0
1230000.0,6,2.25,2930,4320,2.0,3,9,2130,800.0,1913,2860,4320,39878 days 16:47:18.684825,079,2.6666666666666665,2.6625,70,0,1330.0
375000.0,3,2.5,1520,5649,2.0,4,7,1520,0.0,1989,1540,5000,12119 days 16:47:18.684825,231,1.2,0.0,-20,649,1520.0
295000.0,3,1.75,1250,9486,1.0,4,6,1250,0.0,1971,1270,9600,18694 days 16:47:18.684825,248,1.7142857142857142,0.0,-20,-114,1250.0
760000.0,4,2.5,2760,6000,2.0,5,7,2230,530.0,1942,1600,6000,29286 days 16:47:18.684825,176,1.6,4.2075471698113205,1160,0,1700.0
347000.0,3,1.75,1330,7848,1.0,3,8,1330,0.0,1978,2110,8497,16137 days 16:47:18.684825,097,1.7142857142857142,0.0,-780,-649,1330.0
712000.0,3,2.0,1700,5100,1.5,4,7,1500,200.0,1924,1700,5100,35861 days 16:47:18.684825,124,1.5,7.5,0,0,1300.0
495000.0,4,2.0,2050,4000,1.5,5,7,1210,840.0,1941,1310,4000,29651 days 16:47:18.684825,135,2.0,1.4404761904761905,740,0,370.0
925000.0,4,2.0,3140,10437,1.0,4,8,2040,1100.0,1959,2010,10437,23077 days 16:47:18.684825,171,2.0,1.8545454545454545,1130,0,940.0
775000.0,3,1.0,2030,4080,1.5,4,7,1840,190.0,1908,2030,4080,41705 days 16:47:18.684825,092,3.0,9.68421052631579,0,0,1650.0
429000.0,4,2.5,2100,7920,1.5,4,6,1400,700.0,1916,1230,7920,38783 days 16:47:18.684825,213,1.6,2.0,870,0,700.0
229000.0,3,1.0,1010,12705,1.0,4,7,1010,0.0,1959,1490,10200,23077 days 16:47:18.684825,352,3.0,0.0,-480,2505,1010.0
400000.0,4,1.5,1980,113691,1.0,3,7,1980,0.0,1962,1980,89298,21981 days 16:47:18.684825,265,2.6666666666666665,0.0,0,24393,1980.0
625000.0,4,2.25,2100,8290,2.0,4,8,2100,0.0,1978,2100,8290,16137 days 16:47:18.684825,210,1.7777777777777777,0.0,0,0,2100.0
130000.0,2,1.0,840,6654,1.0,3,7,840,0.0,1951,1350,5831,25999 days 16:47:18.684825,294,2.0,0.0,-510,823,840.0
349000.0,3,1.75,1690,5080,1.0,3,7,1190,500.0,1976,1300,5080,16868 days 16:47:18.684825,308,1.7142857142857142,2.38,390,0,690.0
365000.0,3,2.0,2140,26600,1.0,4,7,2140,0.0,1983,2310,8783,14311 days 16:47:18.684825,265,1.5,0.0,-170,17817,2140.0
487500.0,3,2.5,1810,1988,2.0,3,7,1350,460.0,1997,1600,1525,9197 days 16:47:18.684825,076,1.2,2.9347826086956523,210,463,890.0
475000.0,3,2.5,2600,7210,2.0,3,8,2600,0.0,1989,2350,7225,12119 days 16:47:18.684825,154,1.2,0.0,250,-15,2600.0
685000.0,3,1.75,1650,8400,1.0,3,8,1470,180.0,1959,2020,7777,23077 days 16:47:18.684825,267,1.7142857142857142,8.166666666666666,-370,623,1290.0
960000.0,3,1.75,2460,4800,1.0,4,7,1230,1230.0,1938,2860,4800,30747 days 16:47:18.684825,223,1.7142857142857142,1.0,-400,0,0.0
1100000.0,5,2.25,4320,7620,2.0,3,7,2880,1440.0,1973,1880,7620,17963 days 16:47:18.684825,317,2.2222222222222223,2.0,2440,0,1440.0
428000.0,3,2.25,2600,15000,2.0,3,9,2600,0.0,1978,2380,15000,16137 days 16:47:18.684825,079,1.3333333333333333,0.0,220,0,2600.0
435000.0,3,2.5,1930,5790,2.0,4,7,1930,0.0,1988,1790,4901,12485 days 16:47:18.684825,130,1.2,0.0,140,889,1930.0
769950.0,3,2.0,2190,5400,1.0,5,7,1260,930.0,1952,2160,5400,25634 days 16:47:18.684825,301,1.5,1.3548387096774193,30,0,330.0
385000.0,3,1.0,1420,10980,1.0,4,7,1200,220.0,1954,1630,9763,24903 days 16:47:18.684825,272,3.0,5.454545454545454,-210,1217,980.0
352000.0,3,2.5,2090,3002,2.0,3,7,1670,420.0,2005,2090,3163,6275 days 16:47:18.684825,322,1.2,3.9761904761904763,0,-161,1250.0
622500.0,3,2.5,2290,14374,2.0,3,8,2290,0.0,1983,2290,33450,14311 days 16:47:18.684825,254,1.2,0.0,0,-19076,2290.0
660000.0,3,3.0,2470,11900,2.0,3,9,2290,180.0,1976,2590,11900,16868 days 16:47:18.684825,043,1.0,12.722222222222221,-120,0,2110.0
105000.0,3,1.0,840,8400,1.0,3,6,840,0.0,1959,840,9450,23077 days 16:47:18.684825,245,3.0,0.0,0,-1050,840.0
420000.0,2,1.0,2100,4480,1.0,5,7,1400,700.0,1908,1570,4400,41705 days 16:47:18.684825,336,2.0,2.0,530,80,700.0
499950.0,3,1.5,1360,11250,1.0,4,7,1360,0.0,1955,1440,11250,24538 days 16:47:18.684825,246,2.0,0.0,-80,0,1360.0
975000.0,6,3.0,3420,22421,1.0,5,9,2270,1150.0,1948,2430,15560,27095 days 16:47:18.684825,226,2.0,1.9739130434782608,990,6861,1120.0
665000.0,3,2.75,1930,2960,1.5,5,7,1490,440.0,1929,2080,3760,34034 days 16:47:18.684825,274,1.0909090909090908,3.3863636363636362,-150,-800,1050.0
540000.0,4,2.5,2180,10140,1.0,4,7,1180,1000.0,1968,1840,9375,19790 days 16:47:18.684825,182,1.6,1.18,340,765,180.0
400000.0,4,2.0,1670,12056,1.0,3,7,1670,0.0,1955,1860,12056,24538 days 16:47:18.684825,149,2.0,0.0,-190,0,1670.0
469950.0,4,2.75,2720,6427,1.0,3,8,1650,1070.0,2008,2720,8484,5180 days 16:47:18.684825,349,1.4545454545454546,1.5420560747663552,0,-2057,580.0
777000.0,4,2.5,3170,9900,2.0,4,8,3170,0.0,1979,2540,12400,15772 days 16:47:18.684825,289,1.6,0.0,630,-2500,3170.0
346500.0,2,1.75,1610,6300,1.0,3,7,1010,600.0,1941,1370,5225,29651 days 16:47:18.684825,176,1.1428571428571428,1.6833333333333333,240,1075,410.0
685000.0,3,2.5,2370,4950,2.0,3,8,2370,0.0,2003,2230,4950,7006 days 16:47:18.684825,070,1.2,0.0,140,0,2370.0
396500.0,3,2.5,2590,18980,1.0,4,1,2590,0.0,1976,3110,14652,16868 days 16:47:18.684825,175,1.2,0.0,-520,4328,2590.0
783500.0,3,2.5,2850,7130,2.0,3,1,1990,860.0,1980,2280,6459,15407 days 16:47:18.684825,124,1.2,2.313953488372093,570,671,1130.0
575000.0,4,2.0,1660,4800,1.5,3,7,1660,0.0,1922,1660,4800,36591 days 16:47:18.684825,183,2.0,0.0,0,0,1660.0
1500000.0,4,4.25,5550,12968,2.0,3,1,5550,0.0,2005,4750,13001,6275 days 16:47:18.684825,310,0.9411764705882353,0.0,800,-33,5550.0
515000.0,3,1.5,2200,7620,1.0,4,7,1130,1070.0,1942,2170,7672,29286 days 16:47:18.684825,098,2.0,1.0560747663551402,30,-52,60.0
300000.0,3,2.5,2020,6628,1.0,4,7,1250,770.0,1963,1540,9995,21616 days 16:47:18.684825,217,1.2,1.6233766233766234,480,-3367,480.0
272000.0,3,1.5,1760,9600,1.0,4,7,1760,0.0,1966,1450,9600,20520 days 16:47:18.684825,014,2.0,0.0,310,0,1760.0
355000.0,4,2.25,1810,4970,2.0,3,7,1810,0.0,2003,1810,4858,7006 days 16:47:18.684825,147,1.7777777777777777,0.0,0,112,1810.0
223000.0,3,2.0,1310,8440,1.0,5,6,1310,0.0,1951,1790,10775,25999 days 16:47:18.684825,212,1.5,0.0,-480,-2335,1310.0
397000.0,4,2.5,3000,8584,2.0,3,7,3000,0.0,2003,2610,7570,7006 days 16:47:18.684825,232,1.6,0.0,390,1014,3000.0
460000.0,2,2.0,1080,5000,1.0,5,6,1080,0.0,1923,1530,5000,36226 days 16:47:18.684825,077,1.0,0.0,-450,0,1080.0
848000.0,3,2.75,2170,2738,1.5,4,9,1550,620.0,1930,1170,1062,33669 days 16:47:18.684825,037,1.0909090909090908,2.5,1000,1676,930.0
392800.0,2,1.0,740,4275,1.0,5,6,740,0.0,1924,1900,4275,35861 days 16:47:18.684825,280,2.0,0.0,-1160,0,740.0
1690000.0,3,3.25,5290,224442,2.0,4,1,4540,750.0,1988,3750,84936,12485 days 16:47:18.684825,274,0.9230769230769231,6.053333333333334,1540,139506,3790.0
1800000.0,3,3.25,5290,224442,2.0,4,1,4540,750.0,1988,3750,84936,12485 days 16:47:18.684825,085,0.9230769230769231,6.053333333333334,1540,139506,3790.0
577000.0,3,2.25,2370,7878,2.0,3,8,2370,0.0,1985,1870,7766,13580 days 16:47:18.684825,022,1.3333333333333333,0.0,500,112,2370.0
570000.0,3,1.0,1890,3330,1.5,4,7,1390,500.0,1901,1530,3330,44261 days 16:47:18.684825,188,3.0,2.78,360,0,890.0
250000.0,3,1.75,1160,6134,1.0,3,7,1160,0.0,1998,1330,6301,8832 days 16:47:18.684825,168,1.7142857142857142,0.0,-170,-167,1160.0
645000.0,4,1.75,1550,7350,1.5,4,8,1550,0.0,1958,1860,7350,23442 days 16:47:18.684825,247,2.2857142857142856,0.0,-310,0,1550.0
567500.0,3,2.5,3090,67082,2.0,3,9,3090,0.0,1990,3650,62290,11754 days 16:47:18.684825,297,1.2,0.0,-560,4792,3090.0
337000.0,4,2.5,2610,5240,2.0,3,8,2610,0.0,2004,2480,5240,6641 days 16:47:18.684825,203,1.6,0.0,130,0,2610.0
280000.0,3,1.75,1230,8250,1.0,3,7,1230,0.0,1966,1250,8250,20520 days 16:47:18.684825,176,1.7142857142857142,0.0,-20,0,1230.0
167000.0,3,1.5,1280,5547,2.0,4,6,1280,0.0,1985,1150,4500,13580 days 16:47:18.684825,209,2.0,0.0,130,1047,1280.0
280000.0,2,1.0,1880,7560,1.0,3,6,940,940.0,1919,1280,7560,37687 days 16:47:18.684825,150,2.0,1.0,600,0,0.0
317500.0,2,1.5,1220,8409,1.0,4,6,1220,0.0,1948,1130,8409,27095 days 16:47:18.684825,356,1.3333333333333333,0.0,90,0,1220.0
405500.0,2,2.75,1350,1252,2.0,3,8,1120,230.0,2006,1410,1265,5910 days 16:47:18.684825,184,0.7272727272727273,4.869565217391305,-60,-13,890.0
495000.0,4,2.5,2370,15336,2.0,3,8,2370,0.0,1995,2110,15925,9928 days 16:47:18.684825,023,1.6,0.0,260,-589,2370.0
691000.0,4,3.0,3040,11651,2.0,3,1,3040,0.0,1987,2540,11815,12850 days 16:47:18.684825,028,1.3333333333333333,0.0,500,-164,3040.0
480000.0,5,1.75,2080,217800,1.0,5,7,2080,0.0,1963,1670,213008,21616 days 16:47:18.684825,307,2.857142857142857,0.0,410,4792,2080.0
549010.0,2,1.75,1560,4141,1.0,4,7,880,680.0,1942,1210,4141,29286 days 16:47:18.684825,042,1.1428571428571428,1.2941176470588236,350,0,200.0
750000.0,5,3.5,2980,5809,2.0,3,8,2980,0.0,2005,2120,3416,6275 days 16:47:18.684825,112,1.4285714285714286,0.0,860,2393,2980.0
365000.0,2,1.0,870,5689,1.0,4,7,870,0.0,1948,1100,5711,27095 days 16:47:18.684825,055,2.0,0.0,-230,-22,870.0
412500.0,3,1.75,1660,10716,1.0,3,7,1100,560.0,1988,1630,7626,12485 days 16:47:18.684825,064,1.7142857142857142,1.9642857142857142,30,3090,540.0
425000.0,3,2.25,1870,9000,1.0,3,7,1440,430.0,1978,1870,8640,16137 days 16:47:18.684825,154,1.3333333333333333,3.3488372093023258,0,360,1010.0
920000.0,3,1.0,1410,9656,1.0,3,7,960,450.0,1953,2410,9384,25268 days 16:47:18.684825,090,3.0,2.1333333333333333,-1000,272,510.0
340000.0,4,2.25,2180,8000,1.0,4,9,1630,550.0,1975,2310,8000,17233 days 16:47:18.684825,356,1.7777777777777777,2.963636363636364,-130,0,1080.0
405000.0,4,2.5,2620,8960,1.0,5,7,1520,1100.0,1955,1880,8960,24538 days 16:47:18.684825,309,1.6,1.3818181818181818,740,0,420.0
537100.0,3,2.5,2450,7051,1.0,3,8,1870,580.0,1990,2450,8788,11754 days 16:47:18.684825,083,1.2,3.2241379310344827,0,-1737,1290.0
353500.0,4,2.5,3250,4650,2.0,3,8,3250,0.0,2007,2960,4650,5545 days 16:47:18.684825,077,1.6,0.0,290,0,3250.0
522000.0,3,1.0,1150,7080,1.0,3,7,1150,0.0,1952,1490,7921,25634 days 16:47:18.684825,255,3.0,0.0,-340,-841,1150.0
710000.0,4,2.75,2780,6978,2.0,3,8,2780,0.0,2001,2760,5460,7736 days 16:47:18.684825,283,1.4545454545454546,0.0,20,1518,2780.0
329950.0,3,1.75,1360,13320,1.0,4,7,1360,0.0,1985,1580,13625,13580 days 16:47:18.684825,071,1.7142857142857142,0.0,-220,-305,1360.0
830000.0,5,2.5,2810,14207,1.0,3,9,1540,1270.0,1979,3190,14000,15772 days 16:47:18.684825,110,2.0,1.2125984251968505,-380,207,270.0
800500.0,4,2.5,1780,11130,1.0,5,8,1780,0.0,1962,2610,11130,21981 days 16:47:18.684825,050,1.6,0.0,-830,0,1780.0
168500.0,3,1.0,1100,10125,1.0,3,7,1100,0.0,1969,1570,10650,19424 days 16:47:18.684825,148,3.0,0.0,-470,-525,1100.0
490000.0,3,2.5,2230,5348,2.0,3,8,2230,0.0,2000,2190,5205,8102 days 16:47:18.684825,178,1.2,0.0,40,143,2230.0
579000.0,3,2.5,1710,1904,2.0,3,8,1140,570.0,2003,1260,1316,7006 days 16:47:18.684825,279,1.2,2.0,450,588,570.0
600000.0,4,2.5,2620,9873,2.0,3,8,2620,0.0,1987,2520,9935,12850 days 16:47:18.684825,154,1.6,0.0,100,-62,2620.0
445000.0,4,1.75,1990,4725,1.5,4,7,1190,800.0,1944,1240,4961,28556 days 16:47:18.684825,149,2.2857142857142856,1.4875,750,-236,390.0
362500.0,4,1.75,1450,8450,1.0,3,7,1450,0.0,1960,1540,8450,22712 days 16:47:18.684825,175,2.2857142857142856,0.0,-90,0,1450.0
234000.0,4,2.0,1630,9010,1.0,4,7,1050,580.0,1975,1670,7820,17233 days 16:47:18.684825,134,2.0,1.8103448275862069,-40,1190,470.0
321500.0,1,1.0,730,1942,1.0,3,7,730,0.0,2008,1020,2183,5180 days 16:47:18.684825,190,1.0,0.0,-290,-241,730.0
660000.0,3,1.75,1980,3300,1.5,4,7,1140,840.0,1926,1590,5000,35130 days 16:47:18.684825,157,1.7142857142857142,1.3571428571428572,390,-1700,300.0
319000.0,4,1.0,1730,36356,1.5,4,6,1730,0.0,1954,1380,14060,24903 days 16:47:18.684825,268,4.0,0.0,350,22296,1730.0
314000.0,3,1.75,1350,217852,1.0,3,8,1100,250.0,1953,2190,217800,25268 days 16:47:18.684825,293,1.7142857142857142,4.4,-840,52,850.0
517950.0,3,2.0,1410,5000,1.0,5,7,740,670.0,1908,1830,4000,41705 days 16:47:18.684825,279,1.5,1.1044776119402986,-420,1000,70.0
525000.0,5,2.5,2360,10081,1.0,4,7,1180,1180.0,1961,2200,10461,22346 days 16:47:18.684825,195,2.0,1.0,160,-380,0.0
319500.0,3,1.0,1190,8450,1.0,5,6,1190,0.0,1961,1660,8450,22346 days 16:47:18.684825,042,3.0,0.0,-470,0,1190.0
1580000.0,4,3.25,3760,10920,1.5,5,9,2400,1360.0,1950,3430,11050,26364 days 16:47:18.684825,126,1.2307692307692308,1.7647058823529411,330,-130,1040.0
325000.0,1,1.0,1220,12426,1.0,4,6,1220,0.0,1946,2770,22270,27825 days 16:47:18.684825,234,1.0,0.0,-1550,-9844,1220.0
795000.0,4,2.5,2920,32219,2.0,5,1,2920,0.0,1995,3420,37206,9928 days 16:47:18.684825,212,1.6,0.0,-500,-4987,2920.0
850000.0,2,1.75,1590,5136,1.5,3,9,1320,270.0,1927,2520,5243,34765 days 16:47:18.684825,170,1.1428571428571428,4.888888888888889,-930,-107,1050.0
1010000.0,5,3.25,3510,10930,2.0,3,9,3510,0.0,2013,1970,7488,3353 days 16:47:18.684825,342,1.5384615384615385,0.0,1540,3442,3510.0
475000.0,3,2.5,1320,1310,3.0,3,8,1320,0.0,2006,1350,1250,5910 days 16:47:18.684825,216,1.2,0.0,-30,60,1320.0
375000.0,3,1.0,1610,11250,1.0,3,7,1090,520.0,1975,2040,10692,17233 days 16:47:18.684825,205,3.0,2.0961538461538463,-430,558,570.0
405000.0,3,1.0,1410,8053,1.0,4,7,1410,0.0,1951,1170,8042,25999 days 16:47:18.684825,175,3.0,0.0,240,11,1410.0
420000.0,4,2.5,2170,10500,1.0,3,7,1570,600.0,1962,1850,11127,21981 days 16:47:18.684825,288,1.6,2.6166666666666667,320,-627,970.0
775000.0,4,1.75,1890,4800,1.5,3,7,1390,500.0,1906,1890,4800,42435 days 16:47:18.684825,289,2.2857142857142856,2.78,0,0,890.0
800000.0,4,2.75,3260,5000,2.0,3,9,3260,0.0,2007,3450,6218,5545 days 16:47:18.684825,097,1.4545454545454546,0.0,-190,-1218,3260.0
436800.0,3,1.75,2080,12714,2.0,4,8,1540,540.0,1984,2080,12107,13946 days 16:47:18.684825,091,1.7142857142857142,2.8518518518518516,0,607,1000.0
620000.0,3,1.75,2040,4005,1.5,4,8,1740,300.0,1930,1380,4005,33669 days 16:47:18.684825,337,1.7142857142857142,5.8,660,0,1440.0
230000.0,3,1.0,1250,9035,1.0,4,7,1250,0.0,1970,1350,10425,19059 days 16:47:18.684825,084,3.0,0.0,-100,-1390,1250.0
165000.0,1,1.0,850,8050,1.0,2,6,850,0.0,1906,1590,5180,42435 days 16:47:18.684825,189,1.0,0.0,-740,2870,850.0
490000.0,1,1.0,850,8050,1.0,2,6,850,0.0,1906,1590,5180,42435 days 16:47:18.684825,022,1.0,0.0,-740,2870,850.0
480000.0,3,1.75,1600,8400,1.0,5,8,1600,0.0,1963,2210,8400,21616 days 16:47:18.684825,218,1.7142857142857142,0.0,-610,0,1600.0
570000.0,3,2.5,2400,6975,2.0,3,9,2400,0.0,1993,2640,11172,10658 days 16:47:18.684825,157,1.2,0.0,-240,-4197,2400.0
615000.0,3,2.25,1870,4894,2.0,4,8,1750,120.0,1992,1920,5988,11024 days 16:47:18.684825,024,1.3333333333333333,14.583333333333334,-50,-1094,1630.0
280000.0,3,1.0,1720,9605,1.0,3,7,860,860.0,1969,1720,9998,19424 days 16:47:18.684825,267,3.0,1.0,0,-393,0.0
326000.0,3,1.0,1030,9834,1.0,3,7,1030,0.0,1969,1210,9875,19424 days 16:47:18.684825,174,3.0,0.0,-180,-41,1030.0
550700.0,2,2.25,1190,1499,2.0,3,9,1100,90.0,2004,1430,1332,6641 days 16:47:18.684825,047,0.8888888888888888,12.222222222222221,-240,167,1010.0
600000.0,2,1.0,910,2002,1.5,3,6,910,0.0,1900,1190,1208,44626 days 16:47:18.684825,182,2.0,0.0,-280,794,910.0
450000.0,3,1.0,1290,47044,1.0,3,7,1150,140.0,1968,1960,49658,19790 days 16:47:18.684825,253,3.0,8.214285714285714,-670,-2614,1010.0
546000.0,2,2.25,1530,1324,2.0,3,8,1280,250.0,2010,1410,1689,4449 days 16:47:18.684825,068,0.8888888888888888,5.12,120,-365,1030.0
585000.0,3,2.5,2330,33750,2.0,3,9,2330,0.0,1983,2270,35000,14311 days 16:47:18.684825,021,1.2,0.0,60,-1250,2330.0
489000.0,3,1.75,2090,7667,1.0,3,7,1200,890.0,1952,1480,7666,25634 days 16:47:18.684825,321,1.7142857142857142,1.348314606741573,610,1,310.0
765000.0,3,2.0,1570,7000,2.0,4,8,1050,520.0,1971,1990,6675,18694 days 16:47:18.684825,168,1.5,2.019230769230769,-420,325,530.0
519000.0,3,1.75,1560,26099,1.0,4,8,1560,0.0,1973,1760,19687,17963 days 16:47:18.684825,002,1.7142857142857142,0.0,-200,6412,1560.0
262000.0,2,1.0,1500,4120,1.5,3,5,880,620.0,1928,1300,4120,34400 days 16:47:18.684825,149,2.0,1.4193548387096775,200,0,260.0
550000.0,4,2.75,2160,5005,1.0,3,7,1430,730.0,1987,1770,5326,12850 days 16:47:18.684825,183,1.4545454545454546,1.9589041095890412,390,-321,700.0
285000.0,2,1.0,780,5000,1.0,4,6,780,0.0,1943,1030,5000,28921 days 16:47:18.684825,157,2.0,0.0,-250,0,780.0
476000.0,4,1.75,2340,17541,1.0,4,7,1360,980.0,1956,2250,9212,24173 days 16:47:18.684825,035,2.2857142857142856,1.3877551020408163,90,8329,380.0
2200000.0,3,2.0,3570,30456,1.0,3,8,2070,1500.0,1946,3570,27418,27825 days 16:47:18.684825,237,1.5,1.38,0,3038,570.0
335000.0,1,1.0,720,5100,1.0,3,6,720,0.0,1907,1320,5100,42070 days 16:47:18.684825,174,1.0,0.0,-600,0,720.0
510000.0,4,2.0,2990,102366,1.0,4,8,2990,0.0,1974,2820,57140,17598 days 16:47:18.684825,296,2.0,0.0,170,45226,2990.0
291000.0,3,2.25,1860,13939,1.0,4,7,1860,0.0,1961,1530,10018,22346 days 16:47:18.684825,261,1.3333333333333333,0.0,330,3921,1860.0
335000.0,4,1.75,1950,13440,1.5,4,6,1950,0.0,1931,1300,7432,33304 days 16:47:18.684825,233,2.2857142857142856,0.0,650,6008,1950.0
415000.0,3,1.5,1860,9003,1.0,3,7,1490,370.0,1955,2090,11574,24538 days 16:47:18.684825,241,2.0,4.027027027027027,-230,-2571,1120.0
430000.0,3,2.0,1550,6039,1.0,5,7,830,720.0,1942,1330,6042,29286 days 16:47:18.684825,189,1.5,1.1527777777777777,220,-3,110.0
270000.0,3,1.75,1610,6205,1.0,4,7,1210,400.0,1979,1780,8056,15772 days 16:47:18.684825,097,1.7142857142857142,3.025,-170,-1851,810.0
760000.0,3,2.0,1810,4500,1.0,4,7,980,830.0,1906,1800,4500,42435 days 16:47:18.684825,097,1.5,1.180722891566265,10,0,150.0
450000.0,2,2.0,1730,4248,2.0,3,7,1730,0.0,1905,1380,4000,42800 days 16:47:18.684825,128,1.0,0.0,350,248,1730.0
425000.0,3,2.5,1230,23522,1.0,4,7,1230,0.0,1978,2340,23522,16137 days 16:47:18.684825,093,1.2,0.0,-1110,0,1230.0
725000.0,4,2.5,2130,3420,1.5,4,7,1730,400.0,1916,1520,3420,38783 days 16:47:18.684825,325,1.6,4.325,610,0,1330.0
700000.0,3,2.75,2190,11060,1.0,4,7,1610,580.0,1973,2020,8588,17963 days 16:47:18.684825,202,1.0909090909090908,2.7758620689655173,170,2472,1030.0
998000.0,5,4.5,4130,10404,2.0,3,1,4130,0.0,2004,3890,11531,6641 days 16:47:18.684825,238,1.1111111111111112,0.0,240,-1127,4130.0
396000.0,3,2.25,1680,9766,2.0,3,7,1680,0.0,1989,1590,9757,12119 days 16:47:18.684825,128,1.3333333333333333,0.0,90,9,1680.0
547000.0,3,2.5,1480,8381,1.0,4,7,1480,0.0,1968,1710,8050,19790 days 16:47:18.684825,156,1.2,0.0,-230,331,1480.0
302000.0,4,1.5,1790,10200,1.0,4,8,1210,580.0,1963,1540,6600,21616 days 16:47:18.684825,105,2.6666666666666665,2.086206896551724,250,3600,630.0
999000.0,5,3.5,2810,2700,2.0,5,9,1900,910.0,1910,1510,3800,40974 days 16:47:18.684825,294,1.4285714285714286,2.087912087912088,1300,-1100,990.0
633000.0,4,2.5,2360,10000,1.0,3,8,1980,380.0,1977,2480,5000,16502 days 16:47:18.684825,184,1.6,5.2105263157894735,-120,5000,1600.0
265800.0,3,1.75,1460,7361,1.0,3,6,1460,0.0,1982,1460,7505,14676 days 16:47:18.684825,345,1.7142857142857142,0.0,0,-144,1460.0
530000.0,3,2.25,2160,8114,1.0,3,8,1460,700.0,1960,2160,8000,22712 days 16:47:18.684825,289,1.3333333333333333,2.085714285714286,0,114,760.0
605000.0,6,2.0,2610,9132,1.0,4,8,1320,1290.0,1965,2170,8000,20885 days 16:47:18.684825,121,3.0,1.0232558139534884,440,1132,30.0
489000.0,4,2.5,2170,4587,2.0,3,7,2170,0.0,2006,2170,5211,5910 days 16:47:18.684825,111,1.6,0.0,0,-624,2170.0
305000.0,2,1.0,2160,12960,1.0,3,7,1360,800.0,1968,2070,12960,19790 days 16:47:18.684825,183,2.0,1.7,90,0,560.0
513000.0,4,2.75,2020,7070,1.0,5,7,1010,1010.0,1958,1390,6000,23442 days 16:47:18.684825,164,1.4545454545454546,1.0,630,1070,0.0
765000.0,4,2.5,2980,5000,2.0,3,1,2980,0.0,2006,3140,5500,5910 days 16:47:18.684825,197,1.6,0.0,-160,-500,2980.0
550000.0,2,1.5,1300,2970,1.0,3,7,990,310.0,1903,1700,3000,43531 days 16:47:18.684825,259,1.3333333333333333,3.193548387096774,-400,-30,680.0
974350.0,4,2.5,3090,10730,2.0,5,8,2420,670.0,1985,2220,7875,13580 days 16:47:18.684825,205,1.6,3.611940298507463,870,2855,1750.0
653675.0,4,2.25,2280,7229,2.0,4,8,2280,0.0,1984,2320,7735,13946 days 16:47:18.684825,086,1.7777777777777777,0.0,-40,-506,2280.0
245000.0,3,1.75,1260,8614,1.0,4,7,1260,0.0,1985,1600,8614,13580 days 16:47:18.684825,288,1.7142857142857142,0.0,-340,0,1260.0
700180.0,2,1.75,1530,4387,1.0,3,8,1020,510.0,1952,1870,5029,25634 days 16:47:18.684825,125,1.1428571428571428,2.0,-340,-642,510.0
510000.0,3,2.5,1830,8133,1.0,3,8,1390,440.0,1996,2310,11522,9563 days 16:47:18.684825,120,1.2,3.159090909090909,-480,-3389,950.0
390000.0,3,2.5,1610,10292,1.0,4,7,1190,420.0,1969,1940,8700,19424 days 16:47:18.684825,298,1.2,2.8333333333333335,-330,1592,770.0
606500.0,3,2.5,2170,5500,2.0,3,8,2170,0.0,2000,2170,5862,8102 days 16:47:18.684825,124,1.2,0.0,0,-362,2170.0
1500000.0,4,4.25,5020,26319,2.0,3,1,5020,0.0,1998,4930,26319,8832 days 16:47:18.684825,252,0.9411764705882353,0.0,90,0,5020.0
290000.0,3,2.25,1620,7772,2.0,4,8,1620,0.0,1988,1710,6455,12485 days 16:47:18.684825,127,1.3333333333333333,0.0,-90,1317,1620.0
115000.0,3,1.75,1080,7942,1.0,3,7,1080,0.0,1981,1380,8244,15041 days 16:47:18.684825,055,1.7142857142857142,0.0,-300,-302,1080.0
500000.0,3,2.5,1940,37565,1.0,4,8,1940,0.0,1987,2560,37565,12850 days 16:47:18.684825,127,1.2,0.0,-620,0,1940.0
580050.0,3,2.5,2360,4638,2.0,3,9,2360,0.0,1996,1620,4638,9563 days 16:47:18.684825,135,1.2,0.0,740,0,2360.0
550000.0,3,2.5,2010,2261,2.0,3,8,1390,620.0,2014,1690,1899,2988 days 16:47:18.684825,065,1.2,2.2419354838709675,320,362,770.0
465000.0,3,1.0,800,3060,1.5,4,6,800,0.0,1903,1180,3060,43531 days 16:47:18.684825,099,3.0,0.0,-380,0,800.0
354950.0,3,1.0,970,5922,1.5,3,7,970,0.0,1949,1730,6128,26729 days 16:47:18.684825,083,3.0,0.0,-760,-206,970.0
980000.0,4,3.25,3720,7150,2.0,3,1,3720,0.0,2007,4040,7442,5545 days 16:47:18.684825,311,1.2307692307692308,0.0,-320,-292,3720.0
500000.0,3,2.25,2010,7447,2.0,3,8,2010,0.0,1985,2230,7846,13580 days 16:47:18.684825,248,1.3333333333333333,0.0,-220,-399,2010.0
667750.0,4,1.0,1430,4080,1.5,3,7,1430,0.0,1924,1760,4080,35861 days 16:47:18.684825,088,4.0,0.0,-330,0,1430.0
735000.0,3,1.75,2250,11520,1.0,3,8,2250,0.0,1956,2730,12445,24173 days 16:47:18.684825,118,1.7142857142857142,0.0,-480,-925,2250.0
361000.0,3,1.75,2130,8742,1.0,3,7,1330,800.0,1955,2380,7448,24538 days 16:47:18.684825,260,1.7142857142857142,1.6625,-250,1294,530.0
276750.0,3,2.0,1620,12482,1.0,4,7,1290,330.0,1989,1560,8499,12119 days 16:47:18.684825,005,1.5,3.909090909090909,60,3983,960.0
760000.0,4,3.25,3140,3680,2.0,3,1,2310,830.0,2009,2620,2664,4814 days 16:47:18.684825,234,1.2307692307692308,2.783132530120482,520,1016,1480.0
475000.0,2,1.0,870,7975,1.0,3,7,870,0.0,1946,1080,5722,27825 days 16:47:18.684825,241,2.0,0.0,-210,2253,870.0
234000.0,4,2.5,1820,8217,1.0,3,7,1120,700.0,1987,1310,8217,12850 days 16:47:18.684825,239,1.6,1.6,510,0,420.0
234950.0,3,2.0,1510,9153,1.0,4,7,1510,0.0,1974,1780,9286,17598 days 16:47:18.684825,321,1.5,0.0,-270,-133,1510.0
269950.0,2,1.75,1320,7540,1.0,3,7,1320,0.0,1968,1570,7540,19790 days 16:47:18.684825,053,1.1428571428571428,0.0,-250,0,1320.0
495000.0,3,2.5,1800,7318,2.0,3,8,1800,0.0,1989,1800,5414,12119 days 16:47:18.684825,012,1.2,0.0,0,1904,1800.0
438000.0,2,1.0,1120,6380,1.0,3,7,1120,0.0,1942,1230,6380,29286 days 16:47:18.684825,077,2.0,0.0,-110,0,1120.0
260000.0,3,1.75,2160,22702,1.0,4,7,2160,0.0,1981,1820,22687,15041 days 16:47:18.684825,055,1.7142857142857142,0.0,340,15,2160.0
697000.0,4,2.5,3220,6399,2.0,3,9,3220,0.0,2004,2850,6399,6641 days 16:47:18.684825,342,1.6,0.0,370,0,3220.0
212625.0,2,1.0,960,5000,1.0,3,6,960,0.0,1951,930,5000,25999 days 16:47:18.684825,069,2.0,0.0,30,0,960.0
593000.0,5,2.5,2640,4400,1.5,5,7,1840,800.0,1925,1720,4400,35495 days 16:47:18.684825,314,2.0,2.3,920,0,1040.0
410000.0,4,3.0,2430,7243,2.0,3,8,2430,0.0,2003,2430,7084,7006 days 16:47:18.684825,346,1.3333333333333333,0.0,0,159,2430.0
445434.0,2,1.0,1470,7137,1.0,3,7,1020,450.0,1941,1470,7067,29651 days 16:47:18.684825,161,2.0,2.2666666666666666,0,70,570.0
200126.0,3,2.5,2040,15463,1.0,3,8,1340,700.0,1968,2370,12672,19790 days 16:47:18.684825,254,1.2,1.9142857142857144,-330,2791,640.0
290700.0,3,2.5,1670,6666,2.0,4,7,1670,0.0,1992,1370,6170,11024 days 16:47:18.684825,223,1.2,0.0,300,496,1670.0
248000.0,4,1.0,1010,7515,1.0,4,6,1010,0.0,1955,1330,7515,24538 days 16:47:18.684825,029,4.0,0.0,-320,0,1010.0
345000.0,1,1.0,540,10125,1.0,3,5,540,0.0,1961,1840,10125,22346 days 16:47:18.684825,286,1.0,0.0,-1300,0,540.0
525000.0,3,1.0,1240,4800,1.0,3,7,800,440.0,1951,1440,4800,25999 days 16:47:18.684825,232,3.0,1.8181818181818181,-200,0,360.0
400000.0,3,1.75,1510,8385,1.0,3,7,1510,0.0,1968,1570,7480,19790 days 16:47:18.684825,346,1.7142857142857142,0.0,-60,905,1510.0
532000.0,3,1.0,1820,5750,1.0,3,7,1120,700.0,1918,1500,5750,38052 days 16:47:18.684825,098,3.0,1.6,320,0,420.0
159995.0,2,1.0,1000,5026,1.0,5,5,760,240.0,1915,990,5026,39148 days 16:47:18.684825,301,2.0,3.1666666666666665,10,0,520.0
287000.0,5,1.5,2040,11772,1.0,4,7,1030,1010.0,1963,1560,9435,21616 days 16:47:18.684825,289,3.3333333333333335,1.0198019801980198,480,2337,20.0
1120000.0,4,2.5,3690,11191,1.0,4,1,2190,1500.0,1951,3460,8160,25999 days 16:47:18.684825,110,1.6,1.46,230,3031,690.0
765000.0,3,2.5,2310,11993,2.0,3,9,2310,0.0,1988,2830,10031,12485 days 16:47:18.684825,113,1.2,0.0,-520,1962,2310.0
185000.0,3,1.5,1090,9605,1.0,4,6,1090,0.0,1969,1160,10487,19424 days 16:47:18.684825,318,2.0,0.0,-70,-882,1090.0
430000.0,3,1.0,1150,3000,1.0,5,6,1150,0.0,1906,1460,3200,42435 days 16:47:18.684825,141,3.0,0.0,-310,-200,1150.0
346000.0,4,2.5,2100,3916,2.0,3,8,2100,0.0,2009,2100,3916,4814 days 16:47:18.684825,146,1.6,0.0,0,0,2100.0
607000.0,4,2.75,2150,16728,1.0,4,8,1240,910.0,1982,2200,9257,14676 days 16:47:18.684825,196,1.4545454545454546,1.3626373626373627,-50,7471,330.0
417000.0,3,1.5,2500,6000,1.5,5,7,1730,770.0,1941,1340,5000,29651 days 16:47:18.684825,216,2.0,2.2467532467532467,1160,1000,960.0
930000.0,5,2.0,3530,9385,1.5,3,9,3530,0.0,1925,4100,9203,35495 days 16:47:18.684825,170,2.5,0.0,-570,182,3530.0
573300.0,2,1.75,1290,6600,1.0,3,7,870,420.0,1951,2380,7370,25999 days 16:47:18.684825,113,1.1428571428571428,2.0714285714285716,-1090,-770,450.0
260000.0,4,1.75,2010,10816,1.0,3,7,1410,600.0,1955,1610,9360,24538 days 16:47:18.684825,096,2.2857142857142856,2.35,400,1456,810.0
280000.0,1,0.75,420,6720,1.0,3,5,420,0.0,1922,1420,6720,36591 days 16:47:18.684825,163,1.3333333333333333,0.0,-1000,0,420.0
825000.0,4,2.5,2180,4000,2.0,3,8,2180,0.0,1920,2660,4000,37322 days 16:47:18.684825,352,1.6,0.0,-480,0,2180.0
307000.0,4,1.0,1150,8184,1.5,3,6,1150,0.0,1947,990,8184,27460 days 16:47:18.684825,161,4.0,0.0,160,0,1150.0
595000.0,4,1.75,2000,5100,1.0,4,7,1130,870.0,1949,1540,5100,26729 days 16:47:18.684825,225,2.2857142857142856,1.2988505747126438,460,0,260.0
528000.0,5,1.75,2780,7786,1.0,3,8,1390,1390.0,1966,2130,7918,20520 days 16:47:18.684825,105,2.857142857142857,1.0,650,-132,0.0
600000.0,2,1.75,1550,7764,1.0,4,8,1550,0.0,1965,1690,11620,20885 days 16:47:18.684825,234,1.1428571428571428,0.0,-140,-3856,1550.0
275000.0,2,1.0,2180,12875,1.0,3,7,1480,700.0,1959,1800,7447,23077 days 16:47:18.684825,061,2.0,2.1142857142857143,380,5428,780.0
782000.0,2,1.5,1570,3600,1.5,4,7,1320,250.0,1906,2140,3600,42435 days 16:47:18.684825,183,1.3333333333333333,5.28,-570,0,1070.0
610000.0,3,2.5,2260,33042,1.0,3,9,1660,600.0,1986,2600,40115,13215 days 16:47:18.684825,220,1.2,2.7666666666666666,-340,-7073,1060.0
488000.0,3,1.0,1600,3200,1.5,3,7,1600,0.0,1909,1860,3420,41339 days 16:47:18.684825,329,3.0,0.0,-260,-220,1600.0
320000.0,3,1.0,1630,5000,1.0,3,7,930,700.0,1954,1630,5480,24903 days 16:47:18.684825,093,3.0,1.3285714285714285,0,-480,230.0
153500.0,3,1.0,890,4810,1.0,3,6,890,0.0,1910,1230,6057,40974 days 16:47:18.684825,077,3.0,0.0,-340,-1247,890.0
414500.0,3,1.0,1350,9450,1.0,3,7,1350,0.0,1979,1460,9461,15772 days 16:47:18.684825,078,3.0,0.0,-110,-11,1350.0
750000.0,5,1.75,2850,11860,1.0,3,9,2850,0.0,1951,2640,11604,25999 days 16:47:18.684825,216,2.857142857142857,0.0,210,256,2850.0
645000.0,3,2.25,3280,79279,1.0,3,1,3280,0.0,2001,1860,24008,7736 days 16:47:18.684825,335,1.3333333333333333,0.0,1420,55271,3280.0
425000.0,2,1.0,1090,6000,1.0,3,7,1090,0.0,1922,1960,5000,36591 days 16:47:18.684825,096,2.0,0.0,-870,1000,1090.0
785000.0,4,2.5,2990,9374,2.0,3,9,2990,0.0,2003,2440,8711,7006 days 16:47:18.684825,217,1.6,0.0,550,663,2990.0
290000.0,3,1.75,1340,63597,1.0,4,7,1340,0.0,1963,1950,87120,21616 days 16:47:18.684825,311,1.7142857142857142,0.0,-610,-23523,1340.0
415000.0,3,1.75,1340,63597,1.0,4,7,1340,0.0,1963,1950,87120,21616 days 16:47:18.684825,091,1.7142857142857142,0.0,-610,-23523,1340.0
248500.0,2,1.0,720,5160,1.0,3,6,720,0.0,1949,990,5160,26729 days 16:47:18.684825,226,2.0,0.0,-270,0,720.0
325000.0,3,2.5,2330,8627,1.0,4,7,1480,850.0,1980,1940,9607,15407 days 16:47:18.684825,204,1.2,1.7411764705882353,390,-980,630.0
272925.0,2,1.0,1280,5728,1.5,5,6,1280,0.0,1941,2480,9775,29651 days 16:47:18.684825,204,2.0,0.0,-1200,-4047,1280.0
500000.0,2,2.25,1570,1269,2.0,3,9,1280,290.0,2015,1570,6000,2623 days 16:47:18.684825,238,0.8888888888888888,4.413793103448276,0,-4731,990.0
250000.0,4,1.75,1510,5500,1.5,3,7,1510,0.0,1920,1320,6431,37322 days 16:47:18.684825,293,2.2857142857142856,0.0,190,-931,1510.0
470000.0,4,2.5,2470,8536,2.0,3,8,2470,0.0,2002,1690,8840,7371 days 16:47:18.684825,265,1.6,0.0,780,-304,2470.0
440000.0,2,1.0,1190,3400,1.0,4,7,990,200.0,1917,1180,4000,38417 days 16:47:18.684825,274,2.0,4.95,10,-600,790.0
299999.0,4,2.5,1981,4828,2.0,3,8,1981,0.0,2013,1981,3783,3353 days 16:47:18.684825,005,1.6,0.0,0,1045,1981.0
255000.0,3,1.75,1590,7810,1.0,4,7,1590,0.0,1959,1470,7810,23077 days 16:47:18.684825,086,1.7142857142857142,0.0,120,0,1590.0
415950.0,3,1.75,1150,7700,1.0,3,7,1150,0.0,1957,1650,8000,23807 days 16:47:18.684825,225,1.7142857142857142,0.0,-500,-300,1150.0
402000.0,5,2.75,2160,7200,1.5,3,7,1220,940.0,1955,1900,7200,24538 days 16:47:18.684825,217,1.8181818181818181,1.297872340425532,260,0,280.0
635000.0,2,2.5,2470,8840,2.0,4,8,1780,690.0,2001,1940,8840,7736 days 16:47:18.684825,260,0.8,2.579710144927536,530,0,1090.0
479000.0,3,2.5,1710,8998,2.0,3,8,1710,0.0,1982,1710,9859,14676 days 16:47:18.684825,281,1.2,0.0,0,-861,1710.0
462370.0,2,2.25,1860,2670,2.0,4,8,1860,0.0,1986,1860,2531,13215 days 16:47:18.684825,356,0.8888888888888888,0.0,0,139,1860.0
171500.0,3,1.0,1150,6480,1.5,4,5,1150,0.0,1946,1100,7300,27825 days 16:47:18.684825,121,3.0,0.0,50,-820,1150.0
925000.0,5,3.0,3850,9457,2.0,4,9,2910,940.0,1963,2830,9608,21616 days 16:47:18.684825,196,1.6666666666666667,3.095744680851064,1020,-151,1970.0
675000.0,5,3.0,3410,9600,1.0,4,8,1870,1540.0,1968,2390,9679,19790 days 16:47:18.684825,133,1.6666666666666667,1.2142857142857142,1020,-79,330.0
320000.0,4,1.5,1890,43560,1.0,4,8,1890,0.0,1974,2376,5820,17598 days 16:47:18.684825,174,2.6666666666666665,0.0,-486,37740,1890.0
499950.0,5,3.5,3200,43560,2.0,3,7,3200,0.0,1989,2730,43560,12119 days 16:47:18.684825,140,1.4285714285714286,0.0,470,0,3200.0
435000.0,5,1.0,2170,65340,1.5,4,7,1670,500.0,1930,3170,12884,33669 days 16:47:18.684825,321,5.0,3.34,-1000,52456,1170.0
359800.0,4,2.5,2390,6426,2.0,3,9,2390,0.0,1999,2520,6700,8467 days 16:47:18.684825,156,1.6,0.0,-130,-274,2390.0
239900.0,3,2.0,1410,7566,1.0,3,7,1410,0.0,1985,1570,7210,13580 days 16:47:18.684825,127,1.5,0.0,-160,356,1410.0
295000.0,2,1.0,740,4459,1.0,3,5,740,0.0,1915,1490,4700,39148 days 16:47:18.684825,191,2.0,0.0,-750,-241,740.0
380000.0,3,2.5,2150,25705,1.5,3,6,2150,0.0,1980,1850,20160,15407 days 16:47:18.684825,063,1.2,0.0,300,5545,2150.0
435000.0,4,2.5,2180,6500,2.0,3,7,1410,770.0,1945,920,6500,28190 days 16:47:18.684825,111,1.6,1.8311688311688312,1260,0,640.0
508000.0,2,1.0,820,5040,1.0,3,7,820,0.0,1953,1730,5760,25268 days 16:47:18.684825,232,2.0,0.0,-910,-720,820.0
2400000.0,6,4.5,5480,10800,2.0,4,9,4430,1050.0,1999,2970,7200,8467 days 16:47:18.684825,171,1.3333333333333333,4.219047619047619,2510,3600,3380.0
234500.0,4,2.5,1960,7875,1.0,3,7,1220,740.0,1978,2030,7650,16137 days 16:47:18.684825,259,1.6,1.6486486486486487,-70,225,480.0
355000.0,2,1.0,1270,3200,1.0,4,7,960,310.0,1920,1410,1320,37322 days 16:47:18.684825,148,2.0,3.096774193548387,-140,1880,650.0
230000.0,3,2.0,1710,5200,1.0,5,7,1030,680.0,1977,1390,5200,16502 days 16:47:18.684825,213,1.5,1.5147058823529411,320,0,350.0
345000.0,3,1.75,1930,9000,1.0,4,7,1150,780.0,1951,1590,9000,25999 days 16:47:18.684825,042,1.7142857142857142,1.4743589743589745,340,0,370.0
430000.0,3,1.75,1200,4500,1.0,5,7,1200,0.0,1906,1340,4500,42435 days 16:47:18.684825,140,1.7142857142857142,0.0,-140,0,1200.0
500000.0,3,1.5,1680,17409,1.0,3,7,1680,0.0,1962,1680,9101,21981 days 16:47:18.684825,349,2.0,0.0,0,8308,1680.0
378000.0,4,1.0,1300,6075,1.0,5,7,1300,0.0,1954,1450,7320,24903 days 16:47:18.684825,125,4.0,0.0,-150,-1245,1300.0
345000.0,3,2.5,1540,3237,2.0,3,7,1540,0.0,1999,1780,3411,8467 days 16:47:18.684825,220,1.2,0.0,-240,-174,1540.0
410000.0,2,1.75,870,4000,1.0,3,6,870,0.0,1941,1420,4000,29651 days 16:47:18.684825,088,1.1428571428571428,0.0,-550,0,870.0
750000.0,2,2.25,1890,5400,2.0,5,8,1610,280.0,1905,2820,4860,42800 days 16:47:18.684825,234,0.8888888888888888,5.75,-930,540,1330.0
485000.0,4,1.75,2050,8913,1.0,3,7,1330,720.0,1968,1290,8550,19790 days 16:47:18.684825,022,2.2857142857142856,1.8472222222222223,760,363,610.0
105000.0,3,1.0,880,18109,1.0,4,6,880,0.0,1970,940,11193,19059 days 16:47:18.684825,076,3.0,0.0,-60,6916,880.0
1030000.0,3,2.75,2780,4000,2.0,5,8,1960,820.0,1904,1490,4800,43166 days 16:47:18.684825,113,1.0909090909090908,2.3902439024390243,1290,-800,1140.0
360000.0,3,1.0,1160,10988,1.0,3,7,1160,0.0,1965,1670,51376,20885 days 16:47:18.684825,287,3.0,0.0,-510,-40388,1160.0
294000.0,5,2.75,2300,7600,1.0,4,7,1400,900.0,1969,1750,8500,19424 days 16:47:18.684825,303,1.8181818181818181,1.5555555555555556,550,-900,500.0
325000.0,3,1.75,2300,6200,1.0,4,7,1150,1150.0,1970,1740,6600,19059 days 16:47:18.684825,002,1.7142857142857142,1.0,560,-400,0.0
770000.0,3,2.5,2900,23550,1.0,3,1,1490,1410.0,1987,2900,19604,12850 days 16:47:18.684825,247,1.2,1.0567375886524824,0,3946,80.0
443000.0,3,2.25,1920,8223,2.0,4,7,1920,0.0,1989,1940,7274,12119 days 16:47:18.684825,190,1.3333333333333333,0.0,-20,949,1920.0
325000.0,3,1.0,1150,7486,1.0,3,7,1150,0.0,1970,1510,7486,19059 days 16:47:18.684825,260,3.0,0.0,-360,0,1150.0
760000.0,4,2.5,3120,8792,2.0,4,9,3120,0.0,1992,2150,7688,11024 days 16:47:18.684825,023,1.6,0.0,970,1104,3120.0
640000.0,4,2.0,2560,7798,1.0,4,7,1890,670.0,1947,1330,7798,27460 days 16:47:18.684825,135,2.0,2.8208955223880596,1230,0,1220.0
415000.0,3,2.0,1410,4303,1.5,4,7,1410,0.0,1900,1660,4326,44626 days 16:47:18.684825,096,1.5,0.0,-250,-23,1410.0
156000.0,3,1.0,970,8580,1.0,3,7,970,0.0,1959,1430,11907,23077 days 16:47:18.684825,132,3.0,0.0,-460,-3327,970.0
996000.0,3,3.25,3620,8131,2.0,4,1,2730,890.0,1988,2040,3776,12485 days 16:47:18.684825,265,0.9230769230769231,3.067415730337079,1580,4355,1840.0
415000.0,2,1.0,880,5100,1.0,4,7,880,0.0,1941,980,5100,29651 days 16:47:18.684825,086,2.0,0.0,-100,0,880.0
615000.0,3,1.75,1900,3783,1.5,5,7,1110,790.0,1927,1530,5098,34765 days 16:47:18.684825,269,1.7142857142857142,1.4050632911392404,370,-1315,320.0
717000.0,4,2.5,2540,4241,2.0,3,8,2540,0.0,2009,3010,4929,4814 days 16:47:18.684825,280,1.6,0.0,-470,-688,2540.0
548000.0,4,1.75,1690,7794,1.0,3,7,1090,600.0,1968,1380,7325,19790 days 16:47:18.684825,090,2.2857142857142856,1.8166666666666667,310,469,490.0
425000.0,3,1.5,1120,6653,1.0,4,7,1120,0.0,1937,1580,7355,31112 days 16:47:18.684825,091,2.0,0.0,-460,-702,1120.0
325250.0,4,2.75,2130,9339,1.0,3,7,1330,800.0,1991,2090,7628,11389 days 16:47:18.684825,300,1.4545454545454546,1.6625,40,1711,530.0
1230000.0,3,2.5,3420,79279,2.0,3,1,3420,0.0,1990,4240,40500,11754 days 16:47:18.684825,213,1.2,0.0,-820,38779,3420.0
557500.0,3,1.75,1900,11165,1.0,4,7,1900,0.0,1959,2030,11165,23077 days 16:47:18.684825,176,1.7142857142857142,0.0,-130,0,1900.0
1260000.0,4,2.5,3730,16950,2.0,3,1,3730,0.0,1990,3200,16950,11754 days 16:47:18.684825,195,1.6,0.0,530,0,3730.0
249950.0,3,3.0,1790,2003,2.0,3,7,1480,310.0,2006,1220,4000,5910 days 16:47:18.684825,253,1.0,4.774193548387097,570,-1997,1170.0
260000.0,4,2.75,2250,7345,1.0,4,8,1320,930.0,1984,1800,6950,13946 days 16:47:18.684825,259,1.4545454545454546,1.4193548387096775,450,395,390.0
1990000.0,3,2.5,2880,13500,1.0,5,8,1520,1360.0,1950,3710,20486,26364 days 16:47:18.684825,162,1.2,1.1176470588235294,-830,-6986,160.0
442900.0,4,1.75,1780,2788,1.0,4,6,890,890.0,1943,1760,5664,28921 days 16:47:18.684825,172,2.2857142857142856,1.0,20,-2876,0.0
475000.0,3,2.25,1580,12177,1.0,3,7,1200,380.0,1981,1660,11374,15041 days 16:47:18.684825,164,1.3333333333333333,3.1578947368421053,-80,803,820.0
365000.0,5,2.75,3260,9253,2.0,3,8,3260,0.0,2004,2770,8067,6641 days 16:47:18.684825,225,1.8181818181818181,0.0,490,1186,3260.0
780000.0,4,2.5,3180,9603,2.0,3,9,3180,0.0,2002,2440,15261,7371 days 16:47:18.684825,116,1.6,0.0,740,-5658,3180.0
930000.0,3,1.75,2460,4240,1.0,4,7,1230,1230.0,1925,1700,4240,35495 days 16:47:18.684825,058,1.7142857142857142,1.0,760,0,0.0
2890000.0,5,6.25,8670,64033,2.0,3,1,6120,2550.0,1965,4140,81021,20885 days 16:47:18.684825,162,0.8,2.4,4530,-16988,3570.0
350000.0,3,1.0,1020,4980,1.0,4,7,850,170.0,1941,970,4980,29651 days 16:47:18.684825,230,3.0,5.0,50,0,680.0
357500.0,3,1.75,1630,9403,1.0,3,7,1630,0.0,1983,1430,8461,14311 days 16:47:18.684825,352,1.7142857142857142,0.0,200,942,1630.0
520000.0,4,2.5,3290,11446,2.0,3,8,3290,0.0,1992,2050,11933,11024 days 16:47:18.684825,141,1.6,0.0,1240,-487,3290.0
330000.0,4,2.5,1940,3784,2.0,3,8,1940,0.0,2003,1940,4499,7006 days 16:47:18.684825,129,1.6,0.0,0,-715,1940.0
310000.0,3,2.0,1350,11150,1.0,3,7,1110,240.0,1995,1290,10043,9928 days 16:47:18.684825,155,1.5,4.625,60,1107,870.0
279000.0,3,1.0,1110,6060,1.0,3,6,1110,0.0,1949,1480,8100,26729 days 16:47:18.684825,044,3.0,0.0,-370,-2040,1110.0
540000.0,4,1.5,2993,19400,2.0,4,7,2233,760.0,1921,2060,15100,36956 days 16:47:18.684825,206,2.6666666666666665,2.9381578947368423,933,4300,1473.0
322000.0,4,2.5,2280,7200,2.0,3,8,2280,0.0,1994,2250,7200,10293 days 16:47:18.684825,150,1.6,0.0,30,0,2280.0
380000.0,5,3.25,3800,15500,1.0,3,7,2490,1310.0,1965,2000,13980,20885 days 16:47:18.684825,071,1.5384615384615385,1.900763358778626,1800,1520,1180.0
320000.0,2,1.0,850,8400,1.0,4,6,850,0.0,1941,1280,8400,29651 days 16:47:18.684825,118,2.0,0.0,-430,0,850.0
400000.0,3,1.75,1560,8456,1.0,5,7,1560,0.0,1970,2230,13109,19059 days 16:47:18.684825,265,1.7142857142857142,0.0,-670,-4653,1560.0
412000.0,3,1.0,1000,3844,1.0,5,7,900,100.0,1928,1000,3920,34400 days 16:47:18.684825,234,3.0,9.0,0,-76,800.0
887200.0,3,1.0,1400,5100,1.5,3,7,1400,0.0,1900,1740,3060,44626 days 16:47:18.684825,097,3.0,0.0,-340,2040,1400.0
395000.0,4,1.75,1540,5120,1.0,5,6,770,770.0,1943,1080,5120,28921 days 16:47:18.684825,175,2.2857142857142856,1.0,460,0,0.0
895000.0,4,3.0,3570,10273,1.5,3,9,2630,940.0,1935,3640,15324,31843 days 16:47:18.684825,119,1.3333333333333333,2.797872340425532,-70,-5051,1690.0
195000.0,2,1.0,800,5280,1.0,5,6,800,0.0,1918,1240,7670,38052 days 16:47:18.684825,323,2.0,0.0,-440,-2390,800.0
390000.0,3,1.0,1160,3750,1.5,3,7,1160,0.0,1910,1530,3750,40974 days 16:47:18.684825,171,3.0,0.0,-370,0,1160.0
165000.0,3,1.0,1010,7690,1.0,4,6,1010,0.0,1958,1010,7619,23442 days 16:47:18.684825,315,3.0,0.0,0,71,1010.0
255000.0,3,1.0,1010,7690,1.0,4,6,1010,0.0,1958,1010,7619,23442 days 16:47:18.684825,128,3.0,0.0,0,71,1010.0
589000.0,4,2.25,2390,57599,2.0,3,8,2390,0.0,1981,2390,38186,15041 days 16:47:18.684825,075,1.7777777777777777,0.0,0,19413,2390.0
505000.0,3,2.5,1610,4611,2.0,3,8,1610,0.0,1996,1730,4461,9563 days 16:47:18.684825,170,1.2,0.0,-120,150,1610.0
335750.0,3,3.0,2400,7260,1.0,3,7,1440,960.0,1955,1060,7200,24538 days 16:47:18.684825,054,1.0,1.5,1340,60,480.0
719000.0,3,1.75,1800,5816,1.0,5,7,900,900.0,1947,1650,5816,27460 days 16:47:18.684825,015,1.7142857142857142,1.0,150,0,0.0
796000.0,4,3.25,2110,3000,2.0,3,8,2110,0.0,2001,1780,4000,7736 days 16:47:18.684825,252,1.2307692307692308,0.0,330,-1000,2110.0
95000.0,2,1.0,960,7000,1.0,3,4,960,0.0,1918,1850,8120,38052 days 16:47:18.684825,098,2.0,0.0,-890,-1120,960.0
525000.0,3,3.0,2600,5238,1.5,3,9,1890,710.0,1989,2220,4853,12119 days 16:47:18.684825,149,1.0,2.6619718309859155,380,385,1180.0
417000.0,3,1.5,1340,10224,1.0,4,7,1340,0.0,1956,1340,10440,24173 days 16:47:18.684825,135,2.0,0.0,0,-216,1340.0
410000.0,3,1.0,1410,5000,1.0,3,6,980,430.0,1925,1410,5000,35495 days 16:47:18.684825,110,3.0,2.2790697674418605,0,0,550.0
984000.0,4,2.25,2390,12292,1.0,5,9,2390,0.0,1962,2870,12337,21981 days 16:47:18.684825,012,1.7777777777777777,0.0,-480,-45,2390.0
325000.0,2,1.5,1180,834,3.0,3,8,1180,0.0,2009,1180,1207,4814 days 16:47:18.684825,093,1.3333333333333333,0.0,0,-373,1180.0
314950.0,3,1.0,1040,16986,1.0,4,7,1040,0.0,1968,1660,16986,19790 days 16:47:18.684825,127,3.0,0.0,-620,0,1040.0
350000.0,3,2.25,1840,9929,1.0,3,7,1200,640.0,1987,1710,9929,12850 days 16:47:18.684825,266,1.3333333333333333,1.875,130,0,560.0
1050000.0,4,2.25,2630,4000,2.0,5,9,1810,820.0,1909,2370,4700,41339 days 16:47:18.684825,300,1.7777777777777777,2.207317073170732,260,-700,990.0
657000.0,4,2.5,2640,25038,2.0,4,8,2640,0.0,1995,2630,16668,9928 days 16:47:18.684825,191,1.6,0.0,10,8370,2640.0
234950.0,2,2.5,1720,3132,2.0,3,8,1720,0.0,1999,1740,4220,8467 days 16:47:18.684825,098,0.8,0.0,-20,-1088,1720.0
410000.0,4,1.75,2320,7500,1.0,3,7,1220,1100.0,1955,2230,7500,24538 days 16:47:18.684825,079,2.2857142857142856,1.1090909090909091,90,0,120.0
625000.0,3,1.75,1840,5664,2.0,3,7,1270,570.0,1948,1480,5664,27095 days 16:47:18.684825,107,1.7142857142857142,2.2280701754385963,360,0,700.0
706000.0,5,2.5,2890,15891,2.0,3,9,2890,0.0,1990,2590,10556,11754 days 16:47:18.684825,113,2.0,0.0,300,5335,2890.0
485000.0,3,1.75,2200,7706,2.0,3,7,2200,0.0,1908,1170,70973,41705 days 16:47:18.685822,139,1.7142857142857142,0.0,1030,-63267,2200.0
685000.0,4,2.75,1660,5150,1.5,5,7,1280,380.0,1928,1490,4017,34400 days 16:47:18.685822,275,1.4545454545454546,3.3684210526315788,170,1133,900.0
242050.0,3,2.5,2170,9900,1.0,3,7,1690,480.0,1980,1420,10614,15407 days 16:47:18.685822,289,1.2,3.5208333333333335,750,-714,1210.0
770000.0,3,3.25,3310,5000,2.0,3,9,3310,0.0,2006,2670,4907,5910 days 16:47:18.685822,265,0.9230769230769231,0.0,640,93,3310.0
557000.0,2,1.5,1450,3840,1.0,3,7,950,500.0,1947,1450,3840,27460 days 16:47:18.685822,118,1.3333333333333333,1.9,0,0,450.0
246000.0,3,1.75,1440,11325,1.0,4,8,1440,0.0,1966,1440,20000,20520 days 16:47:18.685822,192,1.7142857142857142,0.0,0,-8675,1440.0
194000.0,4,2.0,1760,7700,1.0,4,7,1760,0.0,1962,1870,7316,21981 days 16:47:18.685822,069,2.0,0.0,-110,384,1760.0
720000.0,3,2.5,3170,7187,2.0,3,9,3170,0.0,2005,2790,7336,6275 days 16:47:18.685822,328,1.2,0.0,380,-149,3170.0
925000.0,4,2.5,3280,209088,2.0,3,1,3280,0.0,1994,2460,39498,10293 days 16:47:18.685822,170,1.6,0.0,820,169590,3280.0
570000.0,4,3.0,2460,10401,1.0,5,7,1700,760.0,1947,1470,7727,27460 days 16:47:18.685822,085,1.3333333333333333,2.236842105263158,990,2674,940.0
395000.0,3,2.0,1470,10125,1.0,4,7,1470,0.0,1962,1440,10125,21981 days 16:47:18.685822,316,1.5,0.0,30,0,1470.0
1000000.0,4,2.0,1780,15648,1.5,5,8,1780,0.0,1918,2320,14963,38052 days 16:47:18.685822,210,2.0,0.0,-540,685,1780.0
406000.0,4,1.0,1580,8475,1.5,4,7,1580,0.0,1928,1700,5650,34400 days 16:47:18.685822,182,4.0,0.0,-120,2825,1580.0
574800.0,3,1.5,1630,2946,1.5,4,8,1630,0.0,1932,1550,3800,32939 days 16:47:18.685822,296,2.0,0.0,80,-854,1630.0
309000.0,4,2.0,2240,9240,1.0,3,7,1120,1120.0,1968,2040,8250,19790 days 16:47:18.685822,110,2.0,1.0,200,990,0.0
770000.0,3,2.5,2430,54059,2.0,3,1,2430,0.0,1987,2910,49658,12850 days 16:47:18.685822,154,1.2,0.0,-480,4401,2430.0
525000.0,3,1.5,1940,5625,1.0,4,7,1440,500.0,1941,1460,5500,29651 days 16:47:18.685822,076,2.0,2.88,480,125,940.0
419000.0,3,2.5,1970,4058,2.0,3,7,1970,0.0,2004,2340,4067,6641 days 16:47:18.685822,199,1.2,0.0,-370,-9,1970.0
479000.0,4,2.5,2050,6705,1.0,4,7,1230,820.0,1973,1610,7292,17963 days 16:47:18.685822,101,1.6,1.5,440,-587,410.0
160000.0,3,1.0,1340,18552,1.5,4,5,1340,0.0,1935,960,15141,31843 days 16:47:18.685822,013,3.0,0.0,380,3411,1340.0
333000.0,4,1.75,1880,9880,1.0,4,8,1880,0.0,1967,1880,9600,20155 days 16:47:18.685822,259,2.2857142857142856,0.0,0,280,1880.0
310000.0,2,1.0,860,12160,1.0,4,6,860,0.0,1921,1010,7611,36956 days 16:47:18.685822,273,2.0,0.0,-150,4549,860.0
666000.0,3,2.5,2140,2868,2.0,3,8,1770,370.0,2007,2140,2527,5545 days 16:47:18.685822,036,1.2,4.783783783783784,0,341,1400.0
2230000.0,3,3.0,3620,28064,2.0,5,1,2370,1250.0,1977,2550,34713,16502 days 16:47:18.685822,206,1.0,1.896,1070,-6649,1120.0
310000.0,4,2.75,2370,7320,2.0,3,7,2370,0.0,1989,1960,7320,12119 days 16:47:18.685822,260,1.4545454545454546,0.0,410,0,2370.0
350000.0,3,2.5,1860,21876,2.0,3,8,1860,0.0,1992,2450,21876,11024 days 16:47:18.685822,361,1.2,0.0,-590,0,1860.0
564800.0,3,2.25,1990,8501,2.0,3,8,1990,0.0,1991,2090,6459,11389 days 16:47:18.685822,281,1.3333333333333333,0.0,-100,2042,1990.0
438000.0,3,2.25,1820,9150,1.0,3,7,1320,500.0,1961,1780,8055,22346 days 16:47:18.685822,111,1.3333333333333333,2.64,40,1095,820.0
855000.0,3,2.0,3120,9400,1.0,5,9,1820,1300.0,1978,2770,9500,16137 days 16:47:18.685822,225,1.5,1.4,350,-100,520.0
229000.0,3,2.5,1190,3000,2.0,3,7,1190,0.0,2002,1190,3000,7371 days 16:47:18.685822,128,1.2,0.0,0,0,1190.0
260000.0,3,2.0,1170,5450,1.0,5,6,1170,0.0,1902,1340,6384,43896 days 16:47:18.685822,206,1.5,0.0,-170,-934,1170.0
609000.0,3,2.5,2630,10131,2.0,3,9,2630,0.0,1989,2800,10123,12119 days 16:47:18.685822,261,1.2,0.0,-170,8,2630.0
277000.0,4,1.0,1450,6250,1.0,3,6,990,460.0,1964,1440,4000,21251 days 16:47:18.685822,148,4.0,2.152173913043478,10,2250,530.0
283000.0,4,2.0,2100,8160,1.0,3,7,1200,900.0,1959,1140,8160,23077 days 16:47:18.685822,343,2.0,1.3333333333333333,960,0,300.0
334000.0,2,1.75,1680,8367,1.0,3,6,840,840.0,1914,1830,6720,39513 days 16:47:18.685822,077,1.1428571428571428,1.0,-150,1647,0.0
267000.0,4,1.75,2000,7350,1.0,3,7,1100,900.0,1963,1720,7350,21616 days 16:47:18.685822,057,2.2857142857142856,1.2222222222222223,280,0,200.0
385000.0,3,1.0,1030,3000,1.0,3,7,830,200.0,1924,1830,3000,35861 days 16:47:18.685822,195,3.0,4.15,-800,0,630.0
640000.0,5,1.75,2020,6565,1.0,3,8,1120,900.0,1956,2020,6552,24173 days 16:47:18.685822,297,2.857142857142857,1.2444444444444445,0,13,220.0
532500.0,4,2.0,2220,23750,1.0,3,7,2220,0.0,1963,2650,21167,21616 days 16:47:18.685822,126,2.0,0.0,-430,2583,2220.0
335000.0,4,2.5,1750,8476,1.0,4,7,1240,510.0,1983,1660,7875,14311 days 16:47:18.685822,143,1.6,2.4313725490196076,90,601,730.0
415000.0,3,2.5,1710,4920,2.0,3,7,1710,0.0,1990,1500,4920,11754 days 16:47:18.685822,303,1.2,0.0,210,0,1710.0
1100000.0,6,3.25,3560,107362,1.5,4,8,2760,800.0,1963,3210,35001,21616 days 16:47:18.685822,260,1.8461538461538463,3.45,350,72361,1960.0
1440000.0,2,2.5,2720,16637,1.0,3,1,2160,560.0,1953,2880,7320,25268 days 16:47:18.685822,240,0.8,3.857142857142857,-160,9317,1600.0
180000.0,3,1.0,1010,10215,1.0,3,6,1010,0.0,1955,1320,10245,24538 days 16:47:18.685822,219,3.0,0.0,-310,-30,1010.0
335000.0,4,2.5,1830,4500,2.0,3,7,1830,0.0,2004,2080,5100,6641 days 16:47:18.685822,195,1.6,0.0,-250,-600,1830.0
835000.0,4,3.0,4480,42717,2.0,3,9,4480,0.0,1987,3140,41632,12850 days 16:47:18.685822,204,1.3333333333333333,0.0,1340,1085,4480.0
592500.0,4,1.5,2080,4400,1.5,3,7,2080,0.0,1925,1680,4400,35495 days 16:47:18.685822,276,2.6666666666666665,0.0,400,0,2080.0
418900.0,3,1.5,1470,11112,1.0,3,7,1470,0.0,1954,1460,11407,24903 days 16:47:18.685822,220,2.0,0.0,10,-295,1470.0
340000.0,3,1.0,1600,7324,1.0,4,7,1600,0.0,1958,1430,7249,23442 days 16:47:18.685822,190,3.0,0.0,170,75,1600.0
545000.0,3,2.0,1340,7200,1.5,4,7,1340,0.0,1923,1630,5760,36226 days 16:47:18.685822,183,1.5,0.0,-290,1440,1340.0
1380000.0,5,3.5,3680,8680,2.0,3,9,3680,0.0,2003,2020,8847,7006 days 16:47:18.685822,093,1.4285714285714286,0.0,1660,-167,3680.0
183750.0,3,2.5,1770,3451,2.0,3,7,1770,0.0,2004,1490,2138,6641 days 16:47:18.685822,085,1.2,0.0,280,1313,1770.0
295000.0,4,2.0,980,10640,1.0,5,7,980,0.0,1978,1230,9750,16137 days 16:47:18.685822,142,2.0,0.0,-250,890,980.0
625000.0,4,3.0,2530,5625,1.0,3,8,1470,1060.0,1976,1840,7070,16868 days 16:47:18.685822,192,1.3333333333333333,1.3867924528301887,690,-1445,410.0
290000.0,4,3.0,2390,4500,2.0,3,7,2390,0.0,1974,1320,4500,17598 days 16:47:18.685822,160,1.3333333333333333,0.0,1070,0,2390.0
760000.0,4,2.5,3600,155509,2.0,3,9,3600,0.0,2004,3410,34412,6641 days 16:47:18.685822,023,1.6,0.0,190,121097,3600.0
560000.0,4,2.5,3270,24750,1.0,4,8,1690,1580.0,1979,1520,13480,15772 days 16:47:18.685822,050,1.6,1.0696202531645569,1750,11270,110.0
475000.0,5,2.5,2300,28480,2.0,3,6,2300,0.0,1994,1880,26720,10293 days 16:47:18.685822,266,2.0,0.0,420,1760,2300.0
620000.0,3,1.0,1710,4050,1.5,3,7,1710,0.0,1909,1790,4896,41339 days 16:47:18.685822,133,3.0,0.0,-80,-846,1710.0
330000.0,4,2.0,1170,4000,1.0,3,7,1170,0.0,1955,1720,4000,24538 days 16:47:18.685822,128,2.0,0.0,-550,0,1170.0
620000.0,3,2.25,1990,6256,1.0,3,7,1390,600.0,1960,2080,9300,22712 days 16:47:18.685822,098,1.3333333333333333,2.316666666666667,-90,-3044,790.0
320000.0,4,1.75,1710,10480,1.5,4,6,1710,0.0,1969,1750,10480,19424 days 16:47:18.685822,007,2.2857142857142856,0.0,-40,0,1710.0
525000.0,3,2.5,1740,2350,2.0,3,8,1120,620.0,1996,1750,3802,9563 days 16:47:18.685822,258,1.2,1.8064516129032258,-10,-1452,500.0
802500.0,4,3.75,3320,8030,2.0,3,1,3320,0.0,2005,3740,8030,6275 days 16:47:18.685822,202,1.0666666666666667,0.0,-420,0,3320.0
569500.0,4,1.0,1960,3194,2.0,3,7,1960,0.0,1907,1870,4200,42070 days 16:47:18.685822,269,4.0,0.0,90,-1006,1960.0
850000.0,6,3.5,2820,5400,1.0,3,8,1620,1200.0,1958,1560,2276,23442 days 16:47:18.685822,350,1.7142857142857142,1.35,1260,3124,420.0
630000.0,3,1.0,1590,4080,1.5,3,7,1590,0.0,1922,1570,4080,36591 days 16:47:18.685822,095,3.0,0.0,20,0,1590.0
454800.0,4,2.25,2490,10720,1.0,4,7,1400,1090.0,1979,3080,10720,15772 days 16:47:18.685822,217,1.7777777777777777,1.2844036697247707,-590,0,310.0
177000.0,3,1.0,870,5200,1.0,5,6,870,0.0,1969,870,5200,19424 days 16:47:18.685822,062,3.0,0.0,0,0,870.0
460000.0,3,2.0,2930,29136,2.0,3,8,2240,690.0,1990,2110,29362,11754 days 16:47:18.685822,106,1.5,3.246376811594203,820,-226,1550.0
729000.0,3,1.0,1580,3840,2.0,3,8,1580,0.0,1908,1680,2624,41705 days 16:47:18.685822,168,3.0,0.0,-100,1216,1580.0
935000.0,4,3.25,4110,15488,2.0,3,1,4110,0.0,1995,4190,14973,9928 days 16:47:18.685822,294,1.2307692307692308,0.0,-80,515,4110.0
481450.0,3,2.0,1410,4800,1.0,3,7,1410,0.0,1940,1190,3840,30017 days 16:47:18.685822,129,1.5,0.0,220,960,1410.0
860000.0,3,2.0,2090,4190,1.5,4,8,1490,600.0,1930,2090,6270,33669 days 16:47:18.685822,076,1.5,2.4833333333333334,0,-2080,890.0
274000.0,3,1.75,1400,8364,1.0,4,7,1400,0.0,1958,1210,8160,23442 days 16:47:18.685822,310,1.7142857142857142,0.0,190,204,1400.0
499000.0,3,3.5,1690,1432,2.0,3,7,1360,330.0,2008,1650,2788,5180 days 16:47:18.685822,156,0.8571428571428571,4.121212121212121,40,-1356,1030.0
696500.0,5,2.25,3210,61419,1.5,3,8,3210,0.0,1979,2820,48351,15772 days 16:47:18.685822,260,2.2222222222222223,0.0,390,13068,3210.0
390000.0,3,1.0,1190,85226,1.5,5,5,1190,0.0,1935,1360,46960,31843 days 16:47:18.685822,103,3.0,0.0,-170,38266,1190.0
265000.0,3,1.0,960,9748,1.0,3,5,960,0.0,1922,1600,9958,36591 days 16:47:18.685822,350,3.0,0.0,-640,-210,960.0
470000.0,4,2.25,2380,17199,2.0,3,8,1530,850.0,1979,2280,11529,15772 days 16:47:18.685822,190,1.7777777777777777,1.8,100,5670,680.0
168500.0,2,1.0,1020,7742,1.0,4,6,1020,0.0,1935,1510,7742,31843 days 16:47:18.685822,029,2.0,0.0,-490,0,1020.0
220000.0,3,1.75,1290,8250,1.0,3,7,1290,0.0,1983,1410,7823,14311 days 16:47:18.685822,315,1.7142857142857142,0.0,-120,427,1290.0
295000.0,3,2.0,1830,17321,1.0,4,7,1100,730.0,1948,1450,10706,27095 days 16:47:18.685822,293,1.5,1.5068493150684932,380,6615,370.0
1480000.0,5,4.0,4770,31570,2.0,3,1,4770,0.0,1990,4520,32070,11754 days 16:47:18.685822,014,1.25,0.0,250,-500,4770.0
1300000.0,2,2.5,2910,19449,2.0,5,9,1940,970.0,1985,2540,23598,13580 days 16:47:18.685822,233,0.8,2.0,370,-4149,970.0
285000.0,3,1.0,950,10723,1.0,4,6,950,0.0,1959,1520,10723,23077 days 16:47:18.685822,098,3.0,0.0,-570,0,950.0
294950.0,3,1.0,1160,8950,1.0,3,7,1160,0.0,1968,1210,8193,19790 days 16:47:18.685822,295,3.0,0.0,-50,757,1160.0
1470000.0,4,4.0,4930,22093,2.0,3,1,4930,0.0,2004,4630,18889,6641 days 16:47:18.685822,002,1.0,0.0,300,3204,4930.0
565500.0,3,1.75,1780,5850,1.0,5,7,980,800.0,1944,1550,5850,28556 days 16:47:18.685822,093,1.7142857142857142,1.225,230,0,180.0
230000.0,3,2.0,1410,10625,1.0,3,7,1410,0.0,1980,1410,9744,15407 days 16:47:18.685822,286,1.5,0.0,0,881,1410.0
569950.0,4,3.5,2700,443440,1.5,3,8,2700,0.0,1948,3210,298182,27095 days 16:47:18.685822,082,1.1428571428571428,0.0,-510,145258,2700.0
721000.0,2,1.5,1790,4250,1.0,3,7,920,870.0,1915,1910,4250,39148 days 16:47:18.685822,267,1.3333333333333333,1.0574712643678161,-120,0,50.0
565000.0,3,2.5,4040,8653,2.0,3,9,2900,1140.0,2006,3360,8653,5910 days 16:47:18.685822,352,1.2,2.543859649122807,680,0,1760.0
438000.0,3,1.75,1990,9885,1.0,4,7,1030,960.0,1978,1560,10000,16137 days 16:47:18.685822,260,1.7142857142857142,1.0729166666666667,430,-115,70.0
369900.0,3,1.75,2150,19127,1.0,3,7,1650,500.0,1978,1550,15000,16137 days 16:47:18.685822,092,1.7142857142857142,3.3,600,4127,1150.0
405000.0,4,2.5,1850,9136,2.0,3,8,1850,0.0,1997,1930,7873,9197 days 16:47:18.685822,248,1.6,0.0,-80,1263,1850.0
282000.0,3,2.5,1680,15711,1.0,3,7,1240,440.0,1994,1420,8588,10293 days 16:47:18.685822,147,1.2,2.8181818181818183,260,7123,800.0
380950.0,2,1.0,1430,7819,1.0,3,7,1110,320.0,1944,1380,7473,28556 days 16:47:18.685822,308,2.0,3.46875,50,346,790.0
349810.0,3,1.0,960,8855,1.0,4,7,960,0.0,1958,1250,8855,23442 days 16:47:18.685822,181,3.0,0.0,-290,0,960.0
690000.0,4,2.5,2700,8810,2.0,3,9,2700,0.0,2004,2730,5100,6641 days 16:47:18.685822,146,1.6,0.0,-30,3710,2700.0
653000.0,2,1.5,1290,5141,1.0,4,7,1050,240.0,1947,1290,5406,27460 days 16:47:18.685822,125,1.3333333333333333,4.375,0,-265,810.0
526500.0,3,2.5,1860,43170,2.0,3,8,1860,0.0,1986,2270,40835,13215 days 16:47:18.685822,301,1.2,0.0,-410,2335,1860.0
1040000.0,4,3.5,4320,8490,2.0,3,1,3280,1040.0,2005,4030,11008,6275 days 16:47:18.685822,290,1.1428571428571428,3.1538461538461537,290,-2518,2240.0
335000.0,3,1.0,2130,3825,1.5,3,7,2130,0.0,1917,1780,5150,38417 days 16:47:18.685822,266,3.0,0.0,350,-1325,2130.0
1080000.0,5,3.5,3740,11340,2.0,3,1,3740,0.0,2013,2040,8715,3353 days 16:47:18.685822,069,1.4285714285714286,0.0,1700,2625,3740.0
475000.0,3,2.5,2130,8022,2.0,3,8,2130,0.0,1985,2130,7605,13580 days 16:47:18.685822,265,1.2,0.0,0,417,2130.0
315000.0,4,2.0,1210,4250,1.0,4,7,1210,0.0,1941,1210,6000,29651 days 16:47:18.685822,043,2.0,0.0,0,-1750,1210.0
562000.0,5,2.25,3040,8111,2.0,3,8,3040,0.0,1984,2020,8304,13946 days 16:47:18.685822,126,2.2222222222222223,0.0,1020,-193,3040.0
295000.0,3,2.5,1570,6932,2.0,3,7,1570,0.0,1993,1570,6271,10658 days 16:47:18.685822,114,1.2,0.0,0,661,1570.0
383000.0,3,2.25,2090,15000,1.0,3,7,2090,0.0,1961,1690,14400,22346 days 16:47:18.685822,189,1.3333333333333333,0.0,400,600,2090.0
242000.0,3,2.25,1690,7292,1.0,3,7,1250,440.0,1985,1670,7747,13580 days 16:47:18.685822,103,1.3333333333333333,2.840909090909091,20,-455,810.0
352500.0,3,1.5,1470,17577,1.0,5,7,1470,0.0,1967,2300,13832,20155 days 16:47:18.685822,093,2.0,0.0,-830,3745,1470.0
239950.0,4,1.0,1460,6000,1.0,4,7,730,730.0,1941,1190,6000,29651 days 16:47:18.685822,204,4.0,1.0,270,0,0.0
998000.0,4,2.5,3030,6820,2.0,3,9,2530,500.0,1947,2070,6820,27460 days 16:47:18.685822,246,1.6,5.06,960,0,2030.0
515000.0,3,1.75,1190,4500,1.0,3,6,1190,0.0,1922,1820,4500,36591 days 16:47:18.685822,107,1.7142857142857142,0.0,-630,0,1190.0
1160000.0,4,3.75,3560,13959,2.0,4,9,3560,0.0,1972,3320,11834,18329 days 16:47:18.685822,092,1.0666666666666667,0.0,240,2125,3560.0
289000.0,3,1.75,1580,9750,1.0,5,7,1580,0.0,1954,1460,9750,24903 days 16:47:18.685822,308,1.7142857142857142,0.0,120,0,1580.0
424000.0,3,1.5,1230,7200,1.0,3,7,1230,0.0,1953,1400,6240,25268 days 16:47:18.685822,082,2.0,0.0,-170,960,1230.0
199000.0,4,2.0,1440,9477,1.0,3,5,1440,0.0,1943,1440,9546,28921 days 16:47:18.685822,289,2.0,0.0,0,-69,1440.0
730000.0,4,3.5,4420,7902,2.0,3,1,3350,1070.0,2004,3440,7851,6641 days 16:47:18.685822,279,1.1428571428571428,3.130841121495327,980,51,2280.0
244000.0,3,1.0,910,5250,1.0,4,6,910,0.0,1971,1650,10442,18694 days 16:47:18.685822,147,3.0,0.0,-740,-5192,910.0
240000.0,2,1.0,670,10920,1.0,3,6,670,0.0,1942,900,7425,29286 days 16:47:18.685822,169,2.0,0.0,-230,3495,670.0
797000.0,4,2.75,2650,8610,2.0,3,8,2650,0.0,1959,1680,8316,23077 days 16:47:18.685822,112,1.4545454545454546,0.0,970,294,2650.0
350000.0,4,2.25,2220,6953,2.0,4,8,2220,0.0,1999,2240,6716,8467 days 16:47:18.685822,140,1.7777777777777777,0.0,-20,237,2220.0
415000.0,3,1.75,1640,6435,1.0,3,7,1190,450.0,1972,1770,6930,18329 days 16:47:18.685822,323,1.7142857142857142,2.6444444444444444,-130,-495,740.0
378510.0,2,1.0,770,5185,1.0,3,7,770,0.0,1947,1260,6550,27460 days 16:47:18.685822,104,2.0,0.0,-490,-1365,770.0
1200000.0,4,3.5,3960,6654,2.0,3,1,2850,1110.0,2006,2840,6400,5910 days 16:47:18.685822,189,1.1428571428571428,2.5675675675675675,1120,254,1740.0
379900.0,2,1.5,1140,7620,1.0,4,6,1140,0.0,1925,1300,7620,35495 days 16:47:18.685822,279,1.3333333333333333,0.0,-160,0,1140.0
620000.0,3,2.5,2480,9041,2.0,3,7,2480,0.0,2004,2480,6500,6641 days 16:47:18.685822,140,1.2,0.0,0,2541,2480.0
524500.0,3,1.5,1580,3172,1.0,4,8,900,680.0,1946,1580,5000,27825 days 16:47:18.685822,241,2.0,1.3235294117647058,0,-1828,220.0
270000.0,4,2.75,1990,7252,1.0,3,7,1270,720.0,1999,2100,7535,8467 days 16:47:18.685822,160,1.4545454545454546,1.7638888888888888,-110,-283,550.0
236000.0,4,2.25,1830,9485,1.0,4,7,1200,630.0,1989,1730,10109,12119 days 16:47:18.685822,148,1.7777777777777777,1.9047619047619047,100,-624,570.0
308500.0,2,2.0,840,14564,1.5,5,6,840,0.0,1942,1430,7920,29286 days 16:47:18.685822,309,1.0,0.0,-590,6644,840.0
989900.0,5,2.25,3320,11350,1.0,5,8,1660,1660.0,1963,3320,11085,21616 days 16:47:18.685822,342,2.2222222222222223,1.0,0,265,0.0
299000.0,4,2.25,2050,26000,2.0,4,8,2050,0.0,1977,2330,31100,16502 days 16:47:18.685822,275,1.7777777777777777,0.0,-280,-5100,2050.0
295000.0,2,1.75,1560,43748,2.0,3,8,1560,0.0,1967,1000,24602,20155 days 16:47:18.685822,256,1.1428571428571428,0.0,560,19146,1560.0
110000.0,2,1.0,800,15000,1.0,3,6,800,0.0,1927,1170,15000,34765 days 16:47:18.685822,162,2.0,0.0,-370,0,800.0
295950.0,2,1.0,1190,6200,1.0,3,7,1190,0.0,1948,1470,7800,27095 days 16:47:18.685822,184,2.0,0.0,-280,-1600,1190.0
270000.0,3,1.75,1300,4127,1.0,4,6,650,650.0,1918,1420,4000,38052 days 16:47:18.685822,148,1.7142857142857142,1.0,-120,127,0.0
712000.0,4,2.5,3400,247421,2.0,3,9,3400,0.0,2001,3180,222156,7736 days 16:47:18.685822,141,1.6,0.0,220,25265,3400.0
475000.0,2,1.5,1170,1250,3.0,3,8,1170,0.0,2000,1310,1308,8102 days 16:47:18.685822,126,1.3333333333333333,0.0,-140,-58,1170.0
410000.0,4,2.5,2510,5258,2.0,3,7,2510,0.0,2001,2570,5119,7736 days 16:47:18.685822,076,1.6,0.0,-60,139,2510.0
588000.0,4,2.25,2510,19550,1.0,4,9,1810,700.0,1977,2450,19250,16502 days 16:47:18.685822,072,1.7777777777777777,2.585714285714286,60,300,1110.0
420000.0,3,2.5,2390,3903,2.0,3,8,1970,420.0,2006,2390,3431,5910 days 16:47:18.685822,346,1.2,4.690476190476191,0,472,1550.0
355000.0,4,2.25,2200,3404,2.0,3,8,2200,0.0,2005,2200,3449,6275 days 16:47:18.685822,019,1.7777777777777777,0.0,0,-45,2200.0
446000.0,2,1.0,2550,21675,1.0,4,7,1610,940.0,1958,2030,10591,23442 days 16:47:18.685822,174,2.0,1.7127659574468086,520,11084,670.0
765000.0,4,2.25,2560,12100,1.0,4,8,1760,800.0,1976,2240,12100,16868 days 16:47:18.685822,140,1.7777777777777777,2.2,320,0,960.0
967500.0,3,3.75,3250,5797,2.0,4,8,2370,880.0,1951,1840,5797,25999 days 16:47:18.685822,147,0.8,2.6931818181818183,1410,0,1490.0
381000.0,2,2.0,1340,4447,1.0,3,8,1340,0.0,2004,1350,4458,6641 days 16:47:18.685822,248,1.0,0.0,-10,-11,1340.0
490000.0,3,2.25,2840,107157,2.0,4,9,2840,0.0,1983,2600,215622,14311 days 16:47:18.685822,121,1.3333333333333333,0.0,240,-108465,2840.0
716000.0,4,2.25,2480,9780,1.0,4,8,1900,580.0,1975,2640,9780,17233 days 16:47:18.685822,239,1.7777777777777777,3.2758620689655173,-160,0,1320.0
605000.0,5,3.5,3060,8862,2.0,3,8,3060,0.0,1989,2680,8398,12119 days 16:47:18.685822,104,1.4285714285714286,0.0,380,464,3060.0
312200.0,4,2.5,2910,8596,2.0,3,8,2910,0.0,2004,2770,8602,6641 days 16:47:18.685822,262,1.6,0.0,140,-6,2910.0
327000.0,4,1.0,1900,9000,1.0,4,7,1290,610.0,1948,1950,10800,27095 days 16:47:18.685822,199,4.0,2.1147540983606556,-50,-1800,680.0
229950.0,4,1.75,1300,21000,1.0,4,7,1300,0.0,1969,2120,9920,19424 days 16:47:18.685822,160,2.2857142857142856,0.0,-820,11080,1300.0
160000.0,3,1.5,1480,7000,1.0,3,7,1000,480.0,1980,1470,7022,15407 days 16:47:18.685822,192,2.0,2.0833333333333335,10,-22,520.0
255000.0,3,1.0,1250,9472,1.0,4,6,1250,0.0,1972,1590,9600,18329 days 16:47:18.685822,224,3.0,0.0,-340,-128,1250.0
530000.0,4,2.5,2000,4700,1.5,4,7,1220,780.0,1944,1560,4700,28556 days 16:47:18.685822,329,1.6,1.564102564102564,440,0,440.0
239000.0,3,1.5,1330,6540,1.0,3,7,900,430.0,1971,1400,11500,18694 days 16:47:18.685822,297,2.0,2.0930232558139537,-70,-4960,470.0
285000.0,3,2.25,1840,6214,1.0,4,7,1270,570.0,1983,1840,6214,14311 days 16:47:18.685822,059,1.3333333333333333,2.2280701754385963,0,0,700.0
537000.0,4,2.0,1560,7104,1.5,3,7,1140,420.0,1945,1850,7105,28190 days 16:47:18.685822,239,2.0,2.7142857142857144,-290,-1,720.0
530000.0,3,2.5,3150,21893,2.0,3,9,3150,0.0,2006,2280,21886,5910 days 16:47:18.685822,226,1.2,0.0,870,7,3150.0
213675.0,3,2.25,1560,6013,2.0,3,7,1560,0.0,1990,1640,6290,11754 days 16:47:18.685822,206,1.3333333333333333,0.0,-80,-277,1560.0
530000.0,5,2.5,2910,9636,1.0,4,7,1690,1220.0,1964,2830,10385,21251 days 16:47:18.685822,126,2.0,1.3852459016393444,80,-749,470.0
780000.0,3,2.5,2940,15875,2.0,3,1,2940,0.0,1994,2980,15875,10293 days 16:47:18.685822,064,1.2,0.0,-40,0,2940.0
390000.0,3,1.0,950,3621,1.0,4,6,950,0.0,1947,1540,4080,27460 days 16:47:18.685822,317,3.0,0.0,-590,-459,950.0
450000.0,2,1.0,1200,4000,1.0,3,7,1070,130.0,1940,1770,4000,30017 days 16:47:18.685822,141,2.0,8.23076923076923,-570,0,940.0
420000.0,2,1.0,1000,5375,1.0,3,7,1000,0.0,1953,1380,5000,25268 days 16:47:18.685822,070,2.0,0.0,-380,375,1000.0
550000.0,3,2.0,1490,3880,1.0,3,7,1490,0.0,1959,1490,3880,23077 days 16:47:18.685822,027,1.5,0.0,0,0,1490.0
110000.0,2,1.0,600,6120,1.0,3,5,600,0.0,1943,1060,6120,28921 days 16:47:18.685822,050,2.0,0.0,-460,0,600.0
700000.0,2,1.75,2320,5500,1.5,3,8,1720,600.0,1925,2380,5000,35495 days 16:47:18.685822,148,1.1428571428571428,2.8666666666666667,-60,500,1120.0
807500.0,4,2.5,3190,24170,2.0,3,1,3190,0.0,2002,2110,26321,7371 days 16:47:18.685822,114,1.6,0.0,1080,-2151,3190.0
179000.0,2,1.0,990,8760,1.0,3,7,990,0.0,1977,1560,11880,16502 days 16:47:18.685822,275,2.0,0.0,-570,-3120,990.0
1610000.0,4,2.75,5470,18200,2.0,3,1,3730,1740.0,1992,3620,15100,11024 days 16:47:18.685822,191,1.4545454545454546,2.1436781609195403,1850,3100,1990.0
655000.0,4,2.75,2890,46609,2.0,4,9,2890,0.0,1981,2880,68824,15041 days 16:47:18.685822,099,1.4545454545454546,0.0,10,-22215,2890.0
472500.0,3,2.0,1790,6800,1.0,4,7,1240,550.0,1964,1470,6800,21251 days 16:47:18.685822,075,1.5,2.2545454545454544,320,0,690.0
299000.0,4,2.5,2350,6958,2.0,3,9,2350,0.0,1998,2480,6395,8832 days 16:47:18.685822,300,1.6,0.0,-130,563,2350.0
740000.0,4,2.5,3430,10157,2.0,3,1,3430,0.0,2000,3480,10157,8102 days 16:47:18.685822,134,1.6,0.0,-50,0,3430.0
860000.0,3,1.75,2600,15064,1.0,4,8,1700,900.0,1967,2940,14984,20155 days 16:47:18.685822,283,1.7142857142857142,1.8888888888888888,-340,80,800.0
620000.0,4,3.0,2130,6325,1.0,5,7,1440,690.0,1948,1240,6325,27095 days 16:47:18.685822,182,1.3333333333333333,2.0869565217391304,890,0,750.0
410000.0,3,1.75,1660,5987,1.0,3,7,960,700.0,1982,1510,6000,14676 days 16:47:18.685822,283,1.7142857142857142,1.3714285714285714,150,-13,260.0
343000.0,5,3.5,2473,9282,2.0,5,7,2473,0.0,1963,2040,10920,21616 days 16:47:18.685822,063,1.4285714285714286,0.0,433,-1638,2473.0
465000.0,2,2.75,1430,1425,2.0,3,7,995,435.0,2006,1500,1749,5910 days 16:47:18.685822,168,0.7272727272727273,2.2873563218390807,-70,-324,560.0
273950.0,3,2.25,1570,3109,2.0,3,8,1570,0.0,2002,1680,3590,7371 days 16:47:18.685822,063,1.3333333333333333,0.0,-110,-481,1570.0
825000.0,2,1.0,1240,42247,1.0,4,7,1240,0.0,1915,1550,12459,39148 days 16:47:18.685822,290,2.0,0.0,-310,29788,1240.0
255000.0,3,2.5,1720,6200,2.0,3,7,1720,0.0,2014,1710,9520,2988 days 16:47:18.685822,089,1.2,0.0,10,-3320,1720.0
250000.0,3,2.0,1140,11161,1.0,4,7,1140,0.0,1998,1720,8587,8832 days 16:47:18.685822,251,1.5,0.0,-580,2574,1140.0
635000.0,4,3.25,2690,7200,2.0,3,9,1720,970.0,1978,2400,8845,16137 days 16:47:18.685822,234,1.2307692307692308,1.7731958762886597,290,-1645,750.0
240000.0,3,1.75,1520,9600,1.0,3,8,1520,0.0,1966,2060,9600,20520 days 16:47:18.685822,238,1.7142857142857142,0.0,-540,0,1520.0
670000.0,4,2.25,2040,7031,2.0,3,8,2040,0.0,2012,1670,7031,3719 days 16:47:18.685822,127,1.7777777777777777,0.0,370,0,2040.0
713414.0,3,2.5,2830,6000,1.0,3,9,1730,1100.0,1954,2040,5300,24903 days 16:47:18.685822,297,1.2,1.5727272727272728,790,700,630.0
245000.0,3,1.5,1340,7391,1.0,4,7,1340,0.0,1966,1300,7391,20520 days 16:47:18.685822,133,2.0,0.0,40,0,1340.0
600000.0,4,2.5,2520,10850,1.0,4,8,1680,840.0,1968,2590,10800,19790 days 16:47:18.685822,343,1.6,2.0,-70,50,840.0
270000.0,3,2.5,1660,5550,2.0,3,7,1660,0.0,2002,1810,5550,7371 days 16:47:18.685822,288,1.2,0.0,-150,0,1660.0
190000.0,2,1.0,880,6900,1.0,3,6,880,0.0,1943,1060,8000,28921 days 16:47:18.685822,324,2.0,0.0,-180,-1100,880.0
435000.0,3,2.0,980,5000,1.0,3,6,980,0.0,1940,1970,3025,30017 days 16:47:18.685822,157,1.5,0.0,-990,1975,980.0
560000.0,4,1.0,1360,5814,1.5,2,6,1360,0.0,1900,1010,5814,44626 days 16:47:18.685822,296,4.0,0.0,350,0,1360.0
998000.0,3,3.75,3710,34412,2.0,3,1,2910,800.0,1978,2390,34412,16137 days 16:47:18.685822,248,0.8,3.6375,1320,0,2110.0
725000.0,3,1.0,940,8377,1.0,4,7,940,0.0,1952,1710,6900,25634 days 16:47:18.685822,336,3.0,0.0,-770,1477,940.0
210000.0,2,1.0,970,8874,1.0,3,7,970,0.0,1968,1340,8175,19790 days 16:47:18.685822,328,2.0,0.0,-370,699,970.0
513000.0,3,2.25,1500,1312,3.0,3,8,1500,0.0,2007,1500,1282,5545 days 16:47:18.685822,237,1.3333333333333333,0.0,0,30,1500.0
290000.0,5,2.5,2780,9652,1.0,4,8,1390,1390.0,1967,1790,9652,20155 days 16:47:18.685822,309,2.0,1.0,990,0,0.0
1260000.0,3,2.5,3110,9930,1.0,3,8,1640,1470.0,1954,3650,14399,24903 days 16:47:18.685822,268,1.2,1.1156462585034013,-540,-4469,170.0
330000.0,3,2.25,1860,11227,2.0,3,7,1860,0.0,1995,1820,8800,9928 days 16:47:18.685822,171,1.3333333333333333,0.0,40,2427,1860.0
189000.0,3,1.0,1010,7560,1.0,3,6,1010,0.0,1958,1170,7560,23442 days 16:47:18.685822,156,3.0,0.0,-160,0,1010.0
907500.0,3,2.25,2850,6281,2.0,4,7,1900,950.0,1947,1680,7006,27460 days 16:47:18.685822,124,1.3333333333333333,2.0,1170,-725,950.0
410000.0,3,2.25,2280,200811,1.0,3,7,2280,0.0,1978,2280,206038,16137 days 16:47:18.685822,308,1.3333333333333333,0.0,0,-5227,2280.0
1050000.0,4,3.0,3080,10757,2.0,5,8,3080,0.0,1961,2810,10757,22346 days 16:47:18.685822,051,1.3333333333333333,0.0,270,0,3080.0
622100.0,4,2.5,2280,14290,1.5,4,7,1510,770.0,1942,2140,9890,29286 days 16:47:18.685822,338,1.6,1.9610389610389611,140,4400,740.0
250000.0,3,1.5,2030,14400,1.0,4,7,1310,720.0,1969,1330,14400,19424 days 16:47:18.685822,204,2.0,1.8194444444444444,700,0,590.0
1180000.0,4,3.0,2570,4000,2.0,3,8,1750,820.0,1909,1970,4000,41339 days 16:47:18.685822,230,1.3333333333333333,2.1341463414634148,600,0,930.0
925000.0,3,2.75,3640,10300,1.0,4,9,2060,1580.0,1979,3110,10625,15772 days 16:47:18.685822,040,1.0909090909090908,1.3037974683544304,530,-325,480.0
554000.0,3,2.0,1760,4046,1.0,3,7,960,800.0,1931,1500,4046,33304 days 16:47:18.685822,049,1.5,1.2,260,0,160.0
545000.0,3,2.5,2760,17377,2.0,3,9,2760,0.0,2002,1940,8504,7371 days 16:47:18.685822,190,1.2,0.0,820,8873,2760.0
660000.0,3,2.5,2650,11250,2.0,3,9,2650,0.0,2005,2200,10013,6275 days 16:47:18.685822,252,1.2,0.0,450,1237,2650.0
1900000.0,5,4.5,5160,44315,2.0,3,1,5160,0.0,1996,4760,44315,9563 days 16:47:18.685822,125,1.1111111111111112,0.0,400,0,5160.0
260000.0,4,2.0,1480,8625,1.0,4,7,1480,0.0,1974,2130,8502,17598 days 16:47:18.685822,122,2.0,0.0,-650,123,1480.0
219900.0,3,1.0,860,6664,1.0,3,6,860,0.0,1944,1150,6857,28556 days 16:47:18.685822,303,3.0,0.0,-290,-193,860.0
373500.0,4,2.5,2610,4978,2.0,3,8,2610,0.0,2004,2470,5024,6641 days 16:47:18.685822,084,1.6,0.0,140,-46,2610.0
380000.0,2,1.0,1470,81021,1.0,4,6,1470,0.0,1949,2600,69696,26729 days 16:47:18.685822,192,2.0,0.0,-1130,11325,1470.0
1060000.0,4,2.5,4570,16015,2.0,3,1,4570,0.0,1990,4490,17668,11754 days 16:47:18.685822,182,1.6,0.0,80,-1653,4570.0
2600000.0,3,3.0,3410,16015,2.0,4,1,2220,1190.0,1973,3760,16572,17963 days 16:47:18.685822,089,1.0,1.865546218487395,-350,-557,1030.0
450000.0,3,2.25,1760,10013,2.0,4,8,1760,0.0,1983,1810,9768,14311 days 16:47:18.685822,204,1.3333333333333333,0.0,-50,245,1760.0
379950.0,3,1.75,2040,12065,1.0,3,8,2040,0.0,1987,2010,11717,12850 days 16:47:18.685822,197,1.7142857142857142,0.0,30,348,2040.0
834800.0,3,3.5,3470,4171,3.0,3,9,3470,0.0,2008,3430,4268,5180 days 16:47:18.685822,232,0.8571428571428571,0.0,40,-97,3470.0
365000.0,2,1.0,680,4800,1.0,3,6,680,0.0,1917,1610,4800,38417 days 16:47:18.685822,259,2.0,0.0,-930,0,680.0
465000.0,2,2.0,1494,19271,2.0,3,7,1494,0.0,1943,1494,43583,28921 days 16:47:18.685822,168,1.0,0.0,0,-24312,1494.0
452000.0,3,1.5,1250,4000,1.0,3,7,1250,0.0,1955,1030,4000,24538 days 16:47:18.685822,211,2.0,0.0,220,0,1250.0
840000.0,3,3.0,3570,6250,2.0,3,1,2710,860.0,1985,2550,7596,13580 days 16:47:18.685822,063,1.0,3.1511627906976742,1020,-1346,1850.0
465000.0,4,2.0,2000,6250,1.5,3,7,1480,520.0,1930,1110,6250,33669 days 16:47:18.685822,307,2.0,2.8461538461538463,890,0,960.0
295000.0,3,2.5,2030,4867,2.0,3,7,2030,0.0,2003,2030,5000,7006 days 16:47:18.685822,127,1.2,0.0,0,-133,2030.0
396000.0,3,1.0,1390,6160,1.0,4,7,1390,0.0,1949,1230,6160,26729 days 16:47:18.685822,055,3.0,0.0,160,0,1390.0
397000.0,2,1.0,1030,12350,1.5,3,7,1030,0.0,1942,1790,6900,29286 days 16:47:18.685822,055,2.0,0.0,-760,5450,1030.0
240000.0,3,1.0,1280,9000,1.5,4,6,1280,0.0,1954,1430,4500,24903 days 16:47:18.685822,231,3.0,0.0,-150,4500,1280.0
300523.0,3,2.5,2370,6840,2.0,3,9,2370,0.0,1987,1590,4400,12850 days 16:47:18.685822,005,1.2,0.0,780,2440,2370.0
215500.0,3,2.0,1380,9000,2.0,2,7,1380,0.0,1946,1460,9732,27825 days 16:47:18.685822,310,1.5,0.0,-80,-732,1380.0
375000.0,5,1.5,2050,9360,1.0,3,7,1520,530.0,1968,1840,9383,19790 days 16:47:18.685822,240,3.3333333333333335,2.8679245283018866,210,-23,990.0
160000.0,3,1.0,1210,103237,1.0,2,6,1210,0.0,1918,1880,40510,38052 days 16:47:18.685822,157,3.0,0.0,-670,62727,1210.0
1070000.0,4,2.5,3270,35445,2.0,3,1,3270,0.0,1989,4180,32130,12119 days 16:47:18.685822,163,1.6,0.0,-910,3315,3270.0
952000.0,3,2.5,2450,4400,2.0,4,9,1800,650.0,1922,2220,5500,36591 days 16:47:18.685822,308,1.2,2.769230769230769,230,-1100,1150.0
523460.0,5,1.75,1890,5000,1.5,3,7,1090,800.0,1906,1610,5000,42435 days 16:47:18.685822,178,2.857142857142857,1.3625,280,0,290.0
305950.0,4,2.5,2007,4968,2.0,3,9,2007,0.0,2009,2189,5852,4814 days 16:47:18.685822,224,1.6,0.0,-182,-884,2007.0
220000.0,3,2.5,1430,9044,2.0,3,7,1430,0.0,1991,1580,8624,11389 days 16:47:18.685822,040,1.2,0.0,-150,420,1430.0
289000.0,2,1.75,2056,52333,1.0,4,7,1048,1008.0,1980,2220,6458,15407 days 16:47:18.685822,099,1.1428571428571428,1.0396825396825398,-164,45875,40.0
648000.0,5,2.5,2210,10772,1.0,3,9,1430,780.0,1964,2720,9858,21251 days 16:47:18.685822,040,2.0,1.8333333333333333,-510,914,650.0
825000.0,5,1.75,2330,6000,1.5,3,8,2080,250.0,1937,2150,6000,31112 days 16:47:18.685822,100,2.857142857142857,8.32,180,0,1830.0
400000.0,4,2.0,2070,10800,2.0,3,7,2070,0.0,1982,1880,10800,14676 days 16:47:18.685822,338,2.0,0.0,190,0,2070.0
420000.0,2,2.5,1480,1369,3.0,3,7,1480,0.0,2009,1390,1337,4814 days 16:47:18.685822,132,0.8,0.0,90,32,1480.0
389000.0,2,1.75,1160,4848,2.0,4,7,1160,0.0,1949,1990,7440,26729 days 16:47:18.685822,020,1.1428571428571428,0.0,-830,-2592,1160.0
865000.0,4,2.5,2520,4950,2.0,3,8,2520,0.0,1906,1810,3500,42435 days 16:47:18.685822,251,1.6,0.0,710,1450,2520.0
345000.0,2,1.0,1770,16660,1.0,3,8,1220,550.0,1957,2790,20504,23807 days 16:47:18.685822,337,2.0,2.2181818181818183,-1020,-3844,670.0
700000.0,3,2.5,3110,123710,2.0,3,8,2430,680.0,1995,2420,92782,9928 days 16:47:18.685822,085,1.2,3.573529411764706,690,30928,1750.0
550000.0,3,2.5,1680,10455,2.0,3,8,1680,0.0,1982,1860,10063,14676 days 16:47:18.685822,106,1.2,0.0,-180,392,1680.0
201500.0,3,1.0,1320,5000,1.5,3,7,1320,0.0,1912,1320,4179,40244 days 16:47:18.685822,189,3.0,0.0,0,821,1320.0
459000.0,3,1.0,1320,5000,1.5,3,7,1320,0.0,1912,1320,4179,40244 days 16:47:18.685822,082,3.0,0.0,0,821,1320.0
327000.0,3,2.5,1810,7350,1.0,3,8,1310,500.0,1984,2240,7350,13946 days 16:47:18.685822,352,1.2,2.62,-430,0,810.0
540000.0,1,1.0,1140,6700,1.5,3,7,1140,0.0,1920,1350,6700,37322 days 16:47:18.685822,136,1.0,0.0,-210,0,1140.0
805000.0,5,2.5,4600,19831,1.0,3,9,2300,2300.0,1956,2890,19831,24173 days 16:47:18.685822,157,2.0,1.0,1710,0,0.0
521000.0,3,2.0,1840,6000,1.0,4,6,1840,0.0,1908,2010,6000,41705 days 16:47:18.685822,296,1.5,0.0,-170,0,1840.0
375000.0,3,1.5,2000,7294,1.0,3,7,1520,480.0,1965,2000,6000,20885 days 16:47:18.685822,147,2.0,3.1666666666666665,0,1294,1040.0
235000.0,3,1.75,1480,6592,1.0,4,7,1080,400.0,1978,1660,7150,16137 days 16:47:18.685822,017,1.7142857142857142,2.7,-180,-558,680.0
240000.0,4,2.5,2040,11841,2.0,3,7,2040,0.0,1994,1730,8808,10293 days 16:47:18.685822,272,1.6,0.0,310,3033,2040.0
575000.0,4,2.25,2060,12155,1.0,4,8,2060,0.0,1968,2360,8625,19790 days 16:47:18.685822,258,1.7777777777777777,0.0,-300,3530,2060.0
1520000.0,6,3.5,3720,11690,2.0,3,1,3720,0.0,2003,3030,11686,7006 days 16:47:18.685822,335,1.7142857142857142,0.0,690,4,3720.0
394500.0,4,2.5,3002,6042,2.0,3,8,3002,0.0,2004,2566,6390,6641 days 16:47:18.685822,183,1.6,0.0,436,-348,3002.0
174950.0,3,1.0,1060,5200,1.0,5,6,1060,0.0,1970,1380,5200,19059 days 16:47:18.685822,135,3.0,0.0,-320,0,1060.0
383000.0,4,2.0,1830,21183,1.0,4,7,1060,770.0,1966,1950,6120,20520 days 16:47:18.685822,321,2.0,1.3766233766233766,-120,15063,290.0
249950.0,3,2.0,1550,15040,1.0,4,6,1550,0.0,1958,1510,41416,23442 days 16:47:18.685822,125,1.5,0.0,40,-26376,1550.0
431000.0,3,2.5,1690,2752,2.0,3,8,1690,0.0,1979,1690,2855,15772 days 16:47:18.685822,077,1.2,0.0,0,-103,1690.0
459900.0,3,1.75,2580,11000,1.0,4,7,1290,1290.0,1951,2280,17643,25999 days 16:47:18.685822,150,1.7142857142857142,1.0,300,-6643,0.0
475000.0,5,2.5,2510,8050,1.0,4,7,1490,1020.0,1977,1840,8471,16502 days 16:47:18.685822,188,2.0,1.4607843137254901,670,-421,470.0
605000.0,3,2.25,1290,2500,2.0,4,8,1290,0.0,1987,1700,3750,12850 days 16:47:18.685822,136,1.3333333333333333,0.0,-410,-1250,1290.0
234950.0,4,2.0,1450,7560,1.0,3,7,1450,0.0,1967,1430,7560,20155 days 16:47:18.685822,049,2.0,0.0,20,0,1450.0
419000.0,4,2.5,2690,7947,2.0,3,8,2690,0.0,1993,2160,8328,10658 days 16:47:18.685822,164,1.6,0.0,530,-381,2690.0
910000.0,4,3.25,3340,10890,1.5,3,9,2240,1100.0,1963,2880,9794,21616 days 16:47:18.685822,142,1.2307692307692308,2.036363636363636,460,1096,1140.0
392000.0,4,2.5,2600,8921,2.0,3,8,2600,0.0,1991,2550,8683,11389 days 16:47:18.685822,337,1.6,0.0,50,238,2600.0
915000.0,3,2.5,3140,9808,2.0,3,9,2500,640.0,2001,2370,10014,7736 days 16:47:18.685822,237,1.2,3.90625,770,-206,1860.0
630000.0,3,3.25,3800,13995,2.0,3,9,3800,0.0,1983,2480,8434,14311 days 16:47:18.685822,318,0.9230769230769231,0.0,1320,5561,3800.0
416100.0,4,1.75,2320,5490,1.0,3,8,1160,1160.0,1956,2240,7200,24173 days 16:47:18.685822,191,2.2857142857142856,1.0,80,-1710,0.0
285000.0,4,2.5,2360,7350,1.0,4,7,1440,920.0,1965,1450,7305,20885 days 16:47:18.685822,233,1.6,1.565217391304348,910,45,520.0
353000.0,4,1.5,1100,9600,1.0,4,6,1100,0.0,1960,1100,9630,22712 days 16:47:18.685822,126,2.6666666666666665,0.0,0,-30,1100.0
297950.0,3,2.0,1390,5127,1.0,3,8,1390,0.0,1990,1960,5019,11754 days 16:47:18.685822,238,1.5,0.0,-570,108,1390.0
750000.0,2,2.0,2180,21392,2.0,3,8,2180,0.0,1934,2890,22000,32208 days 16:47:18.685822,280,1.0,0.0,-710,-608,2180.0
525000.0,3,3.0,1730,1074,3.5,3,8,1730,0.0,2006,1370,1185,5910 days 16:47:18.685822,092,1.0,0.0,360,-111,1730.0
495000.0,5,1.75,2760,18112,1.0,3,8,1510,1250.0,1968,1720,8482,19790 days 16:47:18.685822,196,2.857142857142857,1.208,1040,9630,260.0
710000.0,3,1.75,2430,11448,1.0,5,7,1620,810.0,1949,2140,8144,26729 days 16:47:18.685822,237,1.7142857142857142,2.0,290,3304,810.0
310000.0,3,2.0,2010,12950,1.0,3,8,2010,0.0,1953,1490,10181,25268 days 16:47:18.685822,211,1.5,0.0,520,2769,2010.0
205000.0,5,1.75,1730,5200,1.0,4,7,1050,680.0,1978,1350,5200,16137 days 16:47:18.685822,136,2.857142857142857,1.5441176470588236,380,0,370.0
530000.0,3,3.0,2450,211266,1.5,3,8,2450,0.0,2004,2300,263492,6641 days 16:47:18.685822,128,1.0,0.0,150,-52226,2450.0
725000.0,4,2.5,3300,28433,2.0,3,9,3300,0.0,1998,3550,26386,8832 days 16:47:18.685822,205,1.6,0.0,-250,2047,3300.0
195000.0,2,1.0,720,9520,1.0,4,6,720,0.0,1947,1450,8612,27460 days 16:47:18.685822,329,2.0,0.0,-730,908,720.0
401000.0,3,2.0,1240,11172,1.0,3,7,1000,240.0,1984,1330,14102,13946 days 16:47:18.685822,182,1.5,4.166666666666667,-90,-2930,760.0
1030000.0,5,2.5,3050,8200,1.0,4,8,1650,1400.0,1962,2970,8792,21981 days 16:47:18.685822,265,2.0,1.1785714285714286,80,-592,250.0
251000.0,3,1.5,1590,21600,1.5,4,7,1590,0.0,1971,1780,21600,18694 days 16:47:18.685822,093,2.0,0.0,-190,0,1590.0
667500.0,3,2.0,2040,4841,1.0,4,7,1020,1020.0,1949,1600,4841,26729 days 16:47:18.685822,300,1.5,1.0,440,0,0.0
300000.0,4,2.5,1840,5550,2.0,3,8,1840,0.0,2004,2030,5500,6641 days 16:47:18.685822,174,1.6,0.0,-190,50,1840.0
610000.0,4,2.25,1960,9021,2.0,4,8,1960,0.0,1973,1960,9975,17963 days 16:47:18.685822,226,1.7777777777777777,0.0,0,-954,1960.0
1040000.0,4,5.0,4110,43560,2.0,4,1,4110,0.0,1978,3650,43995,16137 days 16:47:18.685822,184,0.8,0.0,460,-435,4110.0
430000.0,3,2.25,1830,19965,1.0,3,8,1400,430.0,1976,1830,17250,16868 days 16:47:18.685822,337,1.3333333333333333,3.255813953488372,0,2715,970.0
455000.0,2,1.0,1330,92782,1.0,2,6,1330,0.0,1950,1280,168141,26364 days 16:47:18.685822,092,2.0,0.0,50,-75359,1330.0
638000.0,3,3.25,1720,1587,2.5,3,9,1410,310.0,2004,1490,1620,6641 days 16:47:18.685822,050,0.9230769230769231,4.548387096774194,230,-33,1100.0
561000.0,3,1.75,1710,5000,1.0,4,7,1360,350.0,1918,1490,6250,38052 days 16:47:18.685822,287,1.7142857142857142,3.8857142857142857,220,-1250,1010.0
625000.0,3,2.5,2180,5000,1.0,4,8,1240,940.0,1977,2000,5000,16502 days 16:47:18.685822,350,1.2,1.3191489361702127,180,0,300.0
263950.0,3,1.75,1700,11613,1.0,5,7,1180,520.0,1977,1500,12377,16502 days 16:47:18.685822,083,1.7142857142857142,2.269230769230769,200,-764,660.0
740000.0,3,2.5,2960,9350,2.0,4,9,2960,0.0,1978,2960,11745,16137 days 16:47:18.685822,301,1.2,0.0,0,-2395,2960.0
234999.0,3,1.0,1330,8912,1.0,3,6,1330,0.0,1948,1200,8913,27095 days 16:47:18.685822,160,3.0,0.0,130,-1,1330.0
329500.0,3,2.25,1500,9656,1.0,3,7,1170,330.0,1989,1690,9656,12119 days 16:47:18.685822,224,1.3333333333333333,3.5454545454545454,-190,0,840.0
464950.0,4,2.5,2230,64438,1.0,4,7,1230,1000.0,1978,2230,71002,16137 days 16:47:18.685822,192,1.6,1.23,0,-6564,230.0
500000.0,3,2.25,1700,9008,1.0,3,8,1340,360.0,1985,2340,8003,13580 days 16:47:18.685822,092,1.3333333333333333,3.7222222222222223,-640,1005,980.0
415000.0,4,1.5,1840,11367,1.5,4,7,1840,0.0,1950,1690,9800,26364 days 16:47:18.685822,190,2.6666666666666665,0.0,150,1567,1840.0
437500.0,3,2.25,2100,205603,2.0,3,8,2100,0.0,1983,2396,187308,14311 days 16:47:18.685822,248,1.3333333333333333,0.0,-296,18295,2100.0
367000.0,4,2.5,2350,8182,2.0,3,8,2350,0.0,1997,2330,7000,9197 days 16:47:18.685822,287,1.6,0.0,20,1182,2350.0
530000.0,2,1.0,760,3000,1.0,3,6,760,0.0,1922,1630,3600,36591 days 16:47:18.685822,115,2.0,0.0,-870,-600,760.0
989000.0,5,3.5,3280,4000,2.0,3,9,2440,840.0,2003,1980,4000,7006 days 16:47:18.685822,155,1.4285714285714286,2.9047619047619047,1300,0,1600.0
462600.0,3,2.0,1320,4000,1.0,4,6,1020,300.0,1940,2410,6212,30017 days 16:47:18.685822,234,1.5,3.4,-1090,-2212,720.0
875000.0,3,2.5,1690,10592,1.0,3,8,1690,0.0,1973,2260,9945,17963 days 16:47:18.685822,114,1.2,0.0,-570,647,1690.0
335000.0,3,2.25,2060,47318,1.0,4,8,1600,460.0,1976,1870,19663,16868 days 16:47:18.685822,203,1.3333333333333333,3.4782608695652173,190,27655,1140.0
393000.0,4,2.0,1450,5456,1.0,5,7,1450,0.0,1951,980,6100,25999 days 16:47:18.685822,212,2.0,0.0,470,-644,1450.0
1340000.0,4,3.0,2760,4905,2.0,4,9,1840,920.0,1938,3200,5424,30747 days 16:47:18.685822,202,1.3333333333333333,2.0,-440,-519,920.0
590000.0,3,2.5,2830,5788,2.0,3,9,2830,0.0,2001,2500,5802,7736 days 16:47:18.685822,082,1.2,0.0,330,-14,2830.0
671000.0,4,2.75,1890,1475,2.0,3,9,1200,690.0,2015,1650,1682,2623 days 16:47:18.685822,111,1.4545454545454546,1.7391304347826086,240,-207,510.0
925000.0,3,3.25,2610,4500,1.5,4,9,1660,950.0,1909,2110,4500,41339 days 16:47:18.685822,209,0.9230769230769231,1.7473684210526317,500,0,710.0
245000.0,3,2.25,1900,7250,1.0,3,7,1250,650.0,1967,1560,9420,20155 days 16:47:18.685822,279,1.3333333333333333,1.9230769230769231,340,-2170,600.0
392500.0,3,1.0,930,6572,1.0,3,7,930,0.0,1952,960,5840,25634 days 16:47:18.685822,092,3.0,0.0,-30,732,930.0
505000.0,4,2.0,2730,12000,1.0,4,8,1410,1320.0,1998,2730,9039,8832 days 16:47:18.685822,240,2.0,1.0681818181818181,0,2961,90.0
702000.0,4,2.5,2650,6240,2.0,3,8,2650,0.0,2013,2640,6524,3353 days 16:47:18.685822,231,1.6,0.0,10,-284,2650.0
337000.0,2,1.0,1010,4000,1.0,3,7,1010,0.0,1947,1480,4366,27460 days 16:47:18.685822,199,2.0,0.0,-470,-366,1010.0
920000.0,4,2.5,3550,10233,2.0,3,9,3550,0.0,1996,3310,9157,9563 days 16:47:18.685822,363,1.6,0.0,240,1076,3550.0
495500.0,3,1.75,2130,6360,1.0,3,7,1720,410.0,1959,1540,6361,23077 days 16:47:18.685822,239,1.7142857142857142,4.195121951219512,590,-1,1310.0
245000.0,2,1.75,1840,7230,1.0,3,7,1570,270.0,1938,1282,6769,30747 days 16:47:18.685822,267,1.1428571428571428,5.814814814814815,558,461,1300.0
395000.0,2,1.0,1320,1824,1.5,4,6,1320,0.0,1909,1320,4000,41339 days 16:47:18.685822,149,2.0,0.0,0,-2176,1320.0
335000.0,3,1.0,990,6315,1.0,3,7,990,0.0,1970,1450,6702,19059 days 16:47:18.685822,048,3.0,0.0,-460,-387,990.0
187000.0,2,1.75,1020,10346,1.0,4,6,1020,0.0,1983,1160,8610,14311 days 16:47:18.685822,314,1.1428571428571428,0.0,-140,1736,1020.0
450000.0,4,2.0,1570,7320,1.0,4,7,1570,0.0,1960,1530,8800,22712 days 16:47:18.685822,325,2.0,0.0,40,-1480,1570.0
280000.0,4,2.25,1930,7207,1.0,4,7,1360,570.0,1988,1760,7207,12485 days 16:47:18.685822,168,1.7777777777777777,2.3859649122807016,170,0,790.0
1380000.0,5,4.0,3760,22763,1.0,4,1,1910,1850.0,1969,3730,11201,19424 days 16:47:18.685822,196,1.25,1.0324324324324323,30,11562,60.0
265000.0,2,1.0,1000,31505,1.0,3,6,1000,0.0,1960,1560,22597,22712 days 16:47:18.685822,160,2.0,0.0,-560,8908,1000.0
795000.0,3,1.75,1930,9600,1.0,3,8,1930,0.0,1958,2350,9840,23442 days 16:47:18.685822,113,1.7142857142857142,0.0,-420,-240,1930.0
510000.0,3,1.5,2240,3800,2.0,3,8,1370,870.0,1929,1690,4275,34034 days 16:47:18.685822,149,2.0,1.5747126436781609,550,-475,500.0
699900.0,4,2.5,2190,11500,1.0,4,8,1430,760.0,1972,2580,9700,18329 days 16:47:18.685822,179,1.6,1.881578947368421,-390,1800,670.0
839000.0,4,2.75,2400,12469,1.0,4,8,1760,640.0,1958,2400,10400,23442 days 16:47:18.685822,224,1.4545454545454546,2.75,0,2069,1120.0
396000.0,4,1.75,1970,12409,1.0,4,7,1220,750.0,1968,1690,10720,19790 days 16:47:18.685822,196,2.2857142857142856,1.6266666666666667,280,1689,470.0
365000.0,3,2.25,2860,8458,2.0,3,7,2860,0.0,1983,1760,8458,14311 days 16:47:18.685822,127,1.3333333333333333,0.0,1100,0,2860.0
440000.0,3,2.25,1900,7225,1.0,3,8,1220,680.0,1970,1900,7399,19059 days 16:47:18.685822,192,1.3333333333333333,1.7941176470588236,0,-174,540.0
405000.0,4,2.5,2090,6667,2.0,3,8,2090,0.0,1997,2250,6165,9197 days 16:47:18.685822,308,1.6,0.0,-160,502,2090.0
295000.0,3,1.5,850,2500,1.0,3,7,850,0.0,1986,850,5000,13215 days 16:47:18.685822,135,2.0,0.0,0,-2500,850.0
275000.0,4,2.5,1840,1562,2.0,3,7,1400,440.0,2004,1840,1766,6641 days 16:47:18.685822,135,1.6,3.1818181818181817,0,-204,960.0
295000.0,2,1.0,820,288367,1.0,3,6,820,0.0,1930,1580,8154,33669 days 16:47:18.685822,276,2.0,0.0,-760,280213,820.0
1500000.0,5,3.5,4370,12240,2.0,3,1,3270,1100.0,1990,2980,12800,11754 days 16:47:18.685822,227,1.4285714285714286,2.9727272727272727,1390,-560,2170.0
795000.0,3,3.5,3190,10223,2.0,3,1,2560,630.0,1994,3120,9735,10293 days 16:47:18.685822,245,0.8571428571428571,4.063492063492063,70,488,1930.0
650000.0,5,3.5,3480,36615,2.0,4,8,2490,990.0,1983,2540,35910,14311 days 16:47:18.685822,126,1.4285714285714286,2.515151515151515,940,705,1500.0
260000.0,3,1.0,1690,13184,1.0,4,7,1690,0.0,1959,1130,13451,23077 days 16:47:18.685822,253,3.0,0.0,560,-267,1690.0
382000.0,2,2.5,1650,2710,2.0,3,8,1650,0.0,2008,1760,2992,5180 days 16:47:18.685822,218,0.8,0.0,-110,-282,1650.0
790100.0,4,2.5,2590,9341,2.0,3,8,2590,0.0,1985,2280,9510,13580 days 16:47:18.685822,111,1.6,0.0,310,-169,2590.0
220000.0,4,2.5,2160,8005,2.0,3,7,2160,0.0,1993,1790,8016,10658 days 16:47:18.685822,141,1.6,0.0,370,-11,2160.0
799000.0,4,3.5,3500,8547,2.0,3,9,2500,1000.0,1994,2350,10270,10293 days 16:47:18.685822,156,1.1428571428571428,2.5,1150,-1723,1500.0
1480000.0,4,2.25,3920,7200,2.0,3,1,3120,800.0,1928,3400,7200,34400 days 16:47:18.685822,204,1.7777777777777777,3.9,520,0,2320.0
367300.0,4,2.75,2190,14937,2.0,3,8,2190,0.0,1993,1920,11360,10658 days 16:47:18.685822,160,1.4545454545454546,0.0,270,3577,2190.0
805000.0,4,2.0,1890,4500,1.5,3,7,1490,400.0,1907,1640,4010,42070 days 16:47:18.685822,099,2.0,3.725,250,490,1090.0
730000.0,2,1.0,1860,3400,1.0,3,7,1010,850.0,1920,1540,3997,37322 days 16:47:18.685822,349,2.0,1.188235294117647,320,-597,160.0
402000.0,3,2.0,1720,7704,1.0,4,7,1160,560.0,1969,1620,7600,19424 days 16:47:18.685822,327,1.5,2.0714285714285716,100,104,600.0
750000.0,4,2.75,2600,4674,1.0,3,8,1560,1040.0,1976,2600,6099,16868 days 16:47:18.685822,150,1.4545454545454546,1.5,0,-1425,520.0
458000.0,3,1.5,1570,12196,1.0,4,7,1570,0.0,1972,1740,12196,18329 days 16:47:18.685822,211,2.0,0.0,-170,0,1570.0
898000.0,3,2.5,3530,9753,2.0,3,1,3530,0.0,1997,3220,9234,9197 days 16:47:18.685822,240,1.2,0.0,310,519,3530.0
308000.0,4,2.5,1960,5642,2.0,3,7,1960,0.0,1998,1870,5250,8832 days 16:47:18.685822,082,1.6,0.0,90,392,1960.0
385000.0,3,2.5,2230,8296,2.0,3,7,2230,0.0,2004,2480,5940,6641 days 16:47:18.685822,126,1.2,0.0,-250,2356,2230.0
1020000.0,4,3.0,2720,4800,1.5,5,8,1790,930.0,1928,2260,4800,34400 days 16:47:18.685822,279,1.3333333333333333,1.924731182795699,460,0,860.0
1430000.0,5,3.0,2840,6240,2.0,5,9,2440,400.0,1905,2940,6000,42800 days 16:47:18.685822,363,1.6666666666666667,6.1,-100,240,2040.0
240000.0,3,1.75,1260,7362,1.0,3,7,1260,0.0,1984,1530,7232,13946 days 16:47:18.685822,204,1.7142857142857142,0.0,-270,130,1260.0
217000.0,3,1.5,1860,8505,1.0,4,7,1860,0.0,1967,1810,8262,20155 days 16:47:18.685822,274,2.0,0.0,50,243,1860.0
972000.0,4,1.75,2010,6300,1.0,5,8,1610,400.0,1937,3290,6300,31112 days 16:47:18.685822,181,2.2857142857142856,4.025,-1280,0,1210.0
361280.0,2,1.0,820,6400,1.0,4,7,820,0.0,1944,1490,6400,28556 days 16:47:18.685822,127,2.0,0.0,-670,0,820.0
385000.0,3,1.75,1220,1450,1.0,3,6,620,600.0,1905,1660,2960,42800 days 16:47:18.685822,216,1.7142857142857142,1.0333333333333334,-440,-1510,20.0
475000.0,3,2.5,2220,60984,2.0,4,8,2220,0.0,1987,1930,55333,12850 days 16:47:18.685822,309,1.2,0.0,290,5651,2220.0
724950.0,4,2.5,2860,3638,1.5,5,7,1720,1140.0,1924,1760,3880,35861 days 16:47:18.685822,092,1.6,1.5087719298245614,1100,-242,580.0
935000.0,5,4.5,4230,9701,2.0,3,1,4230,0.0,1999,4130,12253,8467 days 16:47:18.685822,300,1.1111111111111112,0.0,100,-2552,4230.0
169950.0,3,1.0,840,8470,1.0,4,6,840,0.0,1961,840,8450,22346 days 16:47:18.685822,251,3.0,0.0,0,20,840.0
585000.0,3,2.5,2290,5089,2.0,3,9,2290,0.0,2001,2290,7984,7736 days 16:47:18.685822,342,1.2,0.0,0,-2895,2290.0
585000.0,3,2.5,2290,5089,2.0,3,9,2290,0.0,2001,2290,7984,7736 days 16:47:18.685822,113,1.2,0.0,0,-2895,2290.0
480000.0,5,3.5,3480,12821,2.0,3,1,2890,590.0,2004,3400,9870,6641 days 16:47:18.685822,086,1.4285714285714286,4.898305084745763,80,2951,2300.0
635000.0,4,2.5,4260,36360,1.5,4,8,4100,160.0,1935,2430,17888,31843 days 16:47:18.685822,309,1.6,25.625,1830,18472,3940.0
368750.0,3,2.5,2230,5717,2.0,3,7,2230,0.0,2004,2230,5194,6641 days 16:47:18.685822,035,1.2,0.0,0,523,2230.0
589000.0,3,2.5,2250,4337,2.0,3,8,2250,0.0,2004,2250,4721,6641 days 16:47:18.685822,246,1.2,0.0,0,-384,2250.0
840000.0,4,3.25,3160,6327,2.0,3,9,2280,880.0,2004,3160,5946,6641 days 16:47:18.685822,104,1.2307692307692308,2.590909090909091,0,381,1400.0
316500.0,3,2.5,1770,3873,2.0,3,7,1770,0.0,2005,2280,4330,6275 days 16:47:18.685822,064,1.2,0.0,-510,-457,1770.0
536000.0,4,2.5,2880,8833,2.0,3,7,2880,0.0,2006,2570,5234,5910 days 16:47:18.685822,044,1.6,0.0,310,3599,2880.0
563750.0,4,2.75,2690,25000,1.0,3,8,1750,940.0,1978,2640,28250,16137 days 16:47:18.685822,110,1.4545454545454546,1.8617021276595744,50,-3250,810.0
152500.0,4,1.0,1730,7350,1.5,4,6,1730,0.0,1970,1440,7752,19059 days 16:47:18.685822,360,4.0,0.0,290,-402,1730.0
267950.0,4,1.0,1730,7350,1.5,4,6,1730,0.0,1970,1440,7752,19059 days 16:47:18.685822,110,4.0,0.0,290,-402,1730.0
1640000.0,5,4.0,4780,118047,2.0,3,1,4780,0.0,1994,4040,31760,10293 days 16:47:18.685822,103,1.25,0.0,740,86287,4780.0
269950.0,4,2.5,2540,8400,2.0,5,7,2540,0.0,1977,1600,8050,16502 days 16:47:18.685822,174,1.6,0.0,940,350,2540.0
731688.0,4,3.0,2630,5772,2.0,3,9,2630,0.0,2006,3460,6158,5910 days 16:47:18.685822,202,1.3333333333333333,0.0,-830,-386,2630.0
240000.0,3,1.5,1890,9000,1.0,3,7,1190,700.0,1959,2060,9000,23077 days 16:47:18.685822,337,2.0,1.7,-170,0,490.0
555950.0,2,1.0,1220,5040,1.0,3,7,1220,0.0,1961,1420,5040,22346 days 16:47:18.685822,246,2.0,0.0,-200,0,1220.0
525000.0,3,2.5,2970,11985,1.0,3,9,1770,1200.0,1995,2990,12049,9928 days 16:47:18.685822,126,1.2,1.475,-20,-64,570.0
745000.0,3,2.5,2970,11985,1.0,3,9,1770,1200.0,1995,2990,12049,9928 days 16:47:18.685822,338,1.2,1.475,-20,-64,570.0
397000.0,2,1.0,1000,7664,1.0,3,7,1000,0.0,1939,1570,6350,30382 days 16:47:18.685822,321,2.0,0.0,-570,1314,1000.0
233000.0,3,1.0,1980,8505,1.0,3,7,1030,950.0,1965,1830,8505,20885 days 16:47:18.685822,112,3.0,1.0842105263157895,150,0,80.0
625000.0,4,2.25,1920,8259,2.0,4,8,1920,0.0,1979,2030,8910,15772 days 16:47:18.685822,289,1.7777777777777777,0.0,-110,-651,1920.0
535000.0,3,2.0,2740,23505,2.0,3,1,2740,0.0,1988,2800,16400,12485 days 16:47:18.685822,210,1.5,0.0,-60,7105,2740.0
270000.0,3,2.25,1740,7345,1.0,3,7,1380,360.0,1973,1770,8250,17963 days 16:47:18.685822,124,1.3333333333333333,3.8333333333333335,-30,-905,1020.0
360000.0,3,1.75,1300,7770,1.0,3,7,1300,0.0,1967,1520,7600,20155 days 16:47:18.685822,203,1.7142857142857142,0.0,-220,170,1300.0
970000.0,4,1.75,4060,4000,2.0,3,1,2890,1170.0,1953,1860,4000,25268 days 16:47:18.685822,315,2.2857142857142856,2.47008547008547,2200,0,1720.0
915000.0,5,2.5,3490,18850,1.0,4,9,1840,1650.0,1958,2690,11625,23442 days 16:47:18.685822,283,2.0,1.1151515151515152,800,7225,190.0
412000.0,4,1.75,1430,10500,1.0,4,7,1130,300.0,1960,2070,8640,22712 days 16:47:18.685822,192,2.2857142857142856,3.7666666666666666,-640,1860,830.0
265000.0,4,1.75,1860,9112,1.0,4,7,1110,750.0,1963,1570,9112,21616 days 16:47:18.685822,043,2.2857142857142856,1.48,290,0,360.0
426000.0,4,2.25,2120,7700,1.0,4,7,1490,630.0,1976,1890,8203,16868 days 16:47:18.685822,259,1.7777777777777777,2.365079365079365,230,-503,860.0
266000.0,4,2.25,1860,12693,1.0,3,8,1140,720.0,1978,1950,8740,16137 days 16:47:18.685822,344,1.7777777777777777,1.5833333333333333,-90,3953,420.0
325000.0,3,2.0,2330,4950,1.5,3,6,1430,900.0,1900,1160,5115,44626 days 16:47:18.685822,349,1.5,1.5888888888888888,1170,-165,530.0
615000.0,3,1.75,1670,5100,1.0,5,7,990,680.0,1954,2140,4452,24903 days 16:47:18.685822,020,1.7142857142857142,1.4558823529411764,-470,648,310.0
310000.0,3,1.75,2130,7140,1.0,3,8,1580,550.0,1979,2180,7906,15772 days 16:47:18.685822,113,1.7142857142857142,2.8727272727272726,-50,-766,1030.0
340000.0,4,1.75,1900,7313,1.0,3,7,1900,0.0,1973,1420,7384,17963 days 16:47:18.685822,257,2.2857142857142856,0.0,480,-71,1900.0
562500.0,2,1.0,1170,2800,1.5,4,5,1170,0.0,1905,1660,4996,42800 days 16:47:18.685822,121,2.0,0.0,-490,-2196,1170.0
447000.0,2,1.0,980,1600,2.0,3,8,980,0.0,2010,1180,1600,4449 days 16:47:18.685822,202,2.0,0.0,-200,0,980.0
2450000.0,7,4.25,4670,23115,2.0,3,1,4670,0.0,1992,3240,13912,11024 days 16:47:18.685822,273,1.6470588235294117,0.0,1430,9203,4670.0
250000.0,4,1.5,2500,6300,1.0,4,7,1500,1000.0,1961,1720,8925,22346 days 16:47:18.685822,140,2.6666666666666665,1.5,780,-2625,500.0
633000.0,4,2.5,2020,8044,2.0,3,8,2020,0.0,1990,2320,7328,11754 days 16:47:18.685822,002,1.6,0.0,-300,716,2020.0
310000.0,3,2.0,1290,886,3.0,3,7,1290,0.0,2004,1270,1152,6641 days 16:47:18.685822,113,1.5,0.0,20,-266,1290.0
439000.0,2,1.75,1620,113862,1.5,3,7,1620,0.0,1995,1560,54806,9928 days 16:47:18.685822,314,1.1428571428571428,0.0,60,59056,1620.0
470000.0,3,3.25,1710,2381,2.0,3,8,1360,350.0,2003,1420,1163,7006 days 16:47:18.685822,232,0.9230769230769231,3.8857142857142857,290,1218,1010.0
270000.0,3,2.5,1720,8550,1.0,4,7,1720,0.0,1968,1460,8550,19790 days 16:47:18.685822,104,1.2,0.0,260,0,1720.0
299500.0,3,1.75,1820,8813,2.0,3,7,1820,0.0,1994,1780,7349,10293 days 16:47:18.685822,353,1.7142857142857142,0.0,40,1464,1820.0
227000.0,3,1.0,1130,10018,1.0,4,6,1130,0.0,1954,1770,7700,24903 days 16:47:18.685822,261,3.0,0.0,-640,2318,1130.0
735000.0,4,2.75,3040,2415,2.0,3,8,3040,0.0,1966,2620,2433,20520 days 16:47:18.685822,232,1.4545454545454546,0.0,420,-18,3040.0
537000.0,3,3.0,2410,7479,2.0,3,7,2410,0.0,1942,2610,7479,29286 days 16:47:18.685822,177,1.0,0.0,-200,0,2410.0
699000.0,4,2.5,2440,14470,1.0,4,9,1660,780.0,1970,2810,15564,19059 days 16:47:18.685822,343,1.6,2.128205128205128,-370,-1094,880.0
330000.0,2,1.0,800,4533,1.0,3,6,600,200.0,1929,1720,6800,34034 days 16:47:18.685822,245,2.0,3.0,-920,-2267,400.0
229000.0,3,1.0,1030,7800,1.0,3,7,1030,0.0,1954,1630,12664,24903 days 16:47:18.685822,241,3.0,0.0,-600,-4864,1030.0
200000.0,3,1.0,1480,5600,1.0,4,6,940,540.0,1947,1350,11100,27460 days 16:47:18.685822,325,3.0,1.7407407407407407,130,-5500,400.0
522500.0,3,1.75,1710,9707,1.0,4,8,1710,0.0,1966,1820,8700,20520 days 16:47:18.685822,224,1.7142857142857142,0.0,-110,1007,1710.0
1300000.0,3,2.75,3450,5350,1.5,4,9,2590,860.0,1925,2910,5350,35495 days 16:47:18.685822,083,1.0909090909090908,3.011627906976744,540,0,1730.0
2000000.0,3,3.25,2610,16387,2.0,3,9,2610,0.0,2006,2590,12958,5910 days 16:47:18.685822,314,0.9230769230769231,0.0,20,3429,2610.0
200000.0,2,0.75,780,55764,1.0,4,4,780,0.0,1945,1620,30847,28190 days 16:47:18.685822,295,2.6666666666666665,0.0,-840,24917,780.0
352000.0,3,1.75,1260,7200,1.0,3,7,1260,0.0,1971,1460,7200,18694 days 16:47:18.685822,098,1.7142857142857142,0.0,-200,0,1260.0
855000.0,4,3.0,2590,6250,2.0,3,9,2240,350.0,1964,2260,6780,21251 days 16:47:18.685822,084,1.3333333333333333,6.4,330,-530,1890.0
267000.0,3,2.5,1580,12250,2.0,3,8,1580,0.0,1993,1560,9900,10658 days 16:47:18.685822,232,1.2,0.0,20,2350,1580.0
484000.0,2,1.75,1660,6000,1.0,3,7,1160,500.0,1942,1660,4000,29286 days 16:47:18.685822,126,1.1428571428571428,2.32,0,2000,660.0
402000.0,4,2.75,2950,15540,1.0,4,8,2120,830.0,1974,2840,17136,17598 days 16:47:18.685822,180,1.4545454545454546,2.5542168674698793,110,-1596,1290.0
905000.0,4,2.25,2240,5000,2.0,3,8,1770,470.0,1900,2120,5000,44626 days 16:47:18.685822,110,1.7777777777777777,3.765957446808511,120,0,1300.0
274000.0,4,1.75,1940,7500,1.0,4,7,1720,220.0,1966,2000,9000,20520 days 16:47:18.685822,220,2.2857142857142856,7.818181818181818,-60,-1500,1500.0
475000.0,3,1.75,1850,26445,1.0,4,7,1850,0.0,1962,2110,23280,21981 days 16:47:18.685822,099,1.7142857142857142,0.0,-260,3165,1850.0
1540000.0,4,4.5,5770,10050,1.0,5,9,3160,2610.0,1949,2950,6700,26729 days 16:47:18.685822,318,0.8888888888888888,1.210727969348659,2820,3350,550.0
628000.0,4,2.0,2280,6010,1.0,3,7,1140,1140.0,1900,2240,6200,44626 days 16:47:18.685822,124,2.0,1.0,40,-190,0.0
675000.0,6,1.75,2740,6360,1.0,3,8,1370,1370.0,1953,2150,6600,25268 days 16:47:18.685822,168,3.4285714285714284,1.0,590,-240,0.0
429900.0,4,3.25,3760,4675,2.0,3,8,2740,1020.0,2007,3280,4033,5545 days 16:47:18.685822,308,1.2307692307692308,2.6862745098039214,480,642,1720.0
260000.0,3,1.5,1580,8184,1.0,3,7,1140,440.0,1954,1540,9476,24903 days 16:47:18.685822,176,2.0,2.590909090909091,40,-1292,700.0
690000.0,3,1.75,1600,4400,1.0,3,7,1030,570.0,1941,2150,4000,29651 days 16:47:18.685822,246,1.7142857142857142,1.8070175438596492,-550,400,460.0
1080000.0,4,2.25,2100,12172,1.0,5,9,2100,0.0,1961,2400,10713,22346 days 16:47:18.685822,082,1.7777777777777777,0.0,-300,1459,2100.0
360000.0,4,2.5,2610,7333,2.0,3,8,2610,0.0,1988,2280,9033,12485 days 16:47:18.685822,099,1.6,0.0,330,-1700,2610.0
499000.0,3,1.75,1840,5000,1.0,4,7,920,920.0,1910,1220,5000,40974 days 16:47:18.685822,170,1.7142857142857142,1.0,620,0,0.0
159000.0,3,1.0,1320,6534,1.0,3,7,1320,0.0,1952,2140,7405,25634 days 16:47:18.685822,230,3.0,0.0,-820,-871,1320.0
430000.0,3,1.75,1540,8100,1.0,4,7,940,600.0,1947,1840,8100,27460 days 16:47:18.685822,086,1.7142857142857142,1.5666666666666667,-300,0,340.0
1050000.0,5,2.75,2520,18625,1.0,3,8,1660,860.0,1959,3000,16624,23077 days 16:47:18.685822,103,1.8181818181818181,1.930232558139535,-480,2001,800.0
725000.0,5,2.5,3780,20000,1.0,4,9,1890,1890.0,1978,2840,19908,16137 days 16:47:18.685822,317,2.0,1.0,940,92,0.0
150000.0,3,1.0,1200,9527,1.0,3,7,1200,0.0,1959,1510,9457,23077 days 16:47:18.685822,191,3.0,0.0,-310,70,1200.0
840000.0,4,2.25,2720,8712,2.0,4,9,2720,0.0,1976,2470,8714,16868 days 16:47:18.685822,202,1.7777777777777777,0.0,250,-2,2720.0
499000.0,4,2.5,3100,5700,2.0,3,9,3100,0.0,2011,3060,6000,4084 days 16:47:18.685822,105,1.6,0.0,40,-300,3100.0
285000.0,3,1.75,1630,4000,1.0,3,7,1100,530.0,1968,1300,4000,19790 days 16:47:18.685822,287,1.7142857142857142,2.0754716981132075,330,0,570.0
340000.0,4,2.5,1910,7201,1.0,3,7,1210,700.0,1987,1690,7554,12850 days 16:47:18.685822,067,1.6,1.7285714285714286,220,-353,510.0
405100.0,4,2.0,1580,7300,1.0,4,7,1580,0.0,1955,1180,9450,24538 days 16:47:18.685822,125,2.0,0.0,400,-2150,1580.0
464000.0,3,2.5,1690,4898,2.0,3,7,1690,0.0,2003,2220,4933,7006 days 16:47:18.685822,219,1.2,0.0,-530,-35,1690.0
723000.0,4,2.25,1960,8680,1.0,4,8,1290,670.0,1959,2160,8680,23077 days 16:47:18.685822,149,1.7777777777777777,1.9253731343283582,-200,0,620.0
430000.0,8,3.25,4300,10441,2.0,4,8,2800,1500.0,1979,1780,10457,15772 days 16:47:18.685822,345,2.4615384615384617,1.8666666666666667,2520,-16,1300.0
645000.0,3,1.75,1840,4255,1.0,3,7,940,900.0,1907,1600,4255,42070 days 16:47:18.685822,120,1.7142857142857142,1.0444444444444445,240,0,40.0
1580000.0,4,2.75,3480,19991,2.0,4,1,2630,850.0,1979,3770,20271,15772 days 16:47:18.685822,128,1.4545454545454546,3.0941176470588236,-290,-280,1780.0
925000.0,5,3.0,2710,4200,2.0,3,7,1890,820.0,1919,2150,4200,37687 days 16:47:18.685822,223,1.6666666666666667,2.3048780487804876,560,0,1070.0
759000.0,4,1.75,2100,4750,1.0,3,7,1340,760.0,1975,1700,4125,17233 days 16:47:18.685822,190,2.2857142857142856,1.763157894736842,400,625,580.0
358800.0,4,2.5,2155,8140,2.0,3,8,2155,0.0,1996,2155,7245,9563 days 16:47:18.685822,085,1.6,0.0,0,895,2155.0
683000.0,5,1.5,1720,4000,1.5,3,7,1520,200.0,1925,2280,4000,35495 days 16:47:18.685822,103,3.3333333333333335,7.6,-560,0,1320.0
650000.0,3,1.0,1430,4240,1.5,3,7,1430,0.0,1924,1660,4240,35861 days 16:47:18.685822,342,3.0,0.0,-230,0,1430.0
288000.0,5,2.75,2790,4807,1.5,4,7,2140,650.0,1949,1056,4807,26729 days 16:47:18.685822,343,1.8181818181818181,3.292307692307692,1734,0,1490.0
209950.0,3,1.5,1180,7300,1.0,4,7,1180,0.0,1968,2030,8424,19790 days 16:47:18.685822,188,2.0,0.0,-850,-1124,1180.0
939000.0,3,3.5,2450,9248,2.0,3,8,1960,490.0,1933,2620,10207,32573 days 16:47:18.685822,281,0.8571428571428571,4.0,-170,-959,1470.0
320000.0,3,1.0,1330,5850,1.0,3,7,930,400.0,1954,1440,5850,24903 days 16:47:18.685822,228,3.0,2.325,-110,0,530.0
283748.0,3,2.25,1940,9560,2.0,3,7,1940,0.0,1989,1800,9560,12119 days 16:47:18.685822,234,1.3333333333333333,0.0,140,0,1940.0
370000.0,3,2.25,1600,7620,1.0,3,7,1280,320.0,1987,1600,8215,12850 days 16:47:18.685822,212,1.3333333333333333,4.0,0,-595,960.0
399950.0,4,2.75,3210,41689,1.0,4,8,1610,1600.0,1989,2100,41384,12119 days 16:47:18.685822,086,1.4545454545454546,1.00625,1110,305,10.0
360000.0,5,2.5,2880,6902,1.0,3,8,1680,1200.0,1976,2080,5586,16868 days 16:47:18.685822,346,2.0,1.4,800,1316,480.0
365000.0,2,1.5,1160,8060,1.0,4,7,1160,0.0,1950,1500,8060,26364 days 16:47:18.685822,316,1.3333333333333333,0.0,-340,0,1160.0
396900.0,3,2.0,1360,3120,2.0,3,7,1360,0.0,1989,1360,3120,12119 days 16:47:18.685822,353,1.5,0.0,0,0,1360.0
321000.0,3,2.5,2014,4500,2.0,3,7,2014,0.0,2005,2014,4500,6275 days 16:47:18.685822,112,1.2,0.0,0,0,2014.0
245000.0,3,2.0,1440,7008,1.0,3,7,1440,0.0,1985,1680,7200,13580 days 16:47:18.685822,006,1.5,0.0,-240,-192,1440.0
502000.0,2,1.0,1570,4704,1.5,3,8,1570,0.0,1931,1820,4704,33304 days 16:47:18.685822,280,2.0,0.0,-250,0,1570.0
257000.0,4,2.75,2330,7642,1.0,3,8,1800,530.0,1990,2320,7933,11754 days 16:47:18.685822,156,1.4545454545454546,3.3962264150943398,10,-291,1270.0
423000.0,4,1.75,1880,7303,1.0,3,7,1010,870.0,1976,1710,7200,16868 days 16:47:18.685822,135,2.2857142857142856,1.160919540229885,170,103,140.0
485000.0,4,2.25,1850,9911,1.0,4,7,1850,0.0,1957,1650,8670,23807 days 16:47:18.685822,086,1.7777777777777777,0.0,200,1241,1850.0
500000.0,4,2.5,2230,8560,2.0,3,8,2230,0.0,2002,2400,7756,7371 days 16:47:18.685822,351,1.6,0.0,-170,804,2230.0
442000.0,2,1.0,990,4313,1.5,4,6,990,0.0,1917,1480,5750,38417 days 16:47:18.685822,294,2.0,0.0,-490,-1437,990.0
475000.0,3,1.75,1720,3825,1.5,3,7,1720,0.0,1925,2000,3825,35495 days 16:47:18.685822,132,1.7142857142857142,0.0,-280,0,1720.0
625000.0,4,2.25,3230,9935,2.0,3,8,3230,0.0,1986,2820,9722,13215 days 16:47:18.685822,096,1.7777777777777777,0.0,410,213,3230.0
194000.0,3,1.0,1180,6050,1.0,3,6,820,360.0,1944,1070,6050,28556 days 16:47:18.685822,288,3.0,2.2777777777777777,110,0,460.0
410000.0,3,2.25,1450,19206,2.0,3,7,1450,0.0,1989,1710,21485,12119 days 16:47:18.685822,188,1.3333333333333333,0.0,-260,-2279,1450.0
490000.0,4,2.5,2570,6157,2.0,3,7,2570,0.0,2006,2060,5292,5910 days 16:47:18.685822,083,1.6,0.0,510,865,2570.0
348500.0,4,1.75,1870,7575,1.0,3,7,1480,390.0,1972,1670,7575,18329 days 16:47:18.685822,343,2.2857142857142856,3.7948717948717947,200,0,1090.0
380000.0,3,1.0,1220,3000,1.5,3,6,1220,0.0,1901,1350,3000,44261 days 16:47:18.685822,117,3.0,0.0,-130,0,1220.0
660000.0,3,2.0,1770,2150,3.0,3,8,1770,0.0,1999,2010,3200,8467 days 16:47:18.685822,345,1.5,0.0,-240,-1050,1770.0
525000.0,3,1.0,1500,6800,1.0,3,7,1500,0.0,1943,1500,6800,28921 days 16:47:18.685822,091,3.0,0.0,0,0,1500.0
235000.0,3,2.0,1110,8724,1.0,4,7,1110,0.0,1990,1390,7750,11754 days 16:47:18.685822,198,1.5,0.0,-280,974,1110.0
1210000.0,4,3.75,4980,18069,2.0,3,1,4980,0.0,2006,4080,14577,5910 days 16:47:18.685822,112,1.0666666666666667,0.0,900,3492,4980.0
397950.0,4,1.75,2360,8116,1.0,4,7,1180,1180.0,1916,1670,8160,38783 days 16:47:18.685822,083,2.2857142857142856,1.0,690,-44,0.0
268000.0,3,1.75,1600,7711,1.0,3,7,1600,0.0,1999,2100,7711,8467 days 16:47:18.685822,322,1.7142857142857142,0.0,-500,0,1600.0
525000.0,3,1.0,1450,4000,1.0,4,8,950,500.0,1948,1880,4000,27095 days 16:47:18.685822,141,3.0,1.9,-430,0,450.0
549950.0,3,2.5,2680,5860,2.0,3,8,2680,0.0,2001,2680,5860,7736 days 16:47:18.685822,279,1.2,0.0,0,0,2680.0
370000.0,3,1.75,1150,6600,1.5,4,6,1150,0.0,1970,1530,6600,19059 days 16:47:18.685822,239,1.7142857142857142,0.0,-380,0,1150.0
299000.0,4,2.25,1870,6693,2.0,3,7,1870,0.0,1996,1650,6518,9563 days 16:47:18.685822,269,1.7777777777777777,0.0,220,175,1870.0
715000.0,6,2.75,3400,5000,2.0,3,8,2860,540.0,1977,1800,5000,16502 days 16:47:18.685822,015,2.1818181818181817,5.296296296296297,1600,0,2320.0
430000.0,4,1.5,1810,7200,1.0,3,7,1810,0.0,1966,2060,7200,20520 days 16:47:18.685822,114,2.6666666666666665,0.0,-250,0,1810.0
345000.0,3,1.75,1860,7191,1.0,4,7,1260,600.0,1975,1850,7490,17233 days 16:47:18.685822,041,1.7142857142857142,2.1,10,-299,660.0
1600000.0,3,3.25,3790,19000,2.0,3,1,3790,0.0,1985,2740,18628,13580 days 16:47:18.685822,147,0.9230769230769231,0.0,1050,372,3790.0
534640.0,3,2.5,2130,3500,1.0,4,8,1210,920.0,1994,2030,3710,10293 days 16:47:18.685822,138,1.2,1.315217391304348,100,-210,290.0
1230000.0,3,2.5,2860,4500,2.0,3,8,1980,880.0,1915,2310,4500,39148 days 16:47:18.685822,280,1.2,2.25,550,0,1100.0
351000.0,4,2.5,2370,7274,2.0,3,7,2370,0.0,1997,2090,7656,9197 days 16:47:18.685822,103,1.6,0.0,280,-382,2370.0
745000.0,4,2.25,2290,10409,2.0,3,8,2290,0.0,1972,2040,10409,18329 days 16:47:18.685822,196,1.7777777777777777,0.0,250,0,2290.0
320000.0,2,1.0,1120,5329,1.0,3,6,750,370.0,1929,1530,5330,34034 days 16:47:18.685822,309,2.0,2.027027027027027,-410,-1,380.0
555700.0,3,2.0,1810,12420,1.0,4,7,1810,0.0,1957,2230,12330,23807 days 16:47:18.685822,212,1.5,0.0,-420,90,1810.0
690000.0,4,2.5,3220,35400,2.0,3,9,3220,0.0,1991,3050,35252,11389 days 16:47:18.685822,189,1.6,0.0,170,148,3220.0
449000.0,3,1.75,1660,9697,1.0,4,7,1660,0.0,1952,2060,20624,25634 days 16:47:18.685822,365,1.7142857142857142,0.0,-400,-10927,1660.0
308500.0,2,1.0,850,6174,1.0,4,7,850,0.0,1950,1100,6174,26364 days 16:47:18.685822,122,2.0,0.0,-250,0,850.0
340000.0,4,2.5,2665,5868,2.0,3,9,2665,0.0,2006,2665,6092,5910 days 16:47:18.685822,064,1.6,0.0,0,-224,2665.0
937750.0,4,2.75,2580,3560,1.5,5,7,1710,870.0,1917,1980,3800,38417 days 16:47:18.685822,086,1.4545454545454546,1.9655172413793103,600,-240,840.0
135000.0,3,1.0,840,3000,1.0,3,5,840,0.0,1943,1010,6000,28921 days 16:47:18.685822,005,3.0,0.0,-170,-3000,840.0
635000.0,4,2.5,2970,7961,1.0,3,8,2020,950.0,1969,1410,7959,19424 days 16:47:18.685822,093,1.6,2.126315789473684,1560,2,1070.0
245500.0,2,1.0,790,7500,1.0,3,6,790,0.0,1950,1970,8970,26364 days 16:47:18.685822,218,2.0,0.0,-1180,-1470,790.0
230000.0,6,1.5,2140,36509,1.5,4,8,2140,0.0,1903,1710,12000,43531 days 16:47:18.685822,336,4.0,0.0,430,24509,2140.0
1770000.0,3,2.5,2580,14603,1.0,4,9,2580,0.0,1951,2410,14347,25999 days 16:47:18.685822,063,1.2,0.0,170,256,2580.0
425000.0,5,2.5,2180,7875,1.0,4,7,1200,980.0,1955,1840,5105,24538 days 16:47:18.685822,314,2.0,1.2244897959183674,340,2770,220.0
220000.0,2,1.0,1060,10423,1.5,3,7,1060,0.0,1965,2240,10200,20885 days 16:47:18.685822,110,2.0,0.0,-1180,223,1060.0
370000.0,3,2.0,1860,9100,1.5,3,8,1860,0.0,1939,1620,9519,30382 days 16:47:18.685822,241,1.5,0.0,240,-419,1860.0
390000.0,3,2.0,1840,16815,1.0,5,7,960,880.0,1972,1810,16732,18329 days 16:47:18.685822,260,1.5,1.0909090909090908,30,83,80.0
239000.0,3,1.75,1340,16480,1.0,4,7,1340,0.0,1968,1520,10451,19790 days 16:47:18.685822,154,1.7142857142857142,0.0,-180,6029,1340.0
345000.0,4,2.25,2320,7350,2.0,3,8,2320,0.0,1973,2170,7350,17963 days 16:47:18.685822,002,1.7777777777777777,0.0,150,0,2320.0
289000.0,3,2.5,2110,8304,1.0,4,7,2110,0.0,1985,1680,7508,13580 days 16:47:18.685822,238,1.2,0.0,430,796,2110.0
285000.0,5,1.5,1840,8050,1.5,4,7,1840,0.0,1962,1690,8151,21981 days 16:47:18.685822,128,3.3333333333333335,0.0,150,-101,1840.0
147400.0,3,2.0,1080,9225,1.0,2,7,1080,0.0,1955,1410,9840,24538 days 16:47:18.685822,258,1.5,0.0,-330,-615,1080.0
245000.0,3,2.25,2210,10794,1.0,3,7,1540,670.0,1967,2230,10753,20155 days 16:47:18.685822,218,1.3333333333333333,2.298507462686567,-20,41,870.0
520000.0,3,2.25,2210,10794,1.0,3,7,1540,670.0,1967,2230,10753,20155 days 16:47:18.685822,063,1.3333333333333333,2.298507462686567,-20,41,870.0
352500.0,3,2.25,1410,14110,1.0,3,7,1170,240.0,1987,1560,18336,12850 days 16:47:18.685822,138,1.3333333333333333,4.875,-150,-4226,930.0
448000.0,5,3.5,3740,24684,2.0,3,9,2760,980.0,1998,2880,26023,8832 days 16:47:18.685822,125,1.4285714285714286,2.816326530612245,860,-1339,1780.0
270000.0,4,2.75,2440,7150,1.0,3,7,1200,1240.0,1963,1790,7150,21616 days 16:47:18.685822,272,1.4545454545454546,0.967741935483871,650,0,-40.0
872500.0,3,2.5,2040,6000,1.0,3,8,1840,200.0,1951,1820,4920,25999 days 16:47:18.685822,238,1.2,9.2,220,1080,1640.0
2150000.0,4,3.25,3840,6214,1.5,4,1,2590,1250.0,1939,3280,5915,30382 days 16:47:18.685822,077,1.2307692307692308,2.072,560,299,1340.0
225000.0,3,1.5,1660,7221,1.0,3,7,980,680.0,1962,1770,8083,21981 days 16:47:18.685822,224,2.0,1.4411764705882353,-110,-862,300.0
735000.0,4,2.0,1640,6000,1.5,4,9,1640,0.0,1911,1900,6000,40609 days 16:47:18.685822,325,2.0,0.0,-260,0,1640.0
375000.0,3,1.0,1310,8400,1.0,3,7,1310,0.0,1972,1680,8000,18329 days 16:47:18.685822,091,3.0,0.0,-370,400,1310.0
169000.0,3,1.75,1720,9775,1.0,3,8,1720,0.0,1978,1970,8400,16137 days 16:47:18.685822,296,1.7142857142857142,0.0,-250,1375,1720.0
279950.0,3,1.75,1720,9775,1.0,3,8,1720,0.0,1978,1970,8400,16137 days 16:47:18.685822,063,1.7142857142857142,0.0,-250,1375,1720.0
1950000.0,4,2.75,4020,18745,2.0,4,1,2830,1190.0,1989,3150,20897,12119 days 16:47:18.685822,016,1.4545454545454546,2.3781512605042017,870,-2152,1640.0
310000.0,3,2.25,1960,2345,2.0,3,7,1750,210.0,2003,1760,1958,7006 days 16:47:18.685822,217,1.3333333333333333,8.333333333333334,200,387,1540.0
975000.0,4,2.5,3240,35083,2.0,4,9,3240,0.0,1978,3340,24501,16137 days 16:47:18.685822,211,1.6,0.0,-100,10582,3240.0
650000.0,10,2.0,3610,11914,2.0,4,7,3010,600.0,1958,2040,11914,23442 days 16:47:18.685822,302,5.0,5.016666666666667,1570,0,2410.0
930000.0,2,1.5,1800,4500,1.0,3,7,1000,800.0,1942,2270,3840,29286 days 16:47:18.685822,350,1.3333333333333333,1.25,-470,660,200.0
412000.0,4,1.5,1960,5000,1.0,3,7,980,980.0,1912,1300,5000,40244 days 16:47:18.685822,092,2.6666666666666665,1.0,660,0,0.0
225000.0,3,1.0,1250,10200,1.0,3,6,1250,0.0,1965,1800,8283,20885 days 16:47:18.685822,107,3.0,0.0,-550,1917,1250.0
1760000.0,4,4.0,3860,67953,2.0,4,1,3860,0.0,1927,4410,128066,34765 days 16:47:18.685822,028,1.0,0.0,-550,-60113,3860.0
230000.0,3,2.5,1340,3011,2.0,3,7,1340,0.0,1995,1060,3232,9928 days 16:47:18.685822,321,1.2,0.0,280,-221,1340.0
316000.0,1,2.0,1780,188465,2.0,3,1,1780,0.0,2001,1780,21094,7736 days 16:47:18.685822,054,0.5,0.0,0,167371,1780.0
616200.0,5,3.25,3920,4832,2.0,3,9,3030,890.0,2014,2660,4832,2988 days 16:47:18.685822,253,1.5384615384615385,3.404494382022472,1260,0,2140.0
509900.0,3,1.75,1690,53578,1.0,3,8,1690,0.0,1984,2290,52707,13946 days 16:47:18.685822,241,1.7142857142857142,0.0,-600,871,1690.0
370000.0,4,2.5,2570,7753,2.0,3,8,2570,0.0,1987,2140,7615,12850 days 16:47:18.685822,075,1.6,0.0,430,138,2570.0
619100.0,3,1.75,1870,7030,1.0,3,7,1870,0.0,1977,1820,7500,16502 days 16:47:18.685822,065,1.7142857142857142,0.0,50,-470,1870.0
805000.0,3,2.25,2860,11250,1.0,5,8,2290,570.0,1956,2030,11250,24173 days 16:47:18.685822,233,1.3333333333333333,4.017543859649122,830,0,1720.0
612125.0,2,1.5,1670,6000,1.0,3,7,1090,580.0,1950,1670,6000,26364 days 16:47:18.685822,033,1.3333333333333333,1.8793103448275863,0,0,510.0
350000.0,2,1.5,1070,937,3.0,3,8,1070,0.0,2003,1100,3200,7006 days 16:47:18.685822,255,1.3333333333333333,0.0,-30,-2263,1070.0
225000.0,2,1.0,940,15000,1.0,3,7,940,0.0,1960,1450,15000,22712 days 16:47:18.685822,308,2.0,0.0,-510,0,940.0
335000.0,3,2.5,2588,5701,2.0,3,8,2588,0.0,2008,2389,5702,5180 days 16:47:18.685822,295,1.2,0.0,199,-1,2588.0
972800.0,5,3.25,3500,10457,2.0,3,1,3500,0.0,2001,3500,11734,7736 days 16:47:18.685822,090,1.5384615384615385,0.0,0,-1277,3500.0
500000.0,3,1.75,1690,48096,1.0,3,7,1690,0.0,1973,2070,35160,17963 days 16:47:18.685822,033,1.7142857142857142,0.0,-380,12936,1690.0
2200000.0,4,3.75,3790,7200,2.0,3,1,2530,1260.0,1931,3250,7200,33304 days 16:47:18.685822,357,1.0666666666666667,2.007936507936508,540,0,1270.0
415000.0,3,1.5,1090,8400,1.0,4,7,1090,0.0,1966,1320,8400,20520 days 16:47:18.685822,323,2.0,0.0,-230,0,1090.0
399000.0,3,3.0,2240,10479,2.0,4,7,1710,530.0,1950,1530,5244,26364 days 16:47:18.685822,238,1.0,3.2264150943396226,710,5235,1180.0
376000.0,2,1.0,1150,4000,1.0,3,7,1150,0.0,1947,1150,4288,27460 days 16:47:18.685822,140,2.0,0.0,0,-288,1150.0
340000.0,3,2.0,1870,3378,1.0,3,7,1120,750.0,1913,1870,1872,39878 days 16:47:18.685822,351,1.5,1.4933333333333334,0,1506,370.0
490000.0,5,2.75,2990,7200,2.0,3,8,2990,0.0,1997,2710,7620,9197 days 16:47:18.685822,318,1.8181818181818181,0.0,280,-420,2990.0
374000.0,4,2.5,2580,6260,2.0,3,7,2580,0.0,2004,2160,3600,6641 days 16:47:18.685822,173,1.6,0.0,420,2660,2580.0
852000.0,4,1.0,2220,3588,1.5,4,7,1470,750.0,1927,1740,3588,34765 days 16:47:18.685822,085,4.0,1.96,480,0,720.0
473000.0,3,2.25,1620,12309,2.0,3,7,1620,0.0,1987,2030,13963,12850 days 16:47:18.685822,329,1.3333333333333333,0.0,-410,-1654,1620.0
540000.0,3,1.75,2590,25992,1.0,3,8,1970,620.0,1968,2590,29250,19790 days 16:47:18.685822,124,1.7142857142857142,3.1774193548387095,0,-3258,1350.0
431000.0,2,2.0,1390,12530,1.0,3,8,970,420.0,1959,1940,12530,23077 days 16:47:18.685822,238,1.0,2.3095238095238093,-550,0,550.0
435000.0,4,3.0,2270,7245,1.0,3,7,1410,860.0,1979,1740,7571,15772 days 16:47:18.685822,126,1.3333333333333333,1.6395348837209303,530,-326,550.0
1050000.0,4,3.0,2920,33976,1.0,5,8,1460,1460.0,1964,2970,15210,21251 days 16:47:18.685822,128,1.3333333333333333,1.0,-50,18766,0.0
157500.0,3,1.0,1100,27008,1.0,3,6,960,140.0,1935,1280,8890,31843 days 16:47:18.685822,078,3.0,6.857142857142857,-180,18118,820.0
244000.0,3,1.75,1500,7475,1.0,4,8,1500,0.0,1976,1940,7475,16868 days 16:47:18.685822,351,1.7142857142857142,0.0,-440,0,1500.0
550000.0,3,2.5,2800,10603,2.0,3,9,2800,0.0,2001,2580,10603,7736 days 16:47:18.685822,042,1.2,0.0,220,0,2800.0
975000.0,4,2.5,3420,183387,2.0,3,1,3420,0.0,2000,2260,34613,8102 days 16:47:18.685822,248,1.6,0.0,1160,148774,3420.0
426500.0,4,2.75,2100,88426,1.0,3,6,2100,0.0,1990,2150,63162,11754 days 16:47:18.685822,036,1.4545454545454546,0.0,-50,25264,2100.0
615000.0,3,1.0,1790,3876,1.5,5,7,1090,700.0,1904,1360,4080,43166 days 16:47:18.685822,041,3.0,1.5571428571428572,430,-204,390.0
542000.0,3,2.25,2220,12056,2.0,3,8,2220,0.0,1985,2320,12025,13580 days 16:47:18.685822,054,1.3333333333333333,0.0,-100,31,2220.0
710000.0,4,1.75,2000,6000,1.0,5,7,1000,1000.0,1956,2610,4377,24173 days 16:47:18.685822,323,2.2857142857142856,1.0,-610,1623,0.0
289950.0,3,2.5,1770,9450,1.0,3,8,1770,0.0,1988,2200,8582,12485 days 16:47:18.685822,121,1.2,0.0,-430,868,1770.0
1900000.0,4,2.75,4280,12668,2.0,3,9,3900,380.0,1947,3590,12670,27460 days 16:47:18.685822,289,1.4545454545454546,10.263157894736842,690,-2,3520.0
528000.0,2,1.0,1260,5100,1.5,4,7,1120,140.0,1925,1260,5100,35495 days 16:47:18.685822,323,2.0,8.0,0,0,980.0
471000.0,2,1.0,840,5100,1.0,4,7,840,0.0,1949,1550,5100,26729 days 16:47:18.685822,084,2.0,0.0,-710,0,840.0
250000.0,4,2.75,1830,6643,2.0,3,8,1830,0.0,2001,2400,6472,7736 days 16:47:18.685822,337,1.4545454545454546,0.0,-570,171,1830.0
155000.0,3,1.5,970,8400,1.0,3,7,970,0.0,1966,1230,8400,20520 days 16:47:18.685822,300,2.0,0.0,-260,0,970.0
515000.0,4,1.5,1740,8160,1.5,4,7,1400,340.0,1946,1600,8160,27825 days 16:47:18.685822,230,2.6666666666666665,4.117647058823529,140,0,1060.0
336600.0,3,2.25,1654,8464,2.0,3,7,1654,0.0,1995,1975,8515,9928 days 16:47:18.685822,064,1.3333333333333333,0.0,-321,-51,1654.0
915000.0,3,2.25,2390,2750,2.0,5,8,1580,810.0,1925,2200,5160,35495 days 16:47:18.685822,069,1.3333333333333333,1.9506172839506173,190,-2410,770.0
350000.0,2,1.75,1080,7242,2.0,4,7,1080,0.0,1984,1800,7321,13946 days 16:47:18.685822,196,1.1428571428571428,0.0,-720,-79,1080.0
1300000.0,4,1.75,2610,21600,1.0,4,8,2610,0.0,1966,2920,20330,20520 days 16:47:18.685822,183,2.2857142857142856,0.0,-310,1270,2610.0
175000.0,3,1.0,1070,6164,1.0,3,7,1070,0.0,1967,1320,7920,20155 days 16:47:18.685822,064,3.0,0.0,-250,-1756,1070.0
545000.0,2,2.0,1430,3880,1.0,4,7,1430,0.0,1949,1430,3880,26729 days 16:47:18.685822,089,1.0,0.0,0,0,1430.0
475000.0,4,3.0,2400,5400,2.0,4,7,1600,800.0,1965,2400,5400,20885 days 16:47:18.685822,361,1.3333333333333333,2.0,0,0,800.0
390000.0,2,1.0,670,11505,1.0,3,5,670,0.0,2003,2180,11505,7006 days 16:47:18.685822,120,2.0,0.0,-1510,0,670.0
645000.0,4,2.5,2860,14000,2.0,3,8,2860,0.0,1995,2650,14564,9928 days 16:47:18.685822,198,1.6,0.0,210,-564,2860.0
410000.0,3,1.5,2270,8187,1.0,4,8,1420,850.0,1954,2020,14092,24903 days 16:47:18.685822,336,2.0,1.6705882352941177,250,-5905,570.0
480000.0,4,2.5,2180,9861,2.0,3,8,2180,0.0,1997,2390,9761,9197 days 16:47:18.685822,090,1.6,0.0,-210,100,2180.0
725000.0,3,1.75,1860,6000,2.0,4,8,1860,0.0,1959,3030,7119,23077 days 16:47:18.685822,182,1.7142857142857142,0.0,-1170,-1119,1860.0
1150000.0,6,4.5,6040,219542,2.0,3,1,4100,1940.0,1996,2010,32362,9563 days 16:47:18.685822,142,1.3333333333333333,2.11340206185567,4030,187180,2160.0
300000.0,2,1.0,1010,11919,1.0,3,6,1010,0.0,1947,1220,11240,27460 days 16:47:18.685822,183,2.0,0.0,-210,679,1010.0
752000.0,4,2.5,2570,8178,1.0,3,8,1710,860.0,1961,2050,7500,22346 days 16:47:18.685822,068,1.6,1.9883720930232558,520,678,850.0
585000.0,4,2.5,1950,3720,2.0,3,8,1950,0.0,2004,1720,3720,6641 days 16:47:18.685822,266,1.6,0.0,230,0,1950.0
678700.0,3,1.75,1970,10548,1.0,4,8,1300,670.0,1973,2500,8548,17963 days 16:47:18.685822,044,1.7142857142857142,1.9402985074626866,-530,2000,630.0
603000.0,4,2.25,2110,11155,2.0,3,9,2110,0.0,1975,2660,11900,17233 days 16:47:18.685822,107,1.7777777777777777,0.0,-550,-745,2110.0
715000.0,3,1.75,1650,7276,1.5,4,7,1150,500.0,1928,2300,8088,34400 days 16:47:18.685822,079,1.7142857142857142,2.3,-650,-812,650.0
1400000.0,4,3.0,3520,128502,2.0,4,1,3520,0.0,1981,3260,79714,15041 days 16:47:18.685822,301,1.3333333333333333,0.0,260,48788,3520.0
1090000.0,3,2.5,2840,7500,2.0,3,1,2840,0.0,1997,2580,5918,9197 days 16:47:18.685822,119,1.2,0.0,260,1582,2840.0
467500.0,2,1.75,1490,4800,1.0,4,7,750,740.0,1918,1400,6000,38052 days 16:47:18.685822,053,1.1428571428571428,1.0135135135135136,90,-1200,10.0
359000.0,3,2.25,1650,7218,1.0,3,7,1230,420.0,1985,1690,7459,13580 days 16:47:18.685822,286,1.3333333333333333,2.9285714285714284,-40,-241,810.0
745000.0,4,2.0,1960,4520,1.0,3,8,960,1000.0,1922,1680,4520,36591 days 16:47:18.685822,238,2.0,0.96,280,0,-40.0
450000.0,3,2.25,2450,42180,1.0,4,7,2450,0.0,1978,1440,42180,16137 days 16:47:18.685822,133,1.3333333333333333,0.0,1010,0,2450.0
935000.0,3,2.0,1720,2000,1.5,3,8,1060,660.0,1910,1590,4000,40974 days 16:47:18.685822,098,1.5,1.606060606060606,130,-2000,400.0
615000.0,3,2.5,1980,3128,2.0,3,8,1890,90.0,2009,2160,2240,4814 days 16:47:18.685822,246,1.2,21.0,-180,888,1800.0
1030000.0,3,2.5,4110,35741,2.0,3,7,4110,0.0,1976,2710,8865,16868 days 16:47:18.685822,272,1.2,0.0,1400,26876,4110.0
340000.0,2,1.0,860,7102,1.0,3,6,860,0.0,1947,1450,7102,27460 days 16:47:18.685822,336,2.0,0.0,-590,0,860.0
370000.0,4,2.5,2320,9264,2.0,3,8,2320,0.0,1994,2320,9129,10293 days 16:47:18.685822,056,1.6,0.0,0,135,2320.0
1150000.0,3,2.5,4190,9624,2.0,3,1,4190,0.0,1999,3650,8321,8467 days 16:47:18.685822,232,1.2,0.0,540,1303,4190.0
265000.0,4,1.0,1940,9533,1.0,3,7,1080,860.0,1962,1940,8839,21981 days 16:47:18.685822,130,4.0,1.255813953488372,0,694,220.0
480000.0,4,2.25,2520,2370,2.0,3,8,1690,830.0,1908,1530,2370,41705 days 16:47:18.685822,238,1.7777777777777777,2.036144578313253,990,0,860.0
667500.0,3,2.0,1880,3800,1.0,5,7,1030,850.0,1927,1700,3800,34765 days 16:47:18.685822,168,1.5,1.2117647058823529,180,0,180.0
2300000.0,7,4.75,5310,8816,2.0,3,1,3650,1660.0,2013,2920,10610,3353 days 16:47:18.685822,220,1.4736842105263157,2.1987951807228914,2390,-1794,1990.0
465000.0,3,2.25,2670,7500,1.0,4,7,1640,1030.0,1966,1970,9598,20520 days 16:47:18.685822,167,1.3333333333333333,1.5922330097087378,700,-2098,610.0
192500.0,1,1.0,470,63737,1.0,5,5,470,0.0,1924,1350,46762,35861 days 16:47:18.685822,293,1.0,0.0,-880,16975,470.0
345000.0,3,1.0,1060,5600,1.0,4,6,760,300.0,1943,1310,5600,28921 days 16:47:18.685822,082,3.0,2.533333333333333,-250,0,460.0
439800.0,3,1.5,1120,6900,1.0,5,7,1120,0.0,1956,1300,7000,24173 days 16:47:18.685822,153,2.0,0.0,-180,-100,1120.0
468000.0,4,1.75,2250,8580,1.0,4,7,1330,920.0,1958,2250,10032,23442 days 16:47:18.685822,206,2.2857142857142856,1.4456521739130435,0,-1452,410.0
775000.0,4,2.5,2070,8473,1.0,4,8,1250,820.0,1976,2070,9499,16868 days 16:47:18.685822,205,1.6,1.524390243902439,0,-1026,430.0
684680.0,4,2.25,2370,9360,2.0,4,8,2370,0.0,1979,2370,9720,15772 days 16:47:18.685822,159,1.7777777777777777,0.0,0,-360,2370.0
910000.0,4,3.5,3570,27699,2.0,3,1,3570,0.0,1990,3800,35880,11754 days 16:47:18.685822,016,1.1428571428571428,0.0,-230,-8181,3570.0
3640000.0,4,3.25,4830,22257,2.0,4,1,4830,0.0,1990,3820,25582,11754 days 16:47:18.685822,254,1.2307692307692308,0.0,1010,-3325,4830.0
375000.0,3,1.75,1160,22470,1.0,4,7,1160,0.0,1976,1940,15999,16868 days 16:47:18.685822,168,1.7142857142857142,0.0,-780,6471,1160.0
250000.0,3,2.5,1610,6600,2.0,3,7,1610,0.0,1994,1660,7689,10293 days 16:47:18.685822,254,1.2,0.0,-50,-1089,1610.0
3070000.0,5,3.0,4150,7500,2.5,5,1,3510,640.0,1909,2250,4050,41339 days 16:47:18.685822,043,1.6666666666666667,5.484375,1900,3450,2870.0
442500.0,4,2.25,1840,7575,1.0,4,7,1390,450.0,1973,1820,7500,17963 days 16:47:18.685822,329,1.7777777777777777,3.088888888888889,20,75,940.0
900000.0,3,3.5,4080,217697,1.5,3,1,4080,0.0,2000,2710,217790,8102 days 16:47:18.685822,143,0.8571428571428571,0.0,1370,-93,4080.0
699000.0,3,2.0,1820,4080,2.0,3,8,1820,0.0,1937,2160,5400,31112 days 16:47:18.685822,262,1.5,0.0,-340,-1320,1820.0
360000.0,4,2.0,2680,18768,1.0,5,8,2680,0.0,1965,1230,15750,20885 days 16:47:18.685822,126,2.0,0.0,1450,3018,2680.0
1680000.0,4,4.75,4790,25412,2.0,3,1,4790,0.0,1999,3830,16314,8467 days 16:47:18.685822,252,0.8421052631578947,0.0,960,9098,4790.0
675000.0,5,2.0,2420,21000,1.5,3,8,2420,0.0,1966,1940,8085,20520 days 16:47:18.685822,029,2.5,0.0,480,12915,2420.0
229000.0,4,1.0,1320,5000,1.5,3,7,1320,0.0,1928,1640,5164,34400 days 16:47:18.685822,098,4.0,0.0,-320,-164,1320.0
300000.0,3,1.0,1290,12415,1.5,3,6,1290,0.0,1908,1620,12415,41705 days 16:47:18.685822,085,3.0,0.0,-330,0,1290.0
392500.0,3,3.25,1600,1289,3.0,3,8,1600,0.0,1998,1600,1376,8832 days 16:47:18.685822,232,0.9230769230769231,0.0,0,-87,1600.0
552000.0,3,1.0,1120,2300,1.0,4,7,820,300.0,1912,1430,5100,40244 days 16:47:18.685822,167,3.0,2.7333333333333334,-310,-2800,520.0
457000.0,2,1.75,2060,7192,1.0,3,7,1420,640.0,1940,1860,7140,30017 days 16:47:18.685822,324,1.1428571428571428,2.21875,200,52,780.0
518000.0,4,2.5,2830,13760,2.0,3,8,2830,0.0,1993,2350,14029,10658 days 16:47:18.685822,280,1.6,0.0,480,-269,2830.0
237000.0,3,2.0,1210,6634,1.0,4,7,1210,0.0,1985,1560,7200,13580 days 16:47:18.685822,224,1.5,0.0,-350,-566,1210.0
399950.0,3,2.25,1560,11997,1.0,3,7,1260,300.0,1988,1820,36590,12485 days 16:47:18.685822,073,1.3333333333333333,4.2,-260,-24593,960.0
605000.0,3,2.25,2260,17114,2.0,3,7,2260,0.0,1990,2360,14893,11754 days 16:47:18.685822,126,1.3333333333333333,0.0,-100,2221,2260.0
295000.0,4,2.5,1850,8198,2.0,3,7,1850,0.0,1993,1850,7924,10658 days 16:47:18.685822,203,1.6,0.0,0,274,1850.0
513000.0,4,2.5,1930,8040,1.0,3,7,1380,550.0,1978,2080,7200,16137 days 16:47:18.685822,118,1.6,2.5090909090909093,-150,840,830.0
772500.0,4,2.5,3230,4290,2.0,3,9,3230,0.0,2004,3220,5083,6641 days 16:47:18.685822,274,1.6,0.0,10,-793,3230.0
765000.0,4,2.5,3230,4290,2.0,3,9,3230,0.0,2004,3220,5083,6641 days 16:47:18.685822,353,1.6,0.0,10,-793,3230.0
696950.0,4,2.75,2450,5376,1.5,4,7,1550,900.0,1920,1920,5264,37322 days 16:47:18.685822,283,1.4545454545454546,1.7222222222222223,530,112,650.0
329000.0,3,1.0,1200,5650,1.5,3,7,1200,0.0,1928,1610,5650,34400 days 16:47:18.685822,044,3.0,0.0,-410,0,1200.0
339999.0,3,2.5,2360,8093,2.0,3,8,2360,0.0,1995,1860,6762,9928 days 16:47:18.685822,352,1.2,0.0,500,1331,2360.0
364500.0,3,1.0,1060,9506,1.0,3,7,1060,0.0,1959,1520,8469,23077 days 16:47:18.685822,195,3.0,0.0,-460,1037,1060.0
607500.0,5,1.75,2220,6000,1.5,3,7,1420,800.0,1923,1550,1715,36226 days 16:47:18.685822,134,2.857142857142857,1.775,670,4285,620.0
550000.0,3,1.0,880,6664,1.0,3,6,880,0.0,1961,1690,6564,22346 days 16:47:18.685822,098,3.0,0.0,-810,100,880.0
479900.0,4,2.0,2510,9750,1.0,3,8,1630,880.0,1960,1980,9750,22712 days 16:47:18.685822,111,2.0,1.8522727272727273,530,0,750.0
1120000.0,4,4.0,2530,1774,3.0,3,9,2100,430.0,2013,2160,2400,3353 days 16:47:18.685822,043,1.0,4.883720930232558,370,-626,1670.0
192000.0,2,1.0,700,10540,1.0,3,6,700,0.0,1953,890,10540,25268 days 16:47:18.685822,132,2.0,0.0,-190,0,700.0
250000.0,3,2.0,1500,5200,1.0,3,7,1060,440.0,1977,1640,5200,16502 days 16:47:18.685822,103,1.5,2.409090909090909,-140,0,620.0
340000.0,3,2.0,1130,9879,2.0,3,6,1130,0.0,1996,1900,14907,9563 days 16:47:18.685822,196,1.5,0.0,-770,-5028,1130.0
635250.0,3,2.25,2210,22040,1.0,5,8,1510,700.0,1976,2470,14258,16868 days 16:47:18.685822,286,1.3333333333333333,2.157142857142857,-260,7782,810.0
324800.0,2,1.0,1170,5043,1.0,3,6,880,290.0,1949,1430,5692,26729 days 16:47:18.685822,097,2.0,3.0344827586206895,-260,-649,590.0
78000.0,2,1.0,780,16344,1.0,1,5,780,0.0,1942,1700,10387,29286 days 16:47:18.685822,126,2.0,0.0,-920,5957,780.0
400000.0,4,1.75,1770,12875,1.0,3,8,1770,0.0,1988,2150,12875,12485 days 16:47:18.685822,099,2.2857142857142856,0.0,-380,0,1770.0
640500.0,3,1.0,1070,4505,1.0,4,7,1070,0.0,1919,1380,4505,37687 days 16:47:18.685822,126,3.0,0.0,-310,0,1070.0
570000.0,3,2.0,1930,10929,1.0,3,8,1260,670.0,1964,2030,8750,21251 days 16:47:18.685822,120,1.5,1.8805970149253732,-100,2179,590.0
1330000.0,3,1.5,1940,2885,1.5,3,8,1940,0.0,1900,2550,3600,44626 days 16:47:18.685822,176,2.0,0.0,-610,-715,1940.0
330490.0,3,2.75,1440,7350,1.0,4,7,1040,400.0,1980,1510,7350,15407 days 16:47:18.685822,093,1.0909090909090908,2.6,-70,0,640.0
325000.0,3,2.5,1740,5267,2.0,3,7,1740,0.0,1999,2180,5000,8467 days 16:47:18.685822,231,1.2,0.0,-440,267,1740.0
335000.0,3,2.5,1740,5267,2.0,3,7,1740,0.0,1999,2180,5000,8467 days 16:47:18.685822,111,1.2,0.0,-440,267,1740.0
314000.0,5,2.75,2210,13500,1.0,5,7,1460,750.0,1963,1590,10850,21616 days 16:47:18.685822,317,1.8181818181818181,1.9466666666666668,620,2650,710.0
625000.0,4,2.0,2190,3622,1.5,5,8,1990,200.0,1925,1450,3082,35495 days 16:47:18.685822,266,2.0,9.95,740,540,1790.0
809000.0,3,2.5,2590,7720,2.0,3,9,2590,0.0,1988,2600,9490,12485 days 16:47:18.685822,168,1.2,0.0,-10,-1770,2590.0
535000.0,3,2.5,2790,19485,2.0,3,9,2790,0.0,1990,2580,17859,11754 days 16:47:18.685822,230,1.2,0.0,210,1626,2790.0
275000.0,5,1.75,2180,9178,1.0,3,7,1140,1040.0,1963,2140,9261,21616 days 16:47:18.685822,233,2.857142857142857,1.0961538461538463,40,-83,100.0
358000.0,4,2.75,2580,11900,1.0,4,7,1620,960.0,1967,1570,9375,20155 days 16:47:18.685822,107,1.4545454545454546,1.6875,1010,2525,660.0
297975.0,3,2.25,2820,8100,1.0,4,7,1720,1100.0,1947,1040,8100,27460 days 16:47:18.686819,072,1.3333333333333333,1.5636363636363637,1780,0,620.0
492000.0,2,1.75,1300,22239,1.0,4,7,1300,0.0,1945,1300,14810,28190 days 16:47:18.686819,124,1.1428571428571428,0.0,0,7429,1300.0
210000.0,2,1.0,720,8040,1.0,3,6,720,0.0,1943,2300,9500,28921 days 16:47:18.686819,177,2.0,0.0,-1580,-1460,720.0
622500.0,3,2.5,2260,4550,1.5,4,7,1380,880.0,1928,1870,4582,34400 days 16:47:18.686819,239,1.2,1.5681818181818181,390,-32,500.0
550000.0,3,2.5,1550,1092,3.0,3,8,1390,160.0,2004,1550,1079,6641 days 16:47:18.686819,295,1.2,8.6875,0,13,1230.0
190000.0,3,1.75,1390,7700,1.0,5,7,1390,0.0,1965,1260,7700,20885 days 16:47:18.686819,057,1.7142857142857142,0.0,130,0,1390.0
340000.0,4,2.5,2380,9362,2.0,3,8,2380,0.0,2000,2190,9840,8102 days 16:47:18.686819,209,1.6,0.0,190,-478,2380.0
678000.0,3,2.5,2640,5964,2.0,3,9,2640,0.0,2003,2680,5211,7006 days 16:47:18.686819,206,1.2,0.0,-40,753,2640.0
493000.0,3,2.75,1720,6720,1.0,4,7,1270,450.0,1947,1690,3248,27460 days 16:47:18.686819,258,1.0909090909090908,2.8222222222222224,30,3472,820.0
147000.0,3,1.0,1070,14000,1.0,3,7,1070,0.0,1960,920,12500,22712 days 16:47:18.686819,350,3.0,0.0,150,1500,1070.0
334000.0,3,2.25,2000,7225,2.0,4,7,2000,0.0,1985,1950,7464,13580 days 16:47:18.686819,035,1.3333333333333333,0.0,50,-239,2000.0
605000.0,4,2.5,2800,10786,1.0,3,8,1420,1380.0,1970,2140,10788,19059 days 16:47:18.686819,184,1.6,1.0289855072463767,660,-2,40.0
365000.0,3,1.75,1450,61419,1.0,4,8,1450,0.0,1976,2256,82328,16868 days 16:47:18.686819,117,1.7142857142857142,0.0,-806,-20909,1450.0
345000.0,3,1.0,1620,10610,1.0,4,6,1620,0.0,1958,1680,10795,23442 days 16:47:18.686819,329,3.0,0.0,-60,-185,1620.0
999000.0,3,2.5,2710,23292,1.0,3,9,2080,630.0,1956,2430,20000,24173 days 16:47:18.686819,303,1.2,3.3015873015873014,280,3292,1450.0
470000.0,2,1.75,1520,4220,1.0,4,7,840,680.0,1910,1120,5700,40974 days 16:47:18.686819,092,1.1428571428571428,1.2352941176470589,400,-1480,160.0
599000.0,5,2.75,2730,22572,1.0,3,7,2080,650.0,1968,2260,15458,19790 days 16:47:18.686819,175,1.8181818181818181,3.2,470,7114,1430.0
255000.0,3,2.25,1740,10378,1.0,5,7,1740,0.0,1977,1420,10167,16502 days 16:47:18.686819,260,1.3333333333333333,0.0,320,211,1740.0
295000.0,4,1.75,1800,28650,1.0,4,7,1800,0.0,1975,1800,5234,17233 days 16:47:18.686819,037,2.2857142857142856,0.0,0,23416,1800.0
550000.0,4,3.5,4150,16197,2.0,3,1,4150,0.0,2006,3618,15210,5910 days 16:47:18.686819,178,1.1428571428571428,0.0,532,987,4150.0
225000.0,2,1.0,1070,6000,1.0,4,5,1070,0.0,1922,1910,6000,36591 days 16:47:18.686819,125,2.0,0.0,-840,0,1070.0
520000.0,4,0.75,1960,8277,1.0,4,7,1320,640.0,1923,1940,8402,36226 days 16:47:18.686819,357,5.333333333333333,2.0625,20,-125,680.0
345000.0,3,3.25,1600,1882,2.0,3,8,1360,240.0,2000,1390,1379,8102 days 16:47:18.686819,238,0.9230769230769231,5.666666666666667,210,503,1120.0
475000.0,4,1.75,1650,7775,1.0,4,7,1150,500.0,1950,1390,7200,26364 days 16:47:18.686819,140,2.2857142857142856,2.3,260,575,650.0
497500.0,5,1.5,2170,8610,1.0,4,7,1230,940.0,1959,1670,8610,23077 days 16:47:18.686819,281,3.3333333333333335,1.3085106382978724,500,0,290.0
649500.0,3,3.0,3730,383328,1.5,4,9,2230,1500.0,1990,1940,217800,11754 days 16:47:18.686819,324,1.0,1.4866666666666666,1790,165528,730.0
734500.0,4,2.75,3280,6845,2.0,3,1,3280,0.0,2003,3280,7467,7006 days 16:47:18.686819,237,1.4545454545454546,0.0,0,-622,3280.0
276000.0,3,1.0,870,8040,1.0,3,7,870,0.0,1953,1440,8040,25268 days 16:47:18.686819,352,3.0,0.0,-570,0,870.0
235000.0,2,1.0,900,28800,1.0,1,6,900,0.0,1928,1360,7200,34400 days 16:47:18.686819,181,2.0,0.0,-460,21600,900.0
325000.0,2,1.0,1400,10800,1.0,4,7,1400,0.0,1974,1560,11280,17598 days 16:47:18.686819,224,2.0,0.0,-160,-480,1400.0
425000.0,4,2.75,1680,9545,1.0,4,7,1080,600.0,1979,1890,9545,15772 days 16:47:18.686819,148,1.4545454545454546,1.8,-210,0,480.0
307000.0,4,2.0,2390,23972,2.0,3,7,1720,670.0,1949,1950,22750,26729 days 16:47:18.686819,120,2.0,2.5671641791044775,440,1222,1050.0
635000.0,3,2.5,2300,5500,1.5,4,8,2000,300.0,1921,2100,5000,36956 days 16:47:18.686819,148,1.2,6.666666666666667,200,500,1700.0
223000.0,3,1.75,1340,7473,1.0,4,7,1340,0.0,1973,1510,8240,17963 days 16:47:18.686819,134,1.7142857142857142,0.0,-170,-767,1340.0
425000.0,3,2.75,2600,10874,2.0,3,9,2600,0.0,1994,2800,11504,10293 days 16:47:18.686819,103,1.0909090909090908,0.0,-200,-630,2600.0
190000.0,3,2.25,1640,7730,1.0,4,7,1220,420.0,1989,1560,7566,12119 days 16:47:18.686819,126,1.3333333333333333,2.9047619047619047,80,164,800.0
275000.0,4,1.75,1960,6177,1.0,4,8,1960,0.0,1967,2010,8162,20155 days 16:47:18.686819,261,2.2857142857142856,0.0,-50,-1985,1960.0
450000.0,3,2.5,1480,1961,2.0,3,8,1480,0.0,2005,1400,1138,6275 days 16:47:18.686819,157,1.2,0.0,80,823,1480.0
1470000.0,4,3.25,5010,34460,2.0,3,1,5010,0.0,1988,4760,34460,12485 days 16:47:18.686819,139,1.2307692307692308,0.0,250,0,5010.0
550000.0,4,2.0,1540,5000,1.5,4,7,1540,0.0,1913,1790,4000,39878 days 16:47:18.686819,356,2.0,0.0,-250,1000,1540.0
835000.0,4,2.75,4030,10240,2.0,3,8,3310,720.0,1943,2490,7680,28921 days 16:47:18.686819,338,1.4545454545454546,4.597222222222222,1540,2560,2590.0
900000.0,6,3.0,3020,13783,2.0,3,8,3020,0.0,1952,1720,13500,25634 days 16:47:18.686819,169,2.0,0.0,1300,283,3020.0
290000.0,2,2.0,1590,9375,1.0,3,7,910,680.0,1983,1560,8524,14311 days 16:47:18.686819,328,1.0,1.338235294117647,30,851,230.0
1040000.0,4,2.5,2910,9131,2.0,3,1,2910,0.0,2014,1880,11212,2988 days 16:47:18.686819,220,1.6,0.0,1030,-2081,2910.0
780000.0,4,2.5,3020,15164,1.0,4,8,1730,1290.0,1976,2600,11556,16868 days 16:47:18.686819,005,1.6,1.3410852713178294,420,3608,440.0
572500.0,3,2.0,2290,11200,2.0,3,9,2290,0.0,1979,2250,10000,15772 days 16:47:18.686819,352,1.5,0.0,40,1200,2290.0
389000.0,3,1.75,2180,9220,1.0,4,7,1090,1090.0,1938,2050,22400,30747 days 16:47:18.686819,083,1.7142857142857142,1.0,130,-13180,0.0
350000.0,4,1.75,2740,10086,1.0,3,7,1440,1300.0,1972,1710,9840,18329 days 16:47:18.686819,233,2.2857142857142856,1.1076923076923078,1030,246,140.0
476000.0,4,2.5,2740,33158,2.0,3,9,2740,0.0,1993,2740,36074,10658 days 16:47:18.686819,209,1.6,0.0,0,-2916,2740.0
1050000.0,2,3.0,2330,3600,2.0,5,1,1870,460.0,1927,2950,7200,34765 days 16:47:18.686819,247,0.6666666666666666,4.065217391304348,-620,-3600,1410.0
287000.0,3,2.25,2300,7200,1.0,4,8,1550,750.0,1978,2000,7350,16137 days 16:47:18.686819,351,1.3333333333333333,2.066666666666667,300,-150,800.0
707500.0,4,4.0,1550,6596,1.5,5,7,1550,0.0,1907,1830,4850,42070 days 16:47:18.686819,311,1.0,0.0,-280,1746,1550.0
720000.0,3,1.5,2180,5000,1.0,4,8,1090,1090.0,1941,2070,5000,29651 days 16:47:18.686819,337,2.0,1.0,110,0,0.0
319000.0,3,2.5,1610,8544,2.0,5,7,1610,0.0,1994,1840,8190,10293 days 16:47:18.686819,358,1.2,0.0,-230,354,1610.0
330000.0,3,1.0,1570,9136,1.0,3,7,1570,0.0,1953,1380,9127,25268 days 16:47:18.686819,259,3.0,0.0,190,9,1570.0
120750.0,3,1.75,1140,9628,1.0,4,7,1140,0.0,1969,1510,9633,19424 days 16:47:18.686819,140,1.7142857142857142,0.0,-370,-5,1140.0
195000.0,3,1.75,1140,9628,1.0,4,7,1140,0.0,1969,1510,9633,19424 days 16:47:18.686819,294,1.7142857142857142,0.0,-370,-5,1140.0
650000.0,4,1.5,2480,6383,1.0,3,7,1380,1100.0,1946,1440,6000,27825 days 16:47:18.686819,026,2.6666666666666665,1.2545454545454546,1040,383,280.0
530000.0,3,1.75,1690,8190,1.0,4,8,1690,0.0,1958,1840,8705,23442 days 16:47:18.686819,133,1.7142857142857142,0.0,-150,-515,1690.0
825000.0,4,3.0,2910,8027,1.0,5,8,1800,1110.0,1970,2390,7660,19059 days 16:47:18.686819,097,1.3333333333333333,1.6216216216216217,520,367,690.0
436000.0,4,2.0,1600,15044,1.0,3,7,1600,0.0,1972,1660,8102,18329 days 16:47:18.686819,234,2.0,0.0,-60,6942,1600.0
658000.0,2,1.0,1010,14244,1.0,1,5,1010,0.0,1926,1820,15792,35130 days 16:47:18.686819,014,2.0,0.0,-810,-1548,1010.0
547500.0,3,2.0,1850,9570,1.0,4,7,950,900.0,1940,1430,6380,30017 days 16:47:18.686819,225,1.5,1.0555555555555556,420,3190,50.0
762000.0,3,1.75,2150,2527,2.0,4,8,1400,750.0,1906,1610,3663,42435 days 16:47:18.686819,337,1.7142857142857142,1.8666666666666667,540,-1136,650.0
340000.0,3,1.75,2650,7378,1.0,3,7,1460,1190.0,1952,1600,7616,25634 days 16:47:18.686819,026,1.7142857142857142,1.226890756302521,1050,-238,270.0
880000.0,4,1.75,2510,5800,1.0,4,9,1830,680.0,1953,2190,5800,25268 days 16:47:18.686819,325,2.2857142857142856,2.6911764705882355,320,0,1150.0
1220000.0,4,2.5,3240,3600,2.0,3,9,2060,1180.0,2008,1820,3600,5180 days 16:47:18.686819,141,1.6,1.7457627118644068,1420,0,880.0
1950000.0,4,2.5,3440,14554,2.0,3,8,2170,1270.0,2012,3170,11810,3719 days 16:47:18.686819,098,1.6,1.7086614173228347,270,2744,900.0
382500.0,3,2.0,1150,6249,1.0,3,7,1150,0.0,1952,2470,7751,25634 days 16:47:18.686819,266,1.5,0.0,-1320,-1502,1150.0
344500.0,3,1.75,1890,9535,1.0,3,7,1210,680.0,1976,2040,11108,16868 days 16:47:18.686819,005,1.7142857142857142,1.7794117647058822,-150,-1573,530.0
375000.0,4,2.75,1430,7403,1.0,3,7,1030,400.0,1982,1480,7663,14676 days 16:47:18.686819,102,1.4545454545454546,2.575,-50,-260,630.0
276000.0,1,0.75,370,1801,1.0,5,5,370,0.0,1923,1340,5000,36226 days 16:47:18.686819,182,1.3333333333333333,0.0,-970,-3199,370.0
500000.0,5,3.25,3130,12087,2.0,3,8,2180,950.0,1975,2410,10350,17233 days 16:47:18.686819,182,1.5384615384615385,2.294736842105263,720,1737,1230.0
330000.0,4,2.5,2105,6093,2.0,3,8,2105,0.0,2003,1930,8022,7006 days 16:47:18.686819,183,1.6,0.0,175,-1929,2105.0
328000.0,3,1.0,890,5965,1.0,3,7,890,0.0,1950,1930,7500,26364 days 16:47:18.686819,234,3.0,0.0,-1040,-1535,890.0
450000.0,3,1.5,1340,7200,1.0,3,7,1340,0.0,1972,1730,8820,18329 days 16:47:18.686819,056,2.0,0.0,-390,-1620,1340.0
840500.0,4,2.25,2290,12174,1.0,3,7,1490,800.0,1948,2290,9379,27095 days 16:47:18.686819,196,1.7777777777777777,1.8625,0,2795,690.0
679000.0,3,2.5,2770,9350,2.0,3,8,2770,0.0,1957,2660,9695,23807 days 16:47:18.686819,226,1.2,0.0,110,-345,2770.0
270000.0,3,1.5,1890,9450,1.0,3,7,1090,800.0,1957,1470,8100,23807 days 16:47:18.686819,156,2.0,1.3625,420,1350,290.0
757500.0,5,2.25,3160,8065,2.0,3,8,3160,0.0,1977,2540,7917,16502 days 16:47:18.686819,014,2.2222222222222223,0.0,620,148,3160.0
524950.0,2,2.5,1830,2856,2.0,3,7,1830,0.0,2005,1850,2667,6275 days 16:47:18.686819,316,0.8,0.0,-20,189,1830.0
424900.0,4,2.75,2950,49658,1.0,4,8,2950,0.0,1960,1720,54672,22712 days 16:47:18.686819,204,1.4545454545454546,0.0,1230,-5014,2950.0
551100.0,3,1.0,1430,8640,1.0,5,7,1430,0.0,1954,1430,9840,24903 days 16:47:18.686819,007,3.0,0.0,0,-1200,1430.0
421000.0,3,2.0,1420,12655,1.0,5,7,1420,0.0,1968,2020,9655,19790 days 16:47:18.686819,311,1.5,0.0,-600,3000,1420.0
635000.0,4,1.75,2460,7560,2.0,4,8,2460,0.0,1952,2760,8918,25634 days 16:47:18.686819,213,2.2857142857142856,0.0,-300,-1358,2460.0
255000.0,3,1.0,1340,6120,1.5,4,7,1340,0.0,1920,1260,6000,37322 days 16:47:18.686819,343,3.0,0.0,80,120,1340.0
419950.0,4,1.0,1530,7920,1.0,3,7,1030,500.0,1955,1690,7920,24538 days 16:47:18.686819,069,4.0,2.06,-160,0,530.0
325000.0,6,3.0,2650,12870,1.0,4,7,2650,0.0,1977,1450,8668,16502 days 16:47:18.686819,344,2.0,0.0,1200,4202,2650.0
281000.0,4,2.25,1677,3600,2.0,3,7,1677,0.0,2012,1677,3600,3719 days 16:47:18.686819,111,1.7777777777777777,0.0,0,0,1677.0
655275.0,3,1.75,2050,11856,1.0,3,7,1460,590.0,1962,2670,11856,21981 days 16:47:18.686819,161,1.7142857142857142,2.4745762711864407,-620,0,870.0
861000.0,3,2.0,2520,3959,1.0,5,8,1270,1250.0,1931,1660,3959,33304 days 16:47:18.686819,237,1.5,1.016,860,0,20.0
850000.0,3,3.5,2620,11148,2.0,4,9,2060,560.0,1977,2590,10796,16502 days 16:47:18.686819,289,0.8571428571428571,3.6785714285714284,30,352,1500.0
246000.0,3,2.5,1650,6675,1.0,3,8,1290,360.0,1990,1880,6675,11754 days 16:47:18.686819,323,1.2,3.5833333333333335,-230,0,930.0
380000.0,2,1.0,700,4836,1.0,4,6,700,0.0,1926,1190,7050,35130 days 16:47:18.686819,350,2.0,0.0,-490,-2214,700.0
813000.0,4,2.5,3430,7508,2.0,3,1,3430,0.0,1998,3110,8741,8832 days 16:47:18.686819,293,1.6,0.0,320,-1233,3430.0
990000.0,4,2.5,3140,11049,2.0,3,1,3140,0.0,1988,2750,11049,12485 days 16:47:18.686819,324,1.6,0.0,390,0,3140.0
650000.0,3,2.5,2350,3750,2.0,3,7,1740,610.0,2003,1590,4700,7006 days 16:47:18.686819,309,1.2,2.8524590163934427,760,-950,1130.0
273000.0,4,3.0,1990,6180,2.0,3,7,1990,0.0,1990,1910,6180,11754 days 16:47:18.686819,142,1.3333333333333333,0.0,80,0,1990.0
398000.0,4,2.5,2050,14724,2.0,3,7,2050,0.0,1989,1920,12841,12119 days 16:47:18.686819,205,1.6,0.0,130,1883,2050.0
200000.0,2,1.0,930,8665,1.0,4,6,930,0.0,1938,1630,12375,30747 days 16:47:18.686819,234,2.0,0.0,-700,-3710,930.0
839000.0,3,1.0,1230,12305,1.0,3,7,1230,0.0,1955,2100,7960,24538 days 16:47:18.686819,135,3.0,0.0,-870,4345,1230.0
502000.0,3,2.5,1870,9135,1.0,3,7,1250,620.0,1984,1550,9100,13946 days 16:47:18.686819,308,1.2,2.0161290322580645,320,35,630.0
305000.0,3,2.25,2110,7665,1.0,4,7,1360,750.0,1973,1660,8436,17963 days 16:47:18.686819,168,1.3333333333333333,1.8133333333333332,450,-771,610.0
574950.0,5,3.25,3160,10000,2.0,4,8,3160,0.0,1980,2130,10000,15407 days 16:47:18.686819,169,1.5384615384615385,0.0,1030,0,3160.0
311000.0,3,1.0,1120,8631,1.0,3,7,1120,0.0,1942,1350,7714,29286 days 16:47:18.686819,230,3.0,0.0,-230,917,1120.0
1650000.0,3,2.25,2750,6203,1.0,5,7,1620,1130.0,1959,2570,7009,23077 days 16:47:18.686819,326,1.3333333333333333,1.4336283185840708,180,-806,490.0
387000.0,3,1.0,1230,9568,1.0,5,7,1230,0.0,1962,1270,9575,21981 days 16:47:18.686819,126,3.0,0.0,-40,-7,1230.0
375000.0,3,1.5,1190,20672,1.5,3,7,1190,0.0,1948,2150,16239,27095 days 16:47:18.686819,217,2.0,0.0,-960,4433,1190.0
175000.0,2,1.0,740,3434,1.0,5,6,740,0.0,1920,1160,6000,37322 days 16:47:18.686819,268,2.0,0.0,-420,-2566,740.0
248000.0,4,2.5,1770,5855,2.0,3,7,1770,0.0,2003,1790,5679,7006 days 16:47:18.686819,163,1.6,0.0,-20,176,1770.0
336750.0,4,2.25,1720,7803,1.0,3,8,1350,370.0,1955,1720,7803,24538 days 16:47:18.686819,093,1.7777777777777777,3.6486486486486487,0,0,980.0
685000.0,4,2.5,2770,45514,2.0,4,9,2770,0.0,1989,2940,49495,12119 days 16:47:18.686819,155,1.6,0.0,-170,-3981,2770.0
645000.0,4,2.75,2330,3917,2.0,3,9,2330,0.0,2004,2620,4400,6641 days 16:47:18.686819,196,1.4545454545454546,0.0,-290,-483,2330.0
279000.0,3,2.5,1660,7388,2.0,3,7,1660,0.0,2003,2240,6228,7006 days 16:47:18.686819,352,1.2,0.0,-580,1160,1660.0
479000.0,2,2.5,1730,1037,3.5,3,8,1730,0.0,2008,1280,1026,5180 days 16:47:18.686819,106,0.8,0.0,450,11,1730.0
466000.0,3,2.25,1880,7279,1.0,3,7,1280,600.0,1962,2020,8274,21981 days 16:47:18.686819,028,1.3333333333333333,2.1333333333333333,-140,-995,680.0
361500.0,4,2.75,2190,6740,2.0,3,7,2190,0.0,1995,1950,7150,9928 days 16:47:18.686819,110,1.4545454545454546,0.0,240,-410,2190.0
404000.0,3,1.75,1720,7202,1.0,3,7,1720,0.0,1995,1720,7625,9928 days 16:47:18.686819,336,1.7142857142857142,0.0,0,-423,1720.0
319000.0,4,3.25,2360,8344,2.0,3,8,2360,0.0,1990,1860,8410,11754 days 16:47:18.686819,075,1.2307692307692308,0.0,500,-66,2360.0
320000.0,3,1.5,1490,10132,1.0,4,6,1490,0.0,1969,1720,9915,19424 days 16:47:18.686819,075,2.0,0.0,-230,217,1490.0
1310000.0,4,3.75,3490,5625,2.0,3,9,2610,880.0,2014,1940,5000,2988 days 16:47:18.686819,321,1.0666666666666667,2.965909090909091,1550,625,1730.0
1000000.0,3,2.75,2370,8900,1.0,4,9,1670,700.0,1971,2840,8956,18694 days 16:47:18.686819,266,1.0909090909090908,2.3857142857142857,-470,-56,970.0
660000.0,4,2.5,2290,9120,2.0,4,8,2290,0.0,1977,2290,9120,16502 days 16:47:18.686819,311,1.6,0.0,0,0,2290.0
546000.0,4,3.0,1790,3600,1.5,3,8,1790,0.0,1901,1770,3119,44261 days 16:47:18.686819,111,1.3333333333333333,0.0,20,481,1790.0
300000.0,4,1.75,1820,5015,1.0,4,6,1190,630.0,1926,1530,9130,35130 days 16:47:18.686819,190,2.2857142857142856,1.8888888888888888,290,-4115,560.0
500000.0,2,1.5,1760,12000,1.0,4,7,1760,0.0,1964,2200,12088,21251 days 16:47:18.686819,289,1.3333333333333333,0.0,-440,-88,1760.0
381500.0,4,2.5,2430,5556,2.0,4,8,2430,0.0,2003,2430,5556,7006 days 16:47:18.686819,253,1.6,0.0,0,0,2430.0
990000.0,3,2.25,2630,12899,2.0,4,9,2630,0.0,1966,3140,15320,20520 days 16:47:18.686819,117,1.3333333333333333,0.0,-510,-2421,2630.0
278226.0,4,2.5,2390,4639,2.0,3,8,2390,0.0,2006,2390,4521,5910 days 16:47:18.686819,016,1.6,0.0,0,118,2390.0
340000.0,2,1.75,1500,4158,1.0,4,7,1220,280.0,1947,1270,4081,27460 days 16:47:18.686819,027,1.1428571428571428,4.357142857142857,230,77,940.0
305000.0,4,2.5,2510,12000,1.0,3,8,1520,990.0,1977,2210,8320,16502 days 16:47:18.686819,225,1.6,1.5353535353535352,300,3680,530.0
760000.0,4,2.5,2420,10285,1.0,3,8,1700,720.0,1958,2540,9900,23442 days 16:47:18.686819,164,1.6,2.361111111111111,-120,385,980.0
195000.0,4,1.5,2170,9948,2.0,3,7,2170,0.0,1952,1500,9750,25634 days 16:47:18.686819,302,2.6666666666666665,0.0,670,198,2170.0
564000.0,4,1.75,1960,6138,1.0,4,7,1260,700.0,1960,2000,7057,22712 days 16:47:18.686819,105,2.2857142857142856,1.8,-40,-919,560.0
539500.0,4,2.25,2280,8550,1.0,3,8,1660,620.0,1977,2590,9500,16502 days 16:47:18.686819,358,1.7777777777777777,2.6774193548387095,-310,-950,1040.0
299980.0,4,1.5,1580,10230,1.0,3,6,790,790.0,1945,1130,6955,28190 days 16:47:18.686819,261,2.6666666666666665,1.0,450,3275,0.0
290000.0,4,2.5,1850,5674,2.0,3,7,1850,0.0,1993,1750,6875,10658 days 16:47:18.686819,286,1.6,0.0,100,-1201,1850.0
257000.0,2,1.0,770,11084,1.0,4,6,770,0.0,1947,1010,11084,27460 days 16:47:18.686819,034,2.0,0.0,-240,0,770.0
518500.0,4,3.0,2120,5520,1.5,3,8,1420,700.0,1985,2020,8700,13580 days 16:47:18.686819,233,1.3333333333333333,2.0285714285714285,100,-3180,720.0
657000.0,4,2.75,3060,35380,1.0,3,9,1810,1250.0,1982,1980,10425,14676 days 16:47:18.686819,251,1.4545454545454546,1.448,1080,24955,560.0
590000.0,3,2.25,2680,41250,2.0,3,7,2680,0.0,1984,1940,47044,13946 days 16:47:18.686819,227,1.3333333333333333,0.0,740,-5794,2680.0
526000.0,4,1.75,2220,6350,1.0,3,7,1110,1110.0,1959,1950,8100,23077 days 16:47:18.686819,199,2.2857142857142856,1.0,270,-1750,0.0
254500.0,2,1.0,1150,11250,1.0,3,6,1150,0.0,1920,1100,11400,37322 days 16:47:18.686819,082,2.0,0.0,50,-150,1150.0
575000.0,2,1.0,980,3663,1.0,5,7,980,0.0,1909,1620,3706,41339 days 16:47:18.686819,104,2.0,0.0,-640,-43,980.0
464550.0,3,1.5,1690,10500,1.0,4,7,1690,0.0,1967,1570,10500,20155 days 16:47:18.686819,021,2.0,0.0,120,0,1690.0
409950.0,3,1.75,1320,6030,1.0,4,7,1320,0.0,1969,1840,6565,19424 days 16:47:18.686819,196,1.7142857142857142,0.0,-520,-535,1320.0
100000.0,2,1.0,910,22000,1.0,3,6,910,0.0,1956,1326,9891,24173 days 16:47:18.686819,127,2.0,0.0,-416,12109,910.0
365000.0,2,1.5,820,1270,2.0,3,7,820,0.0,2009,1130,1201,4814 days 16:47:18.686819,061,1.3333333333333333,0.0,-310,69,820.0
208000.0,3,1.0,1300,7420,1.0,4,6,1300,0.0,1960,1250,7420,22712 days 16:47:18.686819,040,3.0,0.0,50,0,1300.0
497950.0,4,2.5,1950,3000,2.0,3,7,1550,400.0,1998,1540,4300,8832 days 16:47:18.686819,314,1.6,3.875,410,-1300,1150.0
405000.0,5,3.5,3672,9742,2.0,3,9,3006,666.0,2006,2140,9118,5910 days 16:47:18.686819,253,1.4285714285714286,4.513513513513513,1532,624,2340.0
568000.0,3,2.5,2740,22499,2.0,3,9,2740,0.0,1994,2710,22499,10293 days 16:47:18.686819,070,1.2,0.0,30,0,2740.0
334000.0,2,1.0,890,6000,1.0,3,6,890,0.0,1941,1090,5900,29651 days 16:47:18.686819,131,2.0,0.0,-200,100,890.0
235000.0,3,2.0,1090,8400,1.0,4,6,1090,0.0,1961,1100,10850,22346 days 16:47:18.686819,015,1.5,0.0,-10,-2450,1090.0
295000.0,2,1.0,1170,10621,1.0,3,7,1170,0.0,1963,1340,9832,21616 days 16:47:18.686819,154,2.0,0.0,-170,789,1170.0
610000.0,4,3.0,2600,29539,1.0,3,8,2600,0.0,1994,1810,11600,10293 days 16:47:18.686819,022,1.3333333333333333,0.0,790,17939,2600.0
453500.0,4,1.75,2000,6032,1.0,3,7,1300,700.0,1959,1930,6032,23077 days 16:47:18.686819,156,2.2857142857142856,1.8571428571428572,70,0,600.0
1220000.0,4,3.75,3520,3944,1.5,5,8,2200,1320.0,1913,2310,4725,39878 days 16:47:18.686819,174,1.0666666666666667,1.6666666666666667,1210,-781,880.0
175000.0,2,1.0,1410,7000,1.0,3,7,1410,0.0,1968,1540,6000,19790 days 16:47:18.686819,028,2.0,0.0,-130,1000,1410.0
335000.0,2,1.0,1410,7000,1.0,3,7,1410,0.0,1968,1540,6000,19790 days 16:47:18.686819,118,2.0,0.0,-130,1000,1410.0
275000.0,3,1.5,1950,7620,1.0,4,7,1010,940.0,1956,1850,7620,24173 days 16:47:18.686819,247,2.0,1.074468085106383,100,0,70.0
400000.0,2,1.0,980,2130,1.0,4,6,860,120.0,1918,980,2800,38052 days 16:47:18.686819,134,2.0,7.166666666666667,0,-670,740.0
915000.0,3,2.75,3390,7000,1.0,4,8,1740,1650.0,1979,1770,6500,15772 days 16:47:18.686819,199,1.0909090909090908,1.0545454545454545,1620,500,90.0
619850.0,4,2.5,2270,9247,1.0,5,8,1500,770.0,1972,2270,9163,18329 days 16:47:18.686819,170,1.6,1.948051948051948,0,84,730.0
225900.0,3,1.0,1510,8800,1.0,4,7,1010,500.0,1963,1290,8470,21616 days 16:47:18.686819,033,3.0,2.02,220,330,510.0
525000.0,2,1.5,960,7200,1.0,3,7,960,0.0,1910,1550,6000,40974 days 16:47:18.686819,261,1.3333333333333333,0.0,-590,1200,960.0
215000.0,4,2.25,1900,9600,1.0,4,7,1900,0.0,1967,2040,9600,20155 days 16:47:18.686819,360,1.7777777777777777,0.0,-140,0,1900.0
802000.0,3,2.5,2580,13096,2.0,3,9,2580,0.0,1986,2580,7988,13215 days 16:47:18.686819,134,1.2,0.0,0,5108,2580.0
330000.0,4,2.5,2340,11784,2.0,3,9,2340,0.0,1997,2250,10760,9197 days 16:47:18.686819,181,1.6,0.0,90,1024,2340.0
549800.0,3,2.25,1580,11680,1.0,4,7,1580,0.0,1958,2270,10948,23442 days 16:47:18.686819,213,1.3333333333333333,0.0,-690,732,1580.0
195500.0,4,1.0,1230,8636,1.5,4,6,1230,0.0,1954,1168,8316,24903 days 16:47:18.686819,297,4.0,0.0,62,320,1230.0
338000.0,3,2.5,1590,7819,2.0,3,7,1590,0.0,1992,1790,7733,11024 days 16:47:18.686819,230,1.2,0.0,-200,86,1590.0
3200000.0,4,3.25,7000,28206,1.0,4,1,3500,3500.0,1991,4913,14663,11389 days 16:47:18.686819,224,1.2307692307692308,1.0,2087,13543,0.0
480000.0,4,2.25,1770,7000,1.0,5,7,1770,0.0,1972,1780,6500,18329 days 16:47:18.686819,232,1.7777777777777777,0.0,-10,500,1770.0
383000.0,4,2.5,1850,8310,1.0,3,7,1200,650.0,1962,1840,10080,21981 days 16:47:18.686819,096,1.6,1.8461538461538463,10,-1770,550.0
257000.0,3,1.75,1430,7210,1.0,3,7,1430,0.0,1975,1220,7777,17233 days 16:47:18.686819,090,1.7142857142857142,0.0,210,-567,1430.0
335000.0,4,2.75,2190,9209,2.0,4,8,2190,0.0,1996,2430,6687,9563 days 16:47:18.686819,054,1.4545454545454546,0.0,-240,2522,2190.0
422000.0,4,2.5,2310,6650,2.0,3,8,2310,0.0,2012,1800,9819,3719 days 16:47:18.686819,128,1.6,0.0,510,-3169,2310.0
560000.0,3,1.75,2000,10182,1.0,5,7,1400,600.0,1963,2050,10182,21616 days 16:47:18.686819,154,1.7142857142857142,2.3333333333333335,-50,0,800.0
680000.0,4,2.75,3620,35429,2.0,3,1,3620,0.0,2006,3310,54193,5910 days 16:47:18.686819,114,1.4545454545454546,0.0,310,-18764,3620.0
320000.0,2,1.0,1210,7040,1.0,3,7,1210,0.0,1952,1210,7205,25634 days 16:47:18.686819,301,2.0,0.0,0,-165,1210.0
751000.0,3,2.5,2840,6854,2.0,3,9,2840,0.0,2002,2840,7398,7371 days 16:47:18.686819,085,1.2,0.0,0,-544,2840.0
320000.0,6,2.75,2410,10763,1.0,5,7,1310,1100.0,1957,1310,10746,23807 days 16:47:18.686819,317,2.1818181818181817,1.190909090909091,1100,17,210.0
290000.0,4,1.75,1820,22043,2.5,4,7,1820,0.0,1918,1880,19961,38052 days 16:47:18.686819,021,2.2857142857142856,0.0,-60,2082,1820.0
250000.0,4,2.0,1470,7412,1.0,3,7,1470,0.0,1967,1390,7825,20155 days 16:47:18.686819,303,2.0,0.0,80,-413,1470.0
423000.0,3,1.75,1100,10005,1.0,5,7,1100,0.0,1964,1340,9709,21251 days 16:47:18.686819,105,1.7142857142857142,0.0,-240,296,1100.0
601002.0,4,2.5,2050,8094,1.0,3,8,1050,1000.0,1976,1990,9020,16868 days 16:47:18.686819,126,1.6,1.05,60,-926,50.0
352900.0,2,1.5,1240,1892,2.0,3,7,1240,0.0,2002,1220,1740,7371 days 16:47:18.686819,036,1.3333333333333333,0.0,20,152,1240.0
509950.0,3,2.5,2210,70567,2.0,3,9,2210,0.0,1995,2000,73616,9928 days 16:47:18.686819,231,1.2,0.0,210,-3049,2210.0
360000.0,2,1.75,1340,1050,3.0,3,8,1340,0.0,2009,1340,1090,4814 days 16:47:18.686819,036,1.1428571428571428,0.0,0,-40,1340.0
1080000.0,4,2.75,2580,8100,2.0,4,8,1780,800.0,1964,2840,10006,21251 days 16:47:18.686819,314,1.4545454545454546,2.225,-260,-1906,980.0
349950.0,3,2.5,2390,6441,2.0,3,7,2390,0.0,2002,2180,7346,7371 days 16:47:18.686819,212,1.2,0.0,210,-905,2390.0
395000.0,4,2.5,2250,6840,2.0,3,9,2250,0.0,1987,2480,7386,12850 days 16:47:18.686819,330,1.6,0.0,-230,-546,2250.0
273500.0,3,1.5,2000,15265,1.0,3,8,1540,460.0,1967,1920,15265,20155 days 16:47:18.686819,007,2.0,3.347826086956522,80,0,1080.0
700000.0,4,1.75,1870,6000,1.0,5,8,1670,200.0,1949,1710,6000,26729 days 16:47:18.686819,104,2.2857142857142856,8.35,160,0,1470.0
699000.0,3,2.5,2370,10968,2.0,4,9,2370,0.0,1985,2380,8144,13580 days 16:47:18.686819,107,1.2,0.0,-10,2824,2370.0
537000.0,4,2.25,2640,8800,1.0,3,8,1620,1020.0,1980,2500,11700,15407 days 16:47:18.686819,106,1.7777777777777777,1.588235294117647,140,-2900,600.0
405000.0,3,1.5,1240,9975,1.0,3,6,1240,0.0,1977,1390,10735,16502 days 16:47:18.686819,119,2.0,0.0,-150,-760,1240.0
269500.0,2,1.0,800,1200,2.0,3,7,800,0.0,1999,806,1200,8467 days 16:47:18.686819,216,2.0,0.0,-6,0,800.0
260000.0,4,2.5,2050,12500,1.0,3,7,1300,750.0,1965,1790,7900,20885 days 16:47:18.686819,268,1.6,1.7333333333333334,260,4600,550.0
266750.0,3,2.25,1650,10000,2.0,3,7,1650,0.0,1988,1420,10000,12485 days 16:47:18.686819,247,1.3333333333333333,0.0,230,0,1650.0
1800000.0,5,3.75,4320,39094,2.0,3,8,4320,0.0,1938,1920,7750,30747 days 16:47:18.686819,343,1.3333333333333333,0.0,2400,31344,4320.0
779000.0,2,2.25,2130,5920,1.0,3,8,1830,300.0,1950,2130,7192,26364 days 16:47:18.686819,233,0.8888888888888888,6.1,0,-1272,1530.0
500000.0,3,2.5,2840,48716,1.0,3,9,1870,970.0,1994,2710,43676,10293 days 16:47:18.686819,170,1.2,1.9278350515463918,130,5040,900.0
365000.0,4,1.75,3080,32997,1.5,4,7,3080,0.0,1950,1980,5711,26364 days 16:47:18.686819,093,2.2857142857142856,0.0,1100,27286,3080.0
724000.0,2,1.0,1560,5000,1.5,4,7,1560,0.0,1942,2620,5400,29286 days 16:47:18.686819,249,2.0,0.0,-1060,-400,1560.0
890000.0,4,2.75,3220,15467,2.0,3,1,3220,0.0,1994,3670,16641,10293 days 16:47:18.686819,223,1.4545454545454546,0.0,-450,-1174,3220.0
431000.0,4,2.5,1450,3600,1.5,3,7,1250,200.0,1902,1680,3600,43896 days 16:47:18.686819,205,1.6,6.25,-230,0,1050.0
242000.0,2,1.0,960,21850,1.0,3,6,960,0.0,1947,1020,21850,27460 days 16:47:18.686819,191,2.0,0.0,-60,0,960.0
415000.0,4,2.5,2670,8279,2.0,3,7,2670,0.0,1999,2290,7504,8467 days 16:47:18.686819,106,1.6,0.0,380,775,2670.0
727160.0,7,3.75,2310,5000,2.0,3,8,2310,0.0,1984,1360,1552,13946 days 16:47:18.686819,226,1.8666666666666667,0.0,950,3448,2310.0
1110000.0,4,3.25,3520,19354,1.0,4,9,2010,1510.0,1978,2630,19354,16137 days 16:47:18.686819,345,1.2307692307692308,1.3311258278145695,890,0,500.0
265000.0,2,1.75,1090,3272,1.0,5,8,1090,0.0,1970,1160,5475,19059 days 16:47:18.686819,014,1.1428571428571428,0.0,-70,-2203,1090.0
519000.0,3,1.75,2000,5680,1.0,4,7,1080,920.0,1903,1230,4535,43531 days 16:47:18.686819,033,1.7142857142857142,1.173913043478261,770,1145,160.0
262000.0,4,1.5,1840,9009,2.0,3,7,1840,0.0,1965,1390,8025,20885 days 16:47:18.686819,012,2.6666666666666665,0.0,450,984,1840.0
1190000.0,4,2.5,3160,13194,2.0,5,1,3160,0.0,1965,3490,13194,20885 days 16:47:18.686819,174,1.6,0.0,-330,0,3160.0
295000.0,3,1.75,1520,6559,1.0,4,7,1170,350.0,1992,1520,6095,11024 days 16:47:18.686819,127,1.7142857142857142,3.342857142857143,0,464,820.0
615000.0,3,1.75,2110,56192,1.0,3,7,1480,630.0,1978,2570,46609,16137 days 16:47:18.686819,023,1.7142857142857142,2.3492063492063493,-460,9583,850.0
1100000.0,4,2.75,3410,7750,1.0,5,8,1710,1700.0,1958,3080,8525,23442 days 16:47:18.686819,248,1.4545454545454546,1.0058823529411764,330,-775,10.0
575000.0,4,2.5,2630,6247,2.0,3,8,2630,0.0,1992,2130,4668,11024 days 16:47:18.686819,269,1.6,0.0,500,1579,2630.0
388000.0,3,1.75,1350,2325,3.0,3,7,1350,0.0,1999,1520,1652,8467 days 16:47:18.686819,097,1.7142857142857142,0.0,-170,673,1350.0
750500.0,4,2.5,2860,9159,1.0,4,8,1530,1330.0,1989,2070,8680,12119 days 16:47:18.686819,307,1.6,1.150375939849624,790,479,200.0
527500.0,3,1.75,2310,78844,1.0,3,8,1760,550.0,1977,2830,6230,16502 days 16:47:18.686819,147,1.7142857142857142,3.2,-520,72614,1210.0
503000.0,3,2.0,2590,108900,2.0,3,8,1980,610.0,1988,3170,108900,12485 days 16:47:18.686819,149,1.5,3.2459016393442623,-580,0,1370.0
1050000.0,4,3.5,3500,4000,2.0,3,1,2560,940.0,2000,1910,4000,8102 days 16:47:18.686819,308,1.1428571428571428,2.723404255319149,1590,0,1620.0
325000.0,2,1.0,800,7260,1.0,3,7,800,0.0,1953,1010,7440,25268 days 16:47:18.686819,189,2.0,0.0,-210,-180,800.0
402000.0,3,1.75,1580,6127,1.5,5,7,1580,0.0,1947,1500,6128,27460 days 16:47:18.686819,237,1.7142857142857142,0.0,80,-1,1580.0
370000.0,3,1.5,1560,6774,1.0,4,6,1060,500.0,1927,1320,3844,34765 days 16:47:18.686819,267,2.0,2.12,240,2930,560.0
329950.0,3,1.0,1750,7800,1.0,4,7,1150,600.0,1956,1750,7560,24173 days 16:47:18.686819,177,3.0,1.9166666666666667,0,240,550.0
482500.0,4,3.0,1630,7626,1.0,5,7,1110,520.0,1990,1630,8082,11754 days 16:47:18.686819,171,1.3333333333333333,2.1346153846153846,0,-456,590.0
259000.0,4,1.5,1260,7248,1.5,5,7,1260,0.0,1955,1300,7732,24538 days 16:47:18.686819,266,2.6666666666666665,0.0,-40,-484,1260.0
210000.0,3,2.25,2140,9775,1.0,4,7,1470,670.0,1978,2050,8625,16137 days 16:47:18.686819,300,1.3333333333333333,2.1940298507462686,90,1150,800.0
459000.0,4,2.75,2790,6600,2.0,3,9,2790,0.0,2000,2900,6752,8102 days 16:47:18.686819,282,1.4545454545454546,0.0,-110,-152,2790.0
375000.0,3,1.75,2530,35150,1.0,4,7,1800,730.0,1977,2460,36386,16502 days 16:47:18.686819,182,1.7142857142857142,2.4657534246575343,70,-1236,1070.0
295000.0,3,2.25,1330,7200,1.0,3,7,900,430.0,1974,1380,9570,17598 days 16:47:18.686819,295,1.3333333333333333,2.0930232558139537,-50,-2370,470.0
910000.0,3,2.0,2700,6120,1.0,4,8,1350,1350.0,1962,1700,4590,21981 days 16:47:18.686819,132,1.5,1.0,1000,1530,0.0
470000.0,4,1.0,1740,37238,1.5,4,7,1740,0.0,1932,1810,18352,32939 days 16:47:18.686819,283,4.0,0.0,-70,18886,1740.0
565000.0,4,2.0,2070,7980,1.5,4,7,2070,0.0,1940,1600,7980,30017 days 16:47:18.686819,051,2.0,0.0,470,0,2070.0
547000.0,5,3.0,2200,103237,1.0,3,7,1160,1040.0,1971,2300,103237,18694 days 16:47:18.686819,015,1.6666666666666667,1.1153846153846154,-100,0,120.0
125000.0,2,1.0,810,8382,1.0,4,5,810,0.0,1942,1040,8382,29286 days 16:47:18.686819,267,2.0,0.0,-230,0,810.0
2300000.0,4,4.75,3970,9778,2.0,4,1,3390,580.0,1928,3970,8460,34400 days 16:47:18.686819,182,0.8421052631578947,5.844827586206897,0,1318,2810.0
348000.0,3,2.5,2370,7500,1.0,3,8,1620,750.0,1979,1960,8062,15772 days 16:47:18.686819,120,1.2,2.16,410,-562,870.0
175000.0,3,1.0,1460,11880,1.0,2,7,1460,0.0,1961,1310,9315,22346 days 16:47:18.686819,104,3.0,0.0,150,2565,1460.0
439950.0,3,2.5,1770,2875,2.0,3,8,1770,0.0,1990,1770,3833,11754 days 16:47:18.686819,122,1.2,0.0,0,-958,1770.0
230000.0,3,1.0,1120,32250,1.0,4,6,1120,0.0,1934,1010,335289,32208 days 16:47:18.686819,070,3.0,0.0,110,-303039,1120.0
207000.0,3,2.5,1520,2550,2.0,3,7,1520,0.0,2005,1460,2550,6275 days 16:47:18.686819,245,1.2,0.0,60,0,1520.0
320000.0,5,2.5,3020,21441,1.0,4,8,1510,1510.0,1978,1610,16445,16137 days 16:47:18.686819,153,2.0,1.0,1410,4996,0.0
1090000.0,5,3.25,5600,107157,2.0,3,1,3440,2160.0,1988,3470,75794,12485 days 16:47:18.686819,096,1.5384615384615385,1.5925925925925926,2130,31363,1280.0
510000.0,4,1.5,1320,14250,1.0,4,7,1320,0.0,1954,1720,14250,24903 days 16:47:18.686819,157,2.6666666666666665,0.0,-400,0,1320.0
730000.0,4,1.0,1870,4992,1.5,4,7,1670,200.0,1940,2160,5239,30017 days 16:47:18.686819,304,4.0,8.35,-290,-247,1470.0
750000.0,3,3.75,2460,7630,1.0,5,8,1940,520.0,1976,2000,7326,16868 days 16:47:18.686819,225,0.8,3.730769230769231,460,304,1420.0
237000.0,3,1.5,960,7400,1.0,3,7,960,0.0,1962,1640,8060,21981 days 16:47:18.686819,100,2.0,0.0,-680,-660,960.0
560000.0,3,2.5,3440,103672,2.0,3,9,3440,0.0,1990,2710,112820,11754 days 16:47:18.686819,269,1.2,0.0,730,-9148,3440.0
745000.0,3,2.75,3010,12432,1.0,4,8,1890,1120.0,1970,2500,12432,19059 days 16:47:18.686819,195,1.0909090909090908,1.6875,510,0,770.0
1830000.0,3,3.75,6030,39317,2.0,3,1,4440,1590.0,1991,4040,12333,11389 days 16:47:18.686819,227,0.8,2.792452830188679,1990,26984,2850.0
180000.0,3,2.25,1990,6350,2.0,3,7,1990,0.0,1967,1220,6250,20155 days 16:47:18.686819,169,1.3333333333333333,0.0,770,100,1990.0
309950.0,3,2.25,1990,6350,2.0,3,7,1990,0.0,1967,1220,6250,20155 days 16:47:18.686819,317,1.3333333333333333,0.0,770,100,1990.0
715000.0,4,1.0,1710,6050,1.5,3,7,1410,300.0,1913,1560,4950,39878 days 16:47:18.686819,126,4.0,4.7,150,1100,1110.0
620000.0,4,2.25,1890,4300,1.5,3,7,1350,540.0,1918,1830,3800,38052 days 16:47:18.686819,117,1.7777777777777777,2.5,60,500,810.0
330000.0,3,2.5,1990,9995,2.0,3,7,1990,0.0,1996,1680,7511,9563 days 16:47:18.686819,365,1.2,0.0,310,2484,1990.0
525000.0,4,1.75,1600,7400,1.0,3,7,1210,390.0,1973,1640,7500,17963 days 16:47:18.686819,091,2.2857142857142856,3.1025641025641026,-40,-100,820.0
611000.0,6,2.5,3820,53173,1.0,4,9,2040,1780.0,1974,2510,15314,17598 days 16:47:18.686819,158,2.4,1.146067415730337,1310,37859,260.0
294000.0,4,2.5,2210,8465,1.0,3,8,1490,720.0,1990,2210,7917,11754 days 16:47:18.686819,163,1.6,2.0694444444444446,0,548,770.0
463000.0,3,1.75,2020,11095,1.0,4,7,1480,540.0,1975,2030,10710,17233 days 16:47:18.686819,111,1.7142857142857142,2.740740740740741,-10,385,940.0
320900.0,3,2.0,1770,7251,1.0,4,8,1770,0.0,1990,2560,7210,11754 days 16:47:18.686819,195,1.5,0.0,-790,41,1770.0
369950.0,4,2.5,2050,4502,2.0,3,7,2050,0.0,2005,2480,4504,6275 days 16:47:18.686819,301,1.6,0.0,-430,-2,2050.0
589500.0,4,1.5,3520,4933,1.5,4,8,2270,1250.0,1929,1710,5400,34034 days 16:47:18.686819,070,2.6666666666666665,1.816,1810,-467,1020.0
400000.0,4,1.75,1810,9750,2.0,4,7,1810,0.0,1977,1570,10000,16502 days 16:47:18.686819,224,2.2857142857142856,0.0,240,-250,1810.0
458000.0,3,2.25,2150,9900,1.0,3,8,1450,700.0,1977,2170,9500,16502 days 16:47:18.686819,295,1.3333333333333333,2.0714285714285716,-20,400,750.0
436000.0,4,2.5,2495,5751,2.0,3,7,2495,0.0,2002,2490,6300,7371 days 16:47:18.686819,336,1.6,0.0,5,-549,2495.0
310000.0,3,2.0,1290,6150,1.0,5,6,1290,0.0,1950,1960,6150,26364 days 16:47:18.686819,275,1.5,0.0,-670,0,1290.0
398000.0,5,2.5,3004,5700,2.0,3,9,3004,0.0,2006,2665,5700,5910 days 16:47:18.686819,296,2.0,0.0,339,0,3004.0
625000.0,4,2.25,2070,7200,1.0,5,8,1390,680.0,1977,2110,8400,16502 days 16:47:18.686819,227,1.7777777777777777,2.0441176470588234,-40,-1200,710.0
1010000.0,5,3.25,4050,35600,2.0,3,1,4050,0.0,1990,4770,33880,11754 days 16:47:18.686819,350,1.5384615384615385,0.0,-720,1720,4050.0
435000.0,2,1.0,960,6250,1.0,4,6,740,220.0,1940,1090,6000,30017 days 16:47:18.686819,103,2.0,3.3636363636363638,-130,250,520.0
250000.0,3,2.25,1900,9990,1.0,3,7,1300,600.0,1961,1900,9990,22346 days 16:47:18.686819,072,1.3333333333333333,2.1666666666666665,0,0,700.0
430000.0,3,1.5,1450,7316,1.0,3,7,1450,0.0,1961,1440,7316,22346 days 16:47:18.686819,076,2.0,0.0,10,0,1450.0
790000.0,4,3.5,2720,3000,2.0,3,9,2250,470.0,2014,1600,4600,2988 days 16:47:18.686819,224,1.1428571428571428,4.787234042553192,1120,-1600,1780.0
1680000.0,5,5.25,4830,18707,2.0,5,9,3930,900.0,1952,2880,10520,25634 days 16:47:18.686819,190,0.9523809523809523,4.366666666666666,1950,8187,3030.0
250000.0,4,2.75,1920,7102,1.0,3,7,1130,790.0,1992,1830,6440,11024 days 16:47:18.686819,097,1.4545454545454546,1.4303797468354431,90,662,340.0
1120000.0,5,1.5,2540,6660,2.0,4,8,2340,200.0,1954,2460,9000,24903 days 16:47:18.686819,164,3.3333333333333335,11.7,80,-2340,2140.0
383900.0,3,1.5,1600,8040,1.0,4,7,1050,550.0,1965,1810,7819,20885 days 16:47:18.686819,117,2.0,1.9090909090909092,-210,221,500.0
330000.0,4,2.5,2210,5929,2.0,3,8,2210,0.0,2004,2200,5901,6641 days 16:47:18.686819,085,1.6,0.0,10,28,2210.0
624000.0,3,2.5,2510,47044,1.0,4,7,1910,600.0,1975,2510,42803,17233 days 16:47:18.686819,258,1.2,3.183333333333333,0,4241,1310.0
383000.0,5,2.0,2280,5750,1.0,4,8,1140,1140.0,1951,1780,5750,25999 days 16:47:18.686819,042,2.5,1.0,500,0,0.0
687000.0,4,3.25,4400,186846,2.0,4,9,4400,0.0,1993,2280,186846,10658 days 16:47:18.686819,153,1.2307692307692308,0.0,2120,0,4400.0
558000.0,4,3.25,3160,8876,2.0,3,9,2460,700.0,1997,2900,10000,9197 days 16:47:18.686819,068,1.2307692307692308,3.5142857142857142,260,-1124,1760.0
275000.0,3,2.0,1380,3500,2.0,3,7,1380,0.0,1971,1620,3900,18694 days 16:47:18.686819,248,1.5,0.0,-240,-400,1380.0
687500.0,5,2.75,3320,10500,1.0,4,7,2020,1300.0,1963,1840,10425,21616 days 16:47:18.686819,209,1.8181818181818181,1.5538461538461539,1480,75,720.0
275000.0,3,2.5,1870,6821,2.0,3,7,1870,0.0,1989,1970,6821,12119 days 16:47:18.686819,209,1.2,0.0,-100,0,1870.0
700000.0,3,3.5,3030,11550,2.0,3,8,3030,0.0,1971,2340,10560,18694 days 16:47:18.686819,345,0.8571428571428571,0.0,690,990,3030.0
342500.0,2,1.75,1210,7507,1.0,3,7,1210,0.0,1982,1840,7500,14676 days 16:47:18.686819,175,1.1428571428571428,0.0,-630,7,1210.0
483500.0,4,2.5,2740,45732,2.0,3,8,2740,0.0,1995,2080,43560,9928 days 16:47:18.686819,126,1.6,0.0,660,2172,2740.0
190000.0,3,1.75,1350,7370,1.0,4,6,1350,0.0,1912,1440,6000,40244 days 16:47:18.686819,213,1.7142857142857142,0.0,-90,1370,1350.0
300000.0,3,1.75,1350,7370,1.0,4,6,1350,0.0,1912,1440,6000,40244 days 16:47:18.686819,077,1.7142857142857142,0.0,-90,1370,1350.0
140000.0,3,1.75,1270,8991,2.0,3,7,1270,0.0,1981,1270,8993,15041 days 16:47:18.686819,042,1.7142857142857142,0.0,0,-2,1270.0
275000.0,4,1.75,1680,19405,1.0,4,7,1560,120.0,1959,2000,12900,23077 days 16:47:18.686819,103,2.2857142857142856,13.0,-320,6505,1440.0
370000.0,3,2.75,2120,7650,1.0,4,7,2120,0.0,1958,1180,7650,23442 days 16:47:18.686819,237,1.0909090909090908,0.0,940,0,2120.0
227000.0,2,1.0,1040,9100,1.0,4,7,1040,0.0,1937,1950,13228,31112 days 16:47:18.686819,084,2.0,0.0,-910,-4128,1040.0
312000.0,4,1.0,1730,8706,1.0,4,7,1010,720.0,1962,1369,8418,21981 days 16:47:18.686819,028,4.0,1.4027777777777777,361,288,290.0
260000.0,2,1.0,1410,5650,1.5,3,6,1410,0.0,1918,1430,5650,38052 days 16:47:18.686819,276,2.0,0.0,-20,0,1410.0
797000.0,3,2.5,1370,1911,2.0,3,9,1370,0.0,1907,1630,2090,42070 days 16:47:18.686819,191,1.2,0.0,-260,-179,1370.0
640000.0,6,2.0,2840,228690,1.5,3,6,2720,120.0,1948,2330,228690,27095 days 16:47:18.686819,290,3.0,22.666666666666668,510,0,2600.0
605000.0,4,1.75,3280,35160,1.0,3,7,2080,1200.0,1976,2510,31331,16868 days 16:47:18.686819,044,2.2857142857142856,1.7333333333333334,770,3829,880.0
329950.0,3,2.25,2070,7995,1.0,3,7,1350,720.0,1987,1620,6799,12850 days 16:47:18.686819,061,1.3333333333333333,1.875,450,1196,630.0
180000.0,2,1.0,960,87991,1.5,3,5,960,0.0,1946,1940,392040,27825 days 16:47:18.686819,346,2.0,0.0,-980,-304049,960.0
220000.0,3,2.25,1470,7518,1.0,3,7,1160,310.0,1985,1720,8300,13580 days 16:47:18.686819,225,1.3333333333333333,3.7419354838709675,-250,-782,850.0
723000.0,4,2.25,2430,4748,1.5,3,8,1630,800.0,1928,2430,4748,34400 days 16:47:18.686819,183,1.7777777777777777,2.0375,0,0,830.0
375000.0,3,1.75,1430,8412,1.0,4,7,1070,360.0,1928,1490,8410,34400 days 16:47:18.686819,016,1.7142857142857142,2.9722222222222223,-60,2,710.0
249950.0,5,2.0,1730,7375,1.0,4,6,1730,0.0,1944,1550,7125,28556 days 16:47:18.686819,304,2.5,0.0,180,250,1730.0
390000.0,5,1.75,2290,7900,1.0,4,7,1190,1100.0,1965,1870,8250,20885 days 16:47:18.686819,310,2.857142857142857,1.0818181818181818,420,-350,90.0
705000.0,4,1.75,1690,11739,1.0,4,8,1690,0.0,1959,2300,11600,23077 days 16:47:18.686819,260,2.2857142857142856,0.0,-610,139,1690.0
590000.0,4,2.5,3220,7875,1.5,4,8,3220,0.0,1966,1600,7875,20520 days 16:47:18.686819,174,1.6,0.0,1620,0,3220.0
292000.0,4,1.75,2130,11097,1.0,3,7,1370,760.0,1952,1850,11097,25634 days 16:47:18.686819,283,2.2857142857142856,1.8026315789473684,280,0,610.0
506000.0,3,2.5,2100,213008,1.0,3,8,2100,0.0,1990,1330,214315,11754 days 16:47:18.686819,217,1.2,0.0,770,-1307,2100.0
907500.0,4,2.5,2770,8642,2.0,4,9,2770,0.0,1987,2670,9000,12850 days 16:47:18.686819,155,1.6,0.0,100,-358,2770.0
2270000.0,4,3.25,4040,18916,1.0,4,9,4040,0.0,1954,3000,18831,24903 days 16:47:18.686819,183,1.2307692307692308,0.0,1040,85,4040.0
319500.0,4,2.75,2500,5100,1.5,4,7,1420,1080.0,1907,1430,5100,42070 days 16:47:18.686819,287,1.4545454545454546,1.3148148148148149,1070,0,340.0
265000.0,5,1.75,1580,5292,1.0,3,6,980,600.0,1913,1600,2976,39878 days 16:47:18.686819,054,2.857142857142857,1.6333333333333333,-20,2316,380.0
237000.0,3,1.0,1130,10650,1.0,3,7,1130,0.0,1954,1320,10650,24903 days 16:47:18.686819,156,3.0,0.0,-190,0,1130.0
235000.0,5,1.0,1500,9282,1.5,5,6,1500,0.0,1966,1520,9639,20520 days 16:47:18.686819,253,5.0,0.0,-20,-357,1500.0
740000.0,4,2.25,2230,6000,1.5,3,8,1810,420.0,1928,2840,6000,34400 days 16:47:18.686819,089,1.7777777777777777,4.309523809523809,-610,0,1390.0
359000.0,3,1.5,1550,4980,1.0,3,7,1080,470.0,1978,940,4980,16137 days 16:47:18.686819,190,2.0,2.297872340425532,610,0,610.0
334950.0,4,2.5,2230,5500,2.0,3,7,2230,0.0,1999,1910,5500,8467 days 16:47:18.686819,044,1.6,0.0,320,0,2230.0
259950.0,2,1.0,790,8100,1.0,3,6,790,0.0,1947,1420,8100,27460 days 16:47:18.686819,272,2.0,0.0,-630,0,790.0
253000.0,4,2.5,2230,4541,2.0,3,7,2230,0.0,2006,2800,4860,5910 days 16:47:18.686819,134,1.6,0.0,-570,-319,2230.0
561000.0,3,2.25,1710,4140,2.0,3,8,1710,0.0,2004,1730,3680,6641 days 16:47:18.686819,163,1.3333333333333333,0.0,-20,460,1710.0
455000.0,2,1.5,1260,5100,1.0,3,7,1260,0.0,1941,1640,5100,29651 days 16:47:18.686819,084,1.3333333333333333,0.0,-380,0,1260.0
675000.0,4,2.5,2420,18470,1.0,3,8,920,1500.0,1968,2690,13800,19790 days 16:47:18.686819,096,1.6,0.6133333333333333,-270,4670,-580.0
267000.0,3,1.5,1090,8160,1.0,3,7,1090,0.0,1967,1260,7560,20155 days 16:47:18.686819,177,2.0,0.0,-170,600,1090.0
368000.0,4,2.5,2689,5724,2.0,3,9,2689,0.0,2006,2665,5700,5910 days 16:47:18.686819,310,1.6,0.0,24,24,2689.0
599995.0,3,1.0,1620,3000,1.5,5,7,1620,0.0,1928,1420,3060,34400 days 16:47:18.686819,327,3.0,0.0,200,-60,1620.0
252000.0,4,1.75,1940,13370,1.0,4,8,1940,0.0,1974,2405,11769,17598 days 16:47:18.686819,322,2.2857142857142856,0.0,-465,1601,1940.0
247200.0,3,1.0,1590,11200,1.0,4,7,1590,0.0,1961,1560,9750,22346 days 16:47:18.686819,197,3.0,0.0,30,1450,1590.0
910000.0,3,3.5,3020,4082,2.0,3,9,2080,940.0,1954,2060,5102,24903 days 16:47:18.686819,126,0.8571428571428571,2.2127659574468086,960,-1020,1140.0
419950.0,4,1.75,1870,16549,1.0,3,8,1870,0.0,1969,1870,10804,19424 days 16:47:18.686819,005,2.2857142857142856,0.0,0,5745,1870.0
160000.0,3,1.0,880,8976,1.0,4,6,880,0.0,1966,990,8760,20520 days 16:47:18.686819,057,3.0,0.0,-110,216,880.0
400000.0,3,2.25,2140,11266,2.0,3,7,2140,0.0,1986,2000,14174,13215 days 16:47:18.686819,168,1.3333333333333333,0.0,140,-2908,2140.0
210000.0,5,2.0,2050,10200,1.0,3,6,1430,620.0,1956,1940,8625,24173 days 16:47:18.686819,125,2.5,2.306451612903226,110,1575,810.0
475000.0,5,2.0,2050,10200,1.0,3,6,1430,620.0,1956,1940,8625,24173 days 16:47:18.686819,072,2.5,2.306451612903226,110,1575,810.0
355900.0,3,2.5,2090,3821,2.0,3,7,2090,0.0,2008,2040,4200,5180 days 16:47:18.686819,124,1.2,0.0,50,-379,2090.0
420000.0,3,2.25,2520,26943,1.0,3,7,1760,760.0,1977,2300,10004,16502 days 16:47:18.686819,020,1.3333333333333333,2.3157894736842106,220,16939,1000.0
710000.0,4,2.5,2630,8580,1.0,4,9,1700,930.0,1977,2430,10240,16502 days 16:47:18.686819,237,1.6,1.8279569892473118,200,-1660,770.0
518000.0,4,1.75,2560,15000,1.0,3,7,1880,680.0,1974,2210,15150,17598 days 16:47:18.686819,097,2.2857142857142856,2.764705882352941,350,-150,1200.0
375000.0,3,1.0,1200,5404,1.0,3,6,1200,0.0,1937,1200,5987,31112 days 16:47:18.686819,289,3.0,0.0,0,-583,1200.0
185000.0,3,1.5,1010,7755,1.0,3,6,1010,0.0,1953,1270,8350,25268 days 16:47:18.686819,311,2.0,0.0,-260,-595,1010.0
402000.0,3,2.5,1520,3425,2.0,3,7,1520,0.0,1986,1640,3425,13215 days 16:47:18.686819,241,1.2,0.0,-120,0,1520.0
585000.0,3,1.75,2170,153767,1.0,3,7,2170,0.0,1976,2840,49500,16868 days 16:47:18.686819,241,1.7142857142857142,0.0,-670,104267,2170.0
500000.0,4,2.0,1980,4500,2.0,4,7,1980,0.0,1910,1550,2541,40974 days 16:47:18.686819,022,2.0,0.0,430,1959,1980.0
1720000.0,4,2.5,3070,7207,2.0,4,1,2670,400.0,1927,3190,7523,34765 days 16:47:18.686819,357,1.6,6.675,-120,-316,2270.0
1680000.0,5,3.5,5170,7197,3.0,3,1,3520,1650.0,1998,3020,12880,8832 days 16:47:18.686819,274,1.4285714285714286,2.1333333333333333,2150,-5683,1870.0
680000.0,8,2.75,2530,4800,2.0,4,7,1390,1140.0,1901,1540,4800,44261 days 16:47:18.686819,226,2.909090909090909,1.219298245614035,990,0,250.0
345000.0,3,2.25,1690,14615,2.0,4,7,1690,0.0,1979,1390,11360,15772 days 16:47:18.686819,343,1.3333333333333333,0.0,300,3255,1690.0
355000.0,4,2.5,2150,3600,2.0,3,7,2150,0.0,2010,2220,3915,4449 days 16:47:18.686819,112,1.6,0.0,-70,-315,2150.0
390000.0,3,1.5,1180,7700,1.0,4,7,1180,0.0,1959,1510,8800,23077 days 16:47:18.686819,265,2.0,0.0,-330,-1100,1180.0
128000.0,3,1.0,1400,9690,1.0,3,7,1400,0.0,1969,1280,9600,19424 days 16:47:18.686819,118,3.0,0.0,120,90,1400.0
448500.0,3,1.75,1300,4800,2.0,4,7,1300,0.0,1912,1300,4800,40244 days 16:47:18.686819,238,1.7142857142857142,0.0,0,0,1300.0
346000.0,3,1.75,1590,9636,1.5,4,6,1590,0.0,1953,1800,9975,25268 days 16:47:18.686819,313,1.7142857142857142,0.0,-210,-339,1590.0
779000.0,3,1.75,1990,5600,1.0,3,8,1330,660.0,1941,2630,6780,29651 days 16:47:18.686819,246,1.7142857142857142,2.015151515151515,-640,-1180,670.0
335000.0,3,1.75,1510,9720,1.0,3,7,1510,0.0,1948,1520,10037,27095 days 16:47:18.686819,034,1.7142857142857142,0.0,-10,-317,1510.0
1850000.0,4,3.25,2910,1880,2.0,5,9,1830,1080.0,1914,3100,8200,39513 days 16:47:18.686819,254,1.2307692307692308,1.6944444444444444,-190,-6320,750.0
799990.0,3,2.5,2850,21780,2.0,3,1,2850,0.0,1994,3020,21798,10293 days 16:47:18.686819,049,1.2,0.0,-170,-18,2850.0
1080000.0,3,2.5,2830,56628,2.0,3,1,2830,0.0,2001,2830,16430,7736 days 16:47:18.686819,283,1.2,0.0,0,40198,2830.0
371000.0,2,1.5,1110,1189,3.0,3,8,1110,0.0,2000,1420,1311,8102 days 16:47:18.686819,234,1.3333333333333333,0.0,-310,-122,1110.0
620000.0,4,2.5,1900,9775,1.0,5,7,1900,0.0,1967,1990,10500,20155 days 16:47:18.686819,300,1.6,0.0,-90,-725,1900.0
343000.0,4,1.75,2290,10290,1.0,3,7,1340,950.0,1960,1800,7605,22712 days 16:47:18.686819,135,2.2857142857142856,1.4105263157894736,490,2685,390.0
265000.0,3,1.0,1010,14948,1.0,5,6,1010,0.0,1969,1510,9600,19424 days 16:47:18.686819,287,3.0,0.0,-500,5348,1010.0
1000000.0,5,2.5,4670,15857,2.0,3,1,4670,0.0,1998,3810,14824,8832 days 16:47:18.686819,216,2.0,0.0,860,1033,4670.0
825000.0,3,2.5,3400,38400,1.0,3,8,1870,1530.0,1955,3400,24338,24538 days 16:47:18.686819,279,1.2,1.2222222222222223,0,14062,340.0
889000.0,4,3.5,4070,10976,2.0,3,1,4070,0.0,2004,4080,10106,6641 days 16:47:18.686819,104,1.1428571428571428,0.0,-10,870,4070.0
305000.0,3,2.25,1630,10962,1.0,4,8,1100,530.0,1977,1830,8470,16502 days 16:47:18.686819,105,1.3333333333333333,2.0754716981132075,-200,2492,570.0
407000.0,2,2.5,1700,6635,2.0,4,8,1700,0.0,1976,1700,6635,16868 days 16:47:18.686819,303,0.8,0.0,0,0,1700.0
613000.0,5,2.5,2070,12000,1.0,4,7,1340,730.0,1967,2090,12000,20155 days 16:47:18.686819,154,2.0,1.8356164383561644,-20,0,610.0
1640000.0,3,3.5,4660,21164,2.0,3,1,4660,0.0,1975,3140,24274,17233 days 16:47:18.686819,335,0.8571428571428571,0.0,1520,-3110,4660.0
645000.0,3,3.75,2050,6000,2.0,5,7,1550,500.0,1910,1780,4000,40974 days 16:47:18.686819,041,0.8,3.1,270,2000,1050.0
1160000.0,4,3.5,4680,9700,2.0,3,1,3360,1320.0,2005,2800,12343,6275 days 16:47:18.686819,169,1.1428571428571428,2.5454545454545454,1880,-2643,2040.0
610000.0,3,2.25,2320,38186,2.0,3,8,2320,0.0,1980,2875,37523,15407 days 16:47:18.686819,272,1.3333333333333333,0.0,-555,663,2320.0
450000.0,3,2.5,3800,13071,2.0,3,1,2730,1070.0,1994,2980,11110,10293 days 16:47:18.686819,077,1.2,2.5514018691588785,820,1961,1660.0
300000.0,3,2.0,720,7598,1.0,5,6,720,0.0,1947,1080,7209,27460 days 16:47:18.686819,209,1.5,0.0,-360,389,720.0
1120000.0,5,2.75,4400,18500,1.0,5,9,2250,2150.0,1963,3290,19257,21616 days 16:47:18.686819,157,1.8181818181818181,1.0465116279069768,1110,-757,100.0
418200.0,3,2.5,2260,74297,2.0,3,9,2260,0.0,1992,3110,98000,11024 days 16:47:18.686819,055,1.2,0.0,-850,-23703,2260.0
619000.0,3,2.5,2560,43608,2.0,3,9,2560,0.0,2002,3000,54088,7371 days 16:47:18.686819,237,1.2,0.0,-440,-10480,2560.0
500000.0,4,3.0,3720,15048,3.0,3,7,3720,0.0,1979,2020,15180,15772 days 16:47:18.686819,181,1.3333333333333333,0.0,1700,-132,3720.0
465000.0,4,2.5,2590,16437,2.0,3,8,2590,0.0,1986,2320,15625,13215 days 16:47:18.686819,311,1.6,0.0,270,812,2590.0
322000.0,4,1.0,1750,68841,1.0,3,7,1750,0.0,1942,1550,32799,29286 days 16:47:18.686819,346,4.0,0.0,200,36042,1750.0
276900.0,3,2.5,1620,7320,2.0,3,7,1620,0.0,1989,1550,7686,12119 days 16:47:18.686819,028,1.2,0.0,70,-366,1620.0
660000.0,3,2.25,1700,12615,1.0,4,7,1300,400.0,1990,1950,13163,11754 days 16:47:18.686819,077,1.3333333333333333,3.25,-250,-548,900.0
480000.0,3,2.5,2450,28185,2.0,3,9,2450,0.0,1990,2440,33541,11754 days 16:47:18.686819,302,1.2,0.0,10,-5356,2450.0
925000.0,3,1.75,1610,10796,1.0,3,7,1070,540.0,1951,1940,10796,25999 days 16:47:18.686819,098,1.7142857142857142,1.9814814814814814,-330,0,530.0
825000.0,3,3.0,3730,35900,1.0,3,9,2960,770.0,1979,2280,16026,15772 days 16:47:18.686819,205,1.0,3.844155844155844,1450,19874,2190.0
326000.0,2,1.0,1210,7440,1.0,3,6,780,430.0,1940,1070,7440,30017 days 16:47:18.686819,077,2.0,1.813953488372093,140,0,350.0
205000.0,3,1.0,1300,9880,1.0,4,7,1300,0.0,1959,2140,9600,23077 days 16:47:18.686819,111,3.0,0.0,-840,280,1300.0
150000.0,2,1.0,850,54000,1.5,1,4,850,0.0,1950,1550,14440,26364 days 16:47:18.686819,205,2.0,0.0,-700,39560,850.0
593567.0,3,2.5,1770,3205,2.0,3,9,1770,0.0,2005,2120,4134,6275 days 16:47:18.686819,119,1.2,0.0,-350,-929,1770.0
751000.0,3,2.5,3090,13316,2.0,3,1,3090,0.0,1992,2980,14437,11024 days 16:47:18.686819,197,1.2,0.0,110,-1121,3090.0
295000.0,2,1.75,1050,6500,1.5,4,6,1050,0.0,1925,1320,10075,35495 days 16:47:18.686819,252,1.1428571428571428,0.0,-270,-3575,1050.0
422500.0,3,2.0,1300,2250,2.0,3,7,1300,0.0,1988,1300,4500,12485 days 16:47:18.686819,247,1.5,0.0,0,-2250,1300.0
480000.0,3,1.0,1160,8800,1.0,4,7,1160,0.0,1959,1750,8400,23077 days 16:47:18.686819,335,3.0,0.0,-590,400,1160.0
890900.0,4,2.5,3420,6233,2.0,3,9,3420,0.0,2006,3350,5000,5910 days 16:47:18.686819,206,1.6,0.0,70,1233,3420.0
672500.0,4,2.75,2620,6707,2.0,3,9,2620,0.0,2000,2590,6530,8102 days 16:47:18.686819,149,1.4545454545454546,0.0,30,177,2620.0
605000.0,4,1.5,1880,3500,1.0,4,7,1080,800.0,1926,1690,3500,35130 days 16:47:18.686819,283,2.6666666666666665,1.35,190,0,280.0
1680000.0,5,3.25,4560,19080,1.0,5,9,2490,2070.0,1963,3390,20140,21616 days 16:47:18.686819,076,1.5384615384615385,1.2028985507246377,1170,-1060,420.0
565000.0,4,2.5,2330,7936,2.0,3,9,2330,0.0,1987,2460,8137,12850 days 16:47:18.686819,269,1.6,0.0,-130,-201,2330.0
725000.0,4,1.75,2350,7574,1.0,3,8,1720,630.0,1979,2220,8496,15772 days 16:47:18.686819,126,2.2857142857142856,2.7301587301587302,130,-922,1090.0
640000.0,3,3.0,1560,1466,3.0,3,8,1560,0.0,2006,1530,2975,5910 days 16:47:18.686819,212,1.0,0.0,30,-1509,1560.0
253750.0,4,1.0,1380,7110,1.5,3,6,1380,0.0,1939,1430,7110,30382 days 16:47:18.686819,057,4.0,0.0,-50,0,1380.0
799950.0,6,2.75,3040,36721,1.0,4,9,1760,1280.0,1958,2420,21075,23442 days 16:47:18.686819,195,2.1818181818181817,1.375,620,15646,480.0
595000.0,4,1.5,1350,8113,1.0,4,7,1350,0.0,1959,1930,8113,23077 days 16:47:18.686819,197,2.6666666666666665,0.0,-580,0,1350.0
850000.0,4,2.5,3180,11652,2.0,3,9,3180,0.0,1977,3110,15183,16502 days 16:47:18.686819,272,1.6,0.0,70,-3531,3180.0
366000.0,3,2.5,1790,4065,2.0,3,8,1790,0.0,2009,2480,4252,4814 days 16:47:18.686819,275,1.2,0.0,-690,-187,1790.0
715000.0,4,3.0,1986,6000,2.0,4,8,1746,240.0,1922,1930,6200,36591 days 16:47:18.686819,265,1.3333333333333333,7.275,56,-200,1506.0
300000.0,4,2.5,2400,7215,2.0,3,8,2400,0.0,1992,2220,7760,11024 days 16:47:18.686819,345,1.6,0.0,180,-545,2400.0
960000.0,4,3.0,4590,9150,2.0,3,1,3490,1100.0,1981,2910,12348,15041 days 16:47:18.686819,154,1.3333333333333333,3.172727272727273,1680,-3198,2390.0
812000.0,3,2.0,1970,3420,2.0,5,8,1970,0.0,1913,1770,3420,39878 days 16:47:18.686819,091,1.5,0.0,200,0,1970.0
234950.0,3,1.0,1360,9948,1.0,3,6,1360,0.0,1977,1670,8475,16502 days 16:47:18.686819,129,3.0,0.0,-310,1473,1360.0
656500.0,4,2.0,2710,4750,1.0,4,7,1460,1250.0,1919,1700,3800,37687 days 16:47:18.686819,163,2.0,1.168,1010,950,210.0
255000.0,2,1.5,920,1598,2.0,3,7,920,0.0,1995,1110,1598,9928 days 16:47:18.686819,184,1.3333333333333333,0.0,-190,0,920.0
538000.0,3,2.75,2000,7204,1.0,5,7,1250,750.0,1960,2480,17633,22712 days 16:47:18.686819,338,1.0909090909090908,1.6666666666666667,-480,-10429,500.0
260000.0,3,2.25,1920,9680,1.0,4,7,1300,620.0,1961,1500,9516,22346 days 16:47:18.686819,182,1.3333333333333333,2.096774193548387,420,164,680.0
546200.0,3,2.5,2678,6607,2.0,3,9,2678,0.0,1998,2780,6607,8832 days 16:47:18.686819,300,1.2,0.0,-102,0,2678.0
280500.0,3,1.0,1220,4541,1.0,3,7,890,330.0,1952,1670,3429,25634 days 16:47:18.686819,109,3.0,2.696969696969697,-450,1112,560.0
295000.0,3,1.75,1440,4000,1.0,4,7,1050,390.0,1979,1560,4000,15772 days 16:47:18.686819,223,1.7142857142857142,2.6923076923076925,-120,0,660.0
700000.0,4,1.75,2420,520,1.5,3,7,2420,0.0,1900,1200,1170,44626 days 16:47:18.686819,295,2.2857142857142856,0.0,1220,-650,2420.0
560000.0,3,2.0,2090,15790,1.0,3,9,2090,0.0,1992,1820,8770,11024 days 16:47:18.686819,324,1.5,0.0,270,7020,2090.0
912000.0,4,2.75,4030,10888,2.0,3,1,4030,0.0,1997,3720,10756,9197 days 16:47:18.686819,091,1.4545454545454546,0.0,310,132,4030.0
437000.0,3,1.75,1310,9282,1.0,4,7,1310,0.0,1976,1310,8748,16868 days 16:47:18.686819,128,1.7142857142857142,0.0,0,534,1310.0
447000.0,3,2.5,1800,3074,2.0,3,7,1800,0.0,2003,1610,2929,7006 days 16:47:18.686819,075,1.2,0.0,190,145,1800.0
500000.0,4,1.0,1160,20100,1.0,4,6,820,340.0,1913,1670,10200,39878 days 16:47:18.686819,293,4.0,2.411764705882353,-510,9900,480.0
508300.0,3,1.0,1160,5969,1.0,3,7,880,280.0,1930,1550,5120,33669 days 16:47:18.686819,078,3.0,3.142857142857143,-390,849,600.0
485000.0,3,1.5,1870,7853,1.0,3,7,1300,570.0,1962,1870,8300,21981 days 16:47:18.686819,212,2.0,2.280701754385965,0,-447,730.0
540000.0,7,5.75,3700,7647,2.0,3,8,3700,0.0,1948,2510,7479,27095 days 16:47:18.686819,127,1.2173913043478262,0.0,1190,168,3700.0
356000.0,3,2.25,2280,8765,2.0,3,8,2280,0.0,1977,1920,8265,16502 days 16:47:18.686819,259,1.3333333333333333,0.0,360,500,2280.0
525000.0,4,2.0,1720,6099,1.0,4,7,860,860.0,1949,1100,5671,26729 days 16:47:18.686819,237,2.0,1.0,620,428,0.0
962800.0,4,2.75,3630,11775,2.0,3,1,3630,0.0,1999,3800,12451,8467 days 16:47:18.686819,083,1.4545454545454546,0.0,-170,-676,3630.0
315000.0,4,2.5,2040,6300,2.0,3,8,2040,0.0,2003,2260,5877,7006 days 16:47:18.686819,274,1.6,0.0,-220,423,2040.0
525000.0,3,2.25,1750,1879,3.0,3,8,1750,0.0,2001,1750,3155,7736 days 16:47:18.686819,171,1.3333333333333333,0.0,0,-1276,1750.0
325000.0,2,2.25,1550,2285,2.0,3,8,1550,0.0,2007,1550,2135,5545 days 16:47:18.686819,120,0.8888888888888888,0.0,0,150,1550.0
965800.0,4,1.75,2500,8725,1.0,4,8,1500,1000.0,1966,1900,8998,20520 days 16:47:18.686819,113,2.2857142857142856,1.5,600,-273,500.0
182200.0,4,1.0,1130,13927,1.5,3,6,1130,0.0,1929,1800,8274,34034 days 16:47:18.686819,294,4.0,0.0,-670,5653,1130.0
315000.0,3,1.0,1210,8505,1.5,3,7,1210,0.0,1958,1430,8505,23442 days 16:47:18.686819,254,3.0,0.0,-220,0,1210.0
500000.0,2,1.0,960,5000,1.0,4,7,960,0.0,1900,1330,5000,44626 days 16:47:18.686819,237,2.0,0.0,-370,0,960.0
480000.0,5,2.5,2160,7737,2.0,3,7,2160,0.0,1998,2460,7737,8832 days 16:47:18.686819,183,2.0,0.0,-300,0,2160.0
1690000.0,3,1.75,3400,8965,1.0,5,9,1820,1580.0,1957,3200,8500,23807 days 16:47:18.686819,140,1.7142857142857142,1.1518987341772151,200,465,240.0
525000.0,5,3.25,3960,321908,2.0,4,9,2690,1270.0,1989,2360,96703,12119 days 16:47:18.686819,322,1.5384615384615385,2.1181102362204722,1600,225205,1420.0
407500.0,4,2.5,1900,9075,2.0,3,7,1900,0.0,1988,1800,8460,12485 days 16:47:18.686819,102,1.6,0.0,100,615,1900.0
443000.0,4,3.0,2620,35124,2.0,3,9,2620,0.0,1987,2920,35807,12850 days 16:47:18.686819,068,1.3333333333333333,0.0,-300,-683,2620.0
1260000.0,4,2.5,3150,13700,2.0,4,9,3150,0.0,1966,3200,11900,20520 days 16:47:18.686819,150,1.6,0.0,-50,1800,3150.0
642000.0,3,1.0,1040,4480,1.0,3,7,870,170.0,1924,1730,4200,35861 days 16:47:18.686819,242,3.0,5.117647058823529,-690,280,700.0
520000.0,3,1.75,1540,7558,1.0,3,8,1540,0.0,1964,1540,7863,21251 days 16:47:18.686819,009,1.7142857142857142,0.0,0,-305,1540.0
750000.0,3,2.0,1820,5000,1.5,4,8,1720,100.0,1941,2220,7200,29651 days 16:47:18.686819,174,1.5,17.2,-400,-2200,1620.0
855000.0,5,1.5,1930,4500,1.5,3,8,1930,0.0,1929,2083,4500,34034 days 16:47:18.686819,097,3.3333333333333335,0.0,-153,0,1930.0
275000.0,4,1.0,1430,27153,1.5,4,5,1430,0.0,1934,1880,27153,32208 days 16:47:18.686819,275,4.0,0.0,-450,0,1430.0
265000.0,5,2.75,2920,5250,1.5,5,7,1800,1120.0,1911,1220,5250,40609 days 16:47:18.686819,253,1.8181818181818181,1.6071428571428572,1700,0,680.0
894400.0,3,2.5,3100,45738,2.0,3,1,3100,0.0,1991,3340,45738,11389 days 16:47:18.686819,100,1.2,0.0,-240,0,3100.0
699950.0,2,2.5,2390,7489,1.0,3,8,2390,0.0,2007,2170,7489,5545 days 16:47:18.686819,330,0.8,0.0,220,0,2390.0
435000.0,3,2.0,1270,10713,1.0,4,7,1270,0.0,1969,1620,8250,19424 days 16:47:18.686819,104,1.5,0.0,-350,2463,1270.0
259500.0,4,1.5,1300,7200,1.0,4,7,1300,0.0,1970,1420,7200,19059 days 16:47:18.686819,126,2.6666666666666665,0.0,-120,0,1300.0
359950.0,4,3.25,2290,4785,2.0,3,9,2290,0.0,2007,2290,4785,5545 days 16:47:18.686819,302,1.2307692307692308,0.0,0,0,2290.0
517000.0,3,1.75,1740,10000,1.0,3,7,1740,0.0,1976,1350,7500,16868 days 16:47:18.686819,349,1.7142857142857142,0.0,390,2500,1740.0
579000.0,3,1.0,1590,5400,1.0,3,8,1280,310.0,1948,2140,7161,27095 days 16:47:18.686819,216,3.0,4.129032258064516,-550,-1761,970.0
525000.0,4,2.0,2420,10735,1.5,3,7,2420,0.0,1967,1570,9540,20155 days 16:47:18.686819,248,2.0,0.0,850,1195,2420.0
320000.0,4,2.5,2130,9653,1.0,3,7,1500,630.0,1978,2000,7988,16137 days 16:47:18.686819,104,1.6,2.380952380952381,130,1665,870.0
635000.0,4,1.75,1950,13320,1.0,4,8,1370,580.0,1969,2120,12051,19424 days 16:47:18.686819,133,2.2857142857142856,2.3620689655172415,-170,1269,790.0
400000.0,4,2.5,2150,5397,2.0,3,8,2150,0.0,1998,2260,5080,8832 days 16:47:18.686819,259,1.6,0.0,-110,317,2150.0
455000.0,3,1.75,1270,7700,1.0,4,7,1270,0.0,1968,1510,7700,19790 days 16:47:18.686819,283,1.7142857142857142,0.0,-240,0,1270.0
572000.0,3,1.75,1850,22767,1.5,5,6,1850,0.0,1908,2700,17906,41705 days 16:47:18.686819,056,1.7142857142857142,0.0,-850,4861,1850.0
650000.0,2,1.5,1440,136778,1.0,4,8,1140,300.0,1956,1740,21600,24173 days 16:47:18.686819,103,1.3333333333333333,3.8,-300,115178,840.0
162500.0,3,1.5,1390,7417,1.0,3,7,1390,0.0,1967,1390,7665,20155 days 16:47:18.686819,023,2.0,0.0,0,-248,1390.0
400000.0,2,2.5,1340,1240,2.0,3,8,1150,190.0,2008,1280,1312,5180 days 16:47:18.686819,317,0.8,6.052631578947368,60,-72,960.0
268300.0,3,1.0,1190,9000,1.0,3,7,1190,0.0,1968,1960,7200,19790 days 16:47:18.686819,077,3.0,0.0,-770,1800,1190.0
989000.0,6,4.5,3830,4800,3.0,3,9,3050,780.0,1919,1990,4800,37687 days 16:47:18.686819,183,1.3333333333333333,3.91025641025641,1840,0,2270.0
342000.0,3,1.75,1780,10409,1.0,3,7,1280,500.0,1981,1780,7415,15041 days 16:47:18.686819,178,1.7142857142857142,2.56,0,2994,780.0
315000.0,4,2.5,3130,5999,2.0,3,7,3130,0.0,2006,3020,5997,5910 days 16:47:18.686819,084,1.6,0.0,110,2,3130.0
485000.0,4,2.75,1830,8384,1.0,3,7,1320,510.0,1979,2190,7695,15772 days 16:47:18.686819,118,1.4545454545454546,2.588235294117647,-360,689,810.0
277500.0,4,2.5,2550,7500,1.0,3,8,1750,800.0,1976,2260,8800,16868 days 16:47:18.686819,338,1.6,2.1875,290,-1300,950.0
1300000.0,4,3.5,3790,90169,2.0,3,1,3790,0.0,1998,3410,46951,8832 days 16:47:18.686819,071,1.1428571428571428,0.0,380,43218,3790.0
385000.0,4,1.75,1800,10890,1.5,4,6,1800,0.0,1912,1530,9818,40244 days 16:47:18.686819,218,2.2857142857142856,0.0,270,1072,1800.0
426000.0,2,1.0,1630,7680,1.0,3,7,830,800.0,1947,1250,7740,27460 days 16:47:18.686819,321,2.0,1.0375,380,-60,30.0
310000.0,4,2.0,1870,6000,1.5,3,7,1870,0.0,1956,1520,7169,24173 days 16:47:18.686819,168,2.0,0.0,350,-1169,1870.0
449000.0,4,2.0,1870,6000,1.5,3,7,1870,0.0,1956,1520,7169,24173 days 16:47:18.686819,026,2.0,0.0,350,-1169,1870.0
375000.0,2,1.0,980,3915,1.0,4,7,980,0.0,1919,1425,1576,37687 days 16:47:18.686819,353,2.0,0.0,-445,2339,980.0
1190000.0,3,2.25,2860,10625,1.0,3,1,1920,940.0,1976,2860,8075,16868 days 16:47:18.686819,089,1.3333333333333333,2.0425531914893615,0,2550,980.0
468000.0,3,2.25,1470,5597,2.0,3,7,1470,0.0,1985,1610,5217,13580 days 16:47:18.686819,104,1.3333333333333333,0.0,-140,380,1470.0
392000.0,4,2.75,1940,6555,2.0,3,8,1940,0.0,1990,1840,6912,11754 days 16:47:18.686819,161,1.4545454545454546,0.0,100,-357,1940.0
412500.0,4,2.25,1630,7969,1.0,3,7,1100,530.0,1977,1580,7440,16502 days 16:47:18.686819,219,1.7777777777777777,2.0754716981132075,50,529,570.0
545000.0,4,2.5,2755,11612,2.0,3,8,2755,0.0,2001,2820,12831,7736 days 16:47:18.686819,084,1.6,0.0,-65,-1219,2755.0
133000.0,5,2.0,1430,5600,1.5,3,6,1430,0.0,1947,1860,5980,27460 days 16:47:18.686819,354,2.5,0.0,-430,-380,1430.0
440000.0,5,2.0,1430,5600,1.5,3,6,1430,0.0,1947,1860,5980,27460 days 16:47:18.686819,134,2.5,0.0,-430,-380,1430.0
294450.0,4,2.25,1400,7341,1.0,3,7,1300,100.0,1961,2090,7410,22346 days 16:47:18.686819,339,1.7777777777777777,13.0,-690,-69,1200.0
335000.0,4,2.5,2520,7205,2.0,3,8,2520,0.0,1987,2350,7632,12850 days 16:47:18.686819,238,1.6,0.0,170,-427,2520.0
362000.0,3,1.0,1290,10125,1.0,4,7,1290,0.0,1956,1760,14460,24173 days 16:47:18.686819,251,3.0,0.0,-470,-4335,1290.0
322000.0,3,1.75,1400,18002,1.0,3,6,1400,0.0,1977,2240,14068,16502 days 16:47:18.686819,301,1.7142857142857142,0.0,-840,3934,1400.0
230500.0,2,1.0,740,8853,1.0,3,6,740,0.0,1943,850,8775,28921 days 16:47:18.686819,076,2.0,0.0,-110,78,740.0
380000.0,4,2.0,1710,9996,1.0,3,7,1710,0.0,1950,1550,6768,26364 days 16:47:18.686819,064,2.0,0.0,160,3228,1710.0
292000.0,4,2.75,2414,7693,2.0,3,8,2414,0.0,2006,1500,7177,5910 days 16:47:18.686819,162,1.4545454545454546,0.0,914,516,2414.0
172500.0,3,1.0,1040,7500,1.0,4,6,1040,0.0,1954,1270,8000,24903 days 16:47:18.686819,224,3.0,0.0,-230,-500,1040.0
784000.0,4,2.75,3540,7091,1.5,4,8,1970,1570.0,1947,2200,6000,27460 days 16:47:18.686819,205,1.4545454545454546,1.2547770700636942,1340,1091,400.0
525000.0,4,2.75,2530,11549,1.0,3,7,1700,830.0,1942,2530,10000,29286 days 16:47:18.686819,275,1.4545454545454546,2.0481927710843375,0,1549,870.0
600000.0,3,2.5,2320,7609,2.0,3,8,2320,0.0,2003,2590,4000,7006 days 16:47:18.686819,185,1.2,0.0,-270,3609,2320.0
435000.0,3,2.5,2530,16102,2.0,3,9,2530,0.0,1989,2370,14957,12119 days 16:47:18.686819,300,1.2,0.0,160,1145,2530.0
359900.0,5,2.75,2790,7600,1.5,4,7,2790,0.0,1965,1480,7600,20885 days 16:47:18.686819,036,1.8181818181818181,0.0,1310,0,2790.0
700000.0,4,1.75,1950,7139,1.0,3,7,1150,800.0,1957,1600,13122,23807 days 16:47:18.686819,345,2.2857142857142856,1.4375,350,-5983,350.0
280000.0,3,2.0,1020,889,2.0,3,7,720,300.0,2009,1130,972,4814 days 16:47:18.686819,071,1.5,2.4,-110,-83,420.0
655000.0,4,2.5,3110,24466,2.0,3,9,3110,0.0,1997,3080,22185,9197 days 16:47:18.686819,275,1.6,0.0,30,2281,3110.0
2480000.0,4,5.0,5310,16909,1.0,3,1,3090,2220.0,1992,5220,15701,11024 days 16:47:18.686819,132,0.8,1.3918918918918919,90,1208,870.0
499950.0,3,2.5,2580,23925,2.0,3,9,2580,0.0,2001,1660,8460,7736 days 16:47:18.686819,055,1.2,0.0,920,15465,2580.0
540000.0,3,2.5,1380,1021,2.0,3,8,1160,220.0,2008,1440,1021,5180 days 16:47:18.686819,217,1.2,5.2727272727272725,-60,0,940.0
970000.0,4,2.75,3980,9209,2.0,3,1,3980,0.0,2002,3800,9333,7371 days 16:47:18.686819,065,1.4545454545454546,0.0,180,-124,3980.0
330000.0,4,2.5,2080,7000,1.0,4,8,1400,680.0,1989,2090,7082,12119 days 16:47:18.686819,225,1.6,2.0588235294117645,-10,-82,720.0
474000.0,3,1.75,1530,8000,2.0,3,7,1530,0.0,1978,1530,7500,16137 days 16:47:18.686819,184,1.7142857142857142,0.0,0,500,1530.0
670000.0,4,1.75,1930,9310,1.0,4,9,1930,0.0,1968,2110,10290,19790 days 16:47:18.686819,076,2.2857142857142856,0.0,-180,-980,1930.0
1300000.0,4,3.25,2330,9687,2.0,3,9,2330,0.0,1918,3880,9017,38052 days 16:47:18.686819,132,1.2307692307692308,0.0,-1550,670,2330.0
1160000.0,4,2.5,3860,10361,2.0,4,1,2940,920.0,1985,3720,13155,13580 days 16:47:18.686819,211,1.6,3.1956521739130435,140,-2794,2020.0
440000.0,4,2.5,2880,8061,2.0,3,9,2880,0.0,1988,2650,7660,12485 days 16:47:18.686819,012,1.6,0.0,230,401,2880.0
411000.0,2,2.5,1590,2088,2.0,3,9,1590,0.0,1997,2320,3174,9197 days 16:47:18.686819,209,0.8,0.0,-730,-1086,1590.0
500000.0,3,1.5,2150,4000,1.5,3,7,1470,680.0,1928,1750,4000,34400 days 16:47:18.686819,206,2.0,2.161764705882353,400,0,790.0
1340000.0,4,1.75,2300,13342,1.5,3,7,2300,0.0,1934,2500,13342,32208 days 16:47:18.686819,352,2.2857142857142856,0.0,-200,0,2300.0
696000.0,6,3.25,2900,6400,2.0,4,8,2300,600.0,1977,2480,6400,16502 days 16:47:18.686819,349,1.8461538461538463,3.8333333333333335,420,0,1700.0
465000.0,3,2.25,1970,11088,1.0,4,8,1180,790.0,1967,1970,10470,20155 days 16:47:18.686819,126,1.3333333333333333,1.4936708860759493,0,618,390.0
518000.0,4,2.5,1740,7500,1.0,4,7,1220,520.0,1976,1790,7350,16868 days 16:47:18.686819,167,1.6,2.3461538461538463,-50,150,700.0
251000.0,3,1.75,1220,7250,1.0,3,7,1220,0.0,1962,1700,15251,21981 days 16:47:18.686819,129,1.7142857142857142,0.0,-480,-8001,1220.0
255000.0,3,2.0,1290,13282,1.0,3,7,1290,0.0,1978,1290,12357,16137 days 16:47:18.686819,120,1.5,0.0,0,925,1290.0
319000.0,2,1.0,780,8271,1.0,4,6,780,0.0,1924,2220,8271,35861 days 16:47:18.686819,232,2.0,0.0,-1440,0,780.0
1520000.0,5,3.5,5930,13288,2.0,3,1,3920,2010.0,1996,3860,12062,9563 days 16:47:18.686819,195,1.4285714285714286,1.9502487562189055,2070,1226,1910.0
322000.0,4,2.5,1950,4553,2.0,3,7,1950,0.0,2000,1780,4598,8102 days 16:47:18.686819,009,1.6,0.0,170,-45,1950.0
205000.0,4,1.0,1340,7920,1.0,4,7,1340,0.0,1970,1090,9600,19059 days 16:47:18.686819,064,4.0,0.0,250,-1680,1340.0
229000.0,3,1.0,1590,6240,1.0,3,7,1060,530.0,1956,1410,6240,24173 days 16:47:18.686819,013,3.0,2.0,180,0,530.0
395000.0,3,2.25,1780,9672,1.0,3,8,1350,430.0,1960,1860,10080,22712 days 16:47:18.686819,303,1.3333333333333333,3.13953488372093,-80,-408,920.0
183000.0,2,1.0,760,7272,1.0,4,7,760,0.0,1980,1370,7866,15407 days 16:47:18.686819,085,2.0,0.0,-610,-594,760.0
583500.0,3,1.75,1720,7800,1.0,4,7,1170,550.0,1978,1760,7276,16137 days 16:47:18.686819,248,1.7142857142857142,2.1272727272727274,-40,524,620.0
312000.0,3,2.5,2070,25710,1.0,5,6,2070,0.0,1917,1350,17998,38417 days 16:47:18.686819,044,1.2,0.0,720,7712,2070.0
539000.0,3,1.75,1790,9860,1.0,4,7,1410,380.0,1978,1820,9555,16137 days 16:47:18.686819,252,1.7142857142857142,3.710526315789474,-30,305,1030.0
409000.0,4,2.75,3230,12651,2.0,4,8,3230,0.0,2002,2550,12081,7371 days 16:47:18.686819,079,1.4545454545454546,0.0,680,570,3230.0
510250.0,3,1.75,1400,4000,1.0,3,7,870,530.0,1951,1400,4000,25999 days 16:47:18.686819,148,1.7142857142857142,1.6415094339622642,0,0,340.0
535000.0,2,2.0,1370,3827,1.0,3,7,1020,350.0,1952,1550,5102,25634 days 16:47:18.686819,336,1.0,2.914285714285714,-180,-1275,670.0
280000.0,3,2.5,1600,7936,2.0,3,7,1600,0.0,1996,1830,7936,9563 days 16:47:18.686819,267,1.2,0.0,-230,0,1600.0
286000.0,3,1.0,950,8400,1.0,3,7,950,0.0,1958,1250,8400,23442 days 16:47:18.686819,099,3.0,0.0,-300,0,950.0
710000.0,3,2.75,2210,7660,1.0,4,7,1460,750.0,1968,2110,8750,19790 days 16:47:18.686819,084,1.0909090909090908,1.9466666666666668,100,-1090,710.0
395000.0,2,1.0,930,6380,1.0,4,7,930,0.0,1940,1180,6380,30017 days 16:47:18.686819,190,2.0,0.0,-250,0,930.0
237500.0,2,1.0,810,8494,1.0,3,6,810,0.0,1949,1050,7975,26729 days 16:47:18.686819,251,2.0,0.0,-240,519,810.0
464000.0,3,2.0,1630,6550,1.0,5,7,850,780.0,1912,1440,6550,40244 days 16:47:18.686819,021,1.5,1.0897435897435896,190,0,70.0
495000.0,3,1.75,1770,10080,1.0,3,8,1770,0.0,1968,1860,10456,19790 days 16:47:18.686819,294,1.7142857142857142,0.0,-90,-376,1770.0
257500.0,1,1.0,710,6060,1.0,4,6,710,0.0,1916,1440,4545,38783 days 16:47:18.686819,048,1.0,0.0,-730,1515,710.0
570000.0,4,3.5,3990,23544,1.0,3,1,2300,1690.0,1999,3410,15932,8467 days 16:47:18.686819,016,1.1428571428571428,1.3609467455621302,580,7612,610.0
362000.0,3,2.5,2310,7485,2.0,3,8,2310,0.0,1986,2310,8142,13215 days 16:47:18.686819,315,1.2,0.0,0,-657,2310.0
640000.0,33,1.75,1620,6000,1.0,5,7,1040,580.0,1947,1330,4700,27460 days 16:47:18.686819,176,18.857142857142858,1.793103448275862,290,1300,460.0
172500.0,3,1.0,1140,8800,1.0,3,7,1140,0.0,1972,1270,13560,18329 days 16:47:18.686819,146,3.0,0.0,-130,-4760,1140.0
596000.0,2,1.0,1040,4880,1.0,3,7,1040,0.0,1910,1500,4590,40974 days 16:47:18.686819,020,2.0,0.0,-460,290,1040.0
840000.0,4,2.5,2170,9796,1.0,4,8,1650,520.0,1980,2350,9796,15407 days 16:47:18.686819,120,1.6,3.173076923076923,-180,0,1130.0
1600000.0,3,2.25,3370,23065,1.0,3,1,1920,1450.0,1980,3410,19688,15407 days 16:47:18.686819,317,1.3333333333333333,1.3241379310344827,-40,3377,470.0
435000.0,2,1.5,901,1245,3.0,3,7,901,0.0,2001,1138,1137,7736 days 16:47:18.686819,255,1.3333333333333333,0.0,-237,108,901.0
251000.0,2,1.0,840,7870,1.0,3,6,840,0.0,1949,1442,8131,26729 days 16:47:18.686819,253,2.0,0.0,-602,-261,840.0
282500.0,4,1.0,1650,9750,1.0,4,7,1650,0.0,1964,1650,10112,21251 days 16:47:18.686819,310,4.0,0.0,0,-362,1650.0
265000.0,3,2.25,1380,7226,1.0,4,7,1140,240.0,1987,1640,7823,12850 days 16:47:18.686819,290,1.3333333333333333,4.75,-260,-597,900.0
330000.0,3,1.0,910,10240,1.0,4,6,910,0.0,1969,1140,10720,19424 days 16:47:18.686819,351,3.0,0.0,-230,-480,910.0
435000.0,2,1.0,1230,3800,1.0,3,7,1230,0.0,1928,1610,3800,34400 days 16:47:18.686819,168,2.0,0.0,-380,0,1230.0
827235.0,3,1.75,1740,8560,1.0,3,8,1500,240.0,1948,2240,5800,27095 days 16:47:18.686819,335,1.7142857142857142,6.25,-500,2760,1260.0
249950.0,4,1.0,1290,5000,1.5,3,7,1290,0.0,1957,1440,2500,23807 days 16:47:18.686819,150,4.0,0.0,-150,2500,1290.0
400000.0,3,2.5,1950,18533,2.0,3,8,1950,0.0,1988,1810,18401,12485 days 16:47:18.686819,083,1.2,0.0,140,132,1950.0
300499.0,4,2.5,2150,7944,2.0,3,8,2150,0.0,1990,2170,8319,11754 days 16:47:18.686819,294,1.6,0.0,-20,-375,2150.0
449000.0,4,2.0,1560,5220,1.0,3,7,1560,0.0,1959,1300,5220,23077 days 16:47:18.686819,107,2.0,0.0,260,0,1560.0
500000.0,2,1.0,1120,3220,1.0,4,7,1120,0.0,1923,1440,3220,36226 days 16:47:18.686819,290,2.0,0.0,-320,0,1120.0
865000.0,3,1.5,1790,7526,1.0,3,7,1790,0.0,1953,2080,10943,25268 days 16:47:18.686819,273,2.0,0.0,-290,-3417,1790.0
899950.0,4,3.5,3290,5414,2.0,3,9,2360,930.0,2006,1820,9609,5910 days 16:47:18.686819,167,1.1428571428571428,2.5376344086021505,1470,-4195,1430.0
370000.0,4,1.0,1540,9541,1.5,4,7,1540,0.0,1961,1290,9541,22346 days 16:47:18.686819,240,4.0,0.0,250,0,1540.0
442500.0,5,3.25,4240,226097,2.0,3,8,3410,830.0,1980,2980,217800,15407 days 16:47:18.686819,124,1.5384615384615385,4.108433734939759,1260,8297,2580.0
310000.0,3,1.0,1010,9945,1.0,4,6,1010,0.0,1973,1390,12710,17963 days 16:47:18.686819,123,3.0,0.0,-380,-2765,1010.0
1570000.0,4,2.75,2970,12750,1.5,4,7,2130,840.0,1918,1980,15300,38052 days 16:47:18.686819,182,1.4545454545454546,2.5357142857142856,990,-2550,1290.0
245000.0,4,2.25,2190,9113,2.0,3,7,2190,0.0,1986,1570,8306,13215 days 16:47:18.686819,248,1.7777777777777777,0.0,620,807,2190.0
254950.0,2,1.0,700,8100,1.0,3,6,700,0.0,1949,1230,8100,26729 days 16:47:18.686819,321,2.0,0.0,-530,0,700.0
510000.0,6,4.5,3300,7480,2.0,3,8,3300,0.0,1980,2470,7561,15407 days 16:47:18.686819,203,1.3333333333333333,0.0,830,-81,3300.0
299950.0,3,2.25,1370,5000,2.0,3,7,1370,0.0,1990,1600,7724,11754 days 16:47:18.686819,117,1.3333333333333333,0.0,-230,-2724,1370.0
379950.0,4,2.5,2680,4500,2.0,3,8,2680,0.0,2011,2010,4500,4084 days 16:47:18.686819,233,1.6,0.0,670,0,2680.0
350000.0,3,1.0,1390,4820,1.0,4,7,910,480.0,1926,1320,4820,35130 days 16:47:18.686819,219,3.0,1.8958333333333333,70,0,430.0
300000.0,3,2.5,1700,3575,2.0,3,7,1700,0.0,2000,1590,3380,8102 days 16:47:18.686819,169,1.2,0.0,110,195,1700.0
994000.0,3,2.25,2510,6339,1.5,5,8,1810,700.0,1932,1820,5741,32939 days 16:47:18.686819,147,1.3333333333333333,2.585714285714286,690,598,1110.0
315000.0,3,1.5,1700,8067,1.0,3,7,1250,450.0,1956,1340,7869,24173 days 16:47:18.686819,323,2.0,2.7777777777777777,360,198,800.0
480500.0,4,2.5,2180,11200,1.0,4,8,2180,0.0,1968,1790,11200,19790 days 16:47:18.686819,127,1.6,0.0,390,0,2180.0
373000.0,3,1.0,1770,5720,1.5,4,7,1140,630.0,1926,1500,4406,35130 days 16:47:18.686819,167,3.0,1.8095238095238095,270,1314,510.0
728000.0,4,2.5,3290,5951,2.0,3,9,3290,0.0,2003,3240,6159,7006 days 16:47:18.686819,245,1.6,0.0,50,-208,3290.0
415000.0,4,3.5,3040,7125,2.0,3,8,2240,800.0,2002,2220,7800,7371 days 16:47:18.686819,268,1.1428571428571428,2.8,820,-675,1440.0
427500.0,4,2.5,2460,5091,2.0,3,9,2460,0.0,2003,2490,4750,7006 days 16:47:18.686819,155,1.6,0.0,-30,341,2460.0
339300.0,3,2.0,970,10000,1.0,5,7,970,0.0,1972,1230,7500,18329 days 16:47:18.686819,314,1.5,0.0,-260,2500,970.0
313000.0,3,1.75,1320,6205,1.0,5,7,1320,0.0,1948,1210,6205,27095 days 16:47:18.686819,147,1.7142857142857142,0.0,110,0,1320.0
431500.0,3,3.5,1900,1612,2.0,3,8,1430,470.0,2008,1780,1525,5180 days 16:47:18.686819,142,0.8571428571428571,3.0425531914893615,120,87,960.0
415000.0,3,1.5,1220,835,1.5,4,6,1220,0.0,1950,1360,1251,26364 days 16:47:18.686819,068,2.0,0.0,-140,-416,1220.0
490000.0,3,1.75,1470,9750,1.0,4,7,1470,0.0,1978,1800,9600,16137 days 16:47:18.686819,075,1.7142857142857142,0.0,-330,150,1470.0
1430000.0,4,5.0,4630,24054,2.0,3,1,4630,0.0,2005,4630,17584,6275 days 16:47:18.686819,083,0.8,0.0,0,6470,4630.0
275000.0,3,1.5,1400,9750,1.0,4,6,1400,0.0,1964,1160,9750,21251 days 16:47:18.686819,089,2.0,0.0,240,0,1400.0
325000.0,2,1.0,1070,5080,1.0,5,6,1070,0.0,1942,900,5080,29286 days 16:47:18.686819,048,2.0,0.0,170,0,1070.0
1180000.0,5,3.75,3630,6000,1.5,3,9,2470,1160.0,2004,2560,7560,6641 days 16:47:18.686819,161,1.3333333333333333,2.1293103448275863,1070,-1560,1310.0
690000.0,4,1.5,1970,4590,2.5,3,7,1970,0.0,1909,1900,4590,41339 days 16:47:18.686819,274,2.6666666666666665,0.0,70,0,1970.0
410000.0,4,2.0,2010,9474,2.0,3,7,2010,0.0,1953,2140,10164,25268 days 16:47:18.686819,089,2.0,0.0,-130,-690,2010.0
960000.0,4,2.5,2820,5934,1.0,5,9,1770,1050.0,1952,2230,6000,25634 days 16:47:18.686819,213,1.6,1.6857142857142857,590,-66,720.0
299250.0,3,2.5,2530,8669,2.0,3,9,2530,0.0,1990,2530,9469,11754 days 16:47:18.686819,303,1.2,0.0,0,-800,2530.0
239000.0,2,1.0,710,14000,1.0,4,6,710,0.0,1953,1500,10540,25268 days 16:47:18.686819,195,2.0,0.0,-790,3460,710.0
235000.0,2,1.0,1210,9400,1.0,2,6,1210,0.0,1949,1580,6026,26729 days 16:47:18.686819,122,2.0,0.0,-370,3374,1210.0
587000.0,3,2.25,2370,217800,2.0,3,7,2370,0.0,1979,3100,86248,15772 days 16:47:18.686819,147,1.3333333333333333,0.0,-730,131552,2370.0
431000.0,4,2.5,2300,6087,2.0,3,7,2300,0.0,2001,1770,5907,7736 days 16:47:18.686819,182,1.6,0.0,530,180,2300.0
1640000.0,3,2.5,3110,6765,2.0,4,9,2550,560.0,1946,2630,7626,27825 days 16:47:18.686819,188,1.2,4.553571428571429,480,-861,1990.0
285000.0,3,1.75,1990,6500,1.0,3,7,1090,900.0,1961,2150,6500,22346 days 16:47:18.686819,337,1.7142857142857142,1.211111111111111,-160,0,190.0
778000.0,3,3.0,2630,10156,1.0,4,9,2630,0.0,1987,2660,10455,12850 days 16:47:18.686819,310,1.0,0.0,-30,-299,2630.0
415000.0,3,1.0,1300,7975,1.0,4,7,1300,0.0,1958,1570,9075,23442 days 16:47:18.686819,212,3.0,0.0,-270,-1100,1300.0
860000.0,3,2.5,2770,9136,2.0,3,1,2770,0.0,1991,2890,8442,11389 days 16:47:18.686819,149,1.2,0.0,-120,694,2770.0
765000.0,3,1.75,2120,5000,2.0,3,7,1980,140.0,1920,2020,5000,37322 days 16:47:18.686819,276,1.7142857142857142,14.142857142857142,100,0,1840.0
782000.0,4,2.5,2830,20345,2.0,3,1,1980,850.0,1979,2830,13732,15772 days 16:47:18.686819,129,1.6,2.3294117647058825,0,6613,1130.0
525000.0,3,3.5,1370,1764,2.0,3,8,1180,190.0,2000,1400,1398,8102 days 16:47:18.686819,069,0.8571428571428571,6.2105263157894735,-30,366,990.0
745000.0,3,2.5,2810,435600,2.0,3,9,2810,0.0,1995,2380,92007,9928 days 16:47:18.686819,356,1.2,0.0,430,343593,2810.0
470000.0,3,3.5,3520,35512,2.0,3,8,2760,760.0,2005,2860,39614,6275 days 16:47:18.686819,206,0.8571428571428571,3.6315789473684212,660,-4102,2000.0
345000.0,3,1.75,1990,5650,1.0,3,7,1320,670.0,1963,2130,5650,21616 days 16:47:18.686819,153,1.7142857142857142,1.9701492537313432,-140,0,650.0
279000.0,3,2.25,2070,7800,1.0,3,7,1170,900.0,1964,1570,8400,21251 days 16:47:18.686819,063,1.3333333333333333,1.3,500,-600,270.0
500000.0,3,1.5,1320,8100,1.0,4,7,1320,0.0,1951,1480,8100,25999 days 16:47:18.686819,192,2.0,0.0,-160,0,1320.0
237000.0,3,1.0,1300,8160,1.0,4,7,1300,0.0,1960,1290,8970,22712 days 16:47:18.686819,171,3.0,0.0,10,-810,1300.0
200500.0,3,1.75,1260,9346,1.0,4,7,1260,0.0,1963,1800,9705,21616 days 16:47:18.686819,177,1.7142857142857142,0.0,-540,-359,1260.0
387500.0,4,1.75,2400,9900,1.0,3,7,1250,1150.0,1957,1960,9900,23807 days 16:47:18.686819,083,2.2857142857142856,1.0869565217391304,440,0,100.0
392500.0,4,2.0,1950,8040,1.0,3,7,1950,0.0,1961,1950,8092,22346 days 16:47:18.686819,198,2.0,0.0,0,-52,1950.0
305000.0,3,2.0,1430,12430,1.0,4,7,1430,0.0,1957,1200,8250,23807 days 16:47:18.686819,044,1.5,0.0,230,4180,1430.0
981000.0,4,2.5,2110,10100,1.0,3,8,2110,0.0,1968,2230,10100,19790 days 16:47:18.686819,267,1.6,0.0,-120,0,2110.0
680000.0,4,2.5,2980,8770,2.0,3,1,2980,0.0,1990,2940,9238,11754 days 16:47:18.686819,343,1.6,0.0,40,-468,2980.0
276000.0,4,2.5,2068,7242,2.0,4,7,2068,0.0,1976,1560,7524,16868 days 16:47:18.686819,156,1.6,0.0,508,-282,2068.0
655500.0,4,3.5,3380,8330,2.0,3,8,3380,0.0,2000,2220,8330,8102 days 16:47:18.686819,126,1.1428571428571428,0.0,1160,0,3380.0
555000.0,5,2.75,2810,13144,1.0,3,8,1440,1370.0,1964,2480,13144,21251 days 16:47:18.686819,363,1.8181818181818181,1.051094890510949,330,0,70.0
325000.0,3,1.0,1300,8879,1.0,3,7,920,380.0,1950,1530,6960,26364 days 16:47:18.686819,050,3.0,2.4210526315789473,-230,1919,540.0
268950.0,3,1.0,1320,8100,1.0,3,6,880,440.0,1943,1000,8100,28921 days 16:47:18.686819,303,3.0,2.0,320,0,440.0
264500.0,3,1.5,1580,14040,1.0,3,7,1050,530.0,1980,2240,12000,15407 days 16:47:18.686819,314,2.0,1.9811320754716981,-660,2040,520.0
240000.0,3,2.5,1620,5250,2.0,3,8,1620,0.0,1987,1650,5250,12850 days 16:47:18.686819,314,1.2,0.0,-30,0,1620.0
819000.0,3,2.5,2750,226512,2.0,3,9,2750,0.0,2000,1250,211266,8102 days 16:47:18.686819,051,1.2,0.0,1500,15246,2750.0
850000.0,2,1.5,2210,5000,1.0,3,8,1530,680.0,1951,2700,5000,25999 days 16:47:18.686819,090,1.3333333333333333,2.25,-490,0,850.0
294950.0,4,2.25,1740,9600,1.0,3,7,1160,580.0,1957,1630,9600,23807 days 16:47:18.686819,295,1.7777777777777777,2.0,110,0,580.0
693000.0,3,2.25,2120,13644,2.0,4,9,1420,700.0,1973,2950,17060,17963 days 16:47:18.686819,349,1.3333333333333333,2.0285714285714285,-830,-3416,720.0
478000.0,4,2.5,2780,7290,2.0,3,8,2780,0.0,1989,2450,7738,12119 days 16:47:18.686819,288,1.6,0.0,330,-448,2780.0
222000.0,2,1.0,830,6893,1.0,3,7,830,0.0,1950,1470,7200,26364 days 16:47:18.686819,036,2.0,0.0,-640,-307,830.0
635000.0,4,2.5,2070,11286,2.0,3,8,2070,0.0,1996,2440,10826,9563 days 16:47:18.686819,098,1.6,0.0,-370,460,2070.0
469000.0,3,3.25,1390,1278,2.0,3,8,1140,250.0,2005,1390,1256,6275 days 16:47:18.686819,273,0.9230769230769231,4.56,0,22,890.0
350000.0,4,2.5,2610,5866,2.0,3,8,2610,0.0,2005,2480,5188,6275 days 16:47:18.686819,206,1.6,0.0,130,678,2610.0
180000.0,5,1.0,1460,11726,1.5,3,6,1290,170.0,1936,1460,10450,31478 days 16:47:18.686819,337,5.0,7.588235294117647,0,1276,1120.0
490000.0,4,2.25,3390,39356,1.0,4,8,1640,1750.0,1964,2160,38061,21251 days 16:47:18.686819,098,1.7777777777777777,0.9371428571428572,1230,1295,-110.0
360000.0,3,1.5,1360,6000,1.0,3,6,860,500.0,1911,1560,3000,40609 days 16:47:18.686819,265,2.0,1.72,-200,3000,360.0
630000.0,4,2.5,2807,9430,2.0,3,8,2807,0.0,1996,2028,11056,9563 days 16:47:18.686819,169,1.6,0.0,779,-1626,2807.0
615000.0,4,1.0,1340,2006,1.5,3,7,1340,0.0,1931,2040,3625,33304 days 16:47:18.686819,104,4.0,0.0,-700,-1619,1340.0
279950.0,3,2.25,1340,7202,2.0,4,7,1340,0.0,1989,1470,7395,12119 days 16:47:18.686819,300,1.3333333333333333,0.0,-130,-193,1340.0
317000.0,3,1.0,1160,8813,1.0,3,7,1160,0.0,1952,1200,7615,25634 days 16:47:18.686819,162,3.0,0.0,-40,1198,1160.0
618000.0,4,2.25,2470,7350,1.0,3,7,1600,870.0,1978,1970,7700,16137 days 16:47:18.686819,289,1.7777777777777777,1.839080459770115,500,-350,730.0
620000.0,5,1.75,2000,8713,1.0,3,7,1000,1000.0,1962,2040,8449,21981 days 16:47:18.686819,070,2.857142857142857,1.0,-40,264,0.0
345000.0,3,1.0,1110,6250,1.0,3,7,1110,0.0,1956,2010,6944,24173 days 16:47:18.686819,126,3.0,0.0,-900,-694,1110.0
608000.0,3,1.5,2240,3750,1.0,3,7,1220,1020.0,1952,1570,3400,25634 days 16:47:18.686819,283,2.0,1.196078431372549,670,350,200.0
325000.0,4,2.25,1920,11603,2.0,4,7,1920,0.0,1967,1840,7350,20155 days 16:47:18.686819,357,1.7777777777777777,0.0,80,4253,1920.0
475000.0,3,1.75,2270,13000,1.0,5,8,2270,0.0,1968,2440,10000,19790 days 16:47:18.686819,316,1.7142857142857142,0.0,-170,3000,2270.0
154000.0,3,3.0,1530,9997,1.0,3,6,1020,510.0,1992,1410,9997,11024 days 16:47:18.686819,289,1.0,2.0,120,0,510.0
1190000.0,5,3.0,3330,19126,2.0,4,1,2610,720.0,1977,3330,16893,16502 days 16:47:18.686819,170,1.6666666666666667,3.625,0,2233,1890.0
376950.0,4,2.5,2643,5750,2.0,3,8,2643,0.0,2012,2406,5772,3719 days 16:47:18.686819,296,1.6,0.0,237,-22,2643.0
500000.0,2,2.0,1250,3360,1.0,3,7,1250,0.0,1957,1250,3360,23807 days 16:47:18.686819,210,1.0,0.0,0,0,1250.0
499950.0,3,2.5,3230,129578,1.0,4,8,2100,1130.0,1964,2760,62059,21251 days 16:47:18.686819,113,1.2,1.8584070796460177,470,67519,970.0
230000.0,3,1.0,880,9035,1.0,4,6,880,0.0,1967,1440,10350,20155 days 16:47:18.686819,027,3.0,0.0,-560,-1315,880.0
652600.0,4,2.5,2220,5900,2.0,3,8,2220,0.0,2014,1620,5900,2988 days 16:47:18.686819,006,1.6,0.0,600,0,2220.0
185000.0,3,1.75,1130,7000,1.0,3,7,1130,0.0,1978,1830,8880,16137 days 16:47:18.686819,363,1.7142857142857142,0.0,-700,-1880,1130.0
274950.0,3,1.0,1450,8820,1.0,3,6,1050,400.0,1958,1510,8820,23442 days 16:47:18.686819,153,3.0,2.625,-60,0,650.0
447000.0,2,1.0,760,6035,1.0,3,6,760,0.0,1920,2110,6046,37322 days 16:47:18.686819,041,2.0,0.0,-1350,-11,760.0
129000.0,2,1.0,1150,30184,1.0,3,6,1150,0.0,1950,1670,19684,26364 days 16:47:18.686819,164,2.0,0.0,-520,10500,1150.0
436000.0,5,3.0,2720,9856,2.0,4,8,2720,0.0,1969,1420,9685,19424 days 16:47:18.686819,084,1.6666666666666667,0.0,1300,171,2720.0
825000.0,3,1.75,2080,5000,2.0,5,8,2080,0.0,1906,1820,5000,42435 days 16:47:18.686819,279,1.7142857142857142,0.0,260,0,2080.0
225000.0,3,1.0,1080,16000,1.0,3,6,1080,0.0,1952,1610,10007,25634 days 16:47:18.686819,283,3.0,0.0,-530,5993,1080.0
265000.0,3,2.5,1890,6088,2.0,3,7,1890,0.0,1996,1700,6600,9563 days 16:47:18.686819,068,1.2,0.0,190,-512,1890.0
765000.0,3,1.5,1500,5111,2.0,5,8,1500,0.0,1984,2380,4519,13946 days 16:47:18.686819,068,2.0,0.0,-880,592,1500.0
509000.0,4,2.0,1960,2166,1.5,4,7,1260,700.0,1926,1670,4000,35130 days 16:47:18.686819,308,2.0,1.8,290,-1834,560.0
762450.0,4,1.75,2570,8640,1.0,4,8,2570,0.0,1958,2520,8800,23442 days 16:47:18.686819,069,2.2857142857142856,0.0,50,-160,2570.0
465000.0,5,1.5,1830,9000,1.0,3,7,1030,800.0,1955,2610,11175,24538 days 16:47:18.686819,344,3.3333333333333335,1.2875,-780,-2175,230.0
564000.0,3,1.75,1980,6250,1.0,5,7,1090,890.0,1910,1980,6250,40974 days 16:47:18.686819,156,1.7142857142857142,1.2247191011235956,0,0,200.0
384500.0,2,1.0,1130,5236,1.0,4,6,1130,0.0,1942,1010,5320,29286 days 16:47:18.686819,111,2.0,0.0,120,-84,1130.0
415000.0,3,2.0,2010,33090,1.5,5,8,2010,0.0,1986,1840,22620,13215 days 16:47:18.686819,300,1.5,0.0,170,10470,2010.0
345000.0,2,1.75,1820,8409,1.0,4,6,910,910.0,1948,1300,8409,27095 days 16:47:18.686819,335,1.1428571428571428,1.0,520,0,0.0
465950.0,4,2.5,2340,6896,2.0,3,7,2340,0.0,2001,2950,6775,7736 days 16:47:18.686819,168,1.6,0.0,-610,121,2340.0
325000.0,3,1.75,1780,11096,1.0,3,7,1210,570.0,1979,1780,10640,15772 days 16:47:18.686819,216,1.7142857142857142,2.1228070175438596,0,456,640.0
500000.0,3,1.75,1780,11096,1.0,3,7,1210,570.0,1979,1780,10640,15772 days 16:47:18.686819,048,1.7142857142857142,2.1228070175438596,0,456,640.0
450000.0,4,2.5,2450,20348,1.0,3,8,1410,1040.0,1978,2450,50094,16137 days 16:47:18.686819,297,1.6,1.3557692307692308,0,-29746,370.0
475000.0,4,3.0,2410,8284,1.0,5,7,1210,1200.0,1969,2050,7940,19424 days 16:47:18.686819,283,1.3333333333333333,1.0083333333333333,360,344,10.0
1350000.0,5,1.75,3380,20021,1.0,4,8,1690,1690.0,1963,3260,19809,21616 days 16:47:18.686819,132,2.857142857142857,1.0,120,212,0.0
747000.0,3,1.5,1710,5120,2.0,4,7,1710,0.0,1920,1530,5170,37322 days 16:47:18.686819,075,2.0,0.0,180,-50,1710.0
395000.0,3,1.75,1740,6220,1.0,4,6,1740,0.0,1954,1630,8418,24903 days 16:47:18.686819,234,1.7142857142857142,0.0,110,-2198,1740.0
505000.0,3,2.5,1995,1483,3.0,3,8,1760,235.0,2005,1520,1173,6275 days 16:47:18.686819,279,1.2,7.48936170212766,475,310,1525.0
215000.0,3,2.0,1760,9282,1.0,5,7,1100,660.0,1947,1730,7500,27460 days 16:47:18.686819,290,1.5,1.6666666666666667,30,1782,440.0
775000.0,4,3.5,3970,210830,2.0,3,9,3970,0.0,2000,1680,42665,8102 days 16:47:18.686819,016,1.1428571428571428,0.0,2290,168165,3970.0
540000.0,4,2.5,3000,5471,2.0,3,8,3000,0.0,2013,2730,5471,3353 days 16:47:18.686819,300,1.6,0.0,270,0,3000.0
392500.0,3,1.75,1540,8925,1.0,4,7,1540,0.0,1957,1620,10397,23807 days 16:47:18.686819,323,1.7142857142857142,0.0,-80,-1472,1540.0
987000.0,3,2.0,2160,15788,1.0,3,8,2160,0.0,1951,2260,9787,25999 days 16:47:18.686819,349,1.5,0.0,-100,6001,2160.0
1190000.0,3,2.0,2160,15788,1.0,3,8,2160,0.0,1951,2260,9787,25999 days 16:47:18.686819,132,1.5,0.0,-100,6001,2160.0
252500.0,3,2.0,1810,10684,2.0,3,8,1810,0.0,1987,2140,9657,12850 days 16:47:18.687817,317,1.5,0.0,-330,1027,1810.0
730000.0,3,3.5,2440,3502,2.0,3,7,1970,470.0,2000,2440,3417,8102 days 16:47:18.687817,113,0.8571428571428571,4.191489361702128,0,85,1500.0
497300.0,6,2.75,3200,9200,1.0,4,8,1600,1600.0,1953,2220,9500,25268 days 16:47:18.687817,125,2.1818181818181817,1.0,980,-300,0.0
640000.0,4,2.5,2970,34981,2.0,3,9,2970,0.0,1998,3170,30277,8832 days 16:47:18.687817,267,1.6,0.0,-200,4704,2970.0
580000.0,5,2.0,2290,7125,1.0,3,7,1190,1100.0,1964,1460,7920,21251 days 16:47:18.687817,133,2.5,1.0818181818181818,830,-795,90.0
377000.0,3,1.75,1820,34800,1.0,4,6,1820,0.0,1967,2570,52707,20155 days 16:47:18.687817,230,1.7142857142857142,0.0,-750,-17907,1820.0
1280000.0,4,3.5,3010,3600,2.0,3,9,2370,640.0,1999,2650,4200,8467 days 16:47:18.687817,157,1.1428571428571428,3.703125,360,-600,1730.0
396500.0,3,1.5,1360,1488,2.0,3,7,1120,240.0,2003,1360,1573,7006 days 16:47:18.687817,224,2.0,4.666666666666667,0,-85,880.0
300000.0,4,2.5,2080,2999,2.0,3,8,2080,0.0,1998,1630,3148,8832 days 16:47:18.687817,212,1.6,0.0,450,-149,2080.0
532000.0,3,1.0,1110,4800,1.5,3,7,1110,0.0,1946,1510,4320,27825 days 16:47:18.687817,071,3.0,0.0,-400,480,1110.0
1400000.0,4,2.5,3520,7815,2.0,3,1,3140,380.0,1929,2790,6644,34034 days 16:47:18.687817,084,1.6,8.263157894736842,730,1171,2760.0
571000.0,5,1.75,2280,43560,1.0,4,8,1380,900.0,1949,1940,17664,26729 days 16:47:18.687817,295,2.857142857142857,1.5333333333333334,340,25896,480.0
301950.0,3,1.75,1370,9288,1.0,4,7,1370,0.0,1988,1500,9864,12485 days 16:47:18.687817,199,1.7142857142857142,0.0,-130,-576,1370.0
660000.0,3,3.0,2340,2970,2.0,5,8,2160,180.0,1925,1370,4000,35495 days 16:47:18.687817,163,1.0,12.0,970,-1030,1980.0
455000.0,4,2.5,3170,10688,2.0,3,9,3170,0.0,2001,3100,12610,7736 days 16:47:18.687817,162,1.6,0.0,70,-1922,3170.0
375000.0,3,1.75,1380,5060,1.0,3,7,1380,0.0,1986,1030,5060,13215 days 16:47:18.687817,350,1.7142857142857142,0.0,350,0,1380.0
470000.0,4,2.5,2700,6769,2.0,3,9,2700,0.0,1999,2880,7968,8467 days 16:47:18.687817,015,1.6,0.0,-180,-1199,2700.0
374990.0,3,2.5,1300,10484,2.0,3,8,1300,0.0,1983,1380,7868,14311 days 16:47:18.687817,090,1.2,0.0,-80,2616,1300.0
541500.0,2,2.5,1900,3690,2.0,3,8,1900,0.0,2006,1900,5153,5910 days 16:47:18.687817,107,0.8,0.0,0,-1463,1900.0
782500.0,3,2.5,3750,7821,2.0,3,9,3750,0.0,2001,3210,8405,7736 days 16:47:18.687817,114,1.2,0.0,540,-584,3750.0
640000.0,4,2.5,2500,7417,2.0,3,9,2500,0.0,1991,2770,8188,11389 days 16:47:18.687817,196,1.6,0.0,-270,-771,2500.0
660000.0,3,2.0,1770,8141,1.0,5,8,1770,0.0,1952,1770,8100,25634 days 16:47:18.687817,044,1.5,0.0,0,41,1770.0
1370000.0,5,3.5,4210,17258,2.0,3,1,4210,0.0,1995,4630,17909,9928 days 16:47:18.687817,162,1.4285714285714286,0.0,-420,-651,4210.0
389950.0,3,2.5,2170,8140,2.0,3,9,2170,0.0,1994,2390,8100,10293 days 16:47:18.687817,076,1.2,0.0,-220,40,2170.0
226000.0,2,1.0,1510,19874,1.0,3,7,1510,0.0,1951,1540,10000,25999 days 16:47:18.687817,063,2.0,0.0,-30,9874,1510.0
390000.0,3,1.75,1870,40250,1.0,5,7,1870,0.0,1959,1870,40250,23077 days 16:47:18.687817,220,1.7142857142857142,0.0,0,0,1870.0
485000.0,3,2.25,1570,8111,2.0,3,8,1570,0.0,1984,1990,7875,13946 days 16:47:18.687817,054,1.3333333333333333,0.0,-420,236,1570.0
840000.0,4,2.5,2480,4602,2.0,3,9,2480,0.0,2000,3480,5739,8102 days 16:47:18.687817,103,1.6,0.0,-1000,-1137,2480.0
600000.0,5,3.5,3580,21343,1.5,4,8,2140,1440.0,1937,2430,21343,31112 days 16:47:18.687817,269,1.4285714285714286,1.4861111111111112,1150,0,700.0
331000.0,2,1.0,1480,6210,1.0,3,7,1080,400.0,1950,1290,7509,26364 days 16:47:18.687817,231,2.0,2.7,190,-1299,680.0
780000.0,3,2.0,2610,6000,1.0,5,7,1310,1300.0,1941,2330,4800,29651 days 16:47:18.687817,289,1.5,1.0076923076923077,280,1200,10.0
300000.0,3,1.75,1700,8481,2.0,3,7,1700,0.0,1993,1830,6600,10658 days 16:47:18.687817,288,1.7142857142857142,0.0,-130,1881,1700.0
361810.0,3,1.75,1240,7620,1.0,3,7,1240,0.0,1968,1150,7620,19790 days 16:47:18.687817,260,1.7142857142857142,0.0,90,0,1240.0
467000.0,3,1.0,1660,6582,1.0,5,7,1000,660.0,1946,1110,6584,27825 days 16:47:18.687817,135,3.0,1.5151515151515151,550,-2,340.0
399000.0,3,1.75,1620,10000,1.5,5,6,1620,0.0,1918,1880,10000,38052 days 16:47:18.687817,360,1.7142857142857142,0.0,-260,0,1620.0
315450.0,3,1.75,1130,7500,1.5,4,7,1130,0.0,1908,1240,6000,41705 days 16:47:18.687817,288,1.7142857142857142,0.0,-110,1500,1130.0
600000.0,3,1.0,1310,5000,1.5,3,7,1310,0.0,1906,1530,4800,42435 days 16:47:18.687817,121,3.0,0.0,-220,200,1310.0
247500.0,4,2.0,1710,5200,1.0,4,7,910,800.0,1977,1560,5200,16502 days 16:47:18.687817,084,2.0,1.1375,150,0,110.0
330000.0,3,1.0,2140,5037,1.0,3,7,2140,0.0,1957,1630,6054,23807 days 16:47:18.687817,030,3.0,0.0,510,-1017,2140.0
500000.0,4,2.25,2350,7210,1.5,4,7,2350,0.0,1972,1930,7519,18329 days 16:47:18.687817,238,1.7777777777777777,0.0,420,-309,2350.0
367500.0,3,1.0,1570,10050,1.0,3,7,1570,0.0,1963,2540,9940,21616 days 16:47:18.687817,232,3.0,0.0,-970,110,1570.0
560000.0,3,2.5,2780,32880,1.0,3,9,2780,0.0,1993,2780,40091,10658 days 16:47:18.687817,255,1.2,0.0,0,-7211,2780.0
655000.0,4,1.75,2540,7620,1.0,3,8,1320,1220.0,1948,2540,8613,27095 days 16:47:18.687817,218,2.2857142857142856,1.0819672131147542,0,-993,100.0
530000.0,5,2.75,2500,7140,1.0,4,7,1250,1250.0,1968,2230,8400,19790 days 16:47:18.687817,291,1.8181818181818181,1.0,270,-1260,0.0
270000.0,3,2.25,2080,26574,1.0,3,7,1380,700.0,1993,1770,8140,10658 days 16:47:18.687817,132,1.3333333333333333,1.9714285714285715,310,18434,680.0
437500.0,3,2.0,1760,2875,2.0,3,7,1290,470.0,1988,1760,4830,12485 days 16:47:18.687817,329,1.5,2.74468085106383,0,-1955,820.0
575000.0,3,1.75,1760,10349,1.0,3,8,1760,0.0,1957,1970,10933,23807 days 16:47:18.687817,034,1.7142857142857142,0.0,-210,-584,1760.0
278000.0,4,2.5,1940,6887,2.0,3,7,1940,0.0,1990,1870,6144,11754 days 16:47:18.687817,311,1.6,0.0,70,743,1940.0
568500.0,4,2.5,3010,6181,2.0,3,9,3010,0.0,2000,2960,6515,8102 days 16:47:18.687817,247,1.6,0.0,50,-334,3010.0
280000.0,4,3.0,2460,9606,1.0,3,8,2460,0.0,2012,1730,7500,3719 days 16:47:18.687817,085,1.3333333333333333,0.0,730,2106,2460.0
250000.0,2,1.0,750,6350,1.0,3,5,750,0.0,1920,920,6350,37322 days 16:47:18.687817,231,2.0,0.0,-170,0,750.0
247500.0,3,0.75,1300,72309,1.0,3,6,680,620.0,1950,3080,8395,26364 days 16:47:18.687817,077,4.0,1.096774193548387,-1780,63914,60.0
1250000.0,5,2.75,3710,13874,1.5,4,9,2340,1370.0,1977,3370,13874,16502 days 16:47:18.687817,338,1.8181818181818181,1.7080291970802919,340,0,970.0
535000.0,4,2.5,2360,15008,1.0,3,9,1920,440.0,1986,2680,15344,13215 days 16:47:18.687817,288,1.6,4.363636363636363,-320,-336,1480.0
814842.0,3,2.5,3190,6899,2.0,3,9,3190,0.0,2014,3190,6899,2988 days 16:47:18.687817,192,1.2,0.0,0,0,3190.0
340000.0,4,2.5,2181,5521,2.0,3,8,2181,0.0,2006,2333,5143,5910 days 16:47:18.687817,044,1.6,0.0,-152,378,2181.0
359950.0,3,1.75,1890,9100,2.0,4,7,1890,0.0,1952,1640,9100,25634 days 16:47:18.687817,161,1.7142857142857142,0.0,250,0,1890.0
750000.0,3,1.75,2610,5544,1.5,3,8,1680,930.0,1934,1330,5074,32208 days 16:47:18.687817,172,1.7142857142857142,1.8064516129032258,1280,470,750.0
1220000.0,4,2.0,3090,8125,2.5,5,8,3090,0.0,1918,1560,6250,38052 days 16:47:18.687817,269,2.0,0.0,1530,1875,3090.0
329950.0,3,1.0,1000,9170,1.0,3,7,1000,0.0,1980,1610,9170,15407 days 16:47:18.687817,105,3.0,0.0,-610,0,1000.0
500000.0,3,2.5,2760,35171,2.0,3,9,2760,0.0,1990,2720,35171,11754 days 16:47:18.687817,002,1.2,0.0,40,0,2760.0
734000.0,4,2.5,3490,18521,2.0,4,9,3490,0.0,1990,2850,18521,11754 days 16:47:18.687817,261,1.6,0.0,640,0,3490.0
385000.0,4,2.5,2960,5054,2.0,3,9,2960,0.0,2006,2960,5000,5910 days 16:47:18.687817,167,1.6,0.0,0,54,2960.0
230000.0,2,1.0,1280,4635,1.0,3,6,840,440.0,1917,1660,6180,38417 days 16:47:18.687817,110,2.0,1.9090909090909092,-380,-1545,400.0
1390000.0,4,3.5,3230,7200,1.0,3,1,1640,1590.0,2000,2660,7200,8102 days 16:47:18.687817,211,1.1428571428571428,1.0314465408805031,570,0,50.0
210000.0,3,2.0,1830,4992,1.0,3,7,1230,600.0,1953,2050,7740,25268 days 16:47:18.687817,352,1.5,2.05,-220,-2748,630.0
293000.0,3,1.75,1420,13187,1.0,4,7,1420,0.0,1974,1620,13824,17598 days 16:47:18.687817,212,1.7142857142857142,0.0,-200,-637,1420.0
465000.0,3,1.0,1580,3774,1.5,3,6,1580,0.0,1900,1580,3860,44626 days 16:47:18.687817,303,3.0,0.0,0,-86,1580.0
449000.0,3,2.25,1960,44634,1.0,3,7,1130,830.0,1984,1970,44634,13946 days 16:47:18.687817,012,1.3333333333333333,1.3614457831325302,-10,0,300.0
325000.0,2,1.75,1670,10725,1.0,3,7,1670,0.0,1965,1600,10725,20885 days 16:47:18.687817,104,1.1428571428571428,0.0,70,0,1670.0
180000.0,3,2.0,1670,7056,1.0,4,7,1670,0.0,1958,1330,8415,23442 days 16:47:18.687817,231,1.5,0.0,340,-1359,1670.0
650000.0,6,3.0,2960,5000,1.0,3,8,1790,1170.0,1968,1280,1251,19790 days 16:47:18.687817,103,2.0,1.5299145299145298,1680,3749,620.0
665000.0,4,2.75,2420,7102,1.0,5,7,1670,750.0,1946,1620,7102,27825 days 16:47:18.687817,267,1.4545454545454546,2.2266666666666666,800,0,920.0
324450.0,3,2.0,1420,16000,1.0,3,7,1420,0.0,1966,1900,12630,20520 days 16:47:18.687817,290,1.5,0.0,-480,3370,1420.0
588000.0,4,1.75,2170,5750,1.0,3,7,1370,800.0,1975,1450,5750,17233 days 16:47:18.687817,065,2.2857142857142856,1.7125,720,0,570.0
200000.0,4,1.0,1310,5200,1.5,3,6,1160,150.0,1945,1090,5180,28190 days 16:47:18.687817,141,4.0,7.733333333333333,220,20,1010.0
383000.0,4,1.75,1830,11090,1.0,3,7,1060,770.0,1962,1990,10917,21981 days 16:47:18.687817,248,2.2857142857142856,1.3766233766233766,-160,173,290.0
499950.0,3,2.0,1360,2500,1.0,3,7,730,630.0,1986,1630,5000,13215 days 16:47:18.687817,349,1.5,1.1587301587301588,-270,-2500,100.0
549000.0,5,2.5,3440,12350,1.0,4,9,1760,1680.0,1976,3440,12763,16868 days 16:47:18.687817,111,2.0,1.0476190476190477,0,-413,80.0
465000.0,5,3.0,2010,7264,1.0,3,7,1290,720.0,1990,1510,7326,11754 days 16:47:18.687817,022,1.6666666666666667,1.7916666666666667,500,-62,570.0
450000.0,3,2.5,2450,19744,2.0,3,1,2450,0.0,1990,2650,19597,11754 days 16:47:18.687817,226,1.2,0.0,-200,147,2450.0
799900.0,4,2.5,3030,7800,2.0,3,9,1580,1450.0,1991,2840,7435,11389 days 16:47:18.687817,113,1.6,1.089655172413793,190,365,130.0
495000.0,4,2.5,2480,91911,1.0,4,7,1470,1010.0,1973,2540,91911,17963 days 16:47:18.687817,096,1.6,1.4554455445544554,-60,0,460.0
1200000.0,3,3.5,4310,10842,2.0,3,1,3140,1170.0,1988,2280,11106,12485 days 16:47:18.687817,234,0.8571428571428571,2.6837606837606836,2030,-264,1970.0
637000.0,4,2.5,2120,15000,2.0,4,8,2120,0.0,1983,2170,15000,14311 days 16:47:18.687817,054,1.6,0.0,-50,0,2120.0
589000.0,4,1.0,2210,4366,2.0,3,8,2210,0.0,1901,1740,1745,44261 days 16:47:18.687817,350,4.0,0.0,470,2621,2210.0
305000.0,3,1.75,1400,10350,1.0,4,7,1400,0.0,1976,1780,10457,16868 days 16:47:18.687817,205,1.7142857142857142,0.0,-380,-107,1400.0
600000.0,4,2.25,2760,5200,2.0,3,7,1790,970.0,1910,1310,2059,40974 days 16:47:18.687817,090,1.7777777777777777,1.8453608247422681,1450,3141,820.0
587000.0,4,2.5,2550,6256,2.0,3,9,2550,0.0,1992,2460,8256,11024 days 16:47:18.687817,151,1.6,0.0,90,-2000,2550.0
1430000.0,2,2.5,2220,4000,2.0,3,9,2220,0.0,2000,1870,4000,8102 days 16:47:18.687817,125,0.8,0.0,350,0,2220.0
250000.0,4,1.0,1320,11212,1.0,5,6,1320,0.0,1914,1060,6766,39513 days 16:47:18.687817,071,4.0,0.0,260,4446,1320.0
515000.0,3,3.0,2440,3202,2.0,4,8,1640,800.0,1982,2440,3200,14676 days 16:47:18.687817,114,1.0,2.05,0,2,840.0
833000.0,4,2.75,3780,10308,2.0,3,1,3780,0.0,1999,3500,10740,8467 days 16:47:18.687817,129,1.4545454545454546,0.0,280,-432,3780.0
860000.0,3,3.25,4720,32467,2.0,3,1,3190,1530.0,1998,3260,26386,8832 days 16:47:18.687817,155,0.9230769230769231,2.084967320261438,1460,6081,1660.0
550000.0,4,3.0,2360,6678,1.0,3,8,1760,600.0,1949,1640,6380,26729 days 16:47:18.687817,251,1.3333333333333333,2.933333333333333,720,298,1160.0
180000.0,2,1.0,890,6000,1.0,2,6,890,0.0,1919,1100,6000,37687 days 16:47:18.687817,078,2.0,0.0,-210,0,890.0
507000.0,4,1.75,1770,9375,1.0,4,7,1170,600.0,1968,1540,9375,19790 days 16:47:18.687817,169,2.2857142857142856,1.95,230,0,570.0
427000.0,3,2.0,1720,128066,1.0,3,7,1720,0.0,1994,2360,111078,10293 days 16:47:18.687817,239,1.5,0.0,-640,16988,1720.0
616950.0,3,3.5,2490,2722,2.0,3,8,2020,470.0,1999,2490,2755,8467 days 16:47:18.687817,324,0.8571428571428571,4.297872340425532,0,-33,1550.0
372000.0,4,1.75,1890,10550,1.0,5,7,1010,880.0,1969,1930,7291,19424 days 16:47:18.687817,196,2.2857142857142856,1.1477272727272727,-40,3259,130.0
290000.0,2,1.0,1020,6380,1.0,3,7,1020,0.0,1930,1380,6380,33669 days 16:47:18.687817,279,2.0,0.0,-360,0,1020.0
329990.0,4,2.75,2420,8438,2.0,3,8,2420,0.0,1997,2270,8770,9197 days 16:47:18.687817,068,1.4545454545454546,0.0,150,-332,2420.0
393500.0,3,1.75,1600,8156,1.0,5,7,1600,0.0,1948,1200,8156,27095 days 16:47:18.687817,286,1.7142857142857142,0.0,400,0,1600.0
1550000.0,5,3.25,3370,17458,1.0,5,1,2000,1370.0,1982,4240,15202,14676 days 16:47:18.687817,133,1.5384615384615385,1.4598540145985401,-870,2256,630.0
240000.0,4,2.25,1720,8300,1.0,4,8,1720,0.0,1973,2010,8000,17963 days 16:47:18.687817,142,1.7777777777777777,0.0,-290,300,1720.0
285000.0,3,1.0,1090,8640,1.0,4,6,1090,0.0,1973,1260,8400,17963 days 16:47:18.687817,133,3.0,0.0,-170,240,1090.0
382500.0,3,1.5,1090,9862,1.0,3,8,1090,0.0,1987,1710,9862,12850 days 16:47:18.687817,104,2.0,0.0,-620,0,1090.0
1930000.0,4,3.75,3600,16101,1.0,3,9,3600,0.0,1951,3650,9506,25999 days 16:47:18.687817,090,1.0666666666666667,0.0,-50,6595,3600.0
800000.0,3,2.5,2760,9471,1.0,3,8,1760,1000.0,1956,3040,6765,24173 days 16:47:18.687817,241,1.2,1.76,-280,2706,760.0
550000.0,4,3.5,2770,24140,2.0,3,8,2770,0.0,1967,1720,16011,20155 days 16:47:18.687817,092,1.1428571428571428,0.0,1050,8129,2770.0
387846.0,4,1.75,2520,15205,1.0,4,7,2040,480.0,1954,1680,10000,24903 days 16:47:18.687817,349,2.2857142857142856,4.25,840,5205,1560.0
367500.0,4,2.0,1960,16015,1.0,3,7,1960,0.0,1980,1960,16015,15407 days 16:47:18.687817,233,2.0,0.0,0,0,1960.0
780500.0,5,1.0,1760,4264,2.0,3,8,1760,0.0,1902,2130,4264,43896 days 16:47:18.687817,216,5.0,0.0,-370,0,1760.0
680000.0,3,1.75,1090,6775,1.0,4,7,850,240.0,1950,1580,5760,26364 days 16:47:18.687817,125,1.7142857142857142,3.5416666666666665,-490,1015,610.0
434400.0,5,1.75,1960,7875,1.0,4,7,1960,0.0,1968,1800,7764,19790 days 16:47:18.687817,358,2.857142857142857,0.0,160,111,1960.0
370000.0,2,1.0,1220,17172,1.0,4,6,1220,0.0,1947,1510,12915,27460 days 16:47:18.687817,163,2.0,0.0,-290,4257,1220.0
465000.0,3,1.75,1730,8073,1.0,3,8,1350,380.0,1971,2500,8073,18694 days 16:47:18.687817,072,1.7142857142857142,3.5526315789473686,-770,0,970.0
323000.0,3,2.0,1830,6925,1.0,4,8,1830,0.0,1979,2010,7350,15772 days 16:47:18.687817,086,1.5,0.0,-180,-425,1830.0
270000.0,4,2.5,1600,9921,2.0,3,7,1600,0.0,2009,2140,5806,4814 days 16:47:18.687817,005,1.6,0.0,-540,4115,1600.0
1320000.0,3,1.75,2040,42693,1.0,3,1,2040,0.0,1980,2640,11957,15407 days 16:47:18.687817,353,1.7142857142857142,0.0,-600,30736,2040.0
560000.0,4,2.5,2710,6583,2.0,3,9,2710,0.0,2003,2710,6583,7006 days 16:47:18.687817,178,1.6,0.0,0,0,2710.0
450000.0,3,1.0,1140,4500,1.0,3,6,840,300.0,1907,1150,3000,42070 days 16:47:18.687817,118,3.0,2.8,-10,1500,540.0
290000.0,2,1.0,930,7740,1.0,3,6,930,0.0,1924,1250,7740,35861 days 16:47:18.687817,177,2.0,0.0,-320,0,930.0
354000.0,3,2.0,1010,21340,1.0,3,8,1010,0.0,1980,1700,13045,15407 days 16:47:18.687817,267,1.5,0.0,-690,8295,1010.0
705000.0,5,3.0,2380,5000,2.0,5,7,2380,0.0,1909,1800,4650,41339 days 16:47:18.687817,063,1.6666666666666667,0.0,580,350,2380.0
445000.0,3,2.25,1860,7200,1.0,4,7,1240,620.0,1977,1560,7630,16502 days 16:47:18.687817,220,1.3333333333333333,2.0,300,-430,620.0
229900.0,3,1.0,1440,11925,1.0,3,7,1440,0.0,1968,1440,10425,19790 days 16:47:18.687817,202,3.0,0.0,0,1500,1440.0
610000.0,4,2.5,2980,5896,2.0,3,8,2980,0.0,2001,2900,5712,7736 days 16:47:18.687817,069,1.6,0.0,80,184,2980.0
535000.0,3,3.25,2670,5108,2.0,3,9,2670,0.0,2000,2670,6500,8102 days 16:47:18.687817,344,0.9230769230769231,0.0,0,-1392,2670.0
437400.0,3,1.75,2150,8925,1.0,4,7,2150,0.0,1960,1100,7875,22712 days 16:47:18.687817,035,1.7142857142857142,0.0,1050,1050,2150.0
540000.0,5,2.75,3160,10059,2.0,3,1,1740,1420.0,1978,3120,11557,16137 days 16:47:18.687817,224,1.8181818181818181,1.2253521126760563,40,-1498,320.0
570000.0,3,2.0,1890,29185,1.0,3,7,1470,420.0,1949,2580,11600,26729 days 16:47:18.687817,181,1.5,3.5,-690,17585,1050.0
533000.0,3,2.5,2810,4607,2.0,3,8,2810,0.0,2004,2540,4871,6641 days 16:47:18.687817,282,1.2,0.0,270,-264,2810.0
555000.0,3,2.5,2690,4819,2.0,3,7,2690,0.0,2004,2360,4829,6641 days 16:47:18.687817,093,1.2,0.0,330,-10,2690.0
239950.0,3,1.75,1230,9600,1.0,4,7,1230,0.0,1984,1330,8250,13946 days 16:47:18.687817,174,1.7142857142857142,0.0,-100,1350,1230.0
350000.0,3,1.0,950,9451,1.0,4,7,950,0.0,1977,1480,8352,16502 days 16:47:18.687817,008,3.0,0.0,-530,1099,950.0
245000.0,2,1.0,1200,4880,1.0,3,6,980,220.0,1943,1040,4880,28921 days 16:47:18.687817,167,2.0,4.454545454545454,160,0,760.0
456000.0,4,1.75,1670,9886,1.0,5,7,1670,0.0,1947,2590,9997,27460 days 16:47:18.687817,156,2.2857142857142856,0.0,-920,-111,1670.0
465000.0,4,2.25,2140,7701,1.0,4,7,1470,670.0,1977,2130,8050,16502 days 16:47:18.687817,225,1.7777777777777777,2.1940298507462686,10,-349,800.0
445000.0,2,1.75,1440,4660,1.0,3,8,1440,0.0,2008,1680,4989,5180 days 16:47:18.687817,007,1.1428571428571428,0.0,-240,-329,1440.0
517850.0,5,2.75,3050,7500,1.0,4,8,1800,1250.0,1966,2060,7848,20520 days 16:47:18.687817,209,1.8181818181818181,1.44,990,-348,550.0
329000.0,5,2.75,2570,7260,2.0,3,8,2570,0.0,1996,2200,7421,9563 days 16:47:18.687817,273,1.8181818181818181,0.0,370,-161,2570.0
512500.0,3,2.5,1840,2875,2.0,4,7,1840,0.0,1997,1240,5750,9197 days 16:47:18.687817,135,1.2,0.0,600,-2875,1840.0
365000.0,2,1.0,1250,8100,1.0,4,7,1250,0.0,1947,1710,8100,27460 days 16:47:18.687817,155,2.0,0.0,-460,0,1250.0
450500.0,3,1.0,1410,9384,1.0,3,7,1410,0.0,1948,1990,9384,27095 days 16:47:18.687817,079,3.0,0.0,-580,0,1410.0
915000.0,3,1.0,1560,8232,1.0,3,7,1560,0.0,1952,1930,8286,25634 days 16:47:18.687817,289,3.0,0.0,-370,-54,1560.0
205000.0,3,1.0,960,7314,1.0,5,6,960,0.0,1960,990,7314,22712 days 16:47:18.687817,171,3.0,0.0,-30,0,960.0
314000.0,4,2.5,1870,8449,2.0,3,8,1870,0.0,1992,2160,8113,11024 days 16:47:18.687817,223,1.6,0.0,-290,336,1870.0
496000.0,2,1.0,900,9260,1.0,3,7,900,0.0,1946,1230,6913,27825 days 16:47:18.687817,183,2.0,0.0,-330,2347,900.0
329950.0,4,1.0,2050,7590,1.0,3,7,1280,770.0,1957,2050,7800,23807 days 16:47:18.687817,106,4.0,1.6623376623376624,0,-210,510.0
623000.0,3,2.5,1850,7777,2.0,5,8,1850,0.0,1989,1850,8482,12119 days 16:47:18.687817,171,1.2,0.0,0,-705,1850.0
310000.0,4,1.5,1220,9600,1.0,3,6,1220,0.0,1980,1180,9000,15407 days 16:47:18.687817,170,2.6666666666666665,0.0,40,600,1220.0
960000.0,4,2.25,2410,4560,2.0,5,9,1800,610.0,1929,2150,5100,34034 days 16:47:18.687817,148,1.7777777777777777,2.9508196721311477,260,-540,1190.0
598000.0,4,2.5,3130,40918,2.0,3,9,3130,0.0,1994,2760,35440,10293 days 16:47:18.687817,179,1.6,0.0,370,5478,3130.0
683000.0,3,2.5,2300,9218,2.0,3,9,2300,0.0,1998,2730,9930,8832 days 16:47:18.687817,226,1.2,0.0,-430,-712,2300.0
425000.0,5,2.5,2840,9425,1.0,4,7,1590,1250.0,1962,1900,11600,21981 days 16:47:18.687817,048,2.0,1.272,940,-2175,340.0
533000.0,5,2.75,1800,3780,1.5,3,7,1400,400.0,1926,1400,3780,35130 days 16:47:18.687817,126,1.8181818181818181,3.5,400,0,1000.0
375000.0,3,1.0,1190,9486,1.0,4,7,1190,0.0,1953,2100,10400,25268 days 16:47:18.687817,133,3.0,0.0,-910,-914,1190.0
250500.0,3,2.0,1710,7225,2.0,4,7,1710,0.0,1988,1710,7225,12485 days 16:47:18.687817,155,1.5,0.0,0,0,1710.0
257000.0,4,1.75,1900,22896,1.5,3,7,1360,540.0,1922,1300,8960,36591 days 16:47:18.687817,218,2.2857142857142856,2.5185185185185186,600,13936,820.0
218000.0,3,1.0,880,18205,1.0,4,6,880,0.0,1945,1110,16115,28190 days 16:47:18.687817,175,3.0,0.0,-230,2090,880.0
460000.0,3,2.0,2060,4437,1.0,3,7,1030,1030.0,1929,1750,4452,34034 days 16:47:18.687817,162,1.5,1.0,310,-15,0.0
255544.0,3,1.0,1360,6186,1.5,4,6,760,600.0,1941,1610,7453,29651 days 16:47:18.687817,104,3.0,1.2666666666666666,-250,-1267,160.0
560000.0,2,2.0,1680,4647,1.0,3,8,1680,0.0,2008,1680,4950,5180 days 16:47:18.687817,257,1.0,0.0,0,-303,1680.0
480000.0,4,2.5,2980,4074,2.0,3,8,2980,0.0,2011,2320,4255,4084 days 16:47:18.687817,042,1.6,0.0,660,-181,2980.0
1300000.0,5,1.75,2130,19180,1.0,3,8,1500,630.0,1968,3650,19180,19790 days 16:47:18.687817,283,2.857142857142857,2.380952380952381,-1520,0,870.0
580000.0,3,2.75,2650,9752,1.0,3,9,2650,0.0,1989,3030,9910,12119 days 16:47:18.687817,116,1.0909090909090908,0.0,-380,-158,2650.0
475000.0,3,2.5,1700,9100,1.0,3,8,1160,540.0,1998,1590,8374,8832 days 16:47:18.687817,179,1.2,2.1481481481481484,110,726,620.0
1310000.0,4,2.5,2680,12215,1.0,3,9,1590,1090.0,1956,2960,19964,24173 days 16:47:18.687817,181,1.6,1.4587155963302751,-280,-7749,500.0
700000.0,3,2.5,2530,623779,1.0,4,8,2530,0.0,1980,2120,100623,15407 days 16:47:18.687817,086,1.2,0.0,410,523156,2530.0
590000.0,3,2.5,2520,10223,2.0,3,1,2520,0.0,1988,2630,10091,12485 days 16:47:18.687817,260,1.2,0.0,-110,132,2520.0
264500.0,3,2.5,1630,8346,1.0,3,8,1630,0.0,1990,2110,8619,11754 days 16:47:18.687817,053,1.2,0.0,-480,-273,1630.0
465000.0,2,1.0,730,2600,1.0,4,6,730,0.0,1918,1480,3900,38052 days 16:47:18.687817,300,2.0,0.0,-750,-1300,730.0
290000.0,3,1.0,910,7620,1.0,3,7,910,0.0,1971,1660,7620,18694 days 16:47:18.687817,082,3.0,0.0,-750,0,910.0
1820000.0,4,4.5,4510,12873,2.0,3,1,4510,0.0,1998,2200,8528,8832 days 16:47:18.687817,325,0.8888888888888888,0.0,2310,4345,4510.0
416000.0,3,1.0,1110,12150,1.0,4,7,1110,0.0,1957,1490,8200,23807 days 16:47:18.687817,166,3.0,0.0,-380,3950,1110.0
360000.0,4,2.0,1450,8940,1.0,3,7,1450,0.0,1962,1310,8914,21981 days 16:47:18.687817,028,2.0,0.0,140,26,1450.0
585083.0,5,2.75,2910,36250,1.0,3,8,1590,1320.0,1977,2910,37376,16502 days 16:47:18.687817,153,1.8181818181818181,1.2045454545454546,0,-1126,270.0
840000.0,4,2.75,2600,2750,1.5,3,7,1620,980.0,1936,1960,3705,31478 days 16:47:18.687817,132,1.4545454545454546,1.653061224489796,640,-955,640.0
81000.0,2,1.0,730,9975,1.0,1,5,730,0.0,1943,860,9000,28921 days 16:47:18.687817,083,2.0,0.0,-130,975,730.0
1290000.0,3,2.25,2440,9200,1.0,4,8,2440,0.0,1950,2750,6211,26364 days 16:47:18.687817,030,1.3333333333333333,0.0,-310,2989,2440.0
326000.0,4,1.75,2290,7380,1.0,3,7,1390,900.0,1963,1170,7381,21616 days 16:47:18.687817,329,2.2857142857142856,1.5444444444444445,1120,-1,490.0
447000.0,2,1.0,720,7500,1.0,3,6,720,0.0,1925,1390,5000,35495 days 16:47:18.687817,055,2.0,0.0,-670,2500,720.0
439950.0,3,2.5,1540,7773,2.0,4,8,1540,0.0,1982,1630,7340,14676 days 16:47:18.687817,204,1.2,0.0,-90,433,1540.0
234000.0,3,1.5,1140,10300,1.5,4,6,1140,0.0,1967,1250,9975,20155 days 16:47:18.687817,274,2.0,0.0,-110,325,1140.0
485000.0,4,2.5,2100,8886,2.0,4,7,2100,0.0,1964,1840,9058,21251 days 16:47:18.687817,365,1.6,0.0,260,-172,2100.0
750000.0,4,1.75,2670,6250,2.0,4,8,2020,650.0,1941,1820,6250,29651 days 16:47:18.687817,196,2.2857142857142856,3.1076923076923078,850,0,1370.0
865000.0,4,2.0,2750,5527,2.0,3,8,2130,620.0,1901,1290,1764,44261 days 16:47:18.687817,127,2.0,3.435483870967742,1460,3763,1510.0
287500.0,4,2.5,2570,9000,1.0,4,8,1590,980.0,1979,2120,8571,15772 days 16:47:18.687817,169,1.6,1.6224489795918366,450,429,610.0
375000.0,3,1.75,1660,9673,1.0,3,7,1130,530.0,1976,1260,9681,16868 days 16:47:18.687817,189,1.7142857142857142,2.1320754716981134,400,-8,600.0
565000.0,3,2.25,1700,8800,1.0,5,7,850,850.0,1969,2180,8960,19424 days 16:47:18.687817,248,1.3333333333333333,1.0,-480,-160,0.0
260000.0,4,3.0,1530,8306,2.0,3,7,1530,0.0,2010,1930,6925,4449 days 16:47:18.687817,050,1.3333333333333333,0.0,-400,1381,1530.0
190000.0,3,1.0,1260,10900,1.0,4,6,1260,0.0,1943,1090,8137,28921 days 16:47:18.687817,290,3.0,0.0,170,2763,1260.0
399950.0,5,2.0,2760,6420,1.0,5,7,1380,1380.0,1964,1400,7112,21251 days 16:47:18.687817,252,2.5,1.0,1360,-692,0.0
275000.0,3,2.5,1830,7062,2.0,3,7,1830,0.0,1990,1820,6434,11754 days 16:47:18.687817,085,1.2,0.0,10,628,1830.0
528000.0,3,2.75,2160,4086,1.0,3,7,1380,780.0,1987,1300,4080,12850 days 16:47:18.687817,336,1.0909090909090908,1.7692307692307692,860,6,600.0
315000.0,3,2.0,1770,9685,1.0,3,5,1770,0.0,1948,1520,11122,27095 days 16:47:18.687817,290,1.5,0.0,250,-1437,1770.0
614306.0,2,2.25,2210,5500,1.0,4,8,1410,800.0,1968,2140,6600,19790 days 16:47:18.687817,233,0.8888888888888888,1.7625,70,-1100,610.0
1490000.0,3,3.5,4560,14608,2.0,3,1,4560,0.0,1990,4050,14226,11754 days 16:47:18.687817,090,0.8571428571428571,0.0,510,382,4560.0
590000.0,3,2.5,2110,3870,2.0,3,9,2110,0.0,2004,2300,3870,6641 days 16:47:18.687817,210,1.2,0.0,-190,0,2110.0
261500.0,3,1.0,1130,3600,1.0,3,6,1130,0.0,1908,1710,2231,41705 days 16:47:18.687817,076,3.0,0.0,-580,1369,1130.0
300000.0,4,2.5,1960,9898,2.0,3,8,1960,0.0,2001,2130,7662,7736 days 16:47:18.687817,143,1.6,0.0,-170,2236,1960.0
439000.0,3,2.25,2230,4551,1.5,5,8,1450,780.0,1928,2060,7200,34400 days 16:47:18.687817,247,1.3333333333333333,1.858974358974359,170,-2649,670.0
277554.0,5,2.25,2350,13000,1.0,3,7,2350,0.0,1961,1570,11440,22346 days 16:47:18.687817,247,2.2222222222222223,0.0,780,1560,2350.0
215000.0,3,2.0,1340,8505,1.0,3,6,1340,0.0,1931,1370,9000,33304 days 16:47:18.687817,174,1.5,0.0,-30,-495,1340.0
1200000.0,2,2.25,2160,17861,2.0,4,9,2160,0.0,1956,2660,18530,24173 days 16:47:18.687817,265,0.8888888888888888,0.0,-500,-669,2160.0
420000.0,4,2.0,1700,6375,1.0,4,7,850,850.0,1950,1470,8360,26364 days 16:47:18.687817,055,2.0,1.0,230,-1985,0.0
485000.0,3,2.5,1650,3436,2.0,3,7,1650,0.0,2003,1680,3446,7006 days 16:47:18.687817,098,1.2,0.0,-30,-10,1650.0
202500.0,3,2.0,1540,8316,1.0,5,6,1540,0.0,1954,1250,8316,24903 days 16:47:18.687817,356,1.5,0.0,290,0,1540.0
710000.0,5,3.25,3920,8572,2.0,3,9,3920,0.0,2007,3335,7258,5545 days 16:47:18.687817,054,1.5384615384615385,0.0,585,1314,3920.0
535000.0,4,2.5,3250,6933,2.0,3,8,3250,0.0,2009,3030,5308,4814 days 16:47:18.687817,120,1.6,0.0,220,1625,3250.0
260000.0,4,1.75,1360,7700,1.0,4,7,1360,0.0,1966,1321,7756,20520 days 16:47:18.687817,352,2.2857142857142856,0.0,39,-56,1360.0
254000.0,3,2.0,1480,7480,1.0,4,7,1480,0.0,1992,1680,7146,11024 days 16:47:18.687817,148,1.5,0.0,-200,334,1480.0
600000.0,4,2.5,2360,5226,2.0,3,8,2360,0.0,2001,2440,5156,7736 days 16:47:18.687817,141,1.6,0.0,-80,70,2360.0
285000.0,3,2.5,1800,2516,2.0,3,7,1800,0.0,2001,1800,2562,7736 days 16:47:18.687817,268,1.2,0.0,0,-46,1800.0
800000.0,4,3.75,2540,20662,2.0,3,1,2540,0.0,1998,2490,37731,8832 days 16:47:18.687817,296,1.0666666666666667,0.0,50,-17069,2540.0
165000.0,3,1.0,1200,13100,1.0,3,6,1200,0.0,1943,1960,11285,28921 days 16:47:18.687817,174,3.0,0.0,-760,1815,1200.0
216500.0,2,1.0,710,6960,1.0,4,6,710,0.0,1943,940,7680,28921 days 16:47:18.687817,310,2.0,0.0,-230,-720,710.0
387990.0,4,2.5,2640,5595,2.0,3,8,2640,0.0,2011,1840,5011,4084 days 16:47:18.687817,262,1.6,0.0,800,584,2640.0
500000.0,4,2.5,3010,5040,2.0,3,8,3010,0.0,2006,1090,5040,5910 days 16:47:18.687817,308,1.6,0.0,1920,0,3010.0
650000.0,4,2.5,2770,5612,2.0,3,7,2770,0.0,2001,2770,5177,7736 days 16:47:18.687817,296,1.6,0.0,0,435,2770.0
646000.0,4,2.5,2310,4079,2.0,3,8,2310,0.0,2008,1220,4800,5180 days 16:47:18.687817,170,1.6,0.0,1090,-721,2310.0
323400.0,4,3.0,2060,9138,1.0,3,8,1430,630.0,1992,2250,7820,11024 days 16:47:18.687817,030,1.3333333333333333,2.2698412698412698,-190,1318,800.0
712500.0,5,2.0,2280,5400,1.5,4,7,1340,940.0,1947,1770,5000,27460 days 16:47:18.687817,280,2.5,1.425531914893617,510,400,400.0
550000.0,3,1.75,1380,3402,1.5,3,7,1380,0.0,1900,1500,5496,44626 days 16:47:18.687817,160,1.7142857142857142,0.0,-120,-2094,1380.0
400000.0,3,1.0,1180,7537,1.0,3,7,1180,0.0,1969,1220,7425,19424 days 16:47:18.687817,048,3.0,0.0,-40,112,1180.0
255000.0,4,1.75,1650,7200,1.0,3,7,1100,550.0,1977,1620,7374,16502 days 16:47:18.687817,301,2.2857142857142856,2.0,30,-174,550.0
534000.0,4,2.25,2130,7210,1.0,5,7,1330,800.0,1965,1310,7896,20885 days 16:47:18.687817,217,1.7777777777777777,1.6625,820,-686,530.0
215000.0,3,1.0,1690,7700,1.0,4,7,1690,0.0,1969,1590,7700,19424 days 16:47:18.687817,323,3.0,0.0,100,0,1690.0
1950000.0,3,2.5,2510,12779,1.5,3,1,2510,0.0,1968,2810,12225,19790 days 16:47:18.687817,287,1.2,0.0,-300,554,2510.0
1400000.0,5,4.25,3530,7924,2.0,3,1,3530,0.0,2001,1750,9226,7736 days 16:47:18.687817,133,1.1764705882352942,0.0,1780,-1302,3530.0
212000.0,3,1.75,1470,8350,1.0,3,7,1470,0.0,1990,1590,8182,11754 days 16:47:18.687817,034,1.7142857142857142,0.0,-120,168,1470.0
265000.0,3,1.75,1840,7300,1.0,3,8,1840,0.0,1966,1920,8010,20520 days 16:47:18.687817,170,1.7142857142857142,0.0,-80,-710,1840.0
400000.0,3,1.75,1860,5750,1.5,5,6,1300,560.0,1918,1550,5750,38052 days 16:47:18.687817,339,1.7142857142857142,2.3214285714285716,310,0,740.0
311500.0,4,2.5,1940,10133,2.0,3,8,1940,0.0,1992,1940,7265,11024 days 16:47:18.687817,044,1.6,0.0,0,2868,1940.0
2330000.0,4,3.5,4420,20759,2.0,3,1,4420,0.0,2003,3020,20666,7006 days 16:47:18.687817,085,1.1428571428571428,0.0,1400,93,4420.0
225000.0,2,1.0,800,6050,1.0,4,6,800,0.0,1944,880,6050,28556 days 16:47:18.687817,290,2.0,0.0,-80,0,800.0
1250000.0,4,2.5,3700,21755,1.0,3,1,2620,1080.0,1988,3480,13786,12485 days 16:47:18.687817,161,1.6,2.425925925925926,220,7969,1540.0
380000.0,3,1.0,1400,8710,1.0,4,7,1400,0.0,1948,1460,8710,27095 days 16:47:18.687817,042,3.0,0.0,-60,0,1400.0
600000.0,4,2.5,2250,11370,2.0,3,8,2250,0.0,1991,2190,9611,11389 days 16:47:18.687817,189,1.6,0.0,60,1759,2250.0
600000.0,3,2.25,2230,9053,2.0,4,9,2230,0.0,1987,2390,8038,12850 days 16:47:18.687817,141,1.3333333333333333,0.0,-160,1015,2230.0
315000.0,3,2.5,1950,3000,2.0,3,7,1950,0.0,2001,1620,6000,7736 days 16:47:18.687817,352,1.2,0.0,330,-3000,1950.0
847000.0,5,1.0,2550,4623,2.5,4,9,2550,0.0,1905,1570,3875,42800 days 16:47:18.687817,154,5.0,0.0,980,748,2550.0
730000.0,4,2.5,2750,10351,2.0,3,1,2750,0.0,1998,3370,10351,8832 days 16:47:18.687817,099,1.6,0.0,-620,0,2750.0
1060000.0,4,2.0,2290,11137,1.0,4,8,2290,0.0,1955,2300,10463,24538 days 16:47:18.687817,134,2.0,0.0,-10,674,2290.0
1620000.0,4,2.25,2350,17709,2.0,4,9,2350,0.0,1977,3360,19855,16502 days 16:47:18.687817,133,1.7777777777777777,0.0,-1010,-2146,2350.0
664000.0,2,1.75,1720,5785,1.0,3,6,860,860.0,1948,1680,5184,27095 days 16:47:18.687817,105,1.1428571428571428,1.0,40,601,0.0
454450.0,4,3.0,2810,6000,2.0,3,9,2810,0.0,2007,2790,6000,5545 days 16:47:18.687817,117,1.3333333333333333,0.0,20,0,2810.0
341000.0,3,1.0,940,4200,1.0,3,7,940,0.0,1955,1380,4080,24538 days 16:47:18.687817,016,3.0,0.0,-440,120,940.0
276693.0,4,1.0,1190,8875,1.5,4,7,1190,0.0,1946,1190,8875,27825 days 16:47:18.687817,302,4.0,0.0,0,0,1190.0
185000.0,2,1.0,1390,11340,1.0,4,7,1390,0.0,1969,1200,10224,19424 days 16:47:18.687817,323,2.0,0.0,190,1116,1390.0
160000.0,2,2.5,1660,2258,2.0,3,7,1660,0.0,1981,1740,2390,15041 days 16:47:18.687817,260,0.8,0.0,-80,-132,1660.0
270000.0,4,2.5,1920,8497,2.0,3,8,1920,0.0,1998,1940,8436,8832 days 16:47:18.687817,153,1.6,0.0,-20,61,1920.0
300000.0,4,1.5,1460,8760,1.0,3,7,1460,0.0,1958,1610,9375,23442 days 16:47:18.687817,199,2.6666666666666665,0.0,-150,-615,1460.0
264950.0,3,1.5,1370,10115,1.0,4,7,1370,0.0,1957,1450,9282,23807 days 16:47:18.687817,241,2.0,0.0,-80,833,1370.0
209950.0,2,1.0,1050,6250,1.0,4,6,840,210.0,1943,1310,12500,28921 days 16:47:18.687817,091,2.0,4.0,-260,-6250,630.0
850000.0,3,2.5,3360,8708,2.0,3,9,3360,0.0,2006,1810,4764,5910 days 16:47:18.687817,089,1.2,0.0,1550,3944,3360.0
645000.0,4,2.5,3160,11380,2.0,3,9,3160,0.0,1983,2970,10385,14311 days 16:47:18.687817,136,1.6,0.0,190,995,3160.0
855000.0,4,2.25,2480,36974,2.0,4,9,2480,0.0,1973,3160,35070,17963 days 16:47:18.687817,013,1.7777777777777777,0.0,-680,1904,2480.0
632500.0,4,1.5,2720,37258,2.0,3,1,2720,0.0,1994,3270,39714,10293 days 16:47:18.687817,335,2.6666666666666665,0.0,-550,-2456,2720.0
289950.0,3,2.5,2070,5013,2.0,3,8,2070,0.0,1987,1670,5013,12850 days 16:47:18.687817,233,1.2,0.0,400,0,2070.0
850000.0,2,1.75,2170,25732,1.0,4,8,2170,0.0,1952,3020,23135,25634 days 16:47:18.687817,267,1.1428571428571428,0.0,-850,2597,2170.0
565000.0,4,2.75,3260,4900,2.0,3,9,3260,0.0,2013,3260,6132,3353 days 16:47:18.687817,171,1.4545454545454546,0.0,0,-1232,3260.0
792000.0,3,2.5,2250,19270,2.0,3,8,2250,0.0,1999,2940,19541,8467 days 16:47:18.687817,115,1.2,0.0,-690,-271,2250.0
260000.0,3,2.25,1950,9600,1.0,4,7,1200,750.0,1987,1760,8850,12850 days 16:47:18.687817,356,1.3333333333333333,1.6,190,750,450.0
585000.0,3,2.0,2220,209523,1.0,3,7,2220,0.0,1991,1600,210830,11389 days 16:47:18.687817,117,1.5,0.0,620,-1307,2220.0
295500.0,3,1.75,1330,10523,1.0,3,7,1000,330.0,1981,1320,8775,15041 days 16:47:18.687817,211,1.7142857142857142,3.0303030303030303,10,1748,670.0
329000.0,4,2.0,1190,7877,1.5,5,7,1190,0.0,1946,1480,9975,27825 days 16:47:18.687817,345,2.0,0.0,-290,-2098,1190.0
750000.0,3,1.75,2770,15232,1.0,3,8,1570,1200.0,1976,2340,11400,16868 days 16:47:18.687817,089,1.7142857142857142,1.3083333333333333,430,3832,370.0
495000.0,4,2.5,2310,7555,2.0,3,9,2310,0.0,1997,1980,8416,9197 days 16:47:18.687817,056,1.6,0.0,330,-861,2310.0
672500.0,3,1.75,1580,5750,1.0,4,8,1330,250.0,1947,2480,5750,27460 days 16:47:18.687817,124,1.7142857142857142,5.32,-900,0,1080.0
1310000.0,5,3.25,2800,3200,1.5,5,1,1910,890.0,1932,2450,3500,32939 days 16:47:18.687817,128,1.5384615384615385,2.146067415730337,350,-300,1020.0
405000.0,3,2.5,1500,9636,2.0,3,7,1500,0.0,1994,1700,9656,10293 days 16:47:18.687817,213,1.2,0.0,-200,-20,1500.0
620000.0,3,1.75,2140,5808,1.0,3,7,1070,1070.0,1947,1930,5808,27460 days 16:47:18.687817,016,1.7142857142857142,1.0,210,0,0.0
615000.0,4,2.25,2330,7020,1.0,4,8,1450,880.0,1973,2330,8500,17963 days 16:47:18.687817,265,1.7777777777777777,1.6477272727272727,0,-1480,570.0
887000.0,6,2.25,3830,11180,1.0,5,9,2440,1390.0,1962,2500,10400,21981 days 16:47:18.687817,247,2.6666666666666665,1.7553956834532374,1330,780,1050.0
1060000.0,4,2.75,4510,5000,2.5,3,8,3270,1240.0,1941,2010,5000,29651 days 16:47:18.687817,265,1.4545454545454546,2.6370967741935485,2500,0,2030.0
753000.0,4,1.75,2160,39430,1.0,4,8,1660,500.0,1974,2430,35329,17598 days 16:47:18.687817,217,2.2857142857142856,3.32,-270,4101,1160.0
1600000.0,3,2.25,3170,5000,2.0,5,1,2230,940.0,1975,3170,5400,17233 days 16:47:18.687817,196,1.3333333333333333,2.372340425531915,0,-400,1290.0
3710000.0,4,3.5,5550,28078,2.0,4,1,3350,2200.0,2000,2980,19602,8102 days 16:47:18.687817,150,1.1428571428571428,1.5227272727272727,2570,8476,1150.0
365000.0,3,1.5,1520,8519,1.0,3,7,1520,0.0,1954,1570,9000,24903 days 16:47:18.687817,365,2.0,0.0,-50,-481,1520.0
870000.0,4,2.75,3410,23000,2.0,4,1,3410,0.0,1982,2490,15512,14676 days 16:47:18.687817,234,1.4545454545454546,0.0,920,7488,3410.0
321000.0,4,2.5,1830,9601,2.0,3,7,1830,0.0,2003,1830,5892,7006 days 16:47:18.687817,182,1.6,0.0,0,3709,1830.0
280000.0,3,2.5,1550,4486,2.0,3,7,1550,0.0,2000,1700,4487,8102 days 16:47:18.687817,127,1.2,0.0,-150,-1,1550.0
288000.0,3,2.5,1520,3593,2.0,3,7,1520,0.0,2004,1610,3612,6641 days 16:47:18.687817,184,1.2,0.0,-90,-19,1520.0
248500.0,3,2.0,1240,12285,1.0,3,7,620,620.0,1939,1560,11564,30382 days 16:47:18.687817,058,1.5,1.0,-320,721,0.0
330000.0,4,2.5,2380,13550,2.0,3,7,2380,0.0,1999,1230,9450,8467 days 16:47:18.687817,173,1.6,0.0,1150,4100,2380.0
740000.0,5,3.5,2720,11454,2.0,3,9,1830,890.0,1988,2920,11310,12485 days 16:47:18.687817,203,1.4285714285714286,2.056179775280899,-200,144,940.0
445000.0,3,2.5,2210,8010,2.0,3,8,2210,0.0,1998,2430,9600,8832 days 16:47:18.687817,266,1.2,0.0,-220,-1590,2210.0
198500.0,2,1.0,1050,9600,1.0,4,6,1050,0.0,1959,990,8880,23077 days 16:47:18.687817,065,2.0,0.0,60,720,1050.0
280000.0,7,2.5,1940,5458,2.0,3,7,1940,0.0,1994,1710,5688,10293 days 16:47:18.687817,176,2.8,0.0,230,-230,1940.0
336500.0,3,2.25,1420,3433,2.0,4,7,1420,0.0,1981,1150,3432,15041 days 16:47:18.687817,191,1.3333333333333333,0.0,270,1,1420.0
267000.0,3,2.5,1690,10336,2.0,4,7,1690,0.0,1989,1580,7700,12119 days 16:47:18.687817,042,1.2,0.0,110,2636,1690.0
315000.0,3,1.0,1160,9180,1.0,3,7,1160,0.0,1968,1160,10282,19790 days 16:47:18.687817,122,3.0,0.0,0,-1102,1160.0
545000.0,4,2.5,2040,7412,2.0,3,8,2040,0.0,1988,2050,7830,12485 days 16:47:18.687817,218,1.6,0.0,-10,-418,2040.0
274950.0,3,1.75,1840,16679,1.0,3,8,1840,0.0,1989,1910,15571,12119 days 16:47:18.687817,216,1.7142857142857142,0.0,-70,1108,1840.0
500000.0,2,1.0,1440,7130,1.0,3,7,1210,230.0,1948,1970,7130,27095 days 16:47:18.687817,358,2.0,5.260869565217392,-530,0,980.0
299000.0,3,1.0,1390,9624,1.5,4,7,1390,0.0,1954,1440,9624,24903 days 16:47:18.687817,148,3.0,0.0,-50,0,1390.0
420000.0,3,2.5,1470,1445,2.0,3,8,1160,310.0,2005,1470,1525,6275 days 16:47:18.687817,125,1.2,3.7419354838709675,0,-80,850.0
620000.0,3,2.5,1776,1248,3.0,3,8,1604,172.0,2006,1780,1248,5910 days 16:47:18.687817,097,1.2,9.325581395348838,-4,0,1432.0
575950.0,3,2.25,1640,12000,1.0,3,7,1180,460.0,1967,1620,12000,20155 days 16:47:18.687817,344,1.3333333333333333,2.5652173913043477,20,0,720.0
666500.0,4,2.5,2860,6600,2.0,3,9,2860,0.0,2000,2790,6723,8102 days 16:47:18.687817,247,1.6,0.0,70,-123,2860.0
180000.0,4,1.5,1740,7292,1.0,3,7,1020,720.0,1962,1740,7573,21981 days 16:47:18.687817,142,2.6666666666666665,1.4166666666666667,0,-281,300.0
261350.0,3,1.75,1390,18200,1.0,4,7,1390,0.0,1962,1810,9675,21981 days 16:47:18.687817,174,1.7142857142857142,0.0,-420,8525,1390.0
1030000.0,4,3.5,2730,5607,1.0,5,9,1660,1070.0,1948,1720,5400,27095 days 16:47:18.687817,055,1.1428571428571428,1.5514018691588785,1010,207,590.0
390000.0,3,1.75,1435,8960,1.0,4,8,1435,0.0,1969,2030,9450,19424 days 16:47:18.687817,119,1.7142857142857142,0.0,-595,-490,1435.0
253500.0,3,1.0,1640,12384,1.0,4,7,1090,550.0,1954,1550,11200,24903 days 16:47:18.687817,177,3.0,1.981818181818182,90,1184,540.0
625000.0,4,2.5,2630,48706,2.0,3,8,2630,0.0,1986,2680,48706,13215 days 16:47:18.687817,141,1.6,0.0,-50,0,2630.0
255000.0,4,2.5,1580,7800,1.0,4,7,1580,0.0,1959,1320,7800,23077 days 16:47:18.687817,265,1.6,0.0,260,0,1580.0
257000.0,3,2.5,1740,3721,2.0,3,8,1740,0.0,2009,2030,3794,4814 days 16:47:18.687817,283,1.2,0.0,-290,-73,1740.0
869000.0,2,1.75,1900,13122,1.0,3,7,1100,800.0,1954,1650,13160,24903 days 16:47:18.687817,203,1.1428571428571428,1.375,250,-38,300.0
745000.0,4,2.5,3130,10860,2.0,3,1,3130,0.0,1990,3130,10860,11754 days 16:47:18.687817,316,1.6,0.0,0,0,3130.0
1350000.0,4,3.5,3500,9525,2.0,3,1,3500,0.0,1999,2630,9525,8467 days 16:47:18.687817,269,1.1428571428571428,0.0,870,0,3500.0
350000.0,3,1.75,2130,7500,1.0,4,7,1090,1040.0,1956,1590,7500,24173 days 16:47:18.687817,293,1.7142857142857142,1.0480769230769231,540,0,50.0
475000.0,3,2.5,950,1110,2.0,3,8,950,0.0,2003,1230,1215,7006 days 16:47:18.687817,170,1.2,0.0,-280,-105,950.0
540000.0,3,2.5,1720,11656,2.0,3,8,1720,0.0,1987,1890,10336,12850 days 16:47:18.687817,261,1.2,0.0,-170,1320,1720.0
175000.0,2,1.0,830,2699,1.0,3,7,830,0.0,1996,1030,3574,9563 days 16:47:18.687817,148,2.0,0.0,-200,-875,830.0
100000.0,2,0.75,660,5240,1.0,4,4,660,0.0,1912,850,5080,40244 days 16:47:18.687817,184,2.6666666666666665,0.0,-190,160,660.0
890000.0,5,1.0,2590,4652,2.0,4,8,2310,280.0,1907,2360,4650,42070 days 16:47:18.687817,282,5.0,8.25,230,2,2030.0
280000.0,3,2.5,1600,4271,2.0,3,7,1600,0.0,2000,1700,4746,8102 days 16:47:18.687817,127,1.2,0.0,-100,-475,1600.0
1050000.0,4,4.25,4390,13833,2.0,3,1,3320,1070.0,2003,3850,11652,7006 days 16:47:18.687817,178,0.9411764705882353,3.102803738317757,540,2181,2250.0
486000.0,4,2.5,3560,12047,2.0,3,1,3560,0.0,1988,3420,11250,12485 days 16:47:18.687817,190,1.6,0.0,140,797,3560.0
670000.0,5,2.5,2860,68519,2.0,5,8,2860,0.0,1958,1670,35910,23442 days 16:47:18.687817,188,2.0,0.0,1190,32609,2860.0
480000.0,3,2.5,1640,7847,2.0,3,8,1640,0.0,1987,1870,6079,12850 days 16:47:18.687817,204,1.2,0.0,-230,1768,1640.0
440000.0,3,1.75,1500,6180,1.0,4,6,1060,440.0,1947,1740,6180,27460 days 16:47:18.687817,127,1.7142857142857142,2.409090909090909,-240,0,620.0
1500000.0,3,3.25,3990,8505,2.0,3,9,2870,1120.0,1922,3640,8505,36591 days 16:47:18.687817,248,0.9230769230769231,2.5625,350,0,1750.0
743700.0,4,2.5,2610,33206,2.0,3,1,2610,0.0,1988,2870,28295,12485 days 16:47:18.687817,160,1.6,0.0,-260,4911,2610.0
449950.0,3,1.75,1470,7590,1.0,3,7,1470,0.0,1988,1700,5080,12485 days 16:47:18.687817,226,1.7142857142857142,0.0,-230,2510,1470.0
367000.0,2,1.0,700,2334,1.0,3,7,700,0.0,1945,2300,5000,28190 days 16:47:18.687817,139,2.0,0.0,-1600,-2666,700.0
1190000.0,4,3.25,3960,12895,2.0,3,1,3960,0.0,2001,3870,12040,7736 days 16:47:18.687817,335,1.2307692307692308,0.0,90,855,3960.0
201000.0,3,1.0,900,7576,1.0,4,6,900,0.0,1959,1220,7452,23077 days 16:47:18.687817,121,3.0,0.0,-320,124,900.0
575000.0,3,1.75,2010,3800,2.0,2,7,2010,0.0,1922,1540,3800,36591 days 16:47:18.687817,357,1.7142857142857142,0.0,470,0,2010.0
295000.0,3,2.5,1940,10350,1.0,3,7,1420,520.0,1979,1810,7800,15772 days 16:47:18.687817,105,1.2,2.730769230769231,130,2550,900.0
190000.0,3,1.0,1510,8760,1.0,4,6,1510,0.0,1946,1040,7828,27825 days 16:47:18.687817,051,3.0,0.0,470,932,1510.0
742500.0,2,3.0,2020,5000,1.0,3,8,1350,670.0,1952,1160,1118,25634 days 16:47:18.687817,127,0.6666666666666666,2.014925373134328,860,3882,680.0
875000.0,6,3.5,4430,11453,2.0,3,9,3000,1430.0,2001,2730,5661,7736 days 16:47:18.687817,071,1.7142857142857142,2.097902097902098,1700,5792,1570.0
1390000.0,4,3.5,4010,10880,2.0,4,1,3150,860.0,1990,3530,17310,11754 days 16:47:18.687817,111,1.1428571428571428,3.6627906976744184,480,-6430,2290.0
600000.0,4,2.25,3070,8400,2.0,4,8,3070,0.0,1970,1880,8000,19059 days 16:47:18.687817,170,1.7777777777777777,0.0,1190,400,3070.0
207000.0,3,1.5,1460,11100,1.0,3,7,1460,0.0,1956,1460,11100,24173 days 16:47:18.687817,265,2.0,0.0,0,0,1460.0
650000.0,4,2.75,3260,5335,2.0,3,9,3260,0.0,2003,3180,5438,7006 days 16:47:18.687817,111,1.4545454545454546,0.0,80,-103,3260.0
275000.0,2,1.0,830,5610,1.0,3,6,830,0.0,1922,1310,2793,36591 days 16:47:18.687817,132,2.0,0.0,-480,2817,830.0
1200000.0,4,2.5,2390,4200,2.0,3,9,2150,240.0,1924,2800,5250,35861 days 16:47:18.687817,098,1.6,8.958333333333334,-410,-1050,1910.0
262500.0,3,2.0,1130,7200,1.0,4,6,1130,0.0,1944,1270,7500,28556 days 16:47:18.687817,287,1.5,0.0,-140,-300,1130.0
399000.0,2,1.0,1120,8661,1.0,3,7,1120,0.0,1946,1470,7205,27825 days 16:47:18.687817,268,2.0,0.0,-350,1456,1120.0
139000.0,4,1.5,1410,10648,1.0,4,7,1410,0.0,1966,1410,10522,20520 days 16:47:18.687817,055,2.6666666666666665,0.0,0,126,1410.0
575000.0,3,2.5,1750,4797,2.0,4,7,1750,0.0,1991,1750,4293,11389 days 16:47:18.687817,238,1.2,0.0,0,504,1750.0
580000.0,2,1.0,1040,3200,1.0,3,7,1040,0.0,1926,1890,4000,35130 days 16:47:18.687817,324,2.0,0.0,-850,-800,1040.0
468000.0,3,2.25,1630,2490,2.0,3,7,1630,0.0,2004,1630,2680,6641 days 16:47:18.687817,206,1.3333333333333333,0.0,0,-190,1630.0
230000.0,3,1.0,1380,10112,1.0,4,7,940,440.0,1963,1240,10112,21616 days 16:47:18.687817,069,3.0,2.1363636363636362,140,0,500.0
675000.0,4,4.0,3680,18804,2.0,3,1,3680,0.0,1990,3200,15954,11754 days 16:47:18.687817,127,1.0,0.0,480,2850,3680.0
318000.0,3,1.0,1250,20040,1.0,3,7,1250,0.0,1970,1640,19840,19059 days 16:47:18.687817,283,3.0,0.0,-390,200,1250.0
332100.0,5,3.5,2660,6978,2.0,3,8,1980,680.0,1996,2220,7294,9563 days 16:47:18.687817,281,1.4285714285714286,2.911764705882353,440,-316,1300.0
175000.0,2,1.0,620,6600,1.0,3,6,620,0.0,1963,1050,6600,21616 days 16:47:18.687817,076,2.0,0.0,-430,0,620.0
817000.0,4,2.25,2600,10660,2.0,4,8,2600,0.0,1979,3150,10660,15772 days 16:47:18.687817,217,1.7777777777777777,0.0,-550,0,2600.0
1200000.0,4,3.0,2150,8119,2.0,3,8,2150,0.0,1953,1590,8119,25268 days 16:47:18.687817,098,1.3333333333333333,0.0,560,0,2150.0
525000.0,3,1.75,1470,6550,1.0,3,7,1070,400.0,1916,1440,6550,38783 days 16:47:18.687817,110,1.7142857142857142,2.675,30,0,670.0
189000.0,3,1.0,1380,7282,1.5,5,6,1380,0.0,1915,860,4826,39148 days 16:47:18.687817,042,3.0,0.0,520,2456,1380.0
629950.0,3,2.5,1680,1683,2.0,3,9,1120,560.0,2014,1610,1618,2988 days 16:47:18.687817,064,1.2,2.0,70,65,560.0
641500.0,1,1.0,1000,9084,1.0,3,7,1000,0.0,1950,1090,6536,26364 days 16:47:18.687817,069,1.0,0.0,-90,2548,1000.0
490000.0,3,2.25,1630,7573,1.0,3,7,1230,400.0,1983,1550,7695,14311 days 16:47:18.687817,255,1.3333333333333333,3.075,80,-122,830.0
415000.0,3,1.75,1790,15142,1.0,3,7,1360,430.0,1976,1910,7500,16868 days 16:47:18.687817,049,1.7142857142857142,3.1627906976744184,-120,7642,930.0
250000.0,2,1.0,890,6380,1.0,3,6,890,0.0,1951,990,6380,25999 days 16:47:18.687817,288,2.0,0.0,-100,0,890.0
781000.0,3,1.5,1290,8175,1.0,4,7,820,470.0,1952,2130,8577,25634 days 16:47:18.687817,232,2.0,1.7446808510638299,-840,-402,350.0
400000.0,4,2.25,2420,7927,1.0,4,7,1400,1020.0,1973,2120,7693,17963 days 16:47:18.687817,171,1.7777777777777777,1.3725490196078431,300,234,380.0
935000.0,4,3.0,3680,7105,2.0,3,1,2890,790.0,2008,1580,6815,5180 days 16:47:18.687817,232,1.3333333333333333,3.6582278481012658,2100,290,2100.0
575000.0,4,2.5,3020,17810,1.0,3,9,1600,1420.0,1979,2500,15815,15772 days 16:47:18.687817,135,1.6,1.1267605633802817,520,1995,180.0
1660000.0,4,3.25,4240,11189,2.0,3,1,4240,0.0,2006,3390,12540,5910 days 16:47:18.687817,288,1.2307692307692308,0.0,850,-1351,4240.0
302300.0,5,2.75,3130,9450,1.0,4,8,1580,1550.0,1973,1900,9000,17963 days 16:47:18.687817,363,1.8181818181818181,1.0193548387096774,1230,450,30.0
355000.0,2,1.0,900,6656,1.0,3,7,900,0.0,1940,1230,6400,30017 days 16:47:18.687817,127,2.0,0.0,-330,256,900.0
1540000.0,3,2.25,2880,7599,1.0,3,9,1710,1170.0,1958,2920,12401,23442 days 16:47:18.687817,168,1.3333333333333333,1.4615384615384615,-40,-4802,540.0
926250.0,4,1.75,2390,17717,1.0,4,8,2390,0.0,1964,2390,10730,21251 days 16:47:18.687817,089,2.2857142857142856,0.0,0,6987,2390.0
300000.0,3,1.75,1450,7620,1.0,4,7,1050,400.0,1955,1380,7620,24538 days 16:47:18.687817,082,1.7142857142857142,2.625,70,0,650.0
361500.0,3,1.75,1070,9000,1.0,4,7,1070,0.0,1978,1700,8400,16137 days 16:47:18.687817,202,1.7142857142857142,0.0,-630,600,1070.0
616000.0,3,1.5,1740,9840,1.0,4,8,1740,0.0,1963,1930,9840,21616 days 16:47:18.687817,309,2.0,0.0,-190,0,1740.0
395000.0,2,1.75,1210,1161,2.0,3,8,1210,0.0,2014,1700,2285,2988 days 16:47:18.687817,103,1.1428571428571428,0.0,-490,-1124,1210.0
245000.0,3,1.5,2100,10000,1.0,4,7,2100,0.0,1954,1300,7500,24903 days 16:47:18.687817,279,2.0,0.0,800,2500,2100.0
206000.0,3,1.0,1060,9600,1.0,4,6,1060,0.0,1962,1060,9604,21981 days 16:47:18.687817,154,3.0,0.0,0,-4,1060.0
706000.0,4,2.5,3280,16575,1.0,3,9,2190,1090.0,1972,1570,13209,18329 days 16:47:18.687817,286,1.6,2.0091743119266057,1710,3366,1100.0
578000.0,3,1.5,1660,6000,1.5,3,7,1660,0.0,1937,1640,6000,31112 days 16:47:18.687817,026,2.0,0.0,20,0,1660.0
341950.0,5,3.0,3070,5252,2.0,3,8,3070,0.0,2005,2760,5203,6275 days 16:47:18.687817,209,1.6666666666666667,0.0,310,49,3070.0
305000.0,3,1.0,1150,9048,1.0,2,7,1150,0.0,1922,1550,8207,36591 days 16:47:18.687817,345,3.0,0.0,-400,841,1150.0
575000.0,3,2.75,1710,3600,1.0,3,7,1590,120.0,1909,1710,3600,41339 days 16:47:18.687817,283,1.0909090909090908,13.25,0,0,1470.0
330000.0,3,1.0,1180,43124,1.0,4,6,1180,0.0,1959,1410,43560,23077 days 16:47:18.687817,140,3.0,0.0,-230,-436,1180.0
445000.0,4,2.25,2130,7200,2.0,3,7,2130,0.0,1972,1990,7200,18329 days 16:47:18.687817,007,1.7777777777777777,0.0,140,0,2130.0
333000.0,3,1.0,1050,7560,1.0,3,7,1050,0.0,1951,1490,7560,25999 days 16:47:18.687817,230,3.0,0.0,-440,0,1050.0
598500.0,4,2.5,2520,3980,2.0,3,8,2520,0.0,2005,2610,3980,6275 days 16:47:18.687817,219,1.6,0.0,-90,0,2520.0
225000.0,2,1.0,700,6000,1.0,3,6,700,0.0,1943,1320,6000,28921 days 16:47:18.687817,287,2.0,0.0,-620,0,700.0
570000.0,4,2.5,2640,4200,2.0,3,8,2640,0.0,1998,2460,4200,8832 days 16:47:18.687817,195,1.6,0.0,180,0,2640.0
630000.0,5,2.0,2330,6783,1.0,3,7,1310,1020.0,1956,1930,6783,24173 days 16:47:18.687817,219,2.5,1.2843137254901962,400,0,290.0
779000.0,5,2.25,2830,7738,2.0,4,8,2830,0.0,1977,2300,9840,16502 days 16:47:18.687817,106,2.2222222222222223,0.0,530,-2102,2830.0
760000.0,4,3.5,3720,13591,2.0,3,1,3720,0.0,2004,4210,14282,6641 days 16:47:18.687817,021,1.1428571428571428,0.0,-490,-691,3720.0
322968.0,5,1.75,1890,9600,1.0,4,7,1890,0.0,1960,2350,5308,22712 days 16:47:18.687817,009,2.857142857142857,0.0,-460,4292,1890.0
595000.0,4,2.5,2910,7287,2.0,3,8,2910,0.0,1998,2420,6180,8832 days 16:47:18.687817,210,1.6,0.0,490,1107,2910.0
321000.0,4,1.0,1300,18836,1.0,4,7,1300,0.0,1941,1540,8498,29651 days 16:47:18.687817,286,4.0,0.0,-240,10338,1300.0
653000.0,3,2.25,2770,57745,2.0,3,8,2770,0.0,1985,2720,46765,13580 days 16:47:18.687817,085,1.3333333333333333,0.0,50,10980,2770.0
750000.0,4,1.75,2520,21834,1.0,3,8,1420,1100.0,1960,1700,8100,22712 days 16:47:18.687817,210,2.2857142857142856,1.290909090909091,820,13734,320.0
530000.0,3,1.0,1340,4284,1.0,3,7,1080,260.0,1910,1960,4080,40974 days 16:47:18.687817,127,3.0,4.153846153846154,-620,204,820.0
352750.0,2,1.75,1060,1241,2.0,3,7,960,100.0,2008,1170,1400,5180 days 16:47:18.687817,160,1.1428571428571428,9.6,-110,-159,860.0
424950.0,4,2.5,2480,8563,2.0,3,8,2480,0.0,1992,2460,8660,11024 days 16:47:18.687817,035,1.6,0.0,20,-97,2480.0
427000.0,5,2.75,2220,4000,1.0,3,7,1230,990.0,1973,1580,4000,17963 days 16:47:18.687817,150,1.8181818181818181,1.2424242424242424,640,0,240.0
558000.0,4,2.5,3220,5120,2.0,3,9,2420,800.0,2000,1770,7680,8102 days 16:47:18.687817,217,1.6,3.025,1450,-2560,1620.0
438200.0,2,2.0,1600,5643,1.0,3,7,1600,0.0,1954,1600,5746,24903 days 16:47:18.687817,314,1.0,0.0,0,-103,1600.0
340000.0,1,1.0,640,4800,1.0,3,6,640,0.0,1918,1250,2847,38052 days 16:47:18.687817,272,1.0,0.0,-610,1953,640.0
830005.0,4,3.75,3610,7904,3.0,3,1,3290,320.0,1994,2460,7300,10293 days 16:47:18.687817,240,1.0666666666666667,10.28125,1150,604,2970.0
548000.0,4,3.25,3420,5012,2.0,3,1,2330,1090.0,2008,2320,5465,5180 days 16:47:18.687817,252,1.2307692307692308,2.1376146788990824,1100,-453,1240.0
411715.0,3,1.75,1840,5101,1.0,5,7,1040,800.0,1952,1340,5000,25634 days 16:47:18.687817,155,1.7142857142857142,1.3,500,101,240.0
865000.0,4,4.0,2790,16117,2.0,4,9,2790,0.0,1999,2740,25369,8467 days 16:47:18.687817,301,1.0,0.0,50,-9252,2790.0
1750000.0,6,4.25,5860,13928,2.0,3,1,4150,1710.0,2013,5790,13928,3353 days 16:47:18.687817,033,1.411764705882353,2.426900584795322,70,0,2440.0
688000.0,3,3.0,3450,16200,2.0,3,1,3450,0.0,1983,3130,12150,14311 days 16:47:18.687817,169,1.0,0.0,320,4050,3450.0
399950.0,4,2.5,2350,5100,2.0,3,8,2350,0.0,2003,2190,5100,7006 days 16:47:18.687817,076,1.6,0.0,160,0,2350.0
555000.0,3,1.0,1250,4590,1.5,3,6,970,280.0,1903,1830,4080,43531 days 16:47:18.687817,086,3.0,3.4642857142857144,-580,510,690.0
677000.0,3,2.0,2000,3207,1.0,4,7,1100,900.0,1916,1460,3200,38783 days 16:47:18.687817,142,1.5,1.2222222222222223,540,7,200.0
539000.0,3,2.0,2260,9568,1.0,3,8,1780,480.0,1985,2250,9744,13580 days 16:47:18.687817,157,1.5,3.7083333333333335,10,-176,1300.0
410000.0,3,1.75,1510,6597,1.0,4,6,950,560.0,1939,1460,5320,30382 days 16:47:18.687817,231,1.7142857142857142,1.6964285714285714,50,1277,390.0
472000.0,2,2.25,1800,2748,2.0,4,9,1800,0.0,1979,1800,2755,15772 days 16:47:18.687817,069,0.8888888888888888,0.0,0,-7,1800.0
755000.0,3,2.5,2420,8856,1.0,3,9,1620,800.0,1957,2650,9750,23807 days 16:47:18.687817,299,1.2,2.025,-230,-894,820.0
269900.0,5,1.75,1750,8325,1.0,5,7,1750,0.0,1966,1430,8325,20520 days 16:47:18.687817,217,2.857142857142857,0.0,320,0,1750.0
667400.0,4,2.5,2660,40312,2.0,4,8,2660,0.0,1977,2650,45302,16502 days 16:47:18.687817,203,1.6,0.0,10,-4990,2660.0
1220000.0,3,2.25,2640,7544,1.0,3,1,2640,0.0,1995,2650,7904,9928 days 16:47:18.687817,303,1.3333333333333333,0.0,-10,-360,2640.0
544000.0,3,2.5,1460,1613,2.0,3,8,1180,280.0,2007,1460,1403,5545 days 16:47:18.687817,181,1.2,4.214285714285714,0,210,900.0
800000.0,2,1.0,1570,5000,1.5,4,8,1570,0.0,1924,1760,3000,35861 days 16:47:18.687817,118,2.0,0.0,-190,2000,1570.0
315000.0,3,1.0,1010,7500,1.0,4,7,1010,0.0,1975,1250,10000,17233 days 16:47:18.687817,234,3.0,0.0,-240,-2500,1010.0
227000.0,4,1.0,1200,7200,1.5,3,6,1200,0.0,1944,1070,6050,28556 days 16:47:18.687817,161,4.0,0.0,130,1150,1200.0
765000.0,4,2.5,4040,25752,2.0,3,1,4040,0.0,2000,3230,22247,8102 days 16:47:18.687817,293,1.6,0.0,810,3505,4040.0
625000.0,3,3.0,1820,1641,3.0,3,8,1540,280.0,2006,1720,1501,5910 days 16:47:18.687817,183,1.0,5.5,100,140,1260.0
1880000.0,4,5.0,5810,7440,2.0,3,1,3790,2020.0,2004,3010,7200,6641 days 16:47:18.687817,245,0.8,1.8762376237623761,2800,240,1770.0
822600.0,4,2.5,3010,9600,1.0,3,9,1510,1500.0,1979,2780,10000,15772 days 16:47:18.687817,042,1.6,1.0066666666666666,230,-400,10.0
515000.0,4,2.5,1910,8947,1.0,4,8,1160,750.0,1970,1920,7350,19059 days 16:47:18.687817,113,1.6,1.5466666666666666,-10,1597,410.0
377000.0,4,2.0,1640,5014,1.0,4,7,930,710.0,1982,1600,5452,14676 days 16:47:18.687817,132,2.0,1.3098591549295775,40,-438,220.0
600000.0,3,1.0,1480,17360,1.0,3,8,1480,0.0,1954,2250,8720,24903 days 16:47:18.687817,063,3.0,0.0,-770,8640,1480.0
525300.0,4,1.75,2520,7770,1.0,3,8,1680,840.0,1965,2340,7770,20885 days 16:47:18.687817,318,2.2857142857142856,2.0,180,0,840.0
760000.0,4,3.0,2840,13554,1.0,4,9,1990,850.0,1974,2840,16940,17598 days 16:47:18.687817,226,1.3333333333333333,2.3411764705882354,0,-3386,1140.0
202000.0,2,1.0,840,7200,1.0,4,5,840,0.0,1907,1030,7200,42070 days 16:47:18.687817,363,2.0,0.0,-190,0,840.0
470000.0,3,2.0,1730,38884,1.0,3,8,1730,0.0,1997,2130,91040,9197 days 16:47:18.687817,170,1.5,0.0,-400,-52156,1730.0
810000.0,3,2.5,3140,10983,2.0,3,1,3140,0.0,1991,3140,10983,11389 days 16:47:18.687817,206,1.2,0.0,0,0,3140.0
175000.0,3,1.0,1480,8415,1.0,3,7,1080,400.0,1967,1780,8512,20155 days 16:47:18.687817,075,3.0,2.7,-300,-97,680.0
440000.0,4,1.75,1920,7986,1.0,3,7,960,960.0,1952,1700,7452,25634 days 16:47:18.687817,288,2.2857142857142856,1.0,220,534,0.0
197000.0,2,1.0,770,8636,1.0,2,6,770,0.0,1951,1110,8636,25999 days 16:47:18.687817,089,2.0,0.0,-340,0,770.0
254000.0,3,1.0,1010,7384,1.0,5,6,1010,0.0,1943,1010,8000,28921 days 16:47:18.687817,065,3.0,0.0,0,-616,1010.0
405000.0,3,1.0,1460,10000,1.5,3,7,1460,0.0,2002,1910,10000,7371 days 16:47:18.687817,171,3.0,0.0,-450,0,1460.0
416000.0,2,1.0,940,4264,1.0,5,7,940,0.0,1949,1630,4472,26729 days 16:47:18.687817,086,2.0,0.0,-690,-208,940.0
779950.0,4,2.75,2840,4864,3.0,3,9,2840,0.0,2014,2990,5314,2988 days 16:47:18.687817,262,1.4545454545454546,0.0,-150,-450,2840.0
200000.0,4,2.75,1910,7210,1.0,4,7,1430,480.0,1980,1750,7446,15407 days 16:47:18.687817,012,1.4545454545454546,2.9791666666666665,160,-236,950.0
658100.0,4,2.5,2430,8509,2.0,3,9,2430,0.0,1992,2760,8509,11024 days 16:47:18.687817,198,1.6,0.0,-330,0,2430.0
397000.0,2,1.75,1610,4104,1.0,3,7,950,660.0,1996,1510,5284,9563 days 16:47:18.687817,195,1.1428571428571428,1.4393939393939394,100,-1180,290.0
815000.0,3,3.75,2780,5002,2.0,3,1,2780,0.0,1999,3110,5717,8467 days 16:47:18.687817,288,0.8,0.0,-330,-715,2780.0
345000.0,2,1.0,1160,8504,1.0,4,7,1160,0.0,1949,1320,8504,26729 days 16:47:18.687817,289,2.0,0.0,-160,0,1160.0
340000.0,3,2.25,2120,13090,1.0,3,8,2120,0.0,1997,1400,12039,9197 days 16:47:18.687817,189,1.3333333333333333,0.0,720,1051,2120.0
330000.0,5,2.5,2620,12763,1.0,3,7,1400,1220.0,1979,2390,9156,15772 days 16:47:18.687817,057,2.0,1.1475409836065573,230,3607,180.0
269000.0,4,2.5,2060,3608,2.0,3,7,2060,0.0,2004,2060,3608,6641 days 16:47:18.687817,111,1.6,0.0,0,0,2060.0
431000.0,3,1.0,1500,6240,1.0,4,7,1500,0.0,1953,1230,6240,25268 days 16:47:18.687817,063,3.0,0.0,270,0,1500.0
735000.0,4,1.75,2380,5700,2.0,4,7,1820,560.0,1946,2190,5700,27825 days 16:47:18.687817,290,2.2857142857142856,3.25,190,0,1260.0
414000.0,5,3.0,3045,5030,2.0,3,8,3045,0.0,1999,3045,5322,8467 days 16:47:18.687817,198,1.6666666666666667,0.0,0,-292,3045.0
619500.0,3,2.5,1700,4105,2.0,3,8,1700,0.0,1992,1880,3665,11024 days 16:47:18.687817,140,1.2,0.0,-180,440,1700.0
675000.0,3,1.75,1240,13869,1.0,4,7,1240,0.0,1957,1970,7790,23807 days 16:47:18.687817,303,1.7142857142857142,0.0,-730,6079,1240.0
380500.0,3,1.0,1410,7854,1.0,4,7,1410,0.0,1971,1460,7500,18694 days 16:47:18.687817,113,3.0,0.0,-50,354,1410.0
253000.0,3,1.5,880,6600,1.0,5,6,880,0.0,1945,1020,6600,28190 days 16:47:18.687817,168,2.0,0.0,-140,0,880.0
157500.0,2,1.0,740,9003,1.0,3,5,740,0.0,1949,1230,8050,26729 days 16:47:18.687817,148,2.0,0.0,-490,953,740.0
627000.0,4,2.0,2030,9300,1.0,4,8,2030,0.0,1976,1800,9018,16868 days 16:47:18.687817,160,2.0,0.0,230,282,2030.0
469500.0,4,2.5,2090,7241,1.0,4,7,1140,950.0,2001,1510,7402,7736 days 16:47:18.687817,267,1.6,1.2,580,-161,190.0
319950.0,2,1.0,920,8341,1.0,3,7,920,0.0,1939,2330,9792,30382 days 16:47:18.687817,170,2.0,0.0,-1410,-1451,920.0
249500.0,3,1.0,1180,7200,1.0,4,7,1180,0.0,1968,1180,7200,19790 days 16:47:18.687817,049,3.0,0.0,0,0,1180.0
485000.0,3,1.0,1260,3230,1.5,3,7,1260,0.0,1907,1700,3500,42070 days 16:47:18.687817,054,3.0,0.0,-440,-270,1260.0
1130000.0,5,3.0,3690,10260,1.0,4,9,2070,1620.0,1967,3160,14000,20155 days 16:47:18.687817,297,1.6666666666666667,1.2777777777777777,530,-3740,450.0
314500.0,3,1.75,1700,17355,1.0,3,7,1200,500.0,1978,1900,9528,16137 days 16:47:18.687817,179,1.7142857142857142,2.4,-200,7827,700.0
220000.0,2,1.0,770,8149,1.0,3,6,770,0.0,1948,880,8149,27095 days 16:47:18.687817,093,2.0,0.0,-110,0,770.0
444950.0,3,2.5,2020,7800,1.0,4,7,1330,690.0,1958,1870,7800,23442 days 16:47:18.687817,328,1.2,1.9275362318840579,150,0,640.0
598000.0,4,2.5,2030,9825,1.0,3,8,1330,700.0,1985,2180,7500,13580 days 16:47:18.687817,237,1.6,1.9,-150,2325,630.0
699850.0,4,3.5,2690,6164,2.0,3,9,2690,0.0,2002,2910,5000,7371 days 16:47:18.687817,167,1.1428571428571428,0.0,-220,1164,2690.0
595000.0,3,2.5,1750,3354,2.0,4,7,1750,0.0,1991,1750,4286,11389 days 16:47:18.687817,128,1.2,0.0,0,-932,1750.0
735000.0,4,2.5,3270,45537,2.0,3,9,3270,0.0,1993,2670,38827,10658 days 16:47:18.687817,352,1.6,0.0,600,6710,3270.0
542500.0,4,2.5,2330,14289,2.0,4,8,2330,0.0,1978,2210,12823,16137 days 16:47:18.687817,129,1.6,0.0,120,1466,2330.0
450000.0,3,1.75,1720,6960,1.0,3,7,1140,580.0,1978,1720,7280,16137 days 16:47:18.687817,132,1.7142857142857142,1.9655172413793103,0,-320,560.0
298500.0,3,2.0,2420,8800,1.0,4,7,1420,1000.0,1959,1546,8666,23077 days 16:47:18.687817,209,1.5,1.42,874,134,420.0
403950.0,2,1.0,710,1136,2.0,4,7,710,0.0,1943,1370,1173,28921 days 16:47:18.687817,160,2.0,0.0,-660,-37,710.0
335000.0,2,1.0,1510,3844,1.0,4,7,1510,0.0,1923,1170,3844,36226 days 16:47:18.687817,254,2.0,0.0,340,0,1510.0
305000.0,2,2.25,1610,1968,2.0,5,7,1610,0.0,1979,1950,1968,15772 days 16:47:18.687817,350,0.8888888888888888,0.0,-340,0,1610.0
630000.0,3,3.0,1880,2200,2.0,3,8,1520,360.0,2007,1500,1426,5545 days 16:47:18.687817,076,1.0,4.222222222222222,380,774,1160.0
253000.0,2,1.75,1220,5000,1.0,5,7,860,360.0,1921,1120,5000,36956 days 16:47:18.687817,154,1.1428571428571428,2.388888888888889,100,0,500.0
395000.0,4,1.75,2060,7900,1.0,4,7,1070,990.0,1957,1830,8000,23807 days 16:47:18.687817,262,2.2857142857142856,1.0808080808080809,230,-100,80.0
265000.0,3,2.5,1340,10290,1.0,4,7,1140,200.0,1981,1760,7903,15041 days 16:47:18.687817,290,1.2,5.7,-420,2387,940.0
225000.0,2,1.0,1030,9192,1.0,4,6,1030,0.0,1959,1030,9190,23077 days 16:47:18.687817,202,2.0,0.0,0,2,1030.0
338500.0,4,2.5,2717,4513,2.0,3,8,2717,0.0,2005,2550,4841,6275 days 16:47:18.687817,260,1.6,0.0,167,-328,2717.0
300000.0,2,1.75,1360,8100,1.0,3,7,860,500.0,1975,1830,6766,17233 days 16:47:18.687817,132,1.1428571428571428,1.72,-470,1334,360.0
255000.0,2,1.0,1260,7810,2.0,3,6,1260,0.0,1945,1260,7755,28190 days 16:47:18.687817,232,2.0,0.0,0,55,1260.0
337000.0,4,3.0,2240,8504,2.0,3,7,2240,0.0,1992,1570,8460,11024 days 16:47:18.687817,171,1.3333333333333333,0.0,670,44,2240.0
324900.0,3,2.25,2080,9740,2.0,3,8,2080,0.0,1988,2080,8705,12485 days 16:47:18.687817,106,1.3333333333333333,0.0,0,1035,2080.0
821000.0,3,2.75,2760,8476,1.0,4,8,1690,1070.0,1967,2610,9835,20155 days 16:47:18.687817,188,1.0909090909090908,1.5794392523364487,150,-1359,620.0
500000.0,4,2.75,3000,213008,1.0,4,8,3000,0.0,1975,2300,74191,17233 days 16:47:18.687817,346,1.4545454545454546,0.0,700,138817,3000.0
885000.0,4,3.5,3310,6000,2.0,3,8,2200,1110.0,2010,1420,6000,4449 days 16:47:18.687817,061,1.1428571428571428,1.981981981981982,1890,0,1090.0
360000.0,4,2.0,1630,10375,1.0,5,7,1630,0.0,1968,1360,10026,19790 days 16:47:18.687817,161,2.0,0.0,270,349,1630.0
304000.0,3,1.0,900,7500,1.0,4,7,900,0.0,1972,1960,7500,18329 days 16:47:18.687817,147,3.0,0.0,-1060,0,900.0
376000.0,2,1.0,880,2400,1.0,3,6,760,120.0,1918,1180,6300,38052 days 16:47:18.687817,075,2.0,6.333333333333333,-300,-3900,640.0
425000.0,4,1.5,1620,7875,1.0,3,7,1620,0.0,1956,1890,8400,24173 days 16:47:18.687817,308,2.6666666666666665,0.0,-270,-525,1620.0
1180000.0,3,1.75,1610,7200,1.0,3,8,1090,520.0,1973,3790,7200,17963 days 16:47:18.687817,142,1.7142857142857142,2.0961538461538463,-2180,0,570.0
187000.0,3,2.5,1730,1803,2.0,3,7,1730,0.0,2005,1190,7980,6275 days 16:47:18.687817,203,1.2,0.0,540,-6177,1730.0
710000.0,2,1.5,1640,4080,1.5,5,7,1540,100.0,1916,1880,4080,38783 days 16:47:18.687817,178,1.3333333333333333,15.4,-240,0,1440.0
585000.0,3,1.75,1840,7350,1.0,3,8,1370,470.0,1974,1920,8518,17598 days 16:47:18.687817,084,1.7142857142857142,2.9148936170212765,-80,-1168,900.0
1400000.0,5,4.0,4700,22326,2.0,3,1,4700,0.0,2002,4730,27110,7371 days 16:47:18.687817,099,1.25,0.0,-30,-4784,4700.0
1980000.0,4,3.5,4500,44384,1.0,3,1,3340,1160.0,1990,2540,26287,11754 days 16:47:18.687817,056,1.1428571428571428,2.8793103448275863,1960,18097,2180.0
250000.0,3,1.75,1780,35233,1.0,4,8,1420,360.0,1979,1950,17334,15772 days 16:47:18.687817,360,1.7142857142857142,3.9444444444444446,-170,17899,1060.0
950000.0,4,2.75,3800,12200,2.0,4,1,3800,0.0,1986,3710,14796,13215 days 16:47:18.687817,352,1.4545454545454546,0.0,90,-2596,3800.0
725000.0,3,2.5,2980,16996,2.0,3,1,2980,0.0,1992,2980,15438,11024 days 16:47:18.687817,245,1.2,0.0,0,1558,2980.0
505000.0,4,2.5,2780,6369,1.0,3,8,1590,1190.0,1978,2170,7490,16137 days 16:47:18.687817,132,1.6,1.3361344537815125,610,-1121,400.0
90000.0,1,1.0,560,4120,1.0,3,4,560,0.0,1947,980,4120,27460 days 16:47:18.687817,108,1.0,0.0,-420,0,560.0
400000.0,4,2.0,2060,3060,2.0,3,7,2060,0.0,1968,1630,3766,19790 days 16:47:18.687817,099,2.0,0.0,430,-706,2060.0
407000.0,3,1.0,1140,7785,1.0,3,8,1140,0.0,1954,2080,10620,24903 days 16:47:18.687817,048,3.0,0.0,-940,-2835,1140.0
651000.0,3,1.5,1890,4400,1.5,5,7,1890,0.0,1919,1620,4080,37687 days 16:47:18.687817,353,2.0,0.0,270,320,1890.0
485000.0,3,2.25,2090,7450,1.0,3,7,1350,740.0,1978,1740,7644,16137 days 16:47:18.687817,036,1.3333333333333333,1.8243243243243243,350,-194,610.0
460000.0,4,2.75,3460,13168,2.0,4,8,3460,0.0,1932,1500,7670,32939 days 16:47:18.687817,013,1.4545454545454546,0.0,1960,5498,3460.0
369000.0,2,1.0,1320,6135,1.0,4,7,880,440.0,1942,1050,4693,29286 days 16:47:18.687817,068,2.0,2.0,270,1442,440.0
355000.0,2,1.0,1240,27042,1.0,3,6,1000,240.0,1943,2140,20059,28921 days 16:47:18.687817,171,2.0,4.166666666666667,-900,6983,760.0
155000.0,2,1.0,810,4755,1.0,3,7,810,0.0,1980,1180,4755,15407 days 16:47:18.687817,259,2.0,0.0,-370,0,810.0
1000000.0,3,1.0,1880,5450,1.5,4,8,1880,0.0,1924,2580,5450,35861 days 16:47:18.687817,349,3.0,0.0,-700,0,1880.0
419625.0,4,2.5,2680,11590,2.0,4,9,2680,0.0,1988,2580,8225,12485 days 16:47:18.687817,042,1.6,0.0,100,3365,2680.0
435000.0,3,2.0,2040,6880,2.0,4,7,2040,0.0,1954,1710,7597,24903 days 16:47:18.687817,049,1.5,0.0,330,-717,2040.0
379000.0,4,1.75,2180,7876,1.0,4,7,1290,890.0,1977,1960,7225,16502 days 16:47:18.687817,131,2.2857142857142856,1.449438202247191,220,651,400.0
293000.0,4,2.25,1870,5371,2.0,3,7,1870,0.0,2009,2380,4502,4814 days 16:47:18.687817,055,1.7777777777777777,0.0,-510,869,1870.0
592100.0,4,2.75,2310,7851,1.0,4,8,1790,520.0,1989,2230,7359,12119 days 16:47:18.687817,218,1.4545454545454546,3.4423076923076925,80,492,1270.0
362000.0,3,1.75,1120,9730,1.0,3,7,1120,0.0,1944,2530,8717,28556 days 16:47:18.687817,314,1.7142857142857142,0.0,-1410,1013,1120.0
227000.0,3,1.0,1340,10035,1.0,3,7,1340,0.0,1959,2090,10035,23077 days 16:47:18.687817,337,3.0,0.0,-750,0,1340.0
335500.0,3,1.75,1260,8487,1.0,3,7,1260,0.0,1970,1890,13051,19059 days 16:47:18.687817,231,1.7142857142857142,0.0,-630,-4564,1260.0
213000.0,3,1.75,1200,55321,1.5,5,7,1200,0.0,1977,1910,54450,16502 days 16:47:18.687817,230,1.7142857142857142,0.0,-710,871,1200.0
338000.0,5,2.5,2400,4496,2.0,3,7,2400,0.0,2004,1880,4319,6641 days 16:47:18.687817,085,2.0,0.0,520,177,2400.0
163500.0,3,1.0,940,7200,1.0,4,7,940,0.0,1954,1090,7800,24903 days 16:47:18.687817,295,3.0,0.0,-150,-600,940.0
199988.0,2,1.0,860,5000,1.0,3,7,860,0.0,1949,1130,6000,26729 days 16:47:18.687817,328,2.0,0.0,-270,-1000,860.0
1190000.0,3,2.25,2390,7875,1.0,3,1,1980,410.0,1948,3720,9075,27095 days 16:47:18.687817,206,1.3333333333333333,4.829268292682927,-1330,-1200,1570.0
320000.0,4,2.5,3130,5200,2.0,3,7,3130,0.0,2005,3020,5200,6275 days 16:47:18.687817,097,1.6,0.0,110,0,3130.0
450000.0,6,2.25,3550,11780,1.0,4,8,2960,590.0,1948,2360,8850,27095 days 16:47:18.687817,167,2.6666666666666665,5.016949152542373,1190,2930,2370.0
249900.0,2,2.0,1470,2541,2.0,3,6,1470,0.0,2005,1310,2721,6275 days 16:47:18.687817,303,1.0,0.0,160,-180,1470.0
223000.0,2,1.0,910,9869,1.0,3,6,910,0.0,1957,1480,9750,23807 days 16:47:18.687817,163,2.0,0.0,-570,119,910.0
631000.0,4,4.0,2630,59586,1.0,3,7,1470,1160.0,1963,2230,5715,21616 days 16:47:18.687817,041,1.0,1.2672413793103448,400,53871,310.0
350000.0,4,2.25,1780,10416,1.0,5,7,1060,720.0,1963,1780,9975,21616 days 16:47:18.687817,125,1.7777777777777777,1.4722222222222223,0,441,340.0
279000.0,3,1.75,1430,39160,1.0,3,7,900,530.0,1925,1430,40860,35495 days 16:47:18.687817,195,1.7142857142857142,1.6981132075471699,0,-1700,370.0
310000.0,5,2.0,2730,7344,1.0,5,7,1510,1220.0,1962,1730,7700,21981 days 16:47:18.687817,099,2.5,1.2377049180327868,1000,-356,290.0
185000.0,2,1.0,900,8000,1.0,4,6,900,0.0,1954,1240,8000,24903 days 16:47:18.687817,224,2.0,0.0,-340,0,900.0
445000.0,3,2.5,1740,22089,1.0,4,8,1130,610.0,1977,2000,24925,16502 days 16:47:18.687817,075,1.2,1.8524590163934427,-260,-2836,520.0
365000.0,4,2.5,2905,4874,2.0,3,9,2905,0.0,2003,2900,5271,7006 days 16:47:18.687817,346,1.6,0.0,5,-397,2905.0
333500.0,3,1.5,2230,9120,1.0,3,7,1390,840.0,1959,1420,8450,23077 days 16:47:18.687817,113,2.0,1.6547619047619047,810,670,550.0
385000.0,3,2.25,1680,8450,1.0,3,8,1340,340.0,1960,1850,8300,22712 days 16:47:18.687817,324,1.3333333333333333,3.9411764705882355,-170,150,1000.0
1260000.0,3,3.0,3230,8625,2.0,3,1,2220,1010.0,1998,2330,6022,8832 days 16:47:18.687817,314,1.0,2.198019801980198,900,2603,1210.0
440000.0,4,2.5,2560,10400,1.0,4,7,1280,1280.0,1965,1740,11050,20885 days 16:47:18.687817,143,1.6,1.0,820,-650,0.0
444500.0,3,2.5,2600,4724,2.0,3,7,2600,0.0,2002,2400,4724,7371 days 16:47:18.687817,268,1.2,0.0,200,0,2600.0
340000.0,4,1.0,1200,11834,1.0,3,6,1200,0.0,1972,1670,47462,18329 days 16:47:18.687817,317,4.0,0.0,-470,-35628,1200.0
680000.0,4,1.0,1660,6075,1.5,5,7,1660,0.0,1915,1810,5400,39148 days 16:47:18.687817,071,4.0,0.0,-150,675,1660.0
420000.0,3,1.75,1140,8558,1.0,4,7,1140,0.0,1982,1490,10530,14676 days 16:47:18.687817,252,1.7142857142857142,0.0,-350,-1972,1140.0
438500.0,3,2.25,3050,10689,2.0,4,9,3050,0.0,1988,2697,10925,12485 days 16:47:18.687817,363,1.3333333333333333,0.0,353,-236,3050.0
109500.0,2,1.0,800,10625,1.0,3,6,800,0.0,1942,1130,10625,29286 days 16:47:18.687817,261,2.0,0.0,-330,0,800.0
461000.0,4,2.75,1700,7495,1.0,4,7,1200,500.0,1964,1650,7495,21251 days 16:47:18.687817,100,1.4545454545454546,2.4,50,0,700.0
968000.0,4,1.75,2630,9645,1.0,4,9,2630,0.0,1963,2690,10439,21616 days 16:47:18.687817,223,2.2857142857142856,0.0,-60,-794,2630.0
355000.0,3,1.75,1960,7705,1.0,4,7,980,980.0,1950,1380,4349,26364 days 16:47:18.687817,266,1.7142857142857142,1.0,580,3356,0.0
249000.0,3,1.5,1180,11579,1.0,4,7,1180,0.0,1962,1780,22486,21981 days 16:47:18.687817,086,2.0,0.0,-600,-10907,1180.0
256500.0,5,2.5,1960,7350,1.0,4,7,1360,600.0,1969,1900,7350,19424 days 16:47:18.687817,085,2.0,2.2666666666666666,60,0,760.0
1810000.0,5,2.5,4250,20441,1.0,4,1,2490,1760.0,1984,3620,16304,13946 days 16:47:18.687817,061,2.0,1.4147727272727273,630,4137,730.0
269000.0,3,2.25,1950,8661,1.0,4,8,1950,0.0,1966,1950,8800,20520 days 16:47:18.687817,357,1.3333333333333333,0.0,0,-139,1950.0
1350000.0,4,3.5,3600,5217,2.0,3,9,2720,880.0,1947,2270,5217,27460 days 16:47:18.687817,316,1.1428571428571428,3.090909090909091,1330,0,1840.0
885000.0,3,2.25,2060,9552,1.0,4,9,1610,450.0,1975,2930,11212,17233 days 16:47:18.687817,171,1.3333333333333333,3.577777777777778,-870,-1660,1160.0
455000.0,3,2.0,1640,9825,1.0,4,7,1090,550.0,1971,1500,9750,18694 days 16:47:18.687817,113,1.5,1.981818181818182,140,75,540.0
980000.0,4,2.5,2730,4800,1.5,5,8,2230,500.0,1909,2190,4200,41339 days 16:47:18.687817,160,1.6,4.46,540,600,1730.0
412500.0,3,1.75,1530,6300,1.0,3,6,1530,0.0,1942,920,6300,29286 days 16:47:18.687817,213,1.7142857142857142,0.0,610,0,1530.0
740000.0,4,3.5,3060,4777,2.0,3,9,3060,0.0,2007,3060,4935,5545 days 16:47:18.687817,351,1.1428571428571428,0.0,0,-158,3060.0
1300000.0,4,2.25,2860,5658,2.0,3,1,2130,730.0,1933,2700,5221,32573 days 16:47:18.687817,235,1.7777777777777777,2.9178082191780823,160,437,1400.0
326000.0,2,1.5,1030,798,3.0,3,8,1030,0.0,2008,1020,1026,5180 days 16:47:18.687817,071,1.3333333333333333,0.0,10,-228,1030.0
568500.0,4,2.5,2460,4200,2.0,3,8,2460,0.0,1998,2460,4200,8832 days 16:47:18.687817,158,1.6,0.0,0,0,2460.0
620000.0,4,2.5,2500,8282,2.0,3,9,2500,0.0,2013,2500,8046,3353 days 16:47:18.687817,265,1.6,0.0,0,236,2500.0
283000.0,3,1.75,1830,7600,2.0,3,7,1490,340.0,1947,1300,4000,27460 days 16:47:18.687817,107,1.7142857142857142,4.382352941176471,530,3600,1150.0
875000.0,6,3.25,2820,4536,2.0,4,8,1930,890.0,1917,2820,4536,38417 days 16:47:18.687817,226,1.8461538461538463,2.168539325842697,0,0,1040.0
1310000.0,4,2.25,3750,5000,2.0,5,8,2440,1310.0,1924,2170,4590,35861 days 16:47:18.687817,147,1.7777777777777777,1.8625954198473282,1580,410,1130.0
289950.0,3,2.5,2070,6145,2.0,3,7,2070,0.0,2003,2070,5297,7006 days 16:47:18.687817,296,1.2,0.0,0,848,2070.0
252500.0,3,2.5,1780,7192,1.0,4,7,1250,530.0,1974,1870,8500,17598 days 16:47:18.687817,318,1.2,2.358490566037736,-90,-1308,720.0
376000.0,4,2.25,2200,6750,1.0,5,8,1480,720.0,1959,2710,6750,23077 days 16:47:18.687817,302,1.7777777777777777,2.0555555555555554,-510,0,760.0
635700.0,4,2.5,3240,13978,1.0,3,9,1860,1380.0,1977,3150,12767,16502 days 16:47:18.687817,142,1.6,1.3478260869565217,90,1211,480.0
710000.0,4,2.5,2880,12349,2.0,3,1,2880,0.0,1996,3490,11539,9563 days 16:47:18.687817,301,1.6,0.0,-610,810,2880.0
440000.0,3,1.75,1570,5120,1.0,3,7,980,590.0,1947,2420,7200,27460 days 16:47:18.687817,060,1.7142857142857142,1.6610169491525424,-850,-2080,390.0
439000.0,3,2.5,3180,7904,1.0,3,8,1810,1370.0,2006,1950,7800,5910 days 16:47:18.687817,181,1.2,1.3211678832116789,1230,104,440.0
455000.0,2,1.5,1310,12196,1.5,3,6,1310,0.0,1970,2970,12196,19059 days 16:47:18.687817,167,1.3333333333333333,0.0,-1660,0,1310.0
225000.0,2,1.0,910,9612,1.0,4,7,910,0.0,1981,1410,9611,15041 days 16:47:18.687817,139,2.0,0.0,-500,1,910.0
250000.0,3,1.0,1460,10914,1.0,4,7,1460,0.0,1959,1490,8314,23077 days 16:47:18.687817,209,3.0,0.0,-30,2600,1460.0
585000.0,4,3.25,3410,34939,2.0,4,9,2470,940.0,1992,2450,39045,11024 days 16:47:18.687817,097,1.2307692307692308,2.627659574468085,960,-4106,1530.0
685000.0,3,1.75,2720,4720,1.5,4,7,1580,1140.0,1925,1660,4640,35495 days 16:47:18.687817,097,1.7142857142857142,1.3859649122807018,1060,80,440.0
420000.0,5,2.75,2280,10319,1.0,3,8,1300,980.0,1959,2370,8056,23077 days 16:47:18.687817,171,1.8181818181818181,1.3265306122448979,-90,2263,320.0
245000.0,2,1.0,670,1675,1.0,5,6,670,0.0,1960,1220,1740,22712 days 16:47:18.687817,326,2.0,0.0,-550,-65,670.0
275000.0,4,2.0,1480,15000,1.0,4,7,1480,0.0,1957,1450,8768,23807 days 16:47:18.687817,308,2.0,0.0,30,6232,1480.0
270000.0,3,2.0,2330,8000,1.0,3,7,1390,940.0,1986,1570,7227,13215 days 16:47:18.687817,302,1.5,1.4787234042553192,760,773,450.0
767250.0,4,3.0,2170,2500,2.0,3,8,1710,460.0,1997,2170,4080,9197 days 16:47:18.687817,294,1.3333333333333333,3.717391304347826,0,-1580,1250.0
229000.0,3,2.0,1760,9900,1.0,4,7,1760,0.0,1943,1190,9900,28921 days 16:47:18.687817,247,1.5,0.0,570,0,1760.0
400000.0,3,1.0,1240,4000,1.5,3,8,1240,0.0,1928,1200,17707,34400 days 16:47:18.687817,117,3.0,0.0,40,-13707,1240.0
2200000.0,5,3.25,5210,35765,2.5,5,1,4940,270.0,1911,2590,10250,40609 days 16:47:18.687817,224,1.5384615384615385,18.296296296296298,2620,25515,4670.0
665000.0,5,2.0,2800,17788,1.0,4,8,1400,1400.0,1963,1760,18282,21616 days 16:47:18.687817,188,2.5,1.0,1040,-494,0.0
500000.0,4,2.25,2060,44431,2.0,3,7,2060,0.0,1988,2160,45657,12485 days 16:47:18.687817,082,1.7777777777777777,0.0,-100,-1226,2060.0
355500.0,5,2.0,2360,19899,1.0,4,7,2360,0.0,1968,1860,19998,19790 days 16:47:18.687817,091,2.5,0.0,500,-99,2360.0
369000.0,4,2.5,2370,6557,2.0,3,9,2370,0.0,1998,2370,7378,8832 days 16:47:18.687817,339,1.6,0.0,0,-821,2370.0
338500.0,2,1.0,720,6050,1.0,2,5,720,0.0,1951,1480,7280,25999 days 16:47:18.687817,033,2.0,0.0,-760,-1230,720.0
256000.0,3,1.0,950,4000,1.0,3,7,780,170.0,1949,1230,4000,26729 days 16:47:18.687817,119,3.0,4.588235294117647,-280,0,610.0
470000.0,3,2.5,1980,9725,2.0,3,8,1980,0.0,1994,2070,9834,10293 days 16:47:18.687817,063,1.2,0.0,-90,-109,1980.0
675000.0,3,2.5,2540,7680,2.0,4,9,2540,0.0,1940,2490,7680,30017 days 16:47:18.687817,147,1.2,0.0,50,0,2540.0
369950.0,4,2.75,2760,7533,1.0,3,8,1400,1360.0,1997,2340,7943,9197 days 16:47:18.687817,314,1.4545454545454546,1.0294117647058822,420,-410,40.0
615000.0,5,3.5,2950,7980,2.0,3,9,2350,600.0,2005,2950,7980,6275 days 16:47:18.687817,258,1.4285714285714286,3.9166666666666665,0,0,1750.0
1200000.0,5,3.0,3640,28531,2.0,3,1,3640,0.0,1996,3330,17186,9563 days 16:47:18.687817,125,1.6666666666666667,0.0,310,11345,3640.0
950000.0,3,1.75,2150,3503,2.0,3,8,1870,280.0,1921,3920,6402,36956 days 16:47:18.687817,209,1.7142857142857142,6.678571428571429,-1770,-2899,1590.0
799500.0,4,2.5,2760,5750,2.0,3,8,2760,0.0,1993,2760,5390,10658 days 16:47:18.687817,294,1.6,0.0,0,360,2760.0
187000.0,2,1.0,840,11600,1.0,3,6,840,0.0,1952,1610,9120,25634 days 16:47:18.687817,190,2.0,0.0,-770,2480,840.0
598000.0,5,2.25,2890,12478,2.0,3,9,2890,0.0,1977,2570,11880,16502 days 16:47:18.687817,140,2.2222222222222223,0.0,320,598,2890.0
429950.0,3,2.25,2060,10160,1.0,4,8,1340,720.0,1967,2320,11186,20155 days 16:47:18.687817,107,1.3333333333333333,1.8611111111111112,-260,-1026,620.0
347950.0,5,2.25,1700,13500,1.5,4,7,1700,0.0,1962,1810,14550,21981 days 16:47:18.687817,090,2.2222222222222223,0.0,-110,-1050,1700.0
851000.0,3,2.5,3560,107290,2.0,3,1,3560,0.0,1987,3660,89298,12850 days 16:47:18.687817,129,1.2,0.0,-100,17992,3560.0
205000.0,3,1.0,1210,10185,1.0,3,6,1210,0.0,1957,1320,10245,23807 days 16:47:18.687817,302,3.0,0.0,-110,-60,1210.0
225000.0,3,2.25,1590,9200,1.0,4,7,1110,480.0,1979,1880,9200,15772 days 16:47:18.687817,086,1.3333333333333333,2.3125,-290,0,630.0
705000.0,4,2.25,2620,10536,1.0,3,8,1520,1100.0,1979,2760,12431,15772 days 16:47:18.687817,279,1.7777777777777777,1.3818181818181818,-140,-1895,420.0
535000.0,5,2.5,3190,6178,2.0,3,8,3190,0.0,2003,2480,7548,7006 days 16:47:18.687817,125,2.0,0.0,710,-1370,3190.0
222500.0,3,2.0,1450,9044,2.0,3,7,1450,0.0,1990,1450,9044,11754 days 16:47:18.687817,021,1.5,0.0,0,0,1450.0
313500.0,2,1.5,1270,1282,2.0,3,8,1000,270.0,2006,1270,1325,5910 days 16:47:18.687817,114,1.3333333333333333,3.7037037037037037,0,-43,730.0
632000.0,3,2.25,2730,7521,2.0,3,9,2730,0.0,1992,2700,8204,11024 days 16:47:18.687817,076,1.3333333333333333,0.0,30,-683,2730.0
467000.0,3,2.0,1840,3432,2.0,3,7,1840,0.0,2012,1280,7573,3719 days 16:47:18.687817,081,1.5,0.0,560,-4141,1840.0
339000.0,3,2.25,1970,7210,1.0,4,8,1380,590.0,1978,1970,7350,16137 days 16:47:18.687817,114,1.3333333333333333,2.3389830508474576,0,-140,790.0
712000.0,3,2.75,3200,6699,2.0,3,9,3200,0.0,2004,3020,6699,6641 days 16:47:18.687817,170,1.0909090909090908,0.0,180,0,3200.0
335000.0,3,1.0,1060,10050,1.0,4,7,1060,0.0,1967,1570,9938,20155 days 16:47:18.687817,140,3.0,0.0,-510,112,1060.0
470000.0,3,3.25,1740,1693,2.0,3,8,1360,380.0,2007,1130,1626,5545 days 16:47:18.687817,198,0.9230769230769231,3.5789473684210527,610,67,980.0
367000.0,3,1.0,810,7000,1.0,3,7,810,0.0,1968,1820,7589,19790 days 16:47:18.687817,205,3.0,0.0,-1010,-589,810.0
440500.0,3,2.5,2460,4399,2.0,3,7,2460,0.0,2007,2060,4399,5545 days 16:47:18.687817,144,1.2,0.0,400,0,2460.0
305000.0,4,1.0,2100,9288,1.0,4,7,1050,1050.0,1968,1600,8550,19790 days 16:47:18.687817,147,4.0,1.0,500,738,0.0
635000.0,3,1.75,1530,5000,1.0,3,7,1020,510.0,1948,1530,5000,27095 days 16:47:18.687817,251,1.7142857142857142,2.0,0,0,510.0
1020000.0,3,2.25,1670,4800,1.5,3,8,1670,0.0,1903,2300,4800,43531 days 16:47:18.687817,178,1.3333333333333333,0.0,-630,0,1670.0
342000.0,2,2.5,1175,1366,2.0,3,8,740,435.0,2005,1710,1255,6275 days 16:47:18.687817,153,0.8,1.7011494252873562,-535,111,305.0
283000.0,3,2.25,2130,8800,1.0,3,8,1270,860.0,1978,1960,8075,16137 days 16:47:18.687817,315,1.3333333333333333,1.4767441860465116,170,725,410.0
430000.0,4,2.75,2470,50123,1.0,3,8,1280,1190.0,1978,2200,54520,16137 days 16:47:18.687817,114,1.4545454545454546,1.0756302521008403,270,-4397,90.0
245000.0,4,2.5,1700,4268,2.0,3,7,1700,0.0,2000,1700,4488,8102 days 16:47:18.687817,220,1.6,0.0,0,-220,1700.0
355500.0,3,2.5,2600,5540,2.0,3,8,2600,0.0,2004,2600,5540,6641 days 16:47:18.687817,156,1.2,0.0,0,0,2600.0
395000.0,3,1.0,1460,5000,1.0,4,7,1460,0.0,1934,1790,4000,32208 days 16:47:18.687817,099,3.0,0.0,-330,1000,1460.0
324900.0,4,2.25,2010,7280,2.0,4,8,2010,0.0,1988,1660,7579,12485 days 16:47:18.687817,350,1.7777777777777777,0.0,350,-299,2010.0
660000.0,3,1.75,1320,5750,1.5,5,7,1320,0.0,1918,1440,5750,38052 days 16:47:18.687817,128,1.7142857142857142,0.0,-120,0,1320.0
570000.0,3,2.5,3150,20189,2.0,3,1,3150,0.0,1990,2920,20612,11754 days 16:47:18.687817,223,1.2,0.0,230,-423,3150.0
552321.0,3,2.5,1960,8469,2.0,4,8,1960,0.0,1984,2040,8189,13946 days 16:47:18.687817,310,1.2,0.0,-80,280,1960.0
1100000.0,2,1.75,2050,11900,1.0,4,8,2050,0.0,1950,2980,11900,26364 days 16:47:18.687817,148,1.1428571428571428,0.0,-930,0,2050.0
237000.0,3,1.5,1800,9216,1.0,4,7,1800,0.0,1950,1400,10022,26364 days 16:47:18.687817,237,2.0,0.0,400,-806,1800.0
402000.0,2,1.0,1210,5600,1.5,3,7,1210,0.0,1922,1400,5028,36591 days 16:47:18.687817,124,2.0,0.0,-190,572,1210.0
470000.0,3,2.25,1830,39165,1.0,5,8,1830,0.0,1963,2020,36184,21616 days 16:47:18.687817,289,1.3333333333333333,0.0,-190,2981,1830.0
395900.0,3,1.75,1880,8706,1.0,3,7,940,940.0,1927,1880,7200,34765 days 16:47:18.687817,079,1.7142857142857142,1.0,0,1506,0.0
442000.0,2,1.75,860,5535,1.0,3,7,860,0.0,1948,1420,4960,27095 days 16:47:18.687817,295,1.1428571428571428,0.0,-560,575,860.0
190500.0,3,2.0,1390,10155,1.0,3,7,1130,260.0,1980,1790,10155,15407 days 16:47:18.687817,224,1.5,4.346153846153846,-400,0,870.0
808000.0,4,2.75,3340,7230,2.0,3,9,3340,0.0,1996,3230,7529,9563 days 16:47:18.687817,324,1.4545454545454546,0.0,110,-299,3340.0
500000.0,4,2.5,2040,6685,2.0,3,8,2040,0.0,1998,1890,8253,8832 days 16:47:18.687817,238,1.6,0.0,150,-1568,2040.0
775000.0,4,2.75,3010,15992,2.0,3,1,3010,0.0,1996,3330,12333,9563 days 16:47:18.687817,170,1.4545454545454546,0.0,-320,3659,3010.0
300000.0,5,1.75,2110,8500,1.0,3,7,1100,1010.0,1962,2020,8500,21981 days 16:47:18.687817,314,2.857142857142857,1.0891089108910892,90,0,90.0
496000.0,5,1.75,2110,8500,1.0,3,7,1100,1010.0,1962,2020,8500,21981 days 16:47:18.687817,100,2.857142857142857,1.0891089108910892,90,0,90.0
448000.0,4,2.5,2510,6853,2.0,3,9,2510,0.0,2006,3400,6965,5910 days 16:47:18.687817,171,1.6,0.0,-890,-112,2510.0
645000.0,2,2.25,2770,11884,1.0,4,8,1570,1200.0,1969,2310,17097,19424 days 16:47:18.687817,329,0.8888888888888888,1.3083333333333333,460,-5213,370.0
464600.0,3,1.75,1120,5500,1.5,4,7,1120,0.0,1925,1490,5500,35495 days 16:47:18.687817,143,1.7142857142857142,0.0,-370,0,1120.0
590000.0,3,1.0,1530,2370,2.0,3,8,1530,0.0,1901,1310,2370,44261 days 16:47:18.687817,209,3.0,0.0,220,0,1530.0
399000.0,3,2.5,1800,3300,2.0,3,7,1690,110.0,2004,1570,3902,6641 days 16:47:18.687817,280,1.2,15.363636363636363,230,-602,1580.0
305000.0,2,1.0,1030,6000,1.0,3,7,1030,0.0,1925,1510,5000,35495 days 16:47:18.687817,288,2.0,0.0,-480,1000,1030.0
478000.0,3,1.75,1210,6175,1.0,3,7,1210,0.0,1976,1520,7475,16868 days 16:47:18.687817,325,1.7142857142857142,0.0,-310,-1300,1210.0
598800.0,1,1.0,1090,32010,1.0,4,6,1090,0.0,1958,1870,25346,23442 days 16:47:18.687817,351,1.0,0.0,-780,6664,1090.0
430000.0,4,2.25,1790,7203,1.0,4,7,1110,680.0,1973,2270,9000,17963 days 16:47:18.687817,154,1.7777777777777777,1.6323529411764706,-480,-1797,430.0
433000.0,4,1.5,1550,5053,1.0,4,7,1180,370.0,1963,1450,5639,21616 days 16:47:18.687817,182,2.6666666666666665,3.189189189189189,100,-586,810.0
420000.0,4,2.75,2400,20000,1.0,3,8,1170,1230.0,1961,1690,20000,22346 days 16:47:18.687817,079,1.4545454545454546,0.9512195121951219,710,0,-60.0
585000.0,4,1.75,2470,131790,2.0,3,8,2470,0.0,1937,1470,92747,31112 days 16:47:18.687817,160,2.2857142857142856,0.0,1000,39043,2470.0
255000.0,3,1.0,1170,7395,1.0,4,7,1170,0.0,1969,1430,7920,19424 days 16:47:18.687817,230,3.0,0.0,-260,-525,1170.0
305000.0,3,1.0,1120,10125,1.0,3,6,1120,0.0,1961,1120,8820,22346 days 16:47:18.687817,112,3.0,0.0,0,1305,1120.0
396000.0,4,1.0,1040,4420,1.5,3,6,1040,0.0,1944,1310,4920,28556 days 16:47:18.687817,056,4.0,0.0,-270,-500,1040.0
347500.0,4,2.5,2460,7350,2.0,3,9,2460,0.0,1989,2390,8568,12119 days 16:47:18.687817,128,1.6,0.0,70,-1218,2460.0
900000.0,4,2.5,3690,11468,2.0,3,1,3690,0.0,1987,3370,10751,12850 days 16:47:18.687817,226,1.6,0.0,320,717,3690.0
425000.0,3,1.75,1960,43332,1.0,4,7,1400,560.0,1982,2010,44431,14676 days 16:47:18.687817,273,1.7142857142857142,2.5,-50,-1099,840.0
429000.0,3,2.5,1920,15124,2.0,3,8,1920,0.0,1995,1920,16477,9928 days 16:47:18.687817,139,1.2,0.0,0,-1353,1920.0
540000.0,3,2.25,1670,3135,2.0,3,8,1220,450.0,2002,1630,1596,7371 days 16:47:18.687817,055,1.3333333333333333,2.7111111111111112,40,1539,770.0
324950.0,3,2.0,1340,9750,1.0,4,7,890,450.0,1974,1460,12900,17598 days 16:47:18.687817,027,1.5,1.9777777777777779,-120,-3150,440.0
1050000.0,3,2.25,2610,3357,2.0,4,7,1980,630.0,1926,1940,3357,35130 days 16:47:18.687817,119,1.3333333333333333,3.142857142857143,670,0,1350.0
221000.0,4,1.75,1540,7200,1.0,3,7,1260,280.0,1966,1540,8416,20520 days 16:47:18.687817,302,2.2857142857142856,4.5,0,-1216,980.0
405000.0,3,2.0,1640,7201,1.0,3,8,1640,0.0,1948,1750,7201,27095 days 16:47:18.687817,162,1.5,0.0,-110,0,1640.0
1150000.0,3,2.5,2100,15120,1.0,4,8,2100,0.0,1953,3070,16078,25268 days 16:47:18.687817,007,1.2,0.0,-970,-958,2100.0
588000.0,4,1.75,1930,7245,1.0,4,8,1510,420.0,1972,1880,7245,18329 days 16:47:18.687817,234,2.2857142857142856,3.5952380952380953,50,0,1090.0
580000.0,4,1.5,2430,4995,1.5,4,7,1730,700.0,1928,2240,5000,34400 days 16:47:18.687817,280,2.6666666666666665,2.4714285714285715,190,-5,1030.0
637000.0,5,3.0,2460,7240,1.0,3,9,1840,620.0,1991,2530,7885,11389 days 16:47:18.687817,197,1.6666666666666667,2.967741935483871,-70,-645,1220.0
210000.0,2,1.0,880,9750,1.0,5,6,880,0.0,1938,1220,9406,30747 days 16:47:18.687817,268,2.0,0.0,-340,344,880.0
772000.0,4,2.5,2110,3750,2.0,3,8,2110,0.0,2000,1700,5000,8102 days 16:47:18.687817,136,1.6,0.0,410,-1250,2110.0
763000.0,4,1.75,1850,4388,2.0,5,8,1850,0.0,1941,1410,4107,29651 days 16:47:18.687817,117,2.2857142857142856,0.0,440,281,1850.0
213500.0,2,1.5,2060,7713,1.5,4,7,2060,0.0,1930,1780,7713,33669 days 16:47:18.687817,049,1.3333333333333333,0.0,280,0,2060.0
255000.0,2,1.0,1360,9367,1.0,4,6,680,680.0,1924,1360,7543,35861 days 16:47:18.687817,354,2.0,1.0,0,1824,0.0
423500.0,3,2.0,2000,10490,1.0,3,8,1430,570.0,1978,1530,7659,16137 days 16:47:18.687817,290,1.5,2.508771929824561,470,2831,860.0
520000.0,3,1.5,1810,18483,1.0,3,8,1810,0.0,1954,2920,20279,24903 days 16:47:18.687817,356,2.0,0.0,-1110,-1796,1810.0
550000.0,3,2.75,2230,14400,1.0,4,8,1460,770.0,1977,2200,13280,16502 days 16:47:18.687817,251,1.0909090909090908,1.896103896103896,30,1120,690.0
795000.0,3,2.75,1820,7517,1.0,3,9,1820,0.0,1997,2540,8035,9197 days 16:47:18.687817,021,1.0909090909090908,0.0,-720,-518,1820.0
495000.0,4,3.0,2740,2811,2.0,3,8,2240,500.0,2003,2740,3596,7006 days 16:47:18.687817,227,1.3333333333333333,4.48,0,-785,1740.0
455000.0,4,2.5,2710,6558,2.0,3,9,2710,0.0,1997,2710,7635,9197 days 16:47:18.687817,061,1.6,0.0,0,-1077,2710.0
85000.0,2,1.0,910,9753,1.0,3,5,910,0.0,1947,1160,7405,27460 days 16:47:18.687817,064,2.0,0.0,-250,2348,910.0
239000.0,4,2.0,1980,10585,1.5,2,6,1980,0.0,1924,1360,7810,35861 days 16:47:18.687817,308,2.0,0.0,620,2775,1980.0
184900.0,3,1.0,1040,10080,1.0,3,6,1040,0.0,1959,1000,8736,23077 days 16:47:18.687817,211,3.0,0.0,40,1344,1040.0
386000.0,4,2.25,2810,8560,1.0,3,8,1610,1200.0,1979,2400,7600,15772 days 16:47:18.687817,111,1.7777777777777777,1.3416666666666666,410,960,410.0
415000.0,4,2.5,2000,5962,2.0,3,8,2000,0.0,1999,1790,10500,8467 days 16:47:18.687817,155,1.6,0.0,210,-4538,2000.0
387000.0,3,1.0,1530,6372,1.0,3,7,1210,320.0,1962,1960,6426,21981 days 16:47:18.687817,132,3.0,3.78125,-430,-54,890.0
2140000.0,6,4.0,5110,7128,2.5,4,1,5110,0.0,1906,4110,6480,42435 days 16:47:18.687817,063,1.5,0.0,1000,648,5110.0
685000.0,4,2.25,3133,16197,2.0,3,9,2533,600.0,1965,3090,15588,20885 days 16:47:18.687817,007,1.7777777777777777,4.221666666666667,43,609,1933.0
340000.0,4,2.5,2020,32710,1.0,3,7,1070,950.0,1941,1340,17700,29651 days 16:47:18.687817,304,1.6,1.1263157894736842,680,15010,120.0
422000.0,2,1.0,750,4000,1.0,4,6,750,0.0,1926,1120,5038,35130 days 16:47:18.687817,131,2.0,0.0,-370,-1038,750.0
442000.0,3,2.5,1980,39932,2.0,3,8,1980,0.0,1994,2610,12769,10293 days 16:47:18.687817,220,1.2,0.0,-630,27163,1980.0
280000.0,3,1.0,1200,6250,1.0,3,6,920,280.0,1943,1280,9375,28921 days 16:47:18.687817,147,3.0,3.2857142857142856,-80,-3125,640.0
1150000.0,5,2.5,3580,8921,2.0,3,9,3580,0.0,2000,2710,9308,8102 days 16:47:18.687817,184,2.0,0.0,870,-387,3580.0
279000.0,3,2.5,2010,11618,2.0,3,7,2010,0.0,1990,1550,9354,11754 days 16:47:18.687817,314,1.2,0.0,460,2264,2010.0
569000.0,4,2.0,1730,3884,1.0,5,7,1060,670.0,1924,1360,3563,35861 days 16:47:18.688814,174,2.0,1.5820895522388059,370,321,390.0
1360000.0,5,3.5,5960,13703,2.0,3,1,4770,1190.0,1984,2810,17320,13946 days 16:47:18.688814,149,1.4285714285714286,4.008403361344538,3150,-3617,3580.0
209950.0,2,1.0,860,5080,1.0,3,7,860,0.0,1960,1250,6477,22712 days 16:47:18.688814,100,2.0,0.0,-390,-1397,860.0
468000.0,3,1.5,1370,7697,1.0,3,7,1370,0.0,1939,1370,7697,30382 days 16:47:18.688814,076,2.0,0.0,0,0,1370.0
237100.0,3,1.75,1360,9603,1.0,3,7,1360,0.0,1963,2240,10605,21616 days 16:47:18.688814,120,1.7142857142857142,0.0,-880,-1002,1360.0
336000.0,4,2.5,2530,8169,2.0,3,8,2530,0.0,1993,2220,8013,10658 days 16:47:18.688814,189,1.6,0.0,310,156,2530.0
500000.0,4,2.0,1680,3813,2.0,4,7,1680,0.0,1900,2540,3996,44626 days 16:47:18.688814,356,2.0,0.0,-860,-183,1680.0
290000.0,3,2.5,1580,6860,2.0,3,7,1580,0.0,1995,1580,7050,9928 days 16:47:18.688814,116,1.2,0.0,0,-190,1580.0
1190000.0,7,3.5,3890,8342,2.0,3,9,2840,1050.0,1968,2870,8342,19790 days 16:47:18.688814,073,2.0,2.704761904761905,1020,0,1790.0
365000.0,5,2.0,1600,4168,1.5,3,7,1600,0.0,1927,1190,4168,34765 days 16:47:18.688814,206,2.5,0.0,410,0,1600.0
146300.0,3,1.0,1200,9668,1.0,5,6,1200,0.0,1975,1200,9800,17233 days 16:47:18.688814,084,3.0,0.0,0,-132,1200.0
554000.0,3,1.75,1760,10780,1.0,3,8,1760,0.0,1977,2090,10780,16502 days 16:47:18.688814,160,1.7142857142857142,0.0,-330,0,1760.0
424000.0,3,2.0,1670,7700,1.0,3,7,1170,500.0,1972,1500,7875,18329 days 16:47:18.688814,169,1.5,2.34,170,-175,670.0
1350000.0,4,3.5,4640,9827,2.0,3,1,3210,1430.0,2007,3810,8207,5545 days 16:47:18.688814,119,1.1428571428571428,2.2447552447552446,830,1620,1780.0
508500.0,4,1.5,1800,6750,1.5,4,7,1800,0.0,1950,1420,5900,26364 days 16:47:18.688814,323,2.6666666666666665,0.0,380,850,1800.0
244500.0,3,1.75,1210,8864,1.0,3,7,1210,0.0,1985,1510,8062,13580 days 16:47:18.688814,121,1.7142857142857142,0.0,-300,802,1210.0
206000.0,2,2.5,1280,1566,2.0,3,7,1280,0.0,2005,1460,1845,6275 days 16:47:18.688814,324,0.8,0.0,-180,-279,1280.0
643500.0,3,2.0,1650,7104,2.0,3,8,1650,0.0,1945,1730,7104,28190 days 16:47:18.688814,248,1.5,0.0,-80,0,1650.0
372500.0,4,1.75,1590,10523,2.0,4,7,1590,0.0,1922,1610,8568,36591 days 16:47:18.688814,140,2.2857142857142856,0.0,-20,1955,1590.0
630000.0,5,2.0,1900,5000,1.0,3,8,1720,180.0,1957,1770,5000,23807 days 16:47:18.688814,196,2.5,9.555555555555555,130,0,1540.0
418000.0,2,2.5,1500,3608,2.0,3,8,1500,0.0,2005,2080,2686,6275 days 16:47:18.688814,191,0.8,0.0,-580,922,1500.0
425000.0,4,2.5,2689,6688,2.0,3,9,2689,0.0,2006,2665,5700,5910 days 16:47:18.688814,056,1.6,0.0,24,988,2689.0
800000.0,4,2.75,3250,5500,2.0,3,9,3250,0.0,2007,3920,6000,5545 days 16:47:18.688814,036,1.4545454545454546,0.0,-670,-500,3250.0
208000.0,2,1.0,960,13438,1.0,3,7,960,0.0,1951,1630,11656,25999 days 16:47:18.688814,342,2.0,0.0,-670,1782,960.0
476000.0,3,1.75,1650,9600,1.0,4,7,1650,0.0,1977,2040,12220,16502 days 16:47:18.688814,195,1.7142857142857142,0.0,-390,-2620,1650.0
277500.0,3,2.5,1690,5171,2.0,3,8,1690,0.0,2003,2550,5025,7006 days 16:47:18.688814,033,1.2,0.0,-860,146,1690.0
478000.0,3,1.75,2790,36585,1.0,4,8,1410,1380.0,1970,1900,45302,19059 days 16:47:18.688814,225,1.7142857142857142,1.0217391304347827,890,-8717,30.0
890000.0,4,2.75,2310,4020,3.0,5,8,2310,0.0,1979,2270,3750,15772 days 16:47:18.688814,189,1.4545454545454546,0.0,40,270,2310.0
450000.0,3,3.5,1790,1288,3.0,3,8,1390,400.0,2000,1560,1426,8102 days 16:47:18.688814,082,0.8571428571428571,3.475,230,-138,990.0
205000.0,3,1.0,1230,8750,1.0,3,6,1230,0.0,1965,1230,8750,20885 days 16:47:18.688814,176,3.0,0.0,0,0,1230.0
665000.0,3,2.0,1620,2640,1.5,5,8,1620,0.0,1929,1470,4080,34034 days 16:47:18.688814,199,1.5,0.0,150,-1440,1620.0
518000.0,4,2.75,2440,12051,1.0,5,8,1440,1000.0,1966,2030,8006,20520 days 16:47:18.688814,276,1.4545454545454546,1.44,410,4045,440.0
465000.0,4,2.25,2100,7350,2.0,3,8,2100,0.0,1979,1780,7350,15772 days 16:47:18.688814,267,1.7777777777777777,0.0,320,0,2100.0
330000.0,3,2.5,3040,7232,2.0,3,7,3040,0.0,2003,2760,6926,7006 days 16:47:18.688814,168,1.2,0.0,280,306,3040.0
449400.0,4,3.0,2490,5064,2.0,3,7,2490,0.0,2007,2470,5064,5545 days 16:47:18.688814,360,1.3333333333333333,0.0,20,0,2490.0
829000.0,3,2.75,2690,10443,1.0,3,9,2690,0.0,2007,1440,4185,5545 days 16:47:18.688814,037,1.0909090909090908,0.0,1250,6258,2690.0
450000.0,4,1.75,2190,9752,1.0,3,8,2190,0.0,1964,2040,9964,21251 days 16:47:18.688814,051,2.2857142857142856,0.0,150,-212,2190.0
310000.0,3,1.75,1490,9120,1.0,5,7,1490,0.0,1959,1340,8040,23077 days 16:47:18.688814,274,1.7142857142857142,0.0,150,1080,1490.0
615000.0,3,2.25,2530,45234,2.0,4,9,2530,0.0,1985,3110,35617,13580 days 16:47:18.688814,251,1.3333333333333333,0.0,-580,9617,2530.0
605000.0,3,2.0,2060,4040,1.0,4,8,1120,940.0,1947,1500,4000,27460 days 16:47:18.688814,154,1.5,1.1914893617021276,560,40,180.0
437500.0,3,2.25,1970,35100,2.0,4,9,1970,0.0,1977,2340,35100,16502 days 16:47:18.688814,122,1.3333333333333333,0.0,-370,0,1970.0
545000.0,3,1.75,1400,4000,1.5,4,7,1400,0.0,1925,1050,4330,35495 days 16:47:18.688814,265,1.7142857142857142,0.0,350,-330,1400.0
770000.0,3,2.5,3680,35617,1.0,3,1,2390,1290.0,1985,3570,35633,13580 days 16:47:18.688814,198,1.2,1.8527131782945736,110,-16,1100.0
600000.0,5,2.25,3000,13899,2.0,4,8,3000,0.0,1975,2270,10763,17233 days 16:47:18.688814,184,2.2222222222222223,0.0,730,3136,3000.0
560000.0,3,1.0,1440,5000,2.0,3,7,1440,0.0,1910,1850,4500,40974 days 16:47:18.688814,133,3.0,0.0,-410,500,1440.0
1920000.0,5,5.75,7730,230868,2.0,3,1,6660,1070.0,2004,2660,39292,6641 days 16:47:18.688814,030,0.8695652173913043,6.224299065420561,5070,191576,5590.0
457000.0,3,1.0,1170,3348,1.5,4,7,1170,0.0,1924,1590,4219,35861 days 16:47:18.688814,328,3.0,0.0,-420,-871,1170.0
585000.0,2,1.0,1770,8640,1.5,3,6,1520,250.0,1949,1060,4804,26729 days 16:47:18.688814,125,2.0,6.08,710,3836,1270.0
560000.0,3,2.0,1860,13374,1.0,3,8,1860,0.0,1985,1960,9797,13580 days 16:47:18.688814,127,1.5,0.0,-100,3577,1860.0
345000.0,2,1.0,770,3008,1.0,4,5,770,0.0,1917,1550,4563,38417 days 16:47:18.688814,095,2.0,0.0,-780,-1555,770.0
550000.0,4,3.5,3820,17745,2.0,3,8,2440,1380.0,1955,2520,9640,24538 days 16:47:18.688814,201,1.1428571428571428,1.7681159420289856,1300,8105,1060.0
589950.0,4,2.5,3190,8195,2.0,3,1,3190,0.0,2006,3400,7607,5910 days 16:47:18.688814,175,1.6,0.0,-210,588,3190.0
327000.0,3,1.5,1320,13200,1.0,3,7,1320,0.0,1970,1730,13200,19059 days 16:47:18.688814,153,2.0,0.0,-410,0,1320.0
800000.0,2,2.25,1730,31491,2.0,4,7,1730,0.0,1947,1400,12410,27460 days 16:47:18.688814,150,0.8888888888888888,0.0,330,19081,1730.0
150000.0,3,1.0,1010,25000,1.0,3,6,1010,0.0,1966,2020,101494,20520 days 16:47:18.688814,141,3.0,0.0,-1010,-76494,1010.0
425000.0,2,2.5,1140,1182,3.0,3,8,1140,0.0,2007,1290,1189,5545 days 16:47:18.688814,154,0.8,0.0,-150,-7,1140.0
350000.0,3,1.0,860,7030,1.0,3,7,860,0.0,1973,1360,7500,17963 days 16:47:18.688814,213,3.0,0.0,-500,-470,860.0
273000.0,3,1.75,1540,10545,2.0,4,6,1540,0.0,1978,1540,10000,16137 days 16:47:18.688814,070,1.7142857142857142,0.0,0,545,1540.0
750000.0,4,2.25,2160,9525,1.0,3,8,1080,1080.0,1961,2780,9525,22346 days 16:47:18.688814,079,1.7777777777777777,1.0,-620,0,0.0
240000.0,3,1.5,1450,9477,1.0,4,7,1450,0.0,1963,1460,9477,21616 days 16:47:18.688814,282,2.0,0.0,-10,0,1450.0
400000.0,3,1.75,1830,9620,1.0,4,8,1830,0.0,1978,1990,8280,16137 days 16:47:18.688814,079,1.7142857142857142,0.0,-160,1340,1830.0
230000.0,3,1.5,1630,6625,1.0,5,7,980,650.0,1980,1440,7145,15407 days 16:47:18.688814,276,2.0,1.5076923076923077,190,-520,330.0
372000.0,4,2.5,2500,8215,2.0,3,8,2500,0.0,1990,2360,7801,11754 days 16:47:18.688814,103,1.6,0.0,140,414,2500.0
459500.0,3,1.75,1470,4950,1.0,3,7,1030,440.0,1984,1100,5250,13946 days 16:47:18.688814,186,1.7142857142857142,2.340909090909091,370,-300,590.0
582000.0,3,2.5,2380,19860,2.0,4,8,2380,0.0,1995,2450,10220,9928 days 16:47:18.688814,217,1.2,0.0,-70,9640,2380.0
465000.0,4,2.5,2170,7700,1.0,3,7,1420,750.0,1969,1710,7770,19424 days 16:47:18.688814,310,1.6,1.8933333333333333,460,-70,670.0
386000.0,3,2.0,2120,7560,1.0,3,9,2120,0.0,1991,2660,7700,11389 days 16:47:18.688814,150,1.5,0.0,-540,-140,2120.0
546000.0,3,2.5,1530,3464,2.0,3,8,1530,0.0,1998,1530,3446,8832 days 16:47:18.688814,160,1.2,0.0,0,18,1530.0
278000.0,3,1.75,2710,9088,1.0,4,7,2060,650.0,1965,1690,10454,20885 days 16:47:18.688814,300,1.7142857142857142,3.169230769230769,1020,-1366,1410.0
540000.0,3,2.5,2860,8935,2.0,3,8,2860,0.0,2004,2650,6167,6641 days 16:47:18.688814,261,1.2,0.0,210,2768,2860.0
529000.0,4,1.75,2800,90169,2.0,3,7,2800,0.0,1934,1600,27194,32208 days 16:47:18.688814,342,2.2857142857142856,0.0,1200,62975,2800.0
554000.0,4,1.0,1120,7104,1.5,3,7,1120,0.0,1946,1370,7104,27825 days 16:47:18.688814,168,4.0,0.0,-250,0,1120.0
210000.0,3,1.0,1730,7210,1.0,3,7,1430,300.0,1963,1820,7210,21616 days 16:47:18.688814,239,3.0,4.766666666666667,-90,0,1130.0
225000.0,2,1.0,1010,5408,1.0,4,6,1010,0.0,1926,980,7800,35130 days 16:47:18.688814,124,2.0,0.0,30,-2392,1010.0
561600.0,4,2.5,2350,6624,2.0,3,9,2350,0.0,1990,2590,11240,11754 days 16:47:18.688814,196,1.6,0.0,-240,-4616,2350.0
300000.0,6,5.25,2860,5682,2.0,3,7,2860,0.0,1978,1390,5956,16137 days 16:47:18.688814,140,1.1428571428571428,0.0,1470,-274,2860.0
1650000.0,4,3.5,4285,9567,2.0,5,1,3485,800.0,1946,2960,6902,27825 days 16:47:18.688814,239,1.1428571428571428,4.35625,1325,2665,2685.0
1020000.0,4,3.75,4060,19290,2.0,3,1,4060,0.0,2002,4020,13250,7371 days 16:47:18.688814,160,1.0666666666666667,0.0,40,6040,4060.0
150000.0,3,1.0,1310,9612,1.0,3,7,960,350.0,1962,1310,9812,21981 days 16:47:18.688814,177,3.0,2.742857142857143,0,-200,610.0
400950.0,2,1.75,2320,6250,1.0,3,7,1400,920.0,1948,1420,6250,27095 days 16:47:18.688814,267,1.1428571428571428,1.5217391304347827,900,0,480.0
620000.0,4,2.25,2210,8101,2.0,3,9,2210,0.0,1985,2330,8842,13580 days 16:47:18.688814,021,1.7777777777777777,0.0,-120,-741,2210.0
449000.0,4,2.75,2090,14141,1.5,4,8,1680,410.0,1941,1990,12920,29651 days 16:47:18.688814,230,1.4545454545454546,4.097560975609756,100,1221,1270.0
630000.0,4,2.5,2240,4025,1.0,3,7,1250,990.0,1926,1380,3500,35130 days 16:47:18.688814,209,1.6,1.2626262626262625,860,525,260.0
336000.0,2,1.0,1180,7200,1.0,4,6,1180,0.0,1949,1180,7200,26729 days 16:47:18.688814,104,2.0,0.0,0,0,1180.0
299950.0,4,1.75,1560,31299,1.0,4,7,1560,0.0,1965,2460,44907,20885 days 16:47:18.688814,156,2.2857142857142856,0.0,-900,-13608,1560.0
352500.0,4,2.0,1970,7451,1.0,3,8,1350,620.0,1962,1980,7510,21981 days 16:47:18.688814,068,2.0,2.1774193548387095,-10,-59,730.0
150000.0,2,1.0,840,12750,1.0,3,6,840,0.0,1925,1480,6969,35495 days 16:47:18.688814,289,2.0,0.0,-640,5781,840.0
175000.0,2,1.0,840,12750,1.0,3,6,840,0.0,1925,1480,6969,35495 days 16:47:18.688814,114,2.0,0.0,-640,5781,840.0
305000.0,3,2.0,1830,10873,1.0,3,8,1830,0.0,1989,2490,8976,12119 days 16:47:18.688814,212,1.5,0.0,-660,1897,1830.0
2570000.0,4,3.75,4475,20424,2.0,3,1,2659,1816.0,1999,4340,5250,8467 days 16:47:18.688814,266,1.0666666666666667,1.4642070484581498,135,15174,843.0
607500.0,3,1.5,1800,4700,1.0,3,7,1200,600.0,1941,1580,4700,29651 days 16:47:18.688814,196,2.0,2.0,220,0,600.0
505000.0,2,1.0,1250,5040,1.0,3,7,950,300.0,1920,1290,5040,37322 days 16:47:18.688814,322,2.0,3.1666666666666665,-40,0,650.0
280500.0,3,1.75,2440,10179,1.0,4,7,1220,1220.0,1962,1650,9711,21981 days 16:47:18.688814,300,1.7142857142857142,1.0,790,468,0.0
610000.0,3,2.5,2910,12283,2.0,3,1,2910,0.0,1993,2680,22499,10658 days 16:47:18.688814,212,1.2,0.0,230,-10216,2910.0
381000.0,5,2.75,3060,6895,2.0,3,8,3060,0.0,2003,2590,6895,7006 days 16:47:18.688814,224,1.8181818181818181,0.0,470,0,3060.0
482000.0,5,2.25,2230,9600,1.0,3,8,1320,910.0,1978,2080,9760,16137 days 16:47:18.688814,142,2.2222222222222223,1.4505494505494505,150,-160,410.0
379950.0,3,1.0,1270,6900,1.0,3,7,1270,0.0,1977,1480,7280,16502 days 16:47:18.688814,295,3.0,0.0,-210,-380,1270.0
2500000.0,4,4.5,4300,19844,2.0,3,1,4300,0.0,1985,3070,19845,13580 days 16:47:18.688814,282,0.8888888888888888,0.0,1230,-1,4300.0
425000.0,3,2.25,1580,39189,1.0,3,7,1180,400.0,1992,1580,29649,11024 days 16:47:18.688814,174,1.3333333333333333,2.95,0,9540,780.0
580000.0,4,2.25,2570,36465,2.0,4,8,2570,0.0,1980,2390,41454,15407 days 16:47:18.688814,253,1.7777777777777777,0.0,180,-4989,2570.0
605000.0,2,1.0,860,6510,1.0,3,7,860,0.0,1952,1740,10800,25634 days 16:47:18.688814,089,2.0,0.0,-880,-4290,860.0
194000.0,1,1.0,820,1060,1.0,3,8,760,60.0,2007,1770,1853,5545 days 16:47:18.688814,140,1.0,12.666666666666666,-950,-793,700.0
546200.0,4,2.25,2090,8579,2.0,3,8,2090,0.0,1987,1850,8843,12850 days 16:47:18.688814,091,1.7777777777777777,0.0,240,-264,2090.0
1400000.0,4,3.5,3560,16782,2.0,3,1,2560,1000.0,2014,3100,18047,2988 days 16:47:18.688814,227,1.1428571428571428,2.56,460,-1265,1560.0
315000.0,3,1.75,1860,9629,1.0,4,7,1240,620.0,1961,1940,9629,22346 days 16:47:18.688814,093,1.7142857142857142,2.0,-80,0,620.0
465000.0,3,1.5,900,8690,1.5,5,6,900,0.0,1941,1000,6150,29651 days 16:47:18.688814,351,2.0,0.0,-100,2540,900.0
330000.0,2,1.0,1160,32251,1.0,3,6,580,580.0,1963,1160,33656,21616 days 16:47:18.688814,274,2.0,1.0,0,-1405,0.0
795000.0,4,2.75,3100,7501,2.0,3,1,3100,0.0,1998,3140,8672,8832 days 16:47:18.688814,220,1.4545454545454546,0.0,-40,-1171,3100.0
265000.0,4,2.25,2300,9100,1.0,3,7,1280,1020.0,1977,1640,9100,16502 days 16:47:18.688814,238,1.7777777777777777,1.2549019607843137,660,0,260.0
1300000.0,4,2.5,3110,11857,2.0,3,1,2040,1070.0,1990,3110,11570,11754 days 16:47:18.688814,012,1.6,1.9065420560747663,0,287,970.0
126500.0,3,1.0,1130,12212,1.0,3,6,1130,0.0,1942,1190,9240,29286 days 16:47:18.688814,125,3.0,0.0,-60,2972,1130.0
760000.0,4,2.5,2920,7901,2.0,3,9,2920,0.0,2004,3020,7900,6641 days 16:47:18.688814,217,1.6,0.0,-100,1,2920.0
540000.0,2,1.25,1230,1569,2.0,3,9,1050,180.0,2009,1100,1230,4814 days 16:47:18.688814,246,1.6,5.833333333333333,130,339,870.0
446000.0,5,2.75,2190,12687,1.0,5,7,1370,820.0,1978,2280,10784,16137 days 16:47:18.688814,139,1.8181818181818181,1.670731707317073,-90,1903,550.0
170000.0,1,0.75,850,5600,1.0,3,6,850,0.0,1903,900,12250,43531 days 16:47:18.688814,085,1.3333333333333333,0.0,-50,-6650,850.0
379000.0,3,2.5,1500,7420,1.0,3,7,1000,500.0,1972,1840,7272,18329 days 16:47:18.688814,296,1.2,2.0,-340,148,500.0
1400000.0,9,4.0,4620,5508,2.5,3,1,3870,750.0,1915,2710,4320,39148 days 16:47:18.688814,076,2.25,5.16,1910,1188,3120.0
800000.0,4,2.75,3150,7035,2.0,3,9,3150,0.0,2004,3200,7035,6641 days 16:47:18.688814,171,1.4545454545454546,0.0,-50,0,3150.0
260000.0,3,1.0,1300,10139,1.0,3,7,1300,0.0,1962,1260,10139,21981 days 16:47:18.688814,075,3.0,0.0,40,0,1300.0
820000.0,5,2.5,3160,8000,1.0,4,7,1580,1580.0,1960,2440,8079,22712 days 16:47:18.688814,069,2.0,1.0,720,-79,0.0
449950.0,3,1.75,2070,96703,1.0,4,7,2070,0.0,1999,1820,117612,8467 days 16:47:18.688814,104,1.7142857142857142,0.0,250,-20909,2070.0
392000.0,3,2.25,1790,7125,1.0,3,7,1220,570.0,1974,2040,7950,17598 days 16:47:18.688814,245,1.3333333333333333,2.1403508771929824,-250,-825,650.0
465000.0,3,2.5,1650,4636,2.0,3,8,1650,0.0,1999,1650,4504,8467 days 16:47:18.688814,112,1.2,0.0,0,132,1650.0
449950.0,4,2.5,2070,7312,1.0,4,7,1230,840.0,1977,1770,7668,16502 days 16:47:18.688814,234,1.6,1.4642857142857142,300,-356,390.0
520000.0,3,1.5,1580,8841,1.5,5,7,1180,400.0,1923,1580,7512,36226 days 16:47:18.688814,118,2.0,2.95,0,1329,780.0
546800.0,4,2.25,2170,10000,1.0,3,8,1420,750.0,1975,2390,11000,17233 days 16:47:18.688814,240,1.7777777777777777,1.8933333333333333,-220,-1000,670.0
825000.0,4,2.75,2220,11925,1.0,3,7,1560,660.0,1953,2500,11377,25268 days 16:47:18.688814,083,1.4545454545454546,2.3636363636363638,-280,548,900.0
337000.0,3,1.75,1440,11364,1.0,3,7,1440,0.0,1985,1950,9390,13580 days 16:47:18.688814,112,1.7142857142857142,0.0,-510,1974,1440.0
333000.0,2,1.0,720,6686,1.0,3,6,720,0.0,1942,1200,6686,29286 days 16:47:18.688814,162,2.0,0.0,-480,0,720.0
380000.0,2,2.0,1120,780,2.0,3,8,760,360.0,2004,1120,1322,6641 days 16:47:18.688814,315,1.0,2.111111111111111,0,-542,400.0
280000.0,3,2.5,1970,8426,2.0,3,8,1970,0.0,1992,1970,9197,11024 days 16:47:18.688814,118,1.2,0.0,0,-771,1970.0
202000.0,3,1.5,1420,9081,1.0,4,6,1420,0.0,1990,1090,8410,11754 days 16:47:18.688814,324,2.0,0.0,330,671,1420.0
585000.0,4,2.5,2250,4119,2.0,3,8,2250,0.0,2001,2290,3115,7736 days 16:47:18.688814,117,1.6,0.0,-40,1004,2250.0
435000.0,4,2.0,2630,9663,1.0,4,8,1330,1300.0,1956,1900,8894,24173 days 16:47:18.688814,308,2.0,1.023076923076923,730,769,30.0
1200000.0,4,3.5,4740,172497,2.0,3,1,4740,0.0,2003,2120,49658,7006 days 16:47:18.688814,143,1.1428571428571428,0.0,2620,122839,4740.0
364000.0,2,2.25,1280,2574,2.0,3,7,1280,0.0,1992,1250,3960,11024 days 16:47:18.688814,267,0.8888888888888888,0.0,30,-1386,1280.0
300000.0,3,1.0,1260,8280,1.0,3,6,1260,0.0,1946,2100,8280,27825 days 16:47:18.688814,134,3.0,0.0,-840,0,1260.0
558000.0,2,1.75,1930,4601,1.0,3,8,1930,0.0,2006,1670,4500,5910 days 16:47:18.688814,076,1.1428571428571428,0.0,260,101,1930.0
199950.0,1,1.5,1048,4800,1.0,3,7,1048,0.0,1942,950,4800,29286 days 16:47:18.688814,223,0.6666666666666666,0.0,98,0,1048.0
515000.0,3,2.25,1640,8400,1.0,4,8,1640,0.0,1962,2110,8400,21981 days 16:47:18.688814,239,1.3333333333333333,0.0,-470,0,1640.0
590000.0,4,2.5,2380,4950,2.0,3,8,2380,0.0,2004,1370,5120,6641 days 16:47:18.688814,311,1.6,0.0,1010,-170,2380.0
813500.0,4,2.0,2530,15520,1.0,5,8,2220,310.0,1964,2500,13300,21251 days 16:47:18.688814,204,2.0,7.161290322580645,30,2220,1910.0
725000.0,4,2.5,2700,25870,2.0,4,8,2700,0.0,1992,1540,20720,11024 days 16:47:18.688814,113,1.6,0.0,1160,5150,2700.0
490000.0,3,2.25,2330,3600,1.5,3,8,2330,0.0,1971,2050,4275,18694 days 16:47:18.688814,118,1.3333333333333333,0.0,280,-675,2330.0
277000.0,3,2.25,2160,9612,2.0,3,7,2160,0.0,1994,1970,9247,10293 days 16:47:18.688814,239,1.3333333333333333,0.0,190,365,2160.0
325000.0,4,1.5,1470,70800,1.0,3,7,1470,0.0,1976,1810,72337,16868 days 16:47:18.688814,129,2.6666666666666665,0.0,-340,-1537,1470.0
649800.0,4,2.5,2280,9827,2.0,3,8,2280,0.0,1995,1660,9827,9928 days 16:47:18.688814,268,1.6,0.0,620,0,2280.0
460000.0,2,1.0,850,4650,1.0,3,7,850,0.0,1975,980,4700,17233 days 16:47:18.688814,088,2.0,0.0,-130,-50,850.0
750000.0,3,3.25,4610,81935,2.0,4,9,4610,0.0,1984,2900,43500,13946 days 16:47:18.688814,217,0.9230769230769231,0.0,1710,38435,4610.0
469000.0,5,2.5,2690,11745,1.0,3,8,1790,900.0,1960,2670,7905,22712 days 16:47:18.688814,191,2.0,1.988888888888889,20,3840,890.0
566000.0,4,1.75,2440,5000,1.0,3,8,1340,1100.0,1954,2170,5000,24903 days 16:47:18.688814,161,2.2857142857142856,1.2181818181818183,270,0,240.0
407500.0,3,2.5,1930,10460,2.0,3,8,1930,0.0,1996,2290,8228,9563 days 16:47:18.688814,122,1.2,0.0,-360,2232,1930.0
353500.0,2,1.0,800,8775,1.0,3,6,800,0.0,1942,1470,8976,29286 days 16:47:18.688814,301,2.0,0.0,-670,-201,800.0
524000.0,3,2.25,2430,73151,1.0,3,8,2430,0.0,1974,2800,39250,17598 days 16:47:18.688814,128,1.3333333333333333,0.0,-370,33901,2430.0
264950.0,4,2.5,1990,9656,2.0,3,7,1990,0.0,1994,1500,9656,10293 days 16:47:18.688814,234,1.6,0.0,490,0,1990.0
547500.0,3,2.5,2550,10355,2.0,3,9,2550,0.0,1990,2550,10084,11754 days 16:47:18.688814,301,1.2,0.0,0,271,2550.0
264500.0,3,2.25,1370,7087,2.0,3,7,1370,0.0,1993,1400,6600,10658 days 16:47:18.688814,321,1.3333333333333333,0.0,-30,487,1370.0
507500.0,3,2.0,2020,8118,1.0,3,7,1020,1000.0,1963,1670,8118,21616 days 16:47:18.688814,140,1.5,1.02,350,0,20.0
560000.0,3,3.5,1560,2198,2.0,3,8,1180,380.0,2006,1550,1467,5910 days 16:47:18.688814,281,0.8571428571428571,3.1052631578947367,10,731,800.0
995000.0,5,4.0,5610,22529,2.0,3,1,4090,1520.0,1996,3860,24751,9563 days 16:47:18.688814,350,1.25,2.6907894736842106,1750,-2222,2570.0
835000.0,6,2.0,3560,5120,2.5,3,9,3560,0.0,1900,2130,5120,44626 days 16:47:18.688814,083,3.0,0.0,1430,0,3560.0
440000.0,3,1.5,2120,6290,1.0,4,8,1220,900.0,1949,1620,5400,26729 days 16:47:18.688814,177,2.0,1.3555555555555556,500,890,320.0
1020000.0,3,2.5,2920,5629,1.0,5,8,1460,1460.0,1955,2380,5000,24538 days 16:47:18.688814,209,1.2,1.0,540,629,0.0
300000.0,2,1.0,1340,7788,1.0,3,7,1340,0.0,1947,2550,7788,27460 days 16:47:18.688814,143,2.0,0.0,-1210,0,1340.0
125000.0,3,1.0,1230,4800,1.5,1,6,1230,0.0,1916,1230,4800,38783 days 16:47:18.688814,344,3.0,0.0,0,0,1230.0
986000.0,4,3.5,2840,5900,2.0,3,1,1920,920.0,1910,1300,4900,40974 days 16:47:18.688814,309,1.1428571428571428,2.0869565217391304,1540,1000,1000.0
315000.0,4,2.5,2080,5650,1.0,3,7,1680,400.0,1950,1270,5650,26364 days 16:47:18.688814,224,1.6,4.2,810,0,1280.0
320000.0,4,2.5,2070,7007,2.0,3,7,2070,0.0,1996,2130,8100,9563 days 16:47:18.688814,224,1.6,0.0,-60,-1093,2070.0
972000.0,4,3.25,4010,13797,2.0,3,1,4010,0.0,2003,3980,12120,7006 days 16:47:18.688814,338,1.2307692307692308,0.0,30,1677,4010.0
760000.0,3,2.5,2190,10000,1.0,4,7,1540,650.0,1957,2880,11782,23807 days 16:47:18.688814,252,1.2,2.3692307692307693,-690,-1782,890.0
265000.0,4,3.0,1730,7264,2.0,3,6,1730,0.0,1920,1500,12104,37322 days 16:47:18.688814,246,1.3333333333333333,0.0,230,-4840,1730.0
355000.0,2,1.0,1250,4558,1.0,3,7,1250,0.0,1948,1180,4494,27095 days 16:47:18.688814,322,2.0,0.0,70,64,1250.0
300000.0,3,1.0,1300,20812,1.0,3,6,1300,0.0,1927,1210,17340,34765 days 16:47:18.688814,239,3.0,0.0,90,3472,1300.0
474950.0,5,2.5,2080,8347,1.0,4,7,1460,620.0,1975,1840,7713,17233 days 16:47:18.688814,238,2.0,2.3548387096774195,240,634,840.0
470000.0,4,2.0,2180,17180,2.0,4,7,2180,0.0,1977,1880,14043,16502 days 16:47:18.688814,239,2.0,0.0,300,3137,2180.0
437500.0,3,1.0,1630,16393,1.0,3,7,1630,0.0,1969,1880,23497,19424 days 16:47:18.688814,329,3.0,0.0,-250,-7104,1630.0
520000.0,2,1.5,1840,3825,1.0,3,8,1040,800.0,1928,1290,5100,34400 days 16:47:18.688814,301,1.3333333333333333,1.3,550,-1275,240.0
237600.0,2,1.0,1370,11584,1.0,4,6,1370,0.0,1950,1330,8012,26364 days 16:47:18.688814,321,2.0,0.0,40,3572,1370.0
162950.0,2,1.0,950,2784,1.0,4,8,950,0.0,1972,1080,3899,18329 days 16:47:18.688814,192,2.0,0.0,-130,-1115,950.0
457000.0,3,1.75,1690,6375,1.0,3,8,1690,0.0,1903,1270,7774,43531 days 16:47:18.688814,315,1.7142857142857142,0.0,420,-1399,1690.0
635000.0,3,2.5,1780,11000,1.0,4,8,1210,570.0,1980,2310,9700,15407 days 16:47:18.688814,220,1.2,2.1228070175438596,-530,1300,640.0
735000.0,4,3.0,2840,4120,1.5,4,8,2060,780.0,1931,1840,5871,33304 days 16:47:18.688814,150,1.3333333333333333,2.641025641025641,1000,-1751,1280.0
910000.0,2,2.5,2000,5150,2.0,3,9,2000,0.0,1992,2510,6800,11024 days 16:47:18.688814,261,0.8,0.0,-510,-1650,2000.0
346500.0,3,3.25,1570,2048,2.0,3,8,1290,280.0,2006,1570,2006,5910 days 16:47:18.688814,294,0.9230769230769231,4.607142857142857,0,42,1010.0
655000.0,4,2.5,2370,9517,1.0,3,9,1630,740.0,1984,2440,9035,13946 days 16:47:18.688814,248,1.6,2.2027027027027026,-70,482,890.0
425000.0,3,1.75,1610,144619,1.0,3,7,1610,0.0,1977,2220,144619,16502 days 16:47:18.688814,314,1.7142857142857142,0.0,-610,0,1610.0
137000.0,3,1.0,1300,10125,1.0,4,6,1300,0.0,1959,1300,10125,23077 days 16:47:18.688814,048,3.0,0.0,0,0,1300.0
557500.0,3,2.5,2620,11056,2.0,3,9,2620,0.0,1988,2560,8688,12485 days 16:47:18.688814,196,1.2,0.0,60,2368,2620.0
415000.0,4,2.25,3060,48787,2.0,3,8,3060,0.0,1992,2090,48787,11024 days 16:47:18.688814,129,1.7777777777777777,0.0,970,0,3060.0
830000.0,5,2.25,2780,10192,2.0,4,9,2780,0.0,1978,2740,9900,16137 days 16:47:18.688814,171,2.2222222222222223,0.0,40,292,2780.0
949000.0,4,3.0,4270,85643,2.0,3,1,4270,0.0,1991,3760,51170,11389 days 16:47:18.688814,105,1.3333333333333333,0.0,510,34473,4270.0
420000.0,3,1.0,1310,3963,1.0,5,7,1310,0.0,1986,1010,3363,13215 days 16:47:18.688814,287,3.0,0.0,300,600,1310.0
353000.0,2,1.0,1100,7500,1.0,3,7,1100,0.0,1951,1920,7149,25999 days 16:47:18.688814,093,2.0,0.0,-820,351,1100.0
560000.0,3,1.75,1480,383328,1.5,3,8,1480,0.0,1980,1480,67082,15407 days 16:47:18.688814,247,1.7142857142857142,0.0,0,316246,1480.0
445700.0,3,2.5,1270,1180,3.0,3,8,1270,0.0,2001,1320,1180,7736 days 16:47:18.688814,122,1.2,0.0,-50,0,1270.0
226000.0,4,1.0,1270,6459,1.5,3,7,1270,0.0,1918,1300,4100,38052 days 16:47:18.688814,198,4.0,0.0,-30,2359,1270.0
358000.0,3,1.0,890,9870,1.0,4,7,890,0.0,1960,1270,9861,22712 days 16:47:18.688814,339,3.0,0.0,-380,9,890.0
501000.0,3,1.75,1480,8667,1.0,5,7,740,740.0,1954,1600,10644,24903 days 16:47:18.688814,064,1.7142857142857142,1.0,-120,-1977,0.0
609000.0,4,2.5,3240,23870,1.0,3,9,1840,1400.0,1972,2290,13340,18329 days 16:47:18.688814,080,1.6,1.3142857142857143,950,10530,440.0
734950.0,4,3.25,4280,47179,2.0,3,1,3050,1230.0,2002,2820,43401,7371 days 16:47:18.688814,190,1.2307692307692308,2.4796747967479673,1460,3778,1820.0
725000.0,5,2.5,3210,12000,1.0,4,8,1830,1380.0,1968,2450,12000,19790 days 16:47:18.688814,164,2.0,1.326086956521739,760,0,450.0
350500.0,3,2.25,1870,7200,1.0,3,7,1390,480.0,1975,1830,7876,17233 days 16:47:18.688814,223,1.3333333333333333,2.8958333333333335,40,-676,910.0
610000.0,5,2.5,3990,3839,1.0,4,8,1990,2000.0,1962,2090,5000,21981 days 16:47:18.688814,153,2.0,0.995,1900,-1161,-10.0
605125.0,2,1.0,1160,5029,1.0,3,7,910,250.0,1940,1220,5029,30017 days 16:47:18.688814,310,2.0,3.64,-60,0,660.0
1390000.0,4,2.25,2940,20384,2.0,4,9,2940,0.0,1970,3410,19910,19059 days 16:47:18.688814,118,1.7777777777777777,0.0,-470,474,2940.0
550000.0,3,2.25,1850,37264,2.0,3,8,1850,0.0,1981,2390,36036,15041 days 16:47:18.688814,111,1.3333333333333333,0.0,-540,1228,1850.0
335000.0,2,1.75,1060,1202,2.0,3,7,760,300.0,2003,1060,1493,7006 days 16:47:18.688814,280,1.1428571428571428,2.533333333333333,0,-291,460.0
397000.0,3,2.0,1100,9165,1.0,4,7,1100,0.0,1969,1510,8500,19424 days 16:47:18.688814,365,1.5,0.0,-410,665,1100.0
240000.0,3,2.0,1190,10299,1.0,3,7,1190,0.0,1994,1700,9849,10293 days 16:47:18.688814,328,1.5,0.0,-510,450,1190.0
240000.0,3,2.0,1030,11118,1.0,5,7,1030,0.0,1970,1300,7920,19059 days 16:47:18.688814,269,1.5,0.0,-270,3198,1030.0
262500.0,2,1.5,1140,14373,1.0,3,7,1140,0.0,1949,2140,9860,26729 days 16:47:18.688814,324,1.3333333333333333,0.0,-1000,4513,1140.0
440000.0,3,1.5,2260,5300,1.0,3,7,1200,1060.0,1940,1950,5000,30017 days 16:47:18.688814,265,2.0,1.1320754716981132,310,300,140.0
160000.0,3,1.0,1140,3240,1.5,4,6,1140,0.0,1910,1140,4700,40974 days 16:47:18.688814,082,3.0,0.0,0,-1460,1140.0
427000.0,4,1.0,1860,4736,1.5,1,7,1860,0.0,1901,1800,4000,44261 days 16:47:18.688814,162,4.0,0.0,60,736,1860.0
920000.0,4,3.5,4080,10666,2.0,3,9,4080,0.0,2005,3920,8154,6275 days 16:47:18.688814,182,1.1428571428571428,0.0,160,2512,4080.0
2300000.0,4,2.5,3280,7100,2.0,3,1,2180,1100.0,1911,3240,6674,40609 days 16:47:18.688814,217,1.6,1.981818181818182,40,426,1080.0
480000.0,4,2.5,2870,35757,2.0,4,9,2870,0.0,1977,2700,41221,16502 days 16:47:18.688814,328,1.6,0.0,170,-5464,2870.0
615000.0,4,1.75,2300,11700,1.0,4,9,1960,340.0,1977,2840,12000,16502 days 16:47:18.688814,125,2.2857142857142856,5.764705882352941,-540,-300,1620.0
736500.0,3,2.0,2230,4800,1.5,4,7,1290,940.0,1915,1650,5040,39148 days 16:47:18.688814,234,1.5,1.372340425531915,580,-240,350.0
542500.0,3,2.5,1920,1649,2.5,3,8,1600,320.0,2004,1650,3053,6641 days 16:47:18.688814,323,1.2,5.0,270,-1404,1280.0
191000.0,2,1.0,700,5000,1.0,5,6,700,0.0,1952,1040,5200,25634 days 16:47:18.688814,078,2.0,0.0,-340,-200,700.0
730000.0,4,2.5,2740,11975,2.0,4,8,2740,0.0,1991,2310,9068,11389 days 16:47:18.688814,199,1.6,0.0,430,2907,2740.0
1230000.0,5,2.25,3440,5000,2.0,5,9,3440,0.0,1901,2822,5000,44261 days 16:47:18.688814,329,2.2222222222222223,0.0,618,0,3440.0
129000.0,1,1.0,650,15364,1.0,4,5,650,0.0,1967,1630,7952,20155 days 16:47:18.688814,155,1.0,0.0,-980,7412,650.0
284000.0,3,1.5,1500,10018,1.0,4,7,1500,0.0,1957,1500,10937,23807 days 16:47:18.688814,190,2.0,0.0,0,-919,1500.0
645000.0,3,2.5,2490,5978,2.0,3,9,2490,0.0,2003,2710,6629,7006 days 16:47:18.688814,080,1.2,0.0,-220,-651,2490.0
218000.0,3,1.5,1330,7600,1.0,4,7,1330,0.0,1968,1500,7776,19790 days 16:47:18.688814,175,2.0,0.0,-170,-176,1330.0
675000.0,4,3.5,3190,6875,2.0,3,8,2120,1070.0,1999,2550,6875,8467 days 16:47:18.688814,282,1.1428571428571428,1.9813084112149533,640,0,1050.0
575000.0,3,2.5,1590,2910,2.0,3,7,1110,480.0,1984,1590,3880,13946 days 16:47:18.688814,363,1.2,2.3125,0,-970,630.0
225000.0,2,1.0,830,5720,1.0,4,6,830,0.0,1950,1150,5250,26364 days 16:47:18.688814,303,2.0,0.0,-320,470,830.0
626000.0,3,2.25,1810,5107,2.0,3,8,1810,0.0,1989,1760,5454,12119 days 16:47:18.688814,098,1.3333333333333333,0.0,50,-347,1810.0
499950.0,4,2.5,2910,20067,2.0,3,9,2910,0.0,2001,1730,21420,7736 days 16:47:18.688814,078,1.6,0.0,1180,-1353,2910.0
405000.0,4,1.75,2180,13529,1.0,3,7,1090,1090.0,1956,2000,13529,24173 days 16:47:18.688814,133,2.2857142857142856,1.0,180,0,0.0
152500.0,3,1.0,1090,3523,1.0,4,6,1090,0.0,1969,1030,3200,19424 days 16:47:18.688814,302,3.0,0.0,60,323,1090.0
325000.0,4,2.5,2160,6825,2.0,3,8,2160,0.0,1994,2020,7035,10293 days 16:47:18.688814,197,1.6,0.0,140,-210,2160.0
475300.0,3,1.0,2110,10005,1.0,5,7,1110,1000.0,1924,1360,9827,35861 days 16:47:18.688814,149,3.0,1.11,750,178,110.0
485000.0,3,1.75,2180,7318,1.0,4,7,1210,970.0,1967,2140,7560,20155 days 16:47:18.688814,098,1.7142857142857142,1.2474226804123711,40,-242,240.0
720000.0,3,2.5,2100,2200,2.0,4,7,1500,600.0,1919,1750,4400,37687 days 16:47:18.688814,102,1.2,2.5,350,-2200,900.0
465000.0,3,1.75,1410,6886,1.0,3,7,1410,0.0,1924,1410,6561,35861 days 16:47:18.688814,135,1.7142857142857142,0.0,0,325,1410.0
489000.0,3,1.5,1020,9072,1.0,3,7,920,100.0,1930,1620,7930,33669 days 16:47:18.688814,155,2.0,9.2,-600,1142,820.0
3100000.0,5,5.25,5090,23669,2.0,3,1,5090,0.0,2006,3830,22605,5910 days 16:47:18.688814,210,0.9523809523809523,0.0,1260,1064,5090.0
288000.0,3,2.25,2090,7500,1.0,4,7,1280,810.0,1977,1800,7350,16502 days 16:47:18.688814,008,1.3333333333333333,1.5802469135802468,290,150,470.0
225000.0,3,1.75,1350,9793,1.0,4,7,1350,0.0,1968,1690,8080,19790 days 16:47:18.688814,220,1.7142857142857142,0.0,-340,1713,1350.0
499000.0,3,1.75,2650,11774,1.0,3,8,2240,410.0,1952,2650,10120,25634 days 16:47:18.688814,111,1.7142857142857142,5.463414634146342,0,1654,1830.0
632000.0,5,3.0,3520,36558,2.0,4,8,2100,1420.0,1985,3000,36558,13580 days 16:47:18.688814,315,1.6666666666666667,1.4788732394366197,520,0,680.0
580000.0,3,2.5,2040,4627,2.0,3,8,2040,0.0,1992,2230,4500,11024 days 16:47:18.688814,164,1.2,0.0,-190,127,2040.0
730000.0,4,1.5,2340,5000,2.0,3,8,2100,240.0,1912,2320,5500,40244 days 16:47:18.688814,113,2.6666666666666665,8.75,20,-500,1860.0
325000.0,4,2.25,1770,7799,2.0,3,7,1770,0.0,1998,1770,7778,8832 days 16:47:18.688814,086,1.7777777777777777,0.0,0,21,1770.0
421000.0,3,1.75,1100,8662,1.0,5,7,1100,0.0,1964,1100,9240,21251 days 16:47:18.688814,105,1.7142857142857142,0.0,0,-578,1100.0
316000.0,3,2.5,1490,4078,2.0,3,8,1490,0.0,1998,1310,2767,8832 days 16:47:18.688814,020,1.2,0.0,180,1311,1490.0
415000.0,2,1.0,1460,4200,1.0,4,6,880,580.0,1914,1540,4200,39513 days 16:47:18.688814,216,2.0,1.5172413793103448,-80,0,300.0
401000.0,3,2.25,1350,2839,2.0,3,7,1350,0.0,2003,1650,3093,7006 days 16:47:18.688814,265,1.3333333333333333,0.0,-300,-254,1350.0
229950.0,3,0.75,1030,12700,1.0,4,5,1030,0.0,1944,1140,6955,28556 days 16:47:18.688814,055,4.0,0.0,-110,5745,1030.0
539950.0,3,1.75,1820,9875,1.0,4,8,1820,0.0,1966,2670,10000,20520 days 16:47:18.688814,089,1.7142857142857142,0.0,-850,-125,1820.0
335000.0,3,2.0,1170,5360,1.0,3,6,1170,0.0,1919,1180,7200,37687 days 16:47:18.688814,156,1.5,0.0,-10,-1840,1170.0
339000.0,3,2.5,1450,3748,2.0,3,7,1450,0.0,2004,1970,3748,6641 days 16:47:18.688814,188,1.2,0.0,-520,0,1450.0
414950.0,4,1.75,2200,8545,1.0,4,7,1100,1100.0,1918,1940,9315,38052 days 16:47:18.688814,293,2.2857142857142856,1.0,260,-770,0.0
650000.0,4,2.0,1610,8976,1.0,4,8,1610,0.0,1966,1930,8976,20520 days 16:47:18.688814,336,2.0,0.0,-320,0,1610.0
445000.0,3,2.5,2690,21883,2.0,3,8,2690,0.0,1994,2370,21781,10293 days 16:47:18.688814,337,1.2,0.0,320,102,2690.0
295000.0,3,2.25,1850,7800,2.0,3,9,1850,0.0,1974,2360,8000,17598 days 16:47:18.688814,079,1.3333333333333333,0.0,-510,-200,1850.0
975000.0,4,2.25,2250,3600,2.0,4,9,2010,240.0,1912,1910,3990,40244 days 16:47:18.688814,103,1.7777777777777777,8.375,340,-390,1770.0
296500.0,3,1.5,1580,10100,1.0,4,7,1580,0.0,1961,1650,10032,22346 days 16:47:18.688814,353,2.0,0.0,-70,68,1580.0
440000.0,4,2.75,2030,56192,1.0,3,8,1550,480.0,1979,2510,44866,15772 days 16:47:18.688814,294,1.4545454545454546,3.2291666666666665,-480,11326,1070.0
420000.0,5,1.5,1890,10880,1.0,3,7,1890,0.0,1962,1670,9750,21981 days 16:47:18.688814,363,3.3333333333333335,0.0,220,1130,1890.0
302000.0,3,2.5,2140,9492,2.0,3,8,2140,0.0,1994,2180,9184,10293 days 16:47:18.688814,204,1.2,0.0,-40,308,2140.0
350000.0,4,1.75,1770,7336,1.0,4,8,1770,0.0,1986,2030,8183,13215 days 16:47:18.688814,099,2.2857142857142856,0.0,-260,-847,1770.0
667000.0,3,1.75,3320,478288,1.5,4,8,2260,1060.0,1933,2960,217800,32573 days 16:47:18.688814,177,1.7142857142857142,2.1320754716981134,360,260488,1200.0
645000.0,3,2.0,1640,4218,1.0,4,7,910,730.0,1941,1670,4000,29651 days 16:47:18.688814,133,1.5,1.2465753424657535,-30,218,180.0
430000.0,4,2.75,1820,5400,1.0,4,7,1220,600.0,1988,1630,5400,12485 days 16:47:18.688814,315,1.4545454545454546,2.033333333333333,190,0,620.0
413000.0,4,1.0,1410,6000,1.0,3,7,810,600.0,1925,1500,4800,35495 days 16:47:18.688814,133,4.0,1.35,-90,1200,210.0
420000.0,3,1.0,1240,7300,1.0,3,7,1240,0.0,1968,1240,8260,19790 days 16:47:18.688814,335,3.0,0.0,0,-960,1240.0
495000.0,3,2.25,1780,8050,1.0,4,7,1230,550.0,1979,1780,7200,15772 days 16:47:18.688814,302,1.3333333333333333,2.2363636363636363,0,850,680.0
2190000.0,4,4.5,4240,13162,2.0,3,1,4240,0.0,2004,3010,12163,6641 days 16:47:18.688814,224,0.8888888888888888,0.0,1230,999,4240.0
965000.0,4,2.5,3570,17411,2.0,3,1,3570,0.0,1990,3510,16153,11754 days 16:47:18.688814,116,1.6,0.0,60,1258,3570.0
500000.0,4,2.5,1900,5001,1.0,3,8,1200,700.0,2008,1950,4680,5180 days 16:47:18.688814,335,1.6,1.7142857142857142,-50,321,500.0
636100.0,3,1.0,1010,6000,1.5,3,7,1010,0.0,1919,1960,4000,37687 days 16:47:18.688814,274,3.0,0.0,-950,2000,1010.0
720000.0,4,2.5,2870,12648,2.0,4,9,2870,0.0,1986,2560,12648,13215 days 16:47:18.688814,154,1.6,0.0,310,0,2870.0
298000.0,3,1.75,1620,12825,1.0,3,8,1340,280.0,1962,2076,11200,21981 days 16:47:18.688814,124,1.7142857142857142,4.785714285714286,-456,1625,1060.0
370000.0,4,2.5,2650,5706,2.0,3,9,2650,0.0,2005,2760,5749,6275 days 16:47:18.688814,360,1.6,0.0,-110,-43,2650.0
230000.0,5,1.0,1410,9000,1.0,5,7,1410,0.0,1967,1200,8346,20155 days 16:47:18.688814,206,5.0,0.0,210,654,1410.0
290000.0,3,2.0,1360,6685,1.0,3,7,1360,0.0,1952,1300,8138,25634 days 16:47:18.688814,083,1.5,0.0,60,-1453,1360.0
420000.0,4,2.25,2930,9840,1.0,4,8,1560,1370.0,1977,2800,8374,16502 days 16:47:18.688814,050,1.7777777777777777,1.1386861313868613,130,1466,190.0
917000.0,4,2.5,3500,10891,2.0,3,1,3500,0.0,1995,3820,13521,9928 days 16:47:18.688814,203,1.6,0.0,-320,-2630,3500.0
957000.0,5,3.25,3160,5000,2.0,3,1,2180,980.0,2005,3160,5746,6275 days 16:47:18.688814,176,1.5384615384615385,2.2244897959183674,0,-746,1200.0
482000.0,3,2.25,1710,21485,2.0,3,7,1710,0.0,1989,1680,21485,12119 days 16:47:18.688814,182,1.3333333333333333,0.0,30,0,1710.0
488000.0,3,1.75,2180,14734,2.0,3,9,2180,0.0,1990,2300,21618,11754 days 16:47:18.688814,325,1.7142857142857142,0.0,-120,-6884,2180.0
760369.0,5,2.5,2870,4712,2.0,3,9,2870,0.0,2014,2870,6768,2988 days 16:47:18.688814,290,2.0,0.0,0,-2056,2870.0
625000.0,3,2.5,2120,10021,1.0,4,8,1230,890.0,1976,2690,10183,16868 days 16:47:18.688814,119,1.2,1.3820224719101124,-570,-162,340.0
357000.0,3,1.5,1590,6750,1.0,3,7,1080,510.0,1976,1590,7400,16868 days 16:47:18.688814,336,2.0,2.1176470588235294,0,-650,570.0
583000.0,3,2.25,1830,8276,1.0,3,8,1350,480.0,1989,1920,8276,12119 days 16:47:18.688814,097,1.3333333333333333,2.8125,-90,0,870.0
173250.0,3,2.0,1210,9097,1.0,4,7,1210,0.0,1954,1360,10125,24903 days 16:47:18.688814,232,1.5,0.0,-150,-1028,1210.0
414050.0,4,2.0,1590,10331,1.5,4,7,1590,0.0,1956,1400,9434,24173 days 16:47:18.688814,197,2.0,0.0,190,897,1590.0
400000.0,3,1.75,1050,6150,1.5,4,6,950,100.0,1928,1360,6150,34400 days 16:47:18.688814,169,1.7142857142857142,9.5,-310,0,850.0
537000.0,3,2.0,1550,27003,1.5,3,8,1550,0.0,1982,2400,27003,14676 days 16:47:18.688814,086,1.5,0.0,-850,0,1550.0
465000.0,4,2.25,2070,7500,2.0,4,7,2070,0.0,1977,2080,7700,16502 days 16:47:18.688814,157,1.7777777777777777,0.0,-10,-200,2070.0
425000.0,3,2.25,1740,9682,1.0,5,8,1740,0.0,1969,2100,9536,19424 days 16:47:18.688814,230,1.3333333333333333,0.0,-360,146,1740.0
445000.0,4,2.0,1700,21780,1.0,4,6,1080,620.0,1940,2070,12054,30017 days 16:47:18.688814,322,2.0,1.7419354838709677,-370,9726,460.0
179950.0,2,1.0,1200,9000,1.0,3,6,1200,0.0,1958,1040,9600,23442 days 16:47:18.688814,345,2.0,0.0,160,-600,1200.0
275000.0,3,2.5,1710,7230,2.0,3,7,1710,0.0,1996,1720,6537,9563 days 16:47:18.688814,111,1.2,0.0,-10,693,1710.0
190000.0,4,2.5,1840,13493,2.0,3,7,1840,0.0,1994,1430,11463,10293 days 16:47:18.688814,196,1.6,0.0,410,2030,1840.0
385000.0,3,1.75,1900,5520,1.0,3,7,1280,620.0,1982,1330,5196,14676 days 16:47:18.688814,126,1.7142857142857142,2.064516129032258,570,324,660.0
303000.0,4,1.0,2300,9583,1.0,3,6,1220,1080.0,1928,1200,11325,34400 days 16:47:18.688814,119,4.0,1.1296296296296295,1100,-1742,140.0
165000.0,3,1.0,970,7503,1.0,4,6,970,0.0,1967,1230,9504,20155 days 16:47:18.688814,005,3.0,0.0,-260,-2001,970.0
600000.0,2,2.0,1270,5000,1.0,3,6,1270,0.0,1944,2190,5000,28556 days 16:47:18.688814,120,1.0,0.0,-920,0,1270.0
710000.0,3,2.25,3130,65775,2.0,4,8,3130,0.0,1978,3130,72309,16137 days 16:47:18.688814,199,1.3333333333333333,0.0,0,-6534,3130.0
875000.0,5,3.25,4230,21455,2.0,3,1,2720,1510.0,1990,3280,22393,11754 days 16:47:18.688814,086,1.5384615384615385,1.8013245033112584,950,-938,1210.0
269950.0,3,2.5,1480,9743,2.0,4,7,1480,0.0,1996,1810,9601,9563 days 16:47:18.688814,245,1.2,0.0,-330,142,1480.0
838000.0,4,2.5,3310,42998,2.0,3,9,3310,0.0,2001,3350,42847,7736 days 16:47:18.688814,122,1.6,0.0,-40,151,3310.0
670500.0,4,2.0,1590,6750,1.0,3,7,1590,0.0,1951,2370,4500,25999 days 16:47:18.688814,143,2.0,0.0,-780,2250,1590.0
420000.0,4,1.5,1690,9391,1.0,3,7,1290,400.0,1960,1780,9390,22712 days 16:47:18.688814,043,2.6666666666666665,3.225,-90,1,890.0
370000.0,3,1.5,1690,161913,1.0,2,7,1430,260.0,1952,1930,12548,25634 days 16:47:18.688814,256,2.0,5.5,-240,149365,1170.0
360000.0,3,1.75,1500,7200,1.0,3,7,1500,0.0,1957,1650,7392,23807 days 16:47:18.688814,175,1.7142857142857142,0.0,-150,-192,1500.0
562500.0,4,2.5,2320,8721,2.0,3,8,2320,0.0,1991,2260,8268,11389 days 16:47:18.688814,276,1.6,0.0,60,453,2320.0
360500.0,3,2.5,3300,11525,1.0,5,8,1650,1650.0,1961,1950,9680,22346 days 16:47:18.688814,230,1.2,1.0,1350,1845,0.0
389999.0,3,2.25,1445,1471,2.0,3,7,1300,145.0,2003,1410,1399,7006 days 16:47:18.688814,141,1.3333333333333333,8.96551724137931,35,72,1155.0
450000.0,4,3.0,1890,13140,1.0,4,7,1270,620.0,1967,1900,11160,20155 days 16:47:18.688814,239,1.3333333333333333,2.0483870967741935,-10,1980,650.0
247500.0,4,2.0,1760,8400,1.0,3,7,1060,700.0,1962,1280,8415,21981 days 16:47:18.688814,062,2.0,1.5142857142857142,480,-15,360.0
208000.0,3,1.0,1050,6240,1.0,5,5,1050,0.0,1948,1410,6240,27095 days 16:47:18.688814,050,3.0,0.0,-360,0,1050.0
455000.0,3,2.5,1980,7309,2.0,3,7,1980,0.0,1993,2060,9681,10658 days 16:47:18.688814,360,1.2,0.0,-80,-2372,1980.0
379400.0,4,1.75,2120,7680,1.0,4,7,1060,1060.0,1950,1530,7680,26364 days 16:47:18.688814,314,2.2857142857142856,1.0,590,0,0.0
190000.0,3,1.5,760,40039,1.0,3,6,760,0.0,1906,980,6000,42435 days 16:47:18.688814,364,2.0,0.0,-220,34039,760.0
326188.0,3,1.0,1300,8800,1.0,3,7,1300,0.0,1977,1600,12210,16502 days 16:47:18.688814,233,3.0,0.0,-300,-3410,1300.0
168000.0,2,2.5,1160,2174,2.0,3,7,1160,0.0,1998,1380,1919,8832 days 16:47:18.688814,142,0.8,0.0,-220,255,1160.0
314000.0,4,2.5,2340,8990,2.0,3,8,2340,0.0,2003,2980,6718,7006 days 16:47:18.688814,136,1.6,0.0,-640,2272,2340.0
630000.0,4,2.75,2710,37277,2.0,3,9,2710,0.0,2000,2390,39299,8102 days 16:47:18.688814,122,1.4545454545454546,0.0,320,-2022,2710.0
550000.0,3,1.75,1440,8957,1.0,4,7,1440,0.0,1957,1340,8780,23807 days 16:47:18.688814,075,1.7142857142857142,0.0,100,177,1440.0
530000.0,4,2.25,1980,15086,2.0,3,8,1980,0.0,1981,2100,10927,15041 days 16:47:18.688814,181,1.7777777777777777,0.0,-120,4159,1980.0
637500.0,3,1.75,1680,10685,1.0,4,7,1680,0.0,1966,3340,10390,20520 days 16:47:18.688814,037,1.7142857142857142,0.0,-1660,295,1680.0
400000.0,3,2.5,1390,2815,2.0,3,8,1390,0.0,1999,1390,3700,8467 days 16:47:18.688814,118,1.2,0.0,0,-885,1390.0
700000.0,5,2.75,3100,9825,2.0,4,8,3100,0.0,1950,2120,8400,26364 days 16:47:18.688814,161,1.8181818181818181,0.0,980,1425,3100.0
272000.0,3,2.5,1680,8512,2.0,3,7,1680,0.0,1991,1580,8512,11389 days 16:47:18.688814,318,1.2,0.0,100,0,1680.0
600000.0,4,2.5,2710,6474,2.0,3,8,2710,0.0,2004,2870,6968,6641 days 16:47:18.688814,107,1.6,0.0,-160,-494,2710.0
450600.0,2,1.0,840,7020,1.5,4,7,840,0.0,1943,1310,7072,28921 days 16:47:18.688814,092,2.0,0.0,-470,-52,840.0
550000.0,3,2.25,2090,8095,2.0,3,1,2090,0.0,1988,1940,5635,12485 days 16:47:18.688814,301,1.3333333333333333,0.0,150,2460,2090.0
225000.0,3,1.0,1120,8407,1.0,5,6,1120,0.0,1987,1250,8658,12850 days 16:47:18.688814,023,3.0,0.0,-130,-251,1120.0
132825.0,3,1.5,1210,5200,1.0,5,6,1210,0.0,1969,1120,5200,19424 days 16:47:18.688814,049,2.0,0.0,90,0,1210.0
219950.0,3,1.5,1210,5200,1.0,5,6,1210,0.0,1969,1120,5200,19424 days 16:47:18.688814,120,2.0,0.0,90,0,1210.0
580000.0,5,2.0,1940,6000,1.0,5,7,970,970.0,1945,1700,6000,28190 days 16:47:18.688814,148,2.5,1.0,240,0,0.0
568000.0,3,1.75,1930,213008,1.0,3,7,1300,630.0,1980,2860,208652,15407 days 16:47:18.688814,203,1.7142857142857142,2.0634920634920637,-930,4356,670.0
406000.0,3,1.75,1270,6017,1.0,4,7,1030,240.0,1990,1630,7381,11754 days 16:47:18.688814,092,1.7142857142857142,4.291666666666667,-360,-1364,790.0
469000.0,3,1.75,1680,2400,1.5,3,7,1170,510.0,1929,1080,4560,34034 days 16:47:18.688814,197,1.7142857142857142,2.2941176470588234,600,-2160,660.0
415000.0,3,2.5,2090,6045,2.0,3,8,2090,0.0,2000,2040,6392,8102 days 16:47:18.688814,161,1.2,0.0,50,-347,2090.0
390000.0,3,1.5,1000,13991,1.0,4,7,1000,0.0,1956,1520,11465,24173 days 16:47:18.688814,342,2.0,0.0,-520,2526,1000.0
251000.0,3,1.75,1350,10125,1.0,3,8,1350,0.0,1967,1520,9720,20155 days 16:47:18.688814,105,1.7142857142857142,0.0,-170,405,1350.0
750000.0,3,2.5,3280,6750,2.0,3,9,2440,840.0,2001,1770,6387,7736 days 16:47:18.688814,071,1.2,2.9047619047619047,1510,363,1600.0
845000.0,4,2.5,2390,5071,2.0,3,9,1760,630.0,1988,1940,5071,12485 days 16:47:18.688814,097,1.6,2.7936507936507935,450,0,1130.0
350000.0,3,1.5,1860,17640,1.0,4,7,1860,0.0,1966,1860,17820,20520 days 16:47:18.688814,283,2.0,0.0,0,-180,1860.0
322000.0,3,1.0,1380,5864,1.0,3,7,790,590.0,1944,1509,5864,28556 days 16:47:18.688814,056,3.0,1.3389830508474576,-129,0,200.0
664500.0,4,2.25,3070,9210,2.0,3,8,2740,330.0,2010,2580,9660,4449 days 16:47:18.688814,127,1.7777777777777777,8.303030303030303,490,-450,2410.0
988000.0,3,1.75,2190,3800,1.5,4,8,2190,0.0,1923,2190,3880,36226 days 16:47:18.688814,007,1.7142857142857142,0.0,0,-80,2190.0
625000.0,2,1.75,1990,4000,1.0,5,7,1090,900.0,1952,1270,5700,25634 days 16:47:18.688814,187,1.1428571428571428,1.211111111111111,720,-1700,190.0
675000.0,2,1.0,930,36478,1.0,3,6,930,0.0,1951,2800,11141,25999 days 16:47:18.688814,126,2.0,0.0,-1870,25337,930.0
503000.0,3,1.75,2070,9827,1.0,4,7,1420,650.0,1967,2150,9827,20155 days 16:47:18.688814,097,1.7142857142857142,2.1846153846153844,-80,0,770.0
431000.0,4,2.25,2170,10500,1.0,4,8,1270,900.0,1960,2080,11019,22712 days 16:47:18.688814,129,1.7777777777777777,1.4111111111111112,90,-519,370.0
250000.0,3,1.75,1910,10230,1.0,4,7,1290,620.0,1964,1590,10800,21251 days 16:47:18.688814,330,1.7142857142857142,2.0806451612903225,320,-570,670.0
268500.0,4,2.5,2100,4237,2.0,3,8,2100,0.0,2006,2100,4575,5910 days 16:47:18.688814,156,1.6,0.0,0,-338,2100.0
1070000.0,6,3.25,3560,21400,2.0,4,9,3560,0.0,1952,3560,24338,25634 days 16:47:18.688814,085,1.8461538461538463,0.0,0,-2938,3560.0
295000.0,4,2.5,2290,4539,2.0,3,7,2290,0.0,2001,1710,7200,7736 days 16:47:18.688814,149,1.6,0.0,580,-2661,2290.0
780000.0,3,2.25,2130,11782,1.0,4,8,1590,540.0,1977,2700,11782,16502 days 16:47:18.688814,206,1.3333333333333333,2.9444444444444446,-570,0,1050.0
354000.0,3,2.5,2160,15817,2.0,3,8,2160,0.0,1999,1990,15817,8467 days 16:47:18.688814,118,1.2,0.0,170,0,2160.0
305000.0,2,1.0,860,7250,1.0,3,6,860,0.0,1949,1270,7250,26729 days 16:47:18.688814,230,2.0,0.0,-410,0,860.0
733000.0,5,2.75,2880,4425,2.0,3,8,2880,0.0,2005,2940,6581,6275 days 16:47:18.688814,091,1.8181818181818181,0.0,-60,-2156,2880.0
640000.0,4,2.75,2100,11894,1.0,4,8,1720,380.0,1968,2390,9450,19790 days 16:47:18.688814,259,1.4545454545454546,4.526315789473684,-290,2444,1340.0
840000.0,4,2.5,2360,9600,1.0,3,8,1630,730.0,1973,2140,6300,17963 days 16:47:18.688814,107,1.6,2.232876712328767,220,3300,900.0
1480000.0,5,3.25,3680,10300,1.5,4,1,3680,0.0,1927,2690,7200,34765 days 16:47:18.688814,344,1.5384615384615385,0.0,990,3100,3680.0
525000.0,3,1.0,1560,8100,1.0,4,8,1140,420.0,1952,2130,8100,25634 days 16:47:18.688814,085,3.0,2.7142857142857144,-570,0,720.0
625000.0,4,2.75,1680,11180,1.0,4,7,1680,0.0,1966,2400,9627,20520 days 16:47:18.688814,134,1.4545454545454546,0.0,-720,1553,1680.0
350000.0,3,2.0,1380,3600,3.0,3,8,1380,0.0,2015,1480,3600,2623 days 16:47:18.688814,168,1.5,0.0,-100,0,1380.0
650000.0,4,2.75,2610,4160,3.0,5,8,1910,700.0,1910,1470,4140,40974 days 16:47:18.688814,167,1.4545454545454546,2.7285714285714286,1140,20,1210.0
435000.0,2,1.0,870,4000,1.0,3,7,870,0.0,1950,1690,4000,26364 days 16:47:18.688814,296,2.0,0.0,-820,0,870.0
660000.0,3,1.0,1210,9622,1.0,3,8,1210,0.0,1955,1580,9714,24538 days 16:47:18.688814,177,3.0,0.0,-370,-92,1210.0
350000.0,3,1.0,1150,12877,1.0,4,6,1150,0.0,1970,1490,12150,19059 days 16:47:18.688814,061,3.0,0.0,-340,727,1150.0
435000.0,3,2.5,3110,6000,1.0,3,8,1560,1550.0,1967,2060,6000,20155 days 16:47:18.688814,084,1.2,1.0064516129032257,1050,0,10.0
375900.0,6,1.5,2550,33740,1.0,4,8,1750,800.0,1958,2010,28200,23442 days 16:47:18.688814,154,4.0,2.1875,540,5540,950.0
272000.0,3,3.0,2430,10500,1.0,4,8,2150,280.0,1983,1670,9800,14311 days 16:47:18.688814,328,1.0,7.678571428571429,760,700,1870.0
233000.0,3,1.75,1460,7800,1.0,2,7,1040,420.0,1979,1310,7865,15772 days 16:47:18.688814,015,1.7142857142857142,2.4761904761904763,150,-65,620.0
500000.0,4,1.5,1330,5750,1.5,3,7,1330,0.0,1915,1360,5750,39148 days 16:47:18.688814,259,2.6666666666666665,0.0,-30,0,1330.0
540000.0,4,1.75,2040,9322,1.0,3,8,1440,600.0,1977,1910,10026,16502 days 16:47:18.688814,092,2.2857142857142856,2.4,130,-704,840.0
712000.0,3,2.5,2375,4094,2.0,3,9,2375,0.0,2002,2095,4442,7371 days 16:47:18.688814,182,1.2,0.0,280,-348,2375.0
425000.0,4,2.5,2480,4504,2.0,3,7,2480,0.0,2005,2950,4504,6275 days 16:47:18.688814,268,1.6,0.0,-470,0,2480.0
515000.0,5,3.25,2740,9629,1.0,5,7,1390,1350.0,1977,2150,10500,16502 days 16:47:18.688814,184,1.5384615384615385,1.0296296296296297,590,-871,40.0
415000.0,4,1.75,1920,7700,2.0,4,7,1920,0.0,1970,1310,7700,19059 days 16:47:18.688814,189,2.2857142857142856,0.0,610,0,1920.0
375000.0,3,2.75,2200,9600,1.0,4,8,1570,630.0,1977,2680,9896,16502 days 16:47:18.688814,344,1.0909090909090908,2.492063492063492,-480,-296,940.0
182500.0,3,1.0,910,7194,1.0,4,7,910,0.0,1971,1530,7200,18694 days 16:47:18.688814,300,3.0,0.0,-620,-6,910.0
310000.0,3,1.5,1860,10379,1.0,3,7,1240,620.0,1963,2240,11328,21616 days 16:47:18.688814,082,2.0,2.0,-380,-949,620.0
360000.0,3,1.75,1510,6000,1.0,3,7,1060,450.0,1947,1610,6000,27460 days 16:47:18.688814,300,1.7142857142857142,2.3555555555555556,-100,0,610.0
889000.0,4,3.5,3920,9555,2.0,3,9,3920,0.0,2004,3920,8598,6641 days 16:47:18.688814,098,1.1428571428571428,0.0,0,957,3920.0
450500.0,2,1.0,1330,3698,1.0,3,7,1330,0.0,1952,1900,5000,25634 days 16:47:18.688814,100,2.0,0.0,-570,-1302,1330.0
342000.0,4,2.25,1964,3541,2.0,3,9,1964,0.0,2013,1757,3547,3353 days 16:47:18.688814,112,1.7777777777777777,0.0,207,-6,1964.0
413000.0,3,2.0,1520,3451,1.0,3,8,1520,0.0,1996,1800,3451,9563 days 16:47:18.688814,195,1.5,0.0,-280,0,1520.0
960000.0,5,4.0,3720,15200,2.0,3,1,3720,0.0,2005,4100,19036,6275 days 16:47:18.688814,147,1.25,0.0,-380,-3836,3720.0
180000.0,2,1.0,770,9370,1.0,3,7,770,0.0,1947,1060,9352,27460 days 16:47:18.688814,248,2.0,0.0,-290,18,770.0
770000.0,4,2.5,3210,14910,2.0,3,1,3210,0.0,1995,3280,14910,9928 days 16:47:18.688814,169,1.6,0.0,-70,0,3210.0
224400.0,3,1.75,1070,7200,1.0,3,7,1070,0.0,1994,1280,7200,10293 days 16:47:18.688814,225,1.7142857142857142,0.0,-210,0,1070.0
280000.0,3,1.5,1430,8861,1.0,3,7,1430,0.0,1956,1080,9425,24173 days 16:47:18.688814,120,2.0,0.0,350,-564,1430.0
153000.0,2,1.0,710,9000,1.0,5,6,710,0.0,1943,1230,9000,28921 days 16:47:18.688814,034,2.0,0.0,-520,0,710.0
385000.0,3,2.25,1920,4833,1.0,4,7,1060,860.0,1921,1580,5134,36956 days 16:47:18.688814,164,1.3333333333333333,1.2325581395348837,340,-301,200.0
325000.0,2,1.0,750,5534,1.0,3,7,750,0.0,1947,1050,5534,27460 days 16:47:18.688814,231,2.0,0.0,-300,0,750.0
315000.0,4,3.0,2210,4191,2.0,3,7,2210,0.0,2004,890,4288,6641 days 16:47:18.688814,099,1.3333333333333333,0.0,1320,-97,2210.0
294999.0,4,2.5,1660,9760,2.0,3,7,1660,0.0,1994,1580,9614,10293 days 16:47:18.688814,168,1.6,0.0,80,146,1660.0
175000.0,3,1.75,1910,17003,1.5,4,8,1910,0.0,1963,1820,14806,21616 days 16:47:18.688814,300,1.7142857142857142,0.0,90,2197,1910.0
299000.0,3,1.75,1910,17003,1.5,4,8,1910,0.0,1963,1820,14806,21616 days 16:47:18.688814,096,1.7142857142857142,0.0,90,2197,1910.0
146000.0,2,1.0,780,9750,1.0,3,6,780,0.0,1937,1670,9750,31112 days 16:47:18.688814,040,2.0,0.0,-890,0,780.0
290000.0,3,2.25,1650,10336,1.0,3,7,1500,150.0,1962,1420,10260,21981 days 16:47:18.688814,309,1.3333333333333333,10.0,230,76,1350.0
1780000.0,3,3.25,3230,7800,2.0,3,1,3230,0.0,2005,3030,6600,6275 days 16:47:18.688814,220,0.9230769230769231,0.0,200,1200,3230.0
367500.0,2,1.0,810,4800,1.0,3,6,810,0.0,1919,1040,4800,37687 days 16:47:18.688814,149,2.0,0.0,-230,0,810.0
535000.0,4,2.5,2750,15099,2.0,3,8,2750,0.0,1994,2500,14564,10293 days 16:47:18.688814,086,1.6,0.0,250,535,2750.0
334999.0,3,2.5,1650,13816,2.0,3,7,1650,0.0,1998,1630,18750,8832 days 16:47:18.688814,217,1.2,0.0,20,-4934,1650.0
655000.0,3,1.75,1960,5520,1.0,4,7,1080,880.0,1952,1720,5760,25634 days 16:47:18.688814,233,1.7142857142857142,1.2272727272727273,240,-240,200.0
1300000.0,4,3.5,2790,10125,1.5,5,8,2790,0.0,1985,2570,10125,13580 days 16:47:18.688814,154,1.1428571428571428,0.0,220,0,2790.0
480000.0,4,2.25,2230,11200,1.0,4,7,1300,930.0,1977,2090,10563,16502 days 16:47:18.688814,080,1.7777777777777777,1.3978494623655915,140,637,370.0
465000.0,3,1.5,1280,4720,1.0,4,7,850,430.0,1941,1280,4720,29651 days 16:47:18.688814,111,2.0,1.9767441860465116,0,0,420.0
297950.0,3,2.0,1240,10800,1.0,3,7,1240,0.0,1967,1480,8840,20155 days 16:47:18.688814,128,1.5,0.0,-240,1960,1240.0
590000.0,3,2.0,1860,3600,1.5,3,7,1110,750.0,1915,1680,3695,39148 days 16:47:18.688814,105,1.5,1.48,180,-95,360.0
805000.0,4,2.75,2410,6000,1.0,5,8,1410,1000.0,1950,1760,6000,26364 days 16:47:18.688814,142,1.4545454545454546,1.41,650,0,410.0
204250.0,3,2.25,1960,7708,1.0,4,7,1490,470.0,1984,1580,8063,13946 days 16:47:18.688814,020,1.3333333333333333,3.1702127659574466,380,-355,1020.0
500000.0,3,2.25,1710,4561,2.0,4,8,1710,0.0,1994,1810,4770,10293 days 16:47:18.688814,197,1.3333333333333333,0.0,-100,-209,1710.0
490000.0,4,2.5,3480,12696,1.0,4,9,1980,1500.0,1977,3480,14175,16502 days 16:47:18.688814,260,1.6,1.32,0,-1479,480.0
2500000.0,4,3.75,3480,14850,1.0,3,9,1870,1610.0,1951,4780,18480,25999 days 16:47:18.688814,083,1.0666666666666667,1.1614906832298137,-1300,-3630,260.0
750000.0,3,2.5,2960,69351,2.0,4,9,2960,0.0,1990,2350,41433,11754 days 16:47:18.688814,210,1.2,0.0,610,27918,2960.0
405000.0,4,2.5,2670,20894,2.0,3,9,2330,340.0,2002,2440,15815,7371 days 16:47:18.688814,099,1.6,6.852941176470588,230,5079,1990.0
209995.0,2,1.0,700,7303,1.0,5,5,700,0.0,1953,960,6060,25268 days 16:47:18.688814,202,2.0,0.0,-260,1243,700.0
680000.0,4,2.5,2830,8399,2.0,3,9,2830,0.0,1998,2520,6890,8832 days 16:47:18.688814,289,1.6,0.0,310,1509,2830.0
355000.0,3,1.75,1120,7740,1.0,4,6,860,260.0,1948,1240,7740,27095 days 16:47:18.688814,275,1.7142857142857142,3.3076923076923075,-120,0,600.0
280000.0,2,1.0,1310,6600,1.0,3,6,1310,0.0,1942,1240,6600,29286 days 16:47:18.688814,112,2.0,0.0,70,0,1310.0
385000.0,3,2.25,1710,11500,1.0,3,7,1210,500.0,1978,1800,11500,16137 days 16:47:18.688814,156,1.3333333333333333,2.42,-90,0,710.0
505000.0,4,2.75,2200,9778,1.0,4,8,1100,1100.0,1962,2140,11321,21981 days 16:47:18.688814,182,1.4545454545454546,1.0,60,-1543,0.0
429900.0,4,3.25,3310,8897,2.0,3,9,2380,930.0,1991,2490,8638,11389 days 16:47:18.688814,234,1.2307692307692308,2.5591397849462365,820,259,1450.0
560000.0,4,2.5,2280,9874,2.0,3,9,2280,0.0,1989,2670,9782,12119 days 16:47:18.688814,202,1.6,0.0,-390,92,2280.0
231000.0,3,2.0,1640,4875,1.0,4,7,1040,600.0,1977,1640,5200,16502 days 16:47:18.688814,272,1.5,1.7333333333333334,0,-325,440.0
135000.0,2,1.0,750,5217,1.0,4,6,750,0.0,1943,760,4440,28921 days 16:47:18.688814,117,2.0,0.0,-10,777,750.0
800000.0,4,3.0,3520,4895,1.0,3,8,1980,1540.0,1954,1570,2153,24903 days 16:47:18.688814,174,1.3333333333333333,1.2857142857142858,1950,2742,440.0
420000.0,3,2.5,2720,8622,2.0,3,8,2720,0.0,2002,1950,8603,7371 days 16:47:18.688814,354,1.2,0.0,770,19,2720.0
360000.0,3,1.0,1660,9600,1.0,3,7,1660,0.0,1963,2020,9600,21616 days 16:47:18.688814,295,3.0,0.0,-360,0,1660.0
642000.0,4,2.5,2560,8780,2.0,3,9,2560,0.0,1992,2780,8357,11024 days 16:47:18.688814,150,1.6,0.0,-220,423,2560.0
379950.0,3,2.0,1080,5077,1.0,3,7,1080,0.0,1985,1070,3471,13580 days 16:47:18.688814,096,1.5,0.0,10,1606,1080.0
745000.0,3,1.75,2050,11041,1.5,5,9,2050,0.0,1959,2530,11041,23077 days 16:47:18.688814,192,1.7142857142857142,0.0,-480,0,2050.0
630000.0,4,2.0,2670,3240,1.5,4,9,1780,890.0,1930,1820,4000,33669 days 16:47:18.688814,210,2.0,2.0,850,-760,890.0
250000.0,3,2.5,1730,7200,2.0,4,7,1730,0.0,1985,1770,7396,13580 days 16:47:18.688814,125,1.2,0.0,-40,-196,1730.0
275000.0,3,1.0,990,9798,1.0,3,7,990,0.0,1968,1210,9870,19790 days 16:47:18.688814,175,3.0,0.0,-220,-72,990.0
435000.0,6,3.0,3560,4290,1.0,4,7,1780,1780.0,1957,3040,6000,23807 days 16:47:18.688814,121,2.0,1.0,520,-1710,0.0
175000.0,2,1.0,700,8174,1.0,3,5,700,0.0,1941,1250,8046,29651 days 16:47:18.688814,064,2.0,0.0,-550,128,700.0
560000.0,4,1.75,1880,3880,1.5,4,7,1090,790.0,1944,1390,3880,28556 days 16:47:18.688814,163,2.2857142857142856,1.379746835443038,490,0,300.0
325000.0,4,2.25,1870,9680,1.0,4,7,1170,700.0,1959,2000,9790,23077 days 16:47:18.688814,140,1.7777777777777777,1.6714285714285715,-130,-110,470.0
1190000.0,3,2.75,2500,5568,2.0,5,9,2500,0.0,1905,2810,5568,42800 days 16:47:18.688814,168,1.0909090909090908,0.0,-310,0,2500.0
399950.0,3,2.5,2570,10431,2.0,3,9,2570,0.0,1989,2590,10078,12119 days 16:47:18.688814,178,1.2,0.0,-20,353,2570.0
752000.0,4,2.5,2940,10382,2.0,4,9,2940,0.0,1991,2980,10547,11389 days 16:47:18.688814,168,1.6,0.0,-40,-165,2940.0
1200000.0,4,3.5,3930,43560,2.0,3,1,3930,0.0,2003,2860,36460,7006 days 16:47:18.688814,113,1.1428571428571428,0.0,1070,7100,3930.0
400000.0,4,1.5,2150,11026,1.0,4,7,2150,0.0,1952,1760,10283,25634 days 16:47:18.688814,268,2.6666666666666665,0.0,390,743,2150.0
240000.0,3,2.0,1330,6000,1.0,4,7,630,700.0,1900,1140,6000,44626 days 16:47:18.688814,150,1.5,0.9,190,0,-70.0
640000.0,5,2.5,3220,4759,2.0,3,8,3220,0.0,2003,2550,4759,7006 days 16:47:18.688814,315,2.0,0.0,670,0,3220.0
564450.0,3,2.5,2710,6174,2.0,3,9,2710,0.0,1998,2730,7266,8832 days 16:47:18.688814,092,1.2,0.0,-20,-1092,2710.0
300000.0,3,1.5,1630,82764,1.0,4,6,1630,0.0,1948,1680,199069,27095 days 16:47:18.688814,126,2.0,0.0,-50,-116305,1630.0
286000.0,3,2.5,1680,4226,2.0,3,8,1680,0.0,2003,1800,5559,7006 days 16:47:18.688814,076,1.2,0.0,-120,-1333,1680.0
531800.0,3,2.5,1930,5344,2.0,3,7,1930,0.0,2004,2410,5080,6641 days 16:47:18.688814,050,1.2,0.0,-480,264,1930.0
502000.0,4,2.25,2140,10943,1.0,3,7,1550,590.0,1977,2350,9000,16502 days 16:47:18.688814,297,1.7777777777777777,2.6271186440677967,-210,1943,960.0
993500.0,4,2.25,4070,23321,2.0,4,1,4070,0.0,1968,2820,10871,19790 days 16:47:18.688814,233,1.7777777777777777,0.0,1250,12450,4070.0
450000.0,3,1.0,1350,10000,1.0,4,7,1350,0.0,1954,1450,10000,24903 days 16:47:18.688814,293,3.0,0.0,-100,0,1350.0
997950.0,4,3.5,4270,117176,2.0,3,9,4270,0.0,2008,2610,5251,5180 days 16:47:18.688814,300,1.1428571428571428,0.0,1660,111925,4270.0
526000.0,3,1.0,1320,5250,1.5,5,7,1320,0.0,1913,1490,5250,39878 days 16:47:18.688814,286,3.0,0.0,-170,0,1320.0
335000.0,3,1.75,2100,8298,1.0,4,7,1230,870.0,1952,1700,10830,25634 days 16:47:18.688814,014,1.7142857142857142,1.4137931034482758,400,-2532,360.0
187250.0,2,1.0,710,14700,1.0,5,6,710,0.0,1926,1320,14700,35130 days 16:47:18.688814,337,2.0,0.0,-610,0,710.0
735000.0,3,2.25,2350,6000,1.0,5,7,1020,1330.0,1948,1570,5000,27095 days 16:47:18.688814,223,1.3333333333333333,0.7669172932330827,780,1000,-310.0
425000.0,3,1.0,1180,8400,1.0,3,7,1180,0.0,1951,1740,7020,25999 days 16:47:18.688814,049,3.0,0.0,-560,1380,1180.0
110000.0,3,1.0,1250,53143,1.0,5,6,1250,0.0,1945,1820,217800,28190 days 16:47:18.688814,132,3.0,0.0,-570,-164657,1250.0
305000.0,3,2.0,1490,7697,1.0,3,7,1490,0.0,1994,1540,7529,10293 days 16:47:18.688814,233,1.5,0.0,-50,168,1490.0
1380000.0,5,4.25,4050,18827,1.0,4,1,2150,1900.0,1979,3600,25120,15772 days 16:47:18.688814,132,1.1764705882352942,1.131578947368421,450,-6293,250.0
298950.0,5,2.25,2300,11505,1.0,3,8,1300,1000.0,1963,2350,11505,21616 days 16:47:18.688814,261,2.2222222222222223,1.3,-50,0,300.0
525000.0,3,1.75,1330,8136,1.0,4,7,1330,0.0,1977,1330,8136,16502 days 16:47:18.688814,075,1.7142857142857142,0.0,0,0,1330.0
707000.0,4,3.25,3200,7081,2.0,3,9,3200,0.0,2004,3120,6094,6641 days 16:47:18.688814,134,1.2307692307692308,0.0,80,987,3200.0
695000.0,3,2.75,2590,12063,2.0,3,1,2590,0.0,1993,2850,8469,10658 days 16:47:18.688814,177,1.0909090909090908,0.0,-260,3594,2590.0
796500.0,3,2.75,2590,12063,2.0,3,1,2590,0.0,1993,2850,8469,10658 days 16:47:18.688814,335,1.0909090909090908,0.0,-260,3594,2590.0
420000.0,4,2.5,2030,8100,1.0,3,7,1150,880.0,1973,1770,8071,17963 days 16:47:18.688814,204,1.6,1.3068181818181819,260,29,270.0
625000.0,5,2.5,2700,21208,1.0,4,8,1950,750.0,1955,2550,20409,24538 days 16:47:18.688814,176,2.0,2.6,150,799,1200.0
620000.0,3,1.75,1670,9900,1.0,4,8,1670,0.0,1957,2410,8800,23807 days 16:47:18.688814,235,1.7142857142857142,0.0,-740,1100,1670.0
1450000.0,5,2.75,3090,19865,1.0,4,9,3090,0.0,1953,2970,19862,25268 days 16:47:18.688814,304,1.8181818181818181,0.0,120,3,3090.0
549950.0,5,2.5,2650,54380,2.0,3,9,2650,0.0,1984,2560,49044,13946 days 16:47:18.688814,099,2.0,0.0,90,5336,2650.0
275000.0,4,2.0,1440,10920,1.0,3,5,1440,0.0,1943,1500,11902,28921 days 16:47:18.688814,058,2.0,0.0,-60,-982,1440.0
705000.0,3,2.5,2820,7200,1.0,3,9,1780,1040.0,1979,2300,7200,15772 days 16:47:18.688814,267,1.2,1.7115384615384615,520,0,740.0
197000.0,3,1.75,1690,7735,1.0,4,7,1060,630.0,1976,1580,7503,16868 days 16:47:18.688814,126,1.7142857142857142,1.6825396825396826,110,232,430.0
265000.0,3,1.75,1420,8126,1.0,3,8,1420,0.0,1991,1730,7954,11389 days 16:47:18.688814,125,1.7142857142857142,0.0,-310,172,1420.0
297000.0,4,1.75,1790,5341,1.0,4,7,1050,740.0,1951,1540,6916,25999 days 16:47:18.688814,324,2.2857142857142856,1.4189189189189189,250,-1575,310.0
207500.0,3,1.75,1320,12528,1.0,4,7,1320,0.0,1970,1340,11039,19059 days 16:47:18.688814,231,1.7142857142857142,0.0,-20,1489,1320.0
410000.0,3,2.5,1509,1418,3.0,3,8,1509,0.0,2014,1509,1991,2988 days 16:47:18.688814,231,1.2,0.0,0,-573,1509.0
268000.0,3,2.0,1610,8416,1.0,3,7,1610,0.0,1994,1600,8308,10293 days 16:47:18.688814,276,1.5,0.0,10,108,1610.0
330000.0,4,1.75,1550,50094,1.0,4,6,1550,0.0,1967,1720,50094,20155 days 16:47:18.688814,217,2.2857142857142856,0.0,-170,0,1550.0
417500.0,3,1.0,1160,7491,1.0,4,6,1160,0.0,1917,1800,2267,38417 days 16:47:18.688814,230,3.0,0.0,-640,5224,1160.0
760000.0,4,2.25,2500,8500,2.0,4,8,2500,0.0,1979,2470,9100,15772 days 16:47:18.688814,216,1.7777777777777777,0.0,30,-600,2500.0
499000.0,3,2.5,1540,1326,3.0,3,8,1390,150.0,1995,1680,1592,9928 days 16:47:18.688814,186,1.2,9.266666666666667,-140,-266,1240.0
620000.0,4,2.5,1910,7683,2.0,3,8,1910,0.0,1987,1980,8485,12850 days 16:47:18.688814,169,1.6,0.0,-70,-802,1910.0
315000.0,3,2.5,2340,6837,2.0,3,7,2340,0.0,1992,1850,6209,11024 days 16:47:18.688814,191,1.2,0.0,490,628,2340.0
624950.0,3,2.5,2060,4730,2.0,4,8,2060,0.0,1994,1980,5010,10293 days 16:47:18.688814,099,1.2,0.0,80,-280,2060.0
525000.0,3,2.25,1960,12350,1.0,4,7,1960,0.0,1961,1920,13608,22346 days 16:47:18.688814,118,1.3333333333333333,0.0,40,-1258,1960.0
300000.0,2,1.5,1150,3927,2.0,3,7,1150,0.0,1982,1400,3425,14676 days 16:47:18.688814,220,1.3333333333333333,0.0,-250,502,1150.0
299900.0,4,2.75,2330,7200,1.0,4,8,1560,770.0,1977,2350,7600,16502 days 16:47:18.688814,069,1.4545454545454546,2.0259740259740258,-20,-400,790.0
299000.0,3,2.5,2210,10119,1.0,4,7,1450,760.0,1966,2110,10119,20520 days 16:47:18.688814,163,1.2,1.9078947368421053,100,0,690.0
1880000.0,4,2.75,3260,19542,1.0,4,1,2170,1090.0,1968,3480,19863,19790 days 16:47:18.688814,134,1.4545454545454546,1.9908256880733946,-220,-321,1080.0
265000.0,4,1.75,1900,10588,1.0,5,6,1900,0.0,1958,1530,10587,23442 days 16:47:18.688814,164,2.2857142857142856,0.0,370,1,1900.0
280000.0,2,1.75,1610,158558,1.5,2,6,1610,0.0,1948,1800,3572,27095 days 16:47:18.688814,160,1.1428571428571428,0.0,-190,154986,1610.0
124740.0,3,1.0,1340,15600,1.0,4,6,1340,0.0,1978,1320,9800,16137 days 16:47:18.688814,148,3.0,0.0,20,5800,1340.0
1090000.0,3,2.75,3170,34850,1.0,5,9,3170,0.0,1957,3920,36740,23807 days 16:47:18.688814,006,1.0909090909090908,0.0,-750,-1890,3170.0
1970000.0,8,3.5,4440,6480,2.0,5,1,3140,1300.0,1959,4440,8640,23077 days 16:47:18.688814,148,2.2857142857142856,2.4153846153846152,0,-2160,1840.0
219000.0,4,1.0,1370,5339,1.5,4,6,1370,0.0,1948,1280,7048,27095 days 16:47:18.688814,046,4.0,0.0,90,-1709,1370.0
569950.0,5,1.0,1420,6250,1.5,4,8,1420,0.0,1926,1420,6250,35130 days 16:47:18.688814,106,5.0,0.0,0,0,1420.0
212500.0,2,2.0,1030,21712,1.0,4,6,1030,0.0,1938,1790,9199,30747 days 16:47:18.688814,160,1.0,0.0,-760,12513,1030.0
680000.0,3,2.25,1820,8316,1.0,5,7,1320,500.0,1960,1780,8400,22712 days 16:47:18.688814,223,1.3333333333333333,2.64,40,-84,820.0
1460000.0,4,1.5,2650,6900,2.0,4,9,2400,250.0,1909,2420,6900,41339 days 16:47:18.688814,272,2.6666666666666665,9.6,230,0,2150.0
300000.0,3,1.0,910,7700,1.0,4,7,910,0.0,1971,1250,7700,18694 days 16:47:18.688814,169,3.0,0.0,-340,0,910.0
629950.0,3,2.5,1680,1683,2.0,3,9,1120,560.0,2014,1610,1249,2988 days 16:47:18.688814,069,1.2,2.0,70,434,560.0
349900.0,2,1.75,1550,9230,1.0,3,6,970,580.0,1969,1550,10856,19424 days 16:47:18.688814,336,1.1428571428571428,1.6724137931034482,0,-1626,390.0
690000.0,4,2.5,2780,6235,2.0,3,8,2780,0.0,2001,2670,4410,7736 days 16:47:18.688814,224,1.6,0.0,110,1825,2780.0
1450000.0,5,4.0,4070,11334,2.0,3,1,4070,0.0,2014,2640,9401,2988 days 16:47:18.688814,056,1.25,0.0,1430,1933,4070.0
1290000.0,3,2.5,3240,12625,2.0,3,1,3240,0.0,1987,3470,12331,12850 days 16:47:18.688814,021,1.2,0.0,-230,294,3240.0
696000.0,4,3.5,3650,38546,2.0,3,9,2550,1100.0,1996,2860,34284,9563 days 16:47:18.688814,190,1.1428571428571428,2.3181818181818183,790,4262,1450.0
650000.0,3,2.25,2180,60112,2.0,3,8,2180,0.0,1976,2060,120225,16868 days 16:47:18.688814,089,1.3333333333333333,0.0,120,-60113,2180.0
640000.0,3,3.5,2480,10800,2.0,3,8,2480,0.0,1998,2380,11310,8832 days 16:47:18.688814,224,0.8571428571428571,0.0,100,-510,2480.0
499950.0,5,2.5,3180,23809,1.0,3,9,3180,0.0,1978,2500,15778,16137 days 16:47:18.688814,220,2.0,0.0,680,8031,3180.0
490000.0,4,2.5,3630,8387,2.0,3,1,3630,0.0,1997,3370,8869,9197 days 16:47:18.688814,357,1.6,0.0,260,-482,3630.0
685000.0,5,2.5,3160,5635,2.0,3,9,3160,0.0,2003,3670,6087,7006 days 16:47:18.688814,283,2.0,0.0,-510,-452,3160.0
387500.0,4,1.0,1370,7140,2.0,3,6,1370,0.0,1942,1090,6300,29286 days 16:47:18.688814,093,4.0,0.0,280,840,1370.0
401750.0,2,1.5,1070,1236,2.0,3,8,1000,70.0,2005,1170,1888,6275 days 16:47:18.688814,111,1.3333333333333333,14.285714285714286,-100,-652,930.0
500000.0,4,2.25,2420,36680,2.0,4,8,2420,0.0,1977,2410,36680,16502 days 16:47:18.688814,079,1.7777777777777777,0.0,10,0,2420.0
856500.0,4,2.5,3290,8147,2.0,3,1,3290,0.0,2003,3290,7467,7006 days 16:47:18.688814,196,1.6,0.0,0,680,3290.0
552000.0,3,1.0,1430,5000,1.0,4,6,1080,350.0,1919,1630,4600,37687 days 16:47:18.688814,143,3.0,3.085714285714286,-200,400,730.0
506500.0,4,2.5,1890,7200,1.0,4,7,1500,390.0,1978,2070,7200,16137 days 16:47:18.688814,253,1.6,3.8461538461538463,-180,0,1110.0
500000.0,3,2.25,1760,4539,2.0,3,8,1760,0.0,1988,1960,4808,12485 days 16:47:18.688814,147,1.3333333333333333,0.0,-200,-269,1760.0
280000.0,4,2.75,2230,10160,1.0,3,7,1400,830.0,1968,1740,10080,19790 days 16:47:18.688814,210,1.4545454545454546,1.6867469879518073,490,80,570.0
308000.0,3,1.75,1630,11475,1.0,4,7,1330,300.0,1979,1630,11475,15772 days 16:47:18.688814,065,1.7142857142857142,4.433333333333334,0,0,1030.0
613500.0,3,2.5,2350,7035,2.0,3,8,2350,0.0,1989,2270,7192,12119 days 16:47:18.688814,036,1.2,0.0,80,-157,2350.0
255000.0,3,1.75,1550,9720,1.0,3,7,1050,500.0,1976,1550,9750,16868 days 16:47:18.688814,189,1.7142857142857142,2.1,0,-30,550.0
545000.0,3,2.5,3550,136343,2.0,3,1,3550,0.0,1977,3080,215186,16502 days 16:47:18.688814,301,1.2,0.0,470,-78843,3550.0
620000.0,4,2.5,2720,34498,1.0,5,7,1360,1360.0,1966,1920,22474,20520 days 16:47:18.688814,266,1.6,1.0,800,12024,0.0
279000.0,4,1.75,1840,7275,1.0,3,7,1090,750.0,1976,1840,7275,16868 days 16:47:18.688814,128,2.2857142857142856,1.4533333333333334,0,0,340.0
625000.0,3,2.5,2010,3200,2.0,3,9,2010,0.0,2009,2250,3200,4814 days 16:47:18.688814,023,1.2,0.0,-240,0,2010.0
274950.0,3,1.75,1670,7415,1.0,3,7,1320,350.0,1987,1650,8585,12850 days 16:47:18.688814,147,1.7142857142857142,3.7714285714285714,20,-1170,970.0
423000.0,3,1.75,1820,6038,1.0,4,7,1040,780.0,1952,1700,6040,25634 days 16:47:18.688814,296,1.7142857142857142,1.3333333333333333,120,-2,260.0
350000.0,2,1.0,720,5820,1.0,5,6,720,0.0,1950,952,5820,26364 days 16:47:18.688814,057,2.0,0.0,-232,0,720.0
305000.0,4,1.75,2370,10140,1.0,3,7,1460,910.0,1968,1450,7800,19790 days 16:47:18.688814,089,2.2857142857142856,1.6043956043956045,920,2340,550.0
368000.0,3,1.75,2120,11340,1.0,4,7,1060,1060.0,1966,1830,8650,20520 days 16:47:18.688814,321,1.7142857142857142,1.0,290,2690,0.0
232000.0,3,1.75,1290,6604,1.0,3,7,1290,0.0,1984,1440,6682,13946 days 16:47:18.688814,269,1.7142857142857142,0.0,-150,-78,1290.0
250000.0,4,3.0,1800,2500,2.0,3,7,1800,0.0,2000,1830,6900,8102 days 16:47:18.688814,330,1.3333333333333333,0.0,-30,-4400,1800.0
220000.0,3,1.75,1230,8917,1.0,4,7,1230,0.0,1966,1420,7938,20520 days 16:47:18.688814,042,1.7142857142857142,0.0,-190,979,1230.0
435000.0,3,2.0,1380,2500,1.0,3,7,750,630.0,1986,1630,3800,13215 days 16:47:18.688814,225,1.5,1.1904761904761905,-250,-1300,120.0
350000.0,2,1.0,740,7680,1.0,4,6,740,0.0,1922,1080,7680,36591 days 16:47:18.688814,175,2.0,0.0,-340,0,740.0
206325.0,5,2.5,1720,10202,1.5,3,7,1720,0.0,1970,1720,8478,19059 days 16:47:18.688814,225,2.0,0.0,0,1724,1720.0
339000.0,5,2.5,1720,10202,1.5,3,7,1720,0.0,1970,1720,8478,19059 days 16:47:18.688814,058,2.0,0.0,0,1724,1720.0
399000.0,4,2.5,2100,7355,1.0,5,7,2100,0.0,1969,1750,7200,19424 days 16:47:18.688814,077,1.6,0.0,350,155,2100.0
529000.0,2,1.0,1210,7667,1.0,3,6,900,310.0,1950,1330,6462,26364 days 16:47:18.688814,050,2.0,2.903225806451613,-120,1205,590.0
640000.0,4,2.5,2210,7722,2.0,3,9,2210,0.0,1999,2970,8683,8467 days 16:47:18.688814,063,1.6,0.0,-760,-961,2210.0
735000.0,4,2.5,2470,2550,3.0,3,8,2470,0.0,2004,1270,3060,6641 days 16:47:18.688814,310,1.6,0.0,1200,-510,2470.0
378000.0,5,2.5,2760,8015,1.0,4,8,1600,1160.0,1960,460,18000,22712 days 16:47:18.688814,167,2.0,1.3793103448275863,2300,-9985,440.0
775000.0,3,2.0,2540,7200,1.5,4,8,1600,940.0,1905,2040,5900,42800 days 16:47:18.688814,127,1.5,1.702127659574468,500,1300,660.0
2250000.0,3,4.25,5150,7800,2.5,3,1,4170,980.0,1954,4270,7800,24903 days 16:47:18.688814,206,0.7058823529411765,4.255102040816326,880,0,3190.0
1350000.0,4,4.5,3420,7440,3.0,3,9,3420,0.0,2014,1360,5580,2988 days 16:47:18.688814,028,0.8888888888888888,0.0,2060,1860,3420.0
380000.0,4,2.5,2270,11500,1.0,3,8,1540,730.0,1967,2020,10918,20155 days 16:47:18.688814,239,1.6,2.1095890410958904,250,582,810.0
624900.0,4,2.5,2270,11500,1.0,3,8,1540,730.0,1967,2020,10918,20155 days 16:47:18.688814,049,1.6,2.1095890410958904,250,582,810.0
379770.0,3,2.5,1470,1779,2.0,3,8,1160,310.0,2005,1470,1576,6275 days 16:47:18.688814,311,1.2,3.7419354838709675,0,203,850.0
340000.0,3,1.75,1280,16200,1.0,3,8,1030,250.0,1976,1160,10565,16868 days 16:47:18.688814,337,1.7142857142857142,4.12,120,5635,780.0
515500.0,4,2.75,2830,8126,2.0,3,8,2830,0.0,2005,2830,7916,6275 days 16:47:18.688814,015,1.4545454545454546,0.0,0,210,2830.0
600000.0,4,2.25,1970,7125,1.5,3,7,1500,470.0,1908,1980,4750,41705 days 16:47:18.688814,321,1.7777777777777777,3.1914893617021276,-10,2375,1030.0
400000.0,1,1.0,1390,60984,1.0,3,6,1390,0.0,1960,1620,24225,22712 days 16:47:18.688814,284,1.0,0.0,-230,36759,1390.0
364000.0,4,1.0,1020,11383,1.5,5,6,1020,0.0,1947,1290,11213,27460 days 16:47:18.688814,335,4.0,0.0,-270,170,1020.0
440000.0,4,2.5,2250,7526,2.0,3,8,2250,0.0,1989,1980,7526,12119 days 16:47:18.688814,177,1.6,0.0,270,0,2250.0
285000.0,2,1.0,800,6240,1.0,3,6,800,0.0,1954,1530,8000,24903 days 16:47:18.688814,148,2.0,0.0,-730,-1760,800.0
669000.0,3,1.0,1560,4500,1.5,5,7,1560,0.0,1915,1530,4500,39148 days 16:47:18.688814,091,3.0,0.0,30,0,1560.0
475000.0,4,2.0,2100,13468,1.0,5,7,1050,1050.0,1962,1470,8675,21981 days 16:47:18.688814,183,2.0,1.0,630,4793,0.0
747000.0,2,1.0,990,4000,1.0,4,7,990,0.0,1911,1560,4000,40609 days 16:47:18.688814,124,2.0,0.0,-570,0,990.0
317000.0,3,1.5,1060,5750,1.0,2,7,1060,0.0,1981,1060,5750,15041 days 16:47:18.688814,005,2.0,0.0,0,0,1060.0
390000.0,2,1.0,1270,8164,1.0,4,6,1270,0.0,1941,1580,9095,29651 days 16:47:18.688814,240,2.0,0.0,-310,-931,1270.0
1070000.0,4,2.5,2740,5000,2.0,3,9,2740,0.0,2012,1660,5000,3719 days 16:47:18.688814,112,1.6,0.0,1080,0,2740.0
1210000.0,4,2.75,2470,5500,1.0,3,9,1570,900.0,1960,1620,5500,22712 days 16:47:18.688814,294,1.4545454545454546,1.7444444444444445,850,0,670.0
580000.0,3,1.75,1970,5100,1.0,3,7,1130,840.0,1908,1250,4080,41705 days 16:47:18.688814,086,1.7142857142857142,1.3452380952380953,720,1020,290.0
518000.0,4,2.5,2070,10244,1.0,3,8,1370,700.0,1969,2070,9683,19424 days 16:47:18.688814,317,1.6,1.957142857142857,0,561,670.0
147500.0,3,1.75,1010,6552,1.0,3,7,1010,0.0,1969,1010,6552,19424 days 16:47:18.688814,338,1.7142857142857142,0.0,0,0,1010.0
555000.0,4,2.25,2220,8125,1.0,4,8,1450,770.0,1965,1980,8700,20885 days 16:47:18.688814,114,1.7777777777777777,1.8831168831168832,240,-575,680.0
427500.0,2,2.0,1090,934,3.0,3,8,1090,0.0,2008,1090,1376,5180 days 16:47:18.688814,181,1.0,0.0,0,-442,1090.0
1740000.0,3,2.5,4310,32093,1.5,5,1,2510,1800.0,1982,3810,26400,14676 days 16:47:18.688814,164,1.2,1.3944444444444444,500,5693,710.0
265950.0,3,2.5,1490,3840,2.0,3,7,1490,0.0,2002,2060,4384,7371 days 16:47:18.688814,198,1.2,0.0,-570,-544,1490.0
247500.0,2,1.0,700,6046,1.0,3,6,700,0.0,1950,990,6790,26364 days 16:47:18.688814,335,2.0,0.0,-290,-744,700.0
244000.0,4,1.0,1450,8960,1.0,3,6,1450,0.0,1943,1160,7680,28921 days 16:47:18.688814,143,4.0,0.0,290,1280,1450.0
578550.0,3,2.5,2120,6602,2.0,4,8,2120,0.0,1989,2330,7795,12119 days 16:47:18.688814,082,1.2,0.0,-210,-1193,2120.0
451000.0,4,2.5,1670,3315,2.0,3,7,1670,0.0,2005,1650,2051,6275 days 16:47:18.688814,168,1.6,0.0,20,1264,1670.0
489000.0,2,1.75,1810,4220,2.0,3,8,1810,0.0,2004,1350,4479,6641 days 16:47:18.688814,238,1.1428571428571428,0.0,460,-259,1810.0
190000.0,2,1.0,710,1164794,1.0,2,5,710,0.0,1915,1680,16730,39148 days 16:47:18.688814,124,2.0,0.0,-970,1148064,710.0
475000.0,3,3.0,2540,18900,1.0,3,7,1580,960.0,1978,2270,16000,16137 days 16:47:18.688814,064,1.0,1.6458333333333333,270,2900,620.0
485000.0,3,2.0,1420,4080,1.5,3,7,1420,0.0,1905,1420,4590,42800 days 16:47:18.688814,126,1.5,0.0,0,-510,1420.0
530000.0,3,2.75,2440,45738,2.0,3,8,1840,600.0,1987,2440,189100,12850 days 16:47:18.688814,289,1.0909090909090908,3.066666666666667,0,-143362,1240.0
379000.0,4,2.5,2570,10155,2.0,3,9,2570,0.0,1994,2770,10155,10293 days 16:47:18.688814,028,1.6,0.0,-200,0,2570.0
1630000.0,5,2.5,3090,16583,2.0,4,9,3090,0.0,1964,3740,17853,21251 days 16:47:18.688814,006,2.0,0.0,-650,-1270,3090.0
739000.0,3,1.75,2050,5160,1.5,4,8,1300,750.0,1926,2220,5960,35130 days 16:47:18.688814,078,1.7142857142857142,1.7333333333333334,-170,-800,550.0
189950.0,3,1.0,920,6460,1.0,5,6,920,0.0,1969,920,4770,19424 days 16:47:18.688814,329,3.0,0.0,0,1690,920.0
637500.0,4,3.0,2320,4468,2.0,3,8,2160,160.0,1999,2330,3541,8467 days 16:47:18.688814,356,1.3333333333333333,13.5,-10,927,2000.0
2230000.0,3,3.0,3450,16740,1.0,4,9,1960,1490.0,1949,3220,12528,26729 days 16:47:18.688814,027,1.0,1.3154362416107384,230,4212,470.0
209950.0,3,1.0,1660,8800,1.0,4,7,960,700.0,1963,1370,10112,21616 days 16:47:18.688814,338,3.0,1.3714285714285714,290,-1312,260.0
460000.0,3,1.0,1130,7000,1.0,3,6,830,300.0,1944,1050,7000,28556 days 16:47:18.688814,051,3.0,2.7666666666666666,80,0,530.0
543500.0,4,2.5,2550,5835,2.0,3,8,2550,0.0,1998,2420,5817,8832 days 16:47:18.688814,293,1.6,0.0,130,18,2550.0
376000.0,4,2.75,2420,5773,2.0,3,8,2420,0.0,2005,2420,6200,6275 days 16:47:18.688814,156,1.4545454545454546,0.0,0,-427,2420.0
430000.0,3,2.25,1470,1703,2.0,3,8,1470,0.0,2005,1380,1107,6275 days 16:47:18.688814,301,1.3333333333333333,0.0,90,596,1470.0
515000.0,4,2.5,2030,39049,1.0,4,7,1530,500.0,1953,2400,14605,25268 days 16:47:18.688814,247,1.6,3.06,-370,24444,1030.0
580000.0,7,2.75,2310,2400,1.5,3,6,2310,0.0,1915,1340,3825,39148 days 16:47:18.688814,192,2.5454545454545454,0.0,970,-1425,2310.0
600000.0,5,3.5,3370,16846,2.0,3,9,2650,720.0,1998,3330,13000,8832 days 16:47:18.688814,034,1.4285714285714286,3.6805555555555554,40,3846,1930.0
476800.0,3,1.75,1900,43700,1.5,4,6,1900,0.0,1919,2070,43995,37687 days 16:47:18.688814,316,1.7142857142857142,0.0,-170,-295,1900.0
815000.0,3,1.5,1940,3570,2.0,4,8,1740,200.0,1916,1580,3570,38783 days 16:47:18.688814,119,2.0,8.7,360,0,1540.0
455600.0,3,2.5,2420,8252,2.0,3,7,2420,0.0,1998,2420,5818,8832 days 16:47:18.688814,147,1.2,0.0,0,2434,2420.0
270000.0,3,1.0,1010,9514,1.0,3,7,1010,0.0,1969,1010,9514,19424 days 16:47:18.688814,135,3.0,0.0,0,0,1010.0
1200000.0,5,4.0,2710,2800,3.0,3,1,2380,330.0,1974,1530,3600,17598 days 16:47:18.688814,226,1.25,7.212121212121212,1180,-800,2050.0
525000.0,2,1.5,1340,3600,1.5,3,7,1340,0.0,1903,1340,3600,43531 days 16:47:18.688814,191,1.3333333333333333,0.0,0,0,1340.0
242000.0,3,1.75,1310,9645,1.0,3,7,1310,0.0,1979,1440,9893,15772 days 16:47:18.688814,148,1.7142857142857142,0.0,-130,-248,1310.0
715000.0,4,2.5,2650,30500,1.0,4,8,1680,970.0,1960,2650,30500,22712 days 16:47:18.688814,174,1.6,1.731958762886598,0,0,710.0
475000.0,3,2.75,1890,3938,2.0,3,8,1890,0.0,1999,1890,4142,8467 days 16:47:18.688814,092,1.0909090909090908,0.0,0,-204,1890.0
370000.0,4,3.0,2580,5511,2.0,3,8,2580,0.0,1999,2010,5600,8467 days 16:47:18.688814,315,1.3333333333333333,0.0,570,-89,2580.0
788600.0,4,2.75,3500,7200,2.0,3,9,3500,0.0,2005,3920,7666,6275 days 16:47:18.688814,143,1.4545454545454546,0.0,-420,-466,3500.0
160000.0,2,1.0,1040,13100,1.0,5,6,1040,0.0,1912,910,5080,40244 days 16:47:18.688814,127,2.0,0.0,130,8020,1040.0
800000.0,5,1.75,1930,501376,2.0,3,7,1930,0.0,1930,1710,87120,33669 days 16:47:18.688814,226,2.857142857142857,0.0,220,414256,1930.0
520000.0,4,3.0,2190,5085,2.0,4,8,2190,0.0,1992,2130,5142,11024 days 16:47:18.688814,267,1.3333333333333333,0.0,60,-57,2190.0
335000.0,4,1.0,1480,6500,1.5,4,7,1480,0.0,1914,2380,6000,39513 days 16:47:18.688814,276,4.0,0.0,-900,500,1480.0
919000.0,4,2.5,3620,17133,1.0,3,1,2220,1400.0,1993,3530,17026,10658 days 16:47:18.688814,016,1.6,1.5857142857142856,90,107,820.0
425000.0,3,2.75,3370,13929,2.0,3,9,2650,720.0,1986,2150,14048,13215 days 16:47:18.688814,133,1.0909090909090908,3.6805555555555554,1220,-119,1930.0
420000.0,5,2.5,2100,14395,1.0,3,7,1140,960.0,1983,1830,8700,14311 days 16:47:18.688814,073,2.0,1.1875,270,5695,180.0
905000.0,4,3.0,3370,47959,2.0,4,1,3370,0.0,1981,3370,38896,15041 days 16:47:18.688814,328,1.3333333333333333,0.0,0,9063,3370.0
435000.0,2,1.0,2240,7200,1.0,4,7,1120,1120.0,1940,1390,6000,30017 days 16:47:18.688814,262,2.0,1.0,850,1200,0.0
438000.0,3,2.5,1650,3031,2.0,3,7,1650,0.0,2003,1560,3070,7006 days 16:47:18.688814,198,1.2,0.0,90,-39,1650.0
725000.0,4,2.75,2630,7505,2.0,3,8,2630,0.0,1994,2670,7506,10293 days 16:47:18.688814,168,1.4545454545454546,0.0,-40,-1,2630.0
840000.0,4,1.75,2330,4000,2.0,5,8,1300,1030.0,1924,2040,4000,35861 days 16:47:18.688814,148,2.2857142857142856,1.2621359223300972,290,0,270.0
425500.0,3,2.5,1970,2752,2.0,3,8,1970,0.0,1978,1850,2778,16137 days 16:47:18.688814,196,1.2,0.0,120,-26,1970.0
853505.0,3,2.5,2820,14890,1.0,3,9,1770,1050.0,1985,3740,14890,13580 days 16:47:18.688814,255,1.2,1.6857142857142857,-920,0,720.0
398000.0,2,1.0,590,10945,1.5,3,5,590,0.0,1983,2020,15180,14311 days 16:47:18.688814,142,2.0,0.0,-1430,-4235,590.0
418500.0,3,2.5,2060,4399,2.0,3,7,2060,0.0,2007,2060,4399,5545 days 16:47:18.688814,155,1.2,0.0,0,0,2060.0
826000.0,3,1.5,1890,5000,1.5,3,9,1890,0.0,1929,2560,5000,34034 days 16:47:18.688814,365,2.0,0.0,-670,0,1890.0
742000.0,4,2.5,2810,10986,2.0,3,1,2810,0.0,1997,3540,10986,9197 days 16:47:18.688814,162,1.6,0.0,-730,0,2810.0
180000.0,4,1.0,1470,18581,1.5,3,6,1470,0.0,1924,1770,18581,35861 days 16:47:18.688814,252,4.0,0.0,-300,0,1470.0
286000.0,4,1.75,2190,8400,2.0,2,8,2190,0.0,1978,2410,7700,16137 days 16:47:18.688814,014,2.2857142857142856,0.0,-220,700,2190.0
421200.0,3,2.5,1440,3060,2.0,3,7,1440,0.0,2003,1650,3060,7006 days 16:47:18.688814,274,1.2,0.0,-210,0,1440.0
390000.0,3,3.0,2480,14141,1.0,3,8,1500,980.0,1994,2480,10667,10293 days 16:47:18.688814,212,1.0,1.530612244897959,0,3474,520.0
739000.0,4,2.5,2780,6737,2.0,3,9,2780,0.0,2002,2750,7950,7371 days 16:47:18.688814,262,1.6,0.0,30,-1213,2780.0
499900.0,4,3.0,2180,12196,2.0,4,7,2180,0.0,1968,1500,6534,19790 days 16:47:18.688814,205,1.3333333333333333,0.0,680,5662,2180.0
670000.0,3,2.25,3340,13805,1.0,3,8,3340,0.0,1950,2060,12304,26364 days 16:47:18.688814,337,1.3333333333333333,0.0,1280,1501,3340.0
842500.0,3,2.25,2560,3996,1.5,3,8,2150,410.0,1910,2970,4320,40974 days 16:47:18.688814,286,1.3333333333333333,5.2439024390243905,-410,-324,1740.0
492500.0,2,2.25,1600,80400,2.0,4,7,1600,0.0,1978,1600,198414,16137 days 16:47:18.688814,342,0.8888888888888888,0.0,0,-118014,1600.0
836500.0,3,2.5,2230,7200,3.0,3,9,2230,0.0,1996,2230,7200,9563 days 16:47:18.688814,246,1.2,0.0,0,0,2230.0
334000.0,2,1.0,900,1818,2.0,4,7,900,0.0,1945,1570,1830,28190 days 16:47:18.688814,085,2.0,0.0,-670,-12,900.0
179900.0,3,1.0,1010,9920,1.0,3,6,1010,0.0,1977,1270,9680,16502 days 16:47:18.688814,240,3.0,0.0,-260,240,1010.0
563000.0,3,2.0,1580,5289,1.0,3,7,870,710.0,1940,1310,5535,30017 days 16:47:18.688814,330,1.5,1.2253521126760563,270,-246,160.0
310000.0,3,2.5,1890,6300,2.0,3,7,1890,0.0,2003,2100,6525,7006 days 16:47:18.688814,062,1.2,0.0,-210,-225,1890.0
335000.0,4,2.25,2160,8817,1.0,3,7,1460,700.0,1965,1880,8817,20885 days 16:47:18.688814,231,1.7777777777777777,2.085714285714286,280,0,760.0
499950.0,4,2.25,2160,8817,1.0,3,7,1460,700.0,1965,1880,8817,20885 days 16:47:18.688814,037,1.7777777777777777,2.085714285714286,280,0,760.0
658500.0,2,1.0,1410,5101,1.5,3,8,1410,0.0,1927,1410,4224,34765 days 16:47:18.688814,207,2.0,0.0,0,877,1410.0
297000.0,2,1.5,1430,1650,3.0,3,7,1430,0.0,1999,1430,1650,8467 days 16:47:18.688814,302,1.3333333333333333,0.0,0,0,1430.0
725000.0,6,1.75,2380,4080,2.0,3,8,2380,0.0,1917,2030,4080,38417 days 16:47:18.688814,171,3.4285714285714284,0.0,350,0,2380.0
780000.0,3,2.25,2206,82031,1.0,3,6,866,1340.0,1983,2590,53024,14311 days 16:47:18.688814,339,1.3333333333333333,0.6462686567164179,-384,29007,-474.0
252500.0,3,1.0,1030,6127,1.0,3,7,880,150.0,1947,1610,6127,27460 days 16:47:18.688814,129,3.0,5.866666666666666,-580,0,730.0
330000.0,3,2.5,1070,1155,2.0,3,7,720,350.0,2005,1120,2594,6275 days 16:47:18.688814,164,1.2,2.057142857142857,-50,-1439,370.0
525000.0,3,2.5,2320,9610,1.0,3,9,1730,590.0,1990,2450,9608,11754 days 16:47:18.688814,041,1.2,2.9322033898305087,-130,2,1140.0
365000.0,2,1.75,1270,7500,1.0,4,7,1270,0.0,1982,1280,7500,14676 days 16:47:18.688814,218,1.1428571428571428,0.0,-10,0,1270.0
500000.0,4,3.0,2570,9104,2.0,3,7,2570,0.0,1930,1630,4950,33669 days 16:47:18.688814,086,1.3333333333333333,0.0,940,4154,2570.0
179950.0,3,1.0,920,4875,1.0,5,6,920,0.0,1969,960,5200,19424 days 16:47:18.688814,316,3.0,0.0,-40,-325,920.0
440000.0,3,2.0,1790,32379,1.0,3,7,1790,0.0,2007,2290,43560,5545 days 16:47:18.688814,203,1.5,0.0,-500,-11181,1790.0
145000.0,1,0.75,480,9750,1.0,2,4,480,0.0,1948,1550,9924,27095 days 16:47:18.688814,237,1.3333333333333333,0.0,-1070,-174,480.0
331000.0,4,3.0,2483,5701,2.0,3,8,2483,0.0,2005,2075,5720,6275 days 16:47:18.688814,112,1.3333333333333333,0.0,408,-19,2483.0
780000.0,3,2.25,2140,3000,2.0,3,9,2140,0.0,1905,1430,4712,42800 days 16:47:18.688814,171,1.3333333333333333,0.0,710,-1712,2140.0
855000.0,3,1.75,1900,4000,1.0,3,7,1300,600.0,1965,1880,4000,20885 days 16:47:18.688814,134,1.7142857142857142,2.1666666666666665,20,0,700.0
225000.0,3,2.25,1650,7739,1.0,3,8,1290,360.0,1986,1650,6033,13215 days 16:47:18.688814,287,1.3333333333333333,3.5833333333333335,0,1706,930.0
199000.0,3,1.0,1510,9100,1.0,3,7,1510,0.0,1966,1180,7220,20520 days 16:47:18.688814,195,3.0,0.0,330,1880,1510.0
550000.0,3,1.75,2910,35200,1.5,3,8,2910,0.0,1979,2590,37500,15772 days 16:47:18.688814,122,1.7142857142857142,0.0,320,-2300,2910.0
1430000.0,4,4.25,4960,6000,2.5,3,1,3680,1280.0,1909,2160,4080,41339 days 16:47:18.688814,149,0.9411764705882353,2.875,2800,1920,2400.0
805000.0,3,2.0,2710,4500,1.5,4,8,1880,830.0,1929,2060,4500,34034 days 16:47:18.689811,122,1.5,2.2650602409638556,650,0,1050.0
261000.0,3,1.5,1810,29308,1.0,3,7,950,860.0,1983,1790,37531,14311 days 16:47:18.689811,155,2.0,1.1046511627906976,20,-8223,90.0
347000.0,3,1.0,940,9198,1.0,3,7,940,0.0,1968,1430,8370,19790 days 16:47:18.689811,252,3.0,0.0,-490,828,940.0
390000.0,3,2.25,1600,10240,1.0,3,7,1090,510.0,1979,1520,9394,15772 days 16:47:18.689811,170,1.3333333333333333,2.1372549019607843,80,846,580.0
436000.0,4,2.5,2640,3899,2.0,3,7,2640,0.0,2000,2460,4057,8102 days 16:47:18.689811,314,1.6,0.0,180,-158,2640.0
1800000.0,5,3.25,3890,20005,1.0,3,1,2260,1630.0,1977,3450,20176,16502 days 16:47:18.689811,090,1.5384615384615385,1.3865030674846626,440,-171,630.0
557000.0,3,2.5,1630,1587,3.0,3,8,1630,0.0,2004,1500,1527,6641 days 16:47:18.689811,204,1.2,0.0,130,60,1630.0
135000.0,3,1.0,830,9600,1.0,3,7,830,0.0,1959,1240,9198,23077 days 16:47:18.689811,096,3.0,0.0,-410,402,830.0
425000.0,3,2.5,1800,14036,2.0,3,8,1800,0.0,1993,2450,14025,10658 days 16:47:18.689811,084,1.2,0.0,-650,11,1800.0
648752.0,3,2.25,2060,9953,1.0,5,8,1070,990.0,1964,2340,9600,21251 days 16:47:18.689811,098,1.3333333333333333,1.0808080808080809,-280,353,80.0
1390000.0,4,3.0,4040,20001,1.0,3,9,2020,2020.0,1972,2990,20098,18329 days 16:47:18.689811,177,1.3333333333333333,1.0,1050,-97,0.0
630100.0,4,2.75,1910,11356,1.0,5,7,1160,750.0,1977,1770,11357,16502 days 16:47:18.689811,083,1.4545454545454546,1.5466666666666666,140,-1,410.0
739000.0,4,2.5,2800,246114,2.0,3,9,2800,0.0,1999,2750,60351,8467 days 16:47:18.689811,160,1.6,0.0,50,185763,2800.0
269000.0,3,1.5,1320,2625,2.0,3,7,1320,0.0,1986,1230,5250,13215 days 16:47:18.689811,230,2.0,0.0,90,-2625,1320.0
250000.0,3,1.0,1220,5038,1.0,5,6,1220,0.0,1942,1140,5038,29286 days 16:47:18.689811,117,3.0,0.0,80,0,1220.0
475000.0,5,2.75,3100,5298,2.0,3,7,3100,0.0,2007,2440,5250,5545 days 16:47:18.689811,079,1.8181818181818181,0.0,660,48,3100.0
290000.0,1,1.0,550,5700,1.0,2,6,550,0.0,1916,1100,4560,38783 days 16:47:18.689811,323,1.0,0.0,-550,1140,550.0
219000.0,3,1.0,1080,10639,1.5,3,7,1080,0.0,1953,1470,10600,25268 days 16:47:18.689811,322,3.0,0.0,-390,39,1080.0
416000.0,2,1.0,880,6650,1.0,5,6,880,0.0,1918,1250,6650,38052 days 16:47:18.689811,272,2.0,0.0,-370,0,880.0
179000.0,2,1.0,720,8914,1.0,3,6,720,0.0,1949,1100,8916,26729 days 16:47:18.689811,103,2.0,0.0,-380,-2,720.0
302000.0,4,2.75,2030,9120,1.0,4,7,2030,0.0,1988,1790,7627,12485 days 16:47:18.689811,196,1.4545454545454546,0.0,240,1493,2030.0
565000.0,4,2.0,2040,8281,2.0,3,7,2040,0.0,1961,2560,8281,22346 days 16:47:18.689811,117,2.0,0.0,-520,0,2040.0
281700.0,3,1.0,1570,8316,1.0,3,7,1070,500.0,1962,2030,8295,21981 days 16:47:18.689811,112,3.0,2.14,-460,21,570.0
480000.0,2,1.0,1500,3420,1.0,3,7,1500,0.0,1902,2050,3420,43896 days 16:47:18.689811,178,2.0,0.0,-550,0,1500.0
775000.0,4,2.5,3180,15358,2.0,3,9,3180,0.0,1988,3020,15522,12485 days 16:47:18.689811,286,1.6,0.0,160,-164,3180.0
375000.0,3,1.75,1260,11224,1.0,5,7,1260,0.0,1947,1570,11052,27460 days 16:47:18.689811,247,1.7142857142857142,0.0,-310,172,1260.0
345000.0,3,1.5,1390,13860,2.0,3,7,1390,0.0,1979,1390,11860,15772 days 16:47:18.689811,286,2.0,0.0,0,2000,1390.0
300000.0,3,3.0,2850,9375,1.0,3,8,2240,610.0,1977,1800,9375,16502 days 16:47:18.689811,054,1.0,3.6721311475409837,1050,0,1630.0
364950.0,4,2.5,2070,2992,2.0,3,8,2070,0.0,2002,1900,2957,7371 days 16:47:18.689811,112,1.6,0.0,170,35,2070.0
410000.0,3,3.25,2650,7819,1.0,4,8,1760,890.0,1956,2400,7727,24173 days 16:47:18.689811,336,0.9230769230769231,1.9775280898876404,250,92,870.0
231000.0,3,1.75,1220,8817,1.0,3,7,1220,0.0,1978,2000,8028,16137 days 16:47:18.689811,104,1.7142857142857142,0.0,-780,789,1220.0
445000.0,3,2.0,1630,8702,1.0,3,9,1630,0.0,1987,2250,9890,12850 days 16:47:18.689811,143,1.5,0.0,-620,-1188,1630.0
530000.0,2,2.5,1785,779,2.0,3,7,1595,190.0,1975,1780,794,17233 days 16:47:18.689811,189,0.8,8.394736842105264,5,-15,1405.0
353500.0,3,2.5,1260,972,2.0,3,8,840,420.0,2008,1270,925,5180 days 16:47:18.689811,360,1.2,2.0,-10,47,420.0
209950.0,3,1.5,1380,11130,1.0,3,7,1380,0.0,1960,1380,9200,22712 days 16:47:18.689811,127,2.0,0.0,0,1930,1380.0
650000.0,3,1.75,2330,7200,1.0,4,8,1320,1010.0,1950,1820,7200,26364 days 16:47:18.689811,113,1.7142857142857142,1.306930693069307,510,0,310.0
325000.0,2,1.0,840,4239,1.0,3,7,840,0.0,1948,1120,4494,27095 days 16:47:18.689811,171,2.0,0.0,-280,-255,840.0
257000.0,3,2.25,1730,9516,1.0,3,8,1180,550.0,1978,1870,8165,16137 days 16:47:18.689811,240,1.3333333333333333,2.1454545454545455,-140,1351,630.0
337000.0,4,2.5,2230,5970,2.0,4,7,2230,0.0,2002,1970,4919,7371 days 16:47:18.689811,181,1.6,0.0,260,1051,2230.0
541000.0,3,2.5,1790,4038,2.0,3,8,1790,0.0,2005,1700,3365,6275 days 16:47:18.689811,269,1.2,0.0,90,673,1790.0
577500.0,3,2.5,2280,10879,2.0,3,9,2280,0.0,1984,2400,9536,13946 days 16:47:18.689811,318,1.2,0.0,-120,1343,2280.0
560000.0,3,2.5,2430,5128,1.0,3,8,1270,1160.0,1978,2510,5330,16137 days 16:47:18.689811,328,1.2,1.0948275862068966,-80,-202,110.0
979700.0,5,3.0,3730,5500,1.5,3,7,2160,1570.0,1927,1890,5500,34765 days 16:47:18.689811,302,1.6666666666666667,1.375796178343949,1840,0,590.0
750000.0,5,3.0,2230,8560,1.0,3,8,1150,1080.0,1960,2040,8560,22712 days 16:47:18.689811,206,1.6666666666666667,1.0648148148148149,190,0,70.0
407500.0,2,1.0,770,2971,1.0,3,7,770,0.0,1923,1440,4000,36226 days 16:47:18.689811,220,2.0,0.0,-670,-1029,770.0
530000.0,4,1.75,1814,5000,1.0,4,7,944,870.0,1951,1290,5000,25999 days 16:47:18.689811,143,2.2857142857142856,1.085057471264368,524,0,74.0
235000.0,4,1.75,1920,9350,1.0,4,7,1000,920.0,1977,1910,8400,16502 days 16:47:18.689811,096,2.2857142857142856,1.0869565217391304,10,950,80.0
715000.0,4,2.5,1860,3840,1.5,3,7,1170,690.0,1928,1400,3840,34400 days 16:47:18.689811,097,1.6,1.6956521739130435,460,0,480.0
795000.0,5,3.0,2750,10000,1.0,4,7,1730,1020.0,1957,2520,10000,23807 days 16:47:18.689811,111,1.6666666666666667,1.696078431372549,230,0,710.0
465000.0,4,2.5,1930,9653,1.0,4,9,1930,0.0,1968,2100,10454,19790 days 16:47:18.689811,129,1.6,0.0,-170,-801,1930.0
287600.0,3,2.5,1950,8251,2.0,3,7,1950,0.0,1990,1540,8588,11754 days 16:47:18.689811,133,1.2,0.0,410,-337,1950.0
630000.0,6,3.0,2470,9328,2.0,3,8,2470,0.0,1982,2470,9454,14676 days 16:47:18.689811,364,2.0,0.0,0,-126,2470.0
445000.0,3,2.25,1630,6449,1.0,3,7,1310,320.0,1986,1620,7429,13215 days 16:47:18.689811,091,1.3333333333333333,4.09375,10,-980,990.0
490000.0,4,2.25,2110,16200,1.0,3,8,1630,480.0,1978,2370,16000,16137 days 16:47:18.689811,005,1.7777777777777777,3.3958333333333335,-260,200,1150.0
565000.0,3,1.75,1490,5000,1.0,3,8,1250,240.0,1954,1980,5000,24903 days 16:47:18.689811,056,1.7142857142857142,5.208333333333333,-490,0,1010.0
330000.0,3,2.5,1740,1844,2.0,3,8,1320,420.0,2008,1740,1789,5180 days 16:47:18.689811,231,1.2,3.142857142857143,0,55,900.0
463000.0,4,2.75,1900,6000,1.0,3,7,1300,600.0,1961,2230,6000,22346 days 16:47:18.689811,352,1.4545454545454546,2.1666666666666665,-330,0,700.0
1870000.0,5,4.0,4510,15175,2.0,3,1,4510,0.0,1969,3510,13500,19424 days 16:47:18.689811,126,1.25,0.0,1000,1675,4510.0
219500.0,3,1.0,1090,6710,1.5,5,5,1090,0.0,1912,1170,6708,40244 days 16:47:18.689811,177,3.0,0.0,-80,2,1090.0
622200.0,3,1.75,1720,7200,1.0,3,7,1420,300.0,1959,1380,8000,23077 days 16:47:18.689811,300,1.7142857142857142,4.733333333333333,340,-800,1120.0
474800.0,2,3.25,1400,1243,3.0,3,8,1400,0.0,2000,1400,1335,8102 days 16:47:18.689811,148,0.6153846153846154,0.0,0,-92,1400.0
465000.0,4,2.5,2090,9702,1.0,5,7,1320,770.0,1965,1850,7200,20885 days 16:47:18.689811,162,1.6,1.7142857142857142,240,2502,550.0
389950.0,3,1.75,1580,9049,1.0,3,8,1580,0.0,1966,2100,8446,20520 days 16:47:18.689811,287,1.7142857142857142,0.0,-520,603,1580.0
650000.0,4,2.5,2620,19864,2.0,4,8,2620,0.0,1984,2500,13285,13946 days 16:47:18.689811,297,1.6,0.0,120,6579,2620.0
395000.0,3,2.0,1500,2506,1.0,3,7,870,630.0,2003,1500,4662,7006 days 16:47:18.689811,248,1.5,1.380952380952381,0,-2156,240.0
304500.0,4,2.5,2030,5202,2.0,3,8,2030,0.0,2001,2260,5232,7736 days 16:47:18.689811,353,1.6,0.0,-230,-30,2030.0
307000.0,3,1.0,1020,8484,1.0,3,6,1020,0.0,1949,1180,9660,26729 days 16:47:18.689811,073,3.0,0.0,-160,-1176,1020.0
485000.0,3,2.5,1540,7120,1.0,3,7,770,770.0,1938,1000,6638,30747 days 16:47:18.689811,007,1.2,1.0,540,482,0.0
1560000.0,5,3.0,3910,16200,1.0,4,9,2890,1020.0,1960,3620,16200,22712 days 16:47:18.689811,296,1.6666666666666667,2.8333333333333335,290,0,1870.0
650500.0,5,4.25,3920,11412,2.0,3,7,3920,0.0,1955,1400,9750,24538 days 16:47:18.689811,022,1.1764705882352942,0.0,2520,1662,3920.0
960000.0,4,2.5,3180,10105,2.0,4,9,3180,0.0,1986,2670,10355,13215 days 16:47:18.689811,033,1.6,0.0,510,-250,3180.0
710000.0,3,2.5,2330,9160,2.0,3,9,2330,0.0,1997,2460,9160,9197 days 16:47:18.689811,044,1.2,0.0,-130,0,2330.0
540000.0,3,2.5,2600,23361,1.5,3,8,2150,450.0,1912,1700,14700,40244 days 16:47:18.689811,088,1.2,4.777777777777778,900,8661,1700.0
601000.0,4,1.75,1950,4200,1.0,5,7,1040,910.0,1951,1450,5000,25999 days 16:47:18.689811,205,2.2857142857142856,1.1428571428571428,500,-800,130.0
463828.0,5,1.75,3250,13702,1.0,3,8,1650,1600.0,1965,2620,11328,20885 days 16:47:18.689811,124,2.857142857142857,1.03125,630,2374,50.0
293000.0,4,1.0,1130,8308,1.5,4,6,1130,0.0,1944,1130,8652,28556 days 16:47:18.689811,042,4.0,0.0,0,-344,1130.0
597500.0,3,2.5,2620,4800,2.0,3,7,2620,0.0,2002,2400,4756,7371 days 16:47:18.689811,293,1.2,0.0,220,44,2620.0
240000.0,2,1.0,1120,45302,1.0,4,5,1120,0.0,1932,2150,101930,32939 days 16:47:18.689811,085,2.0,0.0,-1030,-56628,1120.0
284000.0,3,1.75,1800,23103,1.0,3,7,1800,0.0,1968,1410,18163,19790 days 16:47:18.689811,122,1.7142857142857142,0.0,390,4940,1800.0
440000.0,4,1.75,2180,10200,1.0,3,8,2000,180.0,1966,2590,10445,20520 days 16:47:18.689811,026,2.2857142857142856,11.11111111111111,-410,-245,1820.0
340000.0,3,1.75,1960,8136,1.0,3,7,980,980.0,1948,1070,7480,27095 days 16:47:18.689811,135,1.7142857142857142,1.0,890,656,0.0
363000.0,3,1.75,1960,8136,1.0,3,7,980,980.0,1948,1070,7480,27095 days 16:47:18.689811,076,1.7142857142857142,1.0,890,656,0.0
270000.0,2,1.0,1150,3600,1.0,3,6,1150,0.0,1910,1160,4000,40974 days 16:47:18.689811,195,2.0,0.0,-10,-400,1150.0
365000.0,4,2.5,2800,6820,2.0,4,7,2800,0.0,1997,2060,6820,9197 days 16:47:18.689811,239,1.6,0.0,740,0,2800.0
428000.0,3,2.0,1310,2550,1.0,3,7,780,530.0,1986,1460,5100,13215 days 16:47:18.689811,160,1.5,1.471698113207547,-150,-2550,250.0
600000.0,3,1.75,2340,57499,1.0,3,8,2340,0.0,1988,3260,137649,12485 days 16:47:18.689811,091,1.7142857142857142,0.0,-920,-80150,2340.0
405000.0,3,2.5,1430,10200,1.0,3,7,1430,0.0,1960,1470,10350,22712 days 16:47:18.689811,297,1.2,0.0,-40,-150,1430.0
339900.0,4,2.5,2340,9748,1.0,3,8,1610,730.0,1981,2070,8241,15041 days 16:47:18.689811,192,1.6,2.2054794520547945,270,1507,880.0
275000.0,3,1.0,1290,11250,1.0,3,7,1290,0.0,1956,1410,11196,24173 days 16:47:18.689811,357,3.0,0.0,-120,54,1290.0
361600.0,2,1.0,760,6380,1.0,3,6,760,0.0,1941,1590,6380,29651 days 16:47:18.689811,198,2.0,0.0,-830,0,760.0
325000.0,6,2.0,2780,13950,2.5,4,7,2780,0.0,1955,2120,13950,24538 days 16:47:18.689811,079,3.0,0.0,660,0,2780.0
1050000.0,3,2.0,2090,4077,1.5,4,8,1530,560.0,1931,2010,4132,33304 days 16:47:18.689811,353,1.5,2.732142857142857,80,-55,970.0
959750.0,4,3.0,3060,50002,1.0,4,8,2460,600.0,1957,2740,16181,23807 days 16:47:18.689811,314,1.3333333333333333,4.1,320,33821,1860.0
210000.0,3,1.0,1110,7962,1.0,3,7,1110,0.0,1962,1200,8094,21981 days 16:47:18.689811,154,3.0,0.0,-90,-132,1110.0
258000.0,3,2.0,1790,7879,1.5,3,7,1790,0.0,1998,1790,7879,8832 days 16:47:18.689811,335,1.5,0.0,0,0,1790.0
468000.0,3,1.5,1830,9848,1.0,5,7,1830,0.0,1962,1830,8168,21981 days 16:47:18.689811,189,2.0,0.0,0,1680,1830.0
710000.0,4,3.5,2850,2910,2.0,3,8,1970,880.0,1905,1460,3880,42800 days 16:47:18.689811,124,1.1428571428571428,2.2386363636363638,1390,-970,1090.0
268000.0,3,1.0,1420,6000,1.0,3,6,1420,0.0,1941,1480,6000,29651 days 16:47:18.689811,111,3.0,0.0,-60,0,1420.0
115000.0,2,1.0,790,7252,1.0,3,5,790,0.0,1930,1260,11470,33669 days 16:47:18.689811,016,2.0,0.0,-470,-4218,790.0
500000.0,3,2.5,2300,4307,2.0,3,8,2300,0.0,1998,2010,4307,8832 days 16:47:18.689811,133,1.2,0.0,290,0,2300.0
431000.0,3,2.5,2440,71002,1.0,4,9,2440,0.0,1996,3170,84000,9563 days 16:47:18.689811,290,1.2,0.0,-730,-12998,2440.0
241500.0,3,2.0,1310,7349,1.0,3,7,870,440.0,1995,1690,6580,9928 days 16:47:18.689811,054,1.5,1.9772727272727273,-380,769,430.0
300000.0,3,1.0,1380,12000,1.0,3,7,1380,0.0,1963,1890,22001,21616 days 16:47:18.689811,104,3.0,0.0,-510,-10001,1380.0
982000.0,4,2.5,2790,10289,2.0,3,9,2790,0.0,1987,2650,10126,12850 days 16:47:18.689811,311,1.6,0.0,140,163,2790.0
248500.0,3,2.5,1360,7293,2.0,3,8,1360,0.0,1988,1540,7353,12485 days 16:47:18.689811,006,1.2,0.0,-180,-60,1360.0
665000.0,4,2.5,2510,5936,2.0,3,9,2510,0.0,1998,2760,6060,8832 days 16:47:18.689811,365,1.6,0.0,-250,-124,2510.0
1220000.0,3,3.0,4560,16339,2.0,3,1,4040,520.0,2001,2620,11561,7736 days 16:47:18.689811,195,1.0,7.769230769230769,1940,4778,3520.0
380000.0,2,1.0,780,3910,1.0,3,6,780,0.0,1918,1500,5060,38052 days 16:47:18.689811,190,2.0,0.0,-720,-1150,780.0
220000.0,3,2.0,1410,7998,1.0,4,7,1410,0.0,1940,1780,8278,30017 days 16:47:18.689811,167,1.5,0.0,-370,-280,1410.0
631500.0,4,2.0,2530,5650,1.5,4,8,1910,620.0,1910,1310,5750,40974 days 16:47:18.689811,188,2.0,3.0806451612903225,1220,-100,1290.0
386100.0,3,2.0,1270,6760,1.0,5,7,1270,0.0,1972,1550,5734,18329 days 16:47:18.689811,353,1.5,0.0,-280,1026,1270.0
1050000.0,4,4.5,3180,4606,2.0,4,9,1990,1190.0,1929,2110,5323,34034 days 16:47:18.689811,225,0.8888888888888888,1.6722689075630253,1070,-717,800.0
650000.0,2,1.75,1450,4000,1.5,4,7,1350,100.0,1903,1310,4000,43531 days 16:47:18.689811,022,1.1428571428571428,13.5,140,0,1250.0
545000.0,4,1.75,2040,53578,1.0,5,7,1160,880.0,1959,2040,53578,23077 days 16:47:18.689811,055,2.2857142857142856,1.3181818181818181,0,0,280.0
870000.0,4,2.5,2650,12001,2.0,4,9,2650,0.0,1984,2880,14054,13946 days 16:47:18.689811,283,1.6,0.0,-230,-2053,2650.0
380000.0,3,1.75,1240,8611,1.0,4,7,1240,0.0,1973,1700,8037,17963 days 16:47:18.689811,229,1.7142857142857142,0.0,-460,574,1240.0
265000.0,2,1.0,820,8423,1.0,3,6,820,0.0,1957,1960,9140,23807 days 16:47:18.689811,040,2.0,0.0,-1140,-717,820.0
645500.0,2,1.0,1890,5202,1.5,4,7,1890,0.0,1909,1670,5100,41339 days 16:47:18.689811,150,2.0,0.0,220,102,1890.0
570000.0,3,2.0,1270,3090,2.0,5,7,1270,0.0,1911,1440,3090,40609 days 16:47:18.689811,256,1.5,0.0,-170,0,1270.0
1200000.0,4,2.5,3350,11688,1.0,3,1,1760,1590.0,1995,4240,10804,9928 days 16:47:18.689811,048,1.6,1.1069182389937107,-890,884,170.0
605000.0,2,1.0,1550,3200,1.5,3,8,1550,0.0,1927,1800,3937,34765 days 16:47:18.689811,300,2.0,0.0,-250,-737,1550.0
445000.0,2,1.0,950,4800,1.0,3,6,950,0.0,1941,1420,5400,29651 days 16:47:18.689811,074,2.0,0.0,-470,-600,950.0
495000.0,4,1.75,2040,3570,1.0,4,7,1020,1020.0,1917,1790,4206,38417 days 16:47:18.689811,289,2.2857142857142856,1.0,250,-636,0.0
594000.0,4,1.75,1870,5200,2.0,4,7,1200,670.0,1937,1790,5000,31112 days 16:47:18.689811,163,2.2857142857142856,1.791044776119403,80,200,530.0
465000.0,3,1.75,1720,5280,1.0,4,8,900,820.0,1943,1600,6000,28921 days 16:47:18.689811,231,1.7142857142857142,1.0975609756097562,120,-720,80.0
160000.0,2,1.0,1020,13647,1.0,5,6,1020,0.0,1915,980,8250,39148 days 16:47:18.689811,112,2.0,0.0,40,5397,1020.0
340000.0,4,2.5,2690,6099,2.0,3,9,2690,0.0,1998,2520,6168,8832 days 16:47:18.689811,338,1.6,0.0,170,-69,2690.0
870000.0,4,2.0,3090,41147,1.0,3,7,3090,0.0,1990,3300,34280,11754 days 16:47:18.689811,253,2.0,0.0,-210,6867,3090.0
249000.0,3,1.5,1070,5150,1.0,4,6,1070,0.0,1940,1020,4800,30017 days 16:47:18.689811,230,2.0,0.0,50,350,1070.0
500000.0,4,2.25,2050,7201,2.0,3,8,2050,0.0,1994,1970,7350,10293 days 16:47:18.689811,126,1.7777777777777777,0.0,80,-149,2050.0
220000.0,3,1.5,1660,15600,2.0,3,7,1660,0.0,1981,1660,14400,15041 days 16:47:18.689811,177,2.0,0.0,0,1200,1660.0
368500.0,5,1.75,2810,9360,1.0,4,7,1520,1290.0,1965,1770,9360,20885 days 16:47:18.689811,224,2.857142857142857,1.178294573643411,1040,0,230.0
439950.0,4,2.25,2460,14600,1.0,4,8,1720,740.0,1977,2460,14600,16502 days 16:47:18.689811,272,1.7777777777777777,2.324324324324324,0,0,980.0
179900.0,3,1.75,1230,12000,1.0,3,6,1230,0.0,1970,1550,12000,19059 days 16:47:18.689811,267,1.7142857142857142,0.0,-320,0,1230.0
490000.0,4,2.5,2360,4367,2.0,3,8,2360,0.0,2003,2360,4868,7006 days 16:47:18.689811,148,1.6,0.0,0,-501,2360.0
425000.0,4,1.75,1730,11890,1.0,2,7,980,750.0,1955,2100,12325,24538 days 16:47:18.689811,272,2.2857142857142856,1.3066666666666666,-370,-435,230.0
533300.0,4,2.5,2770,21806,2.0,3,9,2770,0.0,1991,2500,21656,11389 days 16:47:18.689811,241,1.6,0.0,270,150,2770.0
447500.0,4,2.0,1770,3332,2.0,3,7,1630,140.0,1924,1640,4000,35861 days 16:47:18.689811,016,2.0,11.642857142857142,130,-668,1490.0
768000.0,5,2.75,3030,13640,2.0,4,8,3030,0.0,1980,2500,13225,15407 days 16:47:18.689811,204,1.8181818181818181,0.0,530,415,3030.0
336900.0,3,1.75,1780,120661,1.0,4,6,1780,0.0,1979,1440,25000,15772 days 16:47:18.689811,129,1.7142857142857142,0.0,340,95661,1780.0
415000.0,4,1.5,1540,7886,2.0,3,7,1540,0.0,1967,1550,7396,20155 days 16:47:18.689811,195,2.6666666666666665,0.0,-10,490,1540.0
500000.0,3,2.25,1580,4379,2.0,4,8,1580,0.0,1994,1770,4187,10293 days 16:47:18.689811,204,1.3333333333333333,0.0,-190,192,1580.0
337000.0,4,2.5,3200,5772,2.0,3,8,3200,0.0,2003,3010,5772,7006 days 16:47:18.689811,307,1.6,0.0,190,0,3200.0
419950.0,4,2.5,2220,6800,2.0,3,7,2220,0.0,2002,2220,5303,7371 days 16:47:18.689811,262,1.6,0.0,0,1497,2220.0
290000.0,4,2.75,2240,8162,2.0,5,7,1380,860.0,1946,1550,8163,27825 days 16:47:18.689811,007,1.4545454545454546,1.6046511627906976,690,-1,520.0
349950.0,2,1.75,1640,4176,1.0,4,7,1040,600.0,1948,1460,5200,27095 days 16:47:18.689811,199,1.1428571428571428,1.7333333333333334,180,-1024,440.0
330000.0,3,1.5,1170,4950,1.0,4,7,1170,0.0,1960,1570,7700,22712 days 16:47:18.689811,136,2.0,0.0,-400,-2750,1170.0
965000.0,4,2.25,3160,34560,1.0,4,1,3160,0.0,1981,3530,38045,15041 days 16:47:18.689811,160,1.7777777777777777,0.0,-370,-3485,3160.0
515000.0,3,2.5,2100,7851,2.0,3,8,2100,0.0,1986,2100,8187,13215 days 16:47:18.689811,304,1.2,0.0,0,-336,2100.0
665000.0,4,2.5,2600,17388,2.0,3,9,2600,0.0,1996,2950,11553,9563 days 16:47:18.689811,142,1.6,0.0,-350,5835,2600.0
265000.0,3,1.75,1630,5999,1.5,4,7,1630,0.0,1985,1540,7500,13580 days 16:47:18.689811,238,1.7142857142857142,0.0,90,-1501,1630.0
545400.0,3,2.0,2850,19200,1.0,3,8,2340,510.0,2004,2860,18240,6641 days 16:47:18.689811,260,1.5,4.588235294117647,-10,960,1830.0
350000.0,4,3.0,2560,5606,2.0,3,9,2560,0.0,2004,2667,7334,6641 days 16:47:18.689811,175,1.3333333333333333,0.0,-107,-1728,2560.0
260000.0,2,1.5,980,1296,2.0,3,7,840,140.0,2001,1100,1228,7736 days 16:47:18.689811,317,1.3333333333333333,6.0,-120,68,700.0
2510000.0,3,3.25,5480,57990,2.0,3,1,5480,0.0,1991,2500,22954,11389 days 16:47:18.689811,097,0.9230769230769231,0.0,2980,35036,5480.0
355000.0,3,2.0,2160,8091,1.5,3,8,2160,0.0,2000,2190,8297,8102 days 16:47:18.689811,269,1.5,0.0,-30,-206,2160.0
879000.0,3,3.0,3030,5156,1.5,4,9,2080,950.0,1929,1910,5720,34034 days 16:47:18.689811,301,1.0,2.1894736842105265,1120,-564,1130.0
261590.0,2,1.0,760,6407,1.0,3,6,760,0.0,1943,1050,8580,28921 days 16:47:18.689811,007,2.0,0.0,-290,-2173,760.0
512500.0,3,3.0,2260,2400,2.0,3,7,2260,0.0,1909,1320,2790,41339 days 16:47:18.689811,309,1.0,0.0,940,-390,2260.0
600000.0,2,1.75,1560,3200,1.0,5,7,880,680.0,1946,2060,4940,27825 days 16:47:18.689811,117,1.1428571428571428,1.2941176470588236,-500,-1740,200.0
417500.0,5,3.0,2270,6664,1.0,3,7,1340,930.0,1995,1870,6187,9928 days 16:47:18.689811,279,1.6666666666666667,1.4408602150537635,400,477,410.0
970000.0,5,3.0,3480,15185,2.0,4,8,3480,0.0,1964,3030,14257,21251 days 16:47:18.689811,147,1.6666666666666667,0.0,450,928,3480.0
316000.0,3,2.25,1900,7479,2.0,4,7,1900,0.0,1992,1520,6559,11024 days 16:47:18.689811,224,1.3333333333333333,0.0,380,920,1900.0
397500.0,4,3.0,2350,9952,1.0,3,9,1650,700.0,1989,2440,9100,12119 days 16:47:18.689811,065,1.3333333333333333,2.357142857142857,-90,852,950.0
1350000.0,3,2.5,2390,5500,1.0,3,9,1700,690.0,1952,2700,5500,25634 days 16:47:18.689811,202,1.2,2.463768115942029,-310,0,1010.0
840000.0,4,2.5,3730,9847,2.0,3,1,3730,0.0,1997,3490,10219,9197 days 16:47:18.689811,233,1.6,0.0,240,-372,3730.0
270000.0,2,1.0,1780,81021,1.0,4,9,1780,0.0,1954,1780,26723,24903 days 16:47:18.689811,177,2.0,0.0,0,54298,1780.0
312900.0,4,2.5,1630,4473,2.0,3,7,1630,0.0,2003,1830,5082,7006 days 16:47:18.689811,147,1.6,0.0,-200,-609,1630.0
325000.0,2,1.0,1130,6908,1.5,3,6,1130,0.0,1945,1150,6908,28190 days 16:47:18.689811,085,2.0,0.0,-20,0,1130.0
680000.0,3,1.75,2140,3584,1.0,3,7,1070,1070.0,1952,1620,4000,25634 days 16:47:18.689811,200,1.7142857142857142,1.0,520,-416,0.0
763000.0,4,2.5,3220,7873,2.0,3,1,3220,0.0,1994,2610,8023,10293 days 16:47:18.689811,063,1.6,0.0,610,-150,3220.0
375000.0,1,1.0,800,533610,1.5,5,5,800,0.0,1950,1790,216057,26364 days 16:47:18.689811,247,1.0,0.0,-990,317553,800.0
475000.0,3,2.5,1800,3300,2.0,3,7,1690,110.0,2004,1570,4097,6641 days 16:47:18.689811,098,1.2,15.363636363636363,230,-797,1580.0
219000.0,2,2.5,809,940,2.0,3,7,809,0.0,2003,1260,4240,7006 days 16:47:18.689811,325,0.8,0.0,-451,-3300,809.0
415000.0,3,2.25,1820,9694,1.0,3,7,1240,580.0,1977,1820,9694,16502 days 16:47:18.689811,082,1.3333333333333333,2.1379310344827585,0,0,660.0
90000.0,2,1.0,580,7500,1.0,3,5,580,0.0,1943,1700,11250,28921 days 16:47:18.689811,143,2.0,0.0,-1120,-3750,580.0
220000.0,2,1.0,580,7500,1.0,3,5,580,0.0,1943,1700,11250,28921 days 16:47:18.689811,090,2.0,0.0,-1120,-3750,580.0
616000.0,3,2.0,2900,5650,1.0,3,8,1520,1380.0,1959,1810,6250,23077 days 16:47:18.689811,057,1.5,1.1014492753623188,1090,-600,140.0
269500.0,2,1.0,1140,74052,1.0,4,6,1140,0.0,1968,1730,43560,19790 days 16:47:18.689811,227,2.0,0.0,-590,30492,1140.0
395350.0,2,1.0,1060,5754,1.0,4,6,1060,0.0,1917,1460,7200,38417 days 16:47:18.689811,114,2.0,0.0,-400,-1446,1060.0
770000.0,4,3.0,2320,7200,1.0,3,7,1260,1060.0,1943,1760,7200,28921 days 16:47:18.689811,078,1.3333333333333333,1.1886792452830188,560,0,200.0
840000.0,4,2.5,3450,43216,2.0,3,9,3450,0.0,2000,3030,50481,8102 days 16:47:18.689811,119,1.6,0.0,420,-7265,3450.0
428950.0,2,1.0,1760,4441,1.0,3,8,1310,450.0,1950,1350,5748,26364 days 16:47:18.689811,310,2.0,2.911111111111111,410,-1307,860.0
800000.0,4,3.75,3370,6766,2.0,3,9,3370,0.0,2005,3530,6766,6275 days 16:47:18.689811,351,1.0666666666666667,0.0,-160,0,3370.0
401000.0,4,1.0,1940,5753,1.5,3,7,1940,0.0,1947,2170,6075,27460 days 16:47:18.689811,170,4.0,0.0,-230,-322,1940.0
303697.0,4,2.0,2520,7334,1.0,3,7,1600,920.0,1955,2040,7937,24538 days 16:47:18.689811,057,2.0,1.7391304347826086,480,-603,680.0
355000.0,3,1.0,1360,8968,1.0,3,7,1360,0.0,1956,1490,7355,24173 days 16:47:18.689811,258,3.0,0.0,-130,1613,1360.0
350000.0,2,1.0,800,5040,1.0,3,6,800,0.0,1960,1020,5040,22712 days 16:47:18.689811,232,2.0,0.0,-220,0,800.0
754999.0,4,2.5,3010,9323,2.0,3,1,3010,0.0,1992,2840,8413,11024 days 16:47:18.689811,104,1.6,0.0,170,910,3010.0
982218.0,3,1.75,2340,5500,2.0,3,9,2340,0.0,1988,2830,5500,12485 days 16:47:18.689811,090,1.7142857142857142,0.0,-490,0,2340.0
406500.0,3,2.0,1780,8621,1.0,3,8,1780,0.0,1992,2470,8542,11024 days 16:47:18.689811,270,1.5,0.0,-690,79,1780.0
1650000.0,4,3.25,4200,210394,2.0,4,1,4200,0.0,1993,2370,184694,10658 days 16:47:18.689811,091,1.2307692307692308,0.0,1830,25700,4200.0
565000.0,2,1.75,1720,3000,1.0,5,7,860,860.0,1925,1360,4500,35495 days 16:47:18.689811,048,1.1428571428571428,1.0,360,-1500,0.0
160000.0,2,1.0,830,4500,1.0,3,6,830,0.0,1920,1092,5350,37322 days 16:47:18.689811,310,2.0,0.0,-262,-850,830.0
220000.0,3,1.0,1090,6320,1.0,3,6,890,200.0,1954,1460,7080,24903 days 16:47:18.689811,015,3.0,4.45,-370,-760,690.0
1280000.0,5,4.25,5040,9466,2.0,3,1,5040,0.0,2004,4300,9417,6641 days 16:47:18.689811,044,1.1764705882352942,0.0,740,49,5040.0
970000.0,5,2.75,3500,5040,2.0,3,9,2950,550.0,1927,1450,5040,34765 days 16:47:18.689811,189,1.8181818181818181,5.363636363636363,2050,0,2400.0
115000.0,3,1.0,1080,6250,1.0,2,5,1080,0.0,1950,1070,6250,26364 days 16:47:18.689811,267,3.0,0.0,10,0,1080.0
124000.0,3,1.0,1080,6250,1.0,2,5,1080,0.0,1950,1070,6250,26364 days 16:47:18.689811,349,3.0,0.0,10,0,1080.0
157000.0,3,1.0,1080,6250,1.0,2,5,1080,0.0,1950,1070,6250,26364 days 16:47:18.689811,070,3.0,0.0,10,0,1080.0
183000.0,3,1.0,870,5200,1.0,5,6,870,0.0,1969,870,5200,19424 days 16:47:18.689811,206,3.0,0.0,0,0,870.0
527000.0,4,2.5,2830,6163,2.0,3,9,2830,0.0,2000,2730,6202,8102 days 16:47:18.689811,252,1.6,0.0,100,-39,2830.0
407193.0,4,2.0,1880,14653,2.0,3,8,1880,0.0,1978,1750,14858,16137 days 16:47:18.689811,157,2.0,0.0,130,-205,1880.0
970000.0,4,2.75,3600,5040,2.0,3,9,2610,990.0,2004,1590,5040,6641 days 16:47:18.689811,072,1.4545454545454546,2.6363636363636362,2010,0,1620.0
535000.0,4,2.5,2340,5600,2.0,3,7,2340,0.0,1921,1310,5600,36956 days 16:47:18.689811,147,1.6,0.0,1030,0,2340.0
245000.0,3,2.0,2040,13125,1.0,3,6,810,1230.0,1910,1460,10582,40974 days 16:47:18.689811,226,1.5,0.6585365853658537,580,2543,-420.0
337000.0,3,1.75,1310,12750,1.0,3,7,1310,0.0,1993,1790,13500,10658 days 16:47:18.689811,174,1.7142857142857142,0.0,-480,-750,1310.0
630000.0,3,2.0,1470,6000,1.0,3,8,1090,380.0,1950,1880,7799,26364 days 16:47:18.689811,080,1.5,2.8684210526315788,-410,-1799,710.0
320000.0,3,1.75,1370,9900,1.0,4,7,1370,0.0,1983,1490,9600,14311 days 16:47:18.689811,157,1.7142857142857142,0.0,-120,300,1370.0
228500.0,3,1.0,1080,7486,1.5,3,6,990,90.0,1942,1170,7800,29286 days 16:47:18.689811,057,3.0,11.0,-90,-314,900.0
293000.0,3,2.5,1990,7577,2.0,3,7,1990,0.0,1990,1900,7152,11754 days 16:47:18.689811,054,1.2,0.0,90,425,1990.0
447000.0,3,1.0,1310,7000,1.0,4,7,1310,0.0,1958,1280,7300,23442 days 16:47:18.689811,267,3.0,0.0,30,-300,1310.0
226500.0,3,1.75,1640,10762,1.0,3,7,1130,510.0,1988,1680,10259,12485 days 16:47:18.689811,127,1.7142857142857142,2.215686274509804,-40,503,620.0
436000.0,3,2.25,1770,8000,1.0,4,7,1350,420.0,1976,1850,7875,16868 days 16:47:18.689811,343,1.3333333333333333,3.2142857142857144,-80,125,930.0
451000.0,3,2.5,2050,4876,2.0,3,8,2050,0.0,2005,2320,4065,6275 days 16:47:18.689811,216,1.2,0.0,-270,811,2050.0
315000.0,3,1.0,1170,62290,2.0,3,5,1170,0.0,1986,1810,42173,13215 days 16:47:18.689811,098,3.0,0.0,-640,20117,1170.0
450000.0,2,1.0,1340,7250,1.0,4,7,1340,0.0,1951,1450,7026,25999 days 16:47:18.689811,301,2.0,0.0,-110,224,1340.0
635000.0,3,1.5,2240,5300,1.0,5,7,1120,1120.0,1955,1740,7110,24538 days 16:47:18.689811,335,2.0,1.0,500,-1810,0.0
292500.0,2,1.0,880,17743,1.0,4,5,880,0.0,1951,1217,13000,25999 days 16:47:18.689811,084,2.0,0.0,-337,4743,880.0
329900.0,3,2.5,2170,4905,2.0,3,8,2170,0.0,2004,2300,4935,6641 days 16:47:18.689811,140,1.2,0.0,-130,-30,2170.0
531000.0,2,1.5,1260,6660,1.5,4,7,1260,0.0,1926,2140,4770,35130 days 16:47:18.689811,322,1.3333333333333333,0.0,-880,1890,1260.0
725000.0,3,1.75,1880,13300,1.0,3,7,1380,500.0,1967,3550,10883,20155 days 16:47:18.689811,212,1.7142857142857142,2.76,-1670,2417,880.0
355300.0,3,2.5,1620,7410,1.0,5,7,1620,0.0,1955,1450,8121,24538 days 16:47:18.689811,145,1.2,0.0,170,-711,1620.0
280000.0,3,2.5,1610,10022,2.0,3,7,1610,0.0,1996,1820,10017,9563 days 16:47:18.689811,117,1.2,0.0,-210,5,1610.0
1100000.0,4,2.75,3330,9143,2.0,4,1,3330,0.0,1995,2390,9143,9928 days 16:47:18.689811,181,1.4545454545454546,0.0,940,0,3330.0
605004.0,4,2.0,1370,4000,2.0,3,9,1370,0.0,1951,2010,5720,25999 days 16:47:18.689811,156,2.0,0.0,-640,-1720,1370.0
260000.0,2,1.0,690,6000,1.0,3,6,690,0.0,1949,840,3030,26729 days 16:47:18.689811,068,2.0,0.0,-150,2970,690.0
748000.0,4,2.5,3170,4979,2.0,4,7,2570,600.0,1925,2060,5000,35495 days 16:47:18.689811,204,1.6,4.283333333333333,1110,-21,1970.0
776000.0,2,2.0,1990,6180,1.0,4,7,1010,980.0,1941,1470,5150,29651 days 16:47:18.689811,106,1.0,1.030612244897959,520,1030,30.0
425000.0,4,1.0,1080,6095,1.5,4,6,1080,0.0,1924,1200,5060,35861 days 16:47:18.689811,259,4.0,0.0,-120,1035,1080.0
230000.0,4,1.0,1870,14703,1.5,3,6,1090,780.0,1928,1650,6045,34400 days 16:47:18.689811,008,4.0,1.3974358974358974,220,8658,310.0
418000.0,3,1.75,1670,12075,1.0,3,7,1370,300.0,1958,1800,12123,23442 days 16:47:18.689811,030,1.7142857142857142,4.566666666666666,-130,-48,1070.0
440000.0,4,2.5,2800,28254,2.0,3,9,2800,0.0,2001,2530,4694,7736 days 16:47:18.689811,216,1.6,0.0,270,23560,2800.0
858450.0,5,2.75,3460,7977,2.0,3,9,3460,0.0,2011,3390,6630,4084 days 16:47:18.689811,328,1.8181818181818181,0.0,70,1347,3460.0
390000.0,3,2.0,1930,12443,1.0,3,7,1930,0.0,1969,1400,12183,19424 days 16:47:18.689811,280,1.5,0.0,530,260,1930.0
957000.0,4,3.0,2370,3836,2.0,3,9,1750,620.0,1969,1690,4698,19424 days 16:47:18.689811,259,1.3333333333333333,2.8225806451612905,680,-862,1130.0
507000.0,3,1.0,1180,6000,1.0,3,7,1180,0.0,1950,1680,6000,26364 days 16:47:18.689811,247,3.0,0.0,-500,0,1180.0
575000.0,2,1.0,1320,4750,1.5,4,7,1320,0.0,1928,1360,2873,34400 days 16:47:18.689811,056,2.0,0.0,-40,1877,1320.0
700000.0,3,1.75,1350,4000,1.5,4,7,1350,0.0,1925,1880,4000,35495 days 16:47:18.689811,117,1.7142857142857142,0.0,-530,0,1350.0
239950.0,2,1.5,1068,1452,2.0,3,7,1068,0.0,1990,1078,1357,11754 days 16:47:18.689811,036,1.3333333333333333,0.0,-10,95,1068.0
253000.0,3,1.0,1580,8240,1.0,4,7,1040,540.0,1978,1480,9200,16137 days 16:47:18.689811,307,3.0,1.9259259259259258,100,-960,500.0
540000.0,4,1.0,1690,3417,1.5,3,7,1690,0.0,1907,1970,4800,42070 days 16:47:18.689811,086,4.0,0.0,-280,-1383,1690.0
1550000.0,3,4.0,5120,4600,3.0,3,1,4490,630.0,2008,2510,5918,5180 days 16:47:18.689811,037,0.75,7.126984126984127,2610,-1318,3860.0
805000.0,4,2.5,3960,38615,2.0,3,1,3960,0.0,2000,3290,43560,8102 days 16:47:18.689811,316,1.6,0.0,670,-4945,3960.0
920000.0,4,3.25,2420,4000,1.5,5,9,1870,550.0,1911,1810,4000,40609 days 16:47:18.689811,163,1.2307692307692308,3.4,610,0,1320.0
496600.0,3,2.5,1910,5562,2.0,3,8,1910,0.0,1988,1940,4647,12485 days 16:47:18.689811,309,1.2,0.0,-30,915,1910.0
246000.0,3,2.25,1440,10500,1.0,3,8,1130,310.0,1983,1510,8125,14311 days 16:47:18.689811,289,1.3333333333333333,3.6451612903225805,-70,2375,820.0
350000.0,5,3.0,2320,8400,1.0,3,7,1510,810.0,1963,1200,4800,21616 days 16:47:18.689811,125,1.6666666666666667,1.8641975308641976,1120,3600,700.0
585000.0,3,2.0,1670,4572,1.5,3,8,1670,0.0,1931,1480,4890,33304 days 16:47:18.689811,143,1.5,0.0,190,-318,1670.0
450000.0,3,1.75,1390,11700,1.0,4,7,1390,0.0,1966,1060,8686,20520 days 16:47:18.689811,082,1.7142857142857142,0.0,330,3014,1390.0
746000.0,3,2.5,2620,8950,2.0,3,9,2620,0.0,1992,2850,8809,11024 days 16:47:18.689811,132,1.2,0.0,-230,141,2620.0
598555.0,3,2.5,3040,7880,2.0,3,9,3040,0.0,2004,3040,7880,6641 days 16:47:18.689811,300,1.2,0.0,0,0,3040.0
820000.0,3,2.5,2990,10711,1.0,3,9,1560,1430.0,1976,2870,11476,16868 days 16:47:18.689811,303,1.2,1.0909090909090908,120,-765,130.0
266500.0,3,2.25,1740,5460,1.0,3,7,1210,530.0,1998,1740,7500,8832 days 16:47:18.689811,294,1.3333333333333333,2.2830188679245285,0,-2040,680.0
370000.0,2,1.0,2360,105850,1.0,2,6,1180,1180.0,1947,2640,386812,27460 days 16:47:18.689811,082,2.0,1.0,-280,-280962,0.0
625000.0,3,2.75,2240,3600,2.5,3,7,1650,590.0,1901,1716,3120,44261 days 16:47:18.689811,247,1.0909090909090908,2.7966101694915255,524,480,1060.0
243500.0,4,2.0,1610,6200,1.0,4,7,1610,0.0,1979,1610,7500,15772 days 16:47:18.689811,344,2.0,0.0,0,-1300,1610.0
340000.0,2,1.0,700,5829,1.0,3,6,700,0.0,1945,1160,6700,28190 days 16:47:18.689811,076,2.0,0.0,-460,-871,700.0
559950.0,5,3.0,2730,9519,1.0,3,8,1670,1060.0,2014,1150,9519,2988 days 16:47:18.689811,261,1.6666666666666667,1.5754716981132075,1580,0,610.0
315000.0,3,2.75,1780,15114,1.0,3,7,1080,700.0,1980,1792,10155,15407 days 16:47:18.689811,050,1.0909090909090908,1.542857142857143,-12,4959,380.0
753000.0,3,2.5,3070,223463,2.0,3,9,3070,0.0,2003,3640,223463,7006 days 16:47:18.689811,118,1.2,0.0,-570,0,3070.0
800000.0,3,3.0,2060,3200,2.0,3,8,2060,0.0,1907,1760,2669,42070 days 16:47:18.689811,028,1.0,0.0,300,531,2060.0
550000.0,3,2.25,1360,5111,1.5,5,7,1360,0.0,1934,1900,5111,32208 days 16:47:18.689811,254,1.3333333333333333,0.0,-540,0,1360.0
465000.0,3,2.0,1430,14250,1.0,3,7,1430,0.0,1953,1530,11475,25268 days 16:47:18.689811,310,1.5,0.0,-100,2775,1430.0
465000.0,3,2.25,1840,5752,2.0,3,7,1840,0.0,2003,1670,2462,7006 days 16:47:18.689811,148,1.3333333333333333,0.0,170,3290,1840.0
710000.0,4,2.25,2000,8068,2.0,5,8,2000,0.0,1976,2080,7837,16868 days 16:47:18.689811,100,1.7777777777777777,0.0,-80,231,2000.0
505000.0,3,2.5,1820,11012,2.0,3,8,1820,0.0,1988,1860,7767,12485 days 16:47:18.689811,350,1.2,0.0,-40,3245,1820.0
690000.0,3,1.75,2330,16300,2.0,3,9,2330,0.0,1964,2330,16300,21251 days 16:47:18.689811,077,1.7142857142857142,0.0,0,0,2330.0
217500.0,2,2.0,1070,8400,1.0,4,7,1070,0.0,1980,1430,8190,15407 days 16:47:18.689811,325,1.0,0.0,-360,210,1070.0
500000.0,2,1.0,930,3750,1.0,4,7,930,0.0,1909,1740,4300,41339 days 16:47:18.689811,245,2.0,0.0,-810,-550,930.0
325000.0,2,2.0,1040,5796,1.0,4,6,1040,0.0,1921,2300,5796,36956 days 16:47:18.689811,049,1.0,0.0,-1260,0,1040.0
500000.0,4,2.25,1960,12436,2.0,3,8,1960,0.0,1984,1960,12436,13946 days 16:47:18.689811,237,1.7777777777777777,0.0,0,0,1960.0
721500.0,3,3.25,2970,234788,2.0,3,9,2040,930.0,1991,2970,220413,11389 days 16:47:18.689811,090,0.9230769230769231,2.193548387096774,0,14375,1110.0
924000.0,3,1.5,2200,5000,1.5,3,9,2200,0.0,1932,2860,5000,32939 days 16:47:18.689811,139,2.0,0.0,-660,0,2200.0
2010000.0,6,4.5,3810,28176,1.0,5,1,3810,0.0,1969,3810,26400,19424 days 16:47:18.689811,155,1.3333333333333333,0.0,0,1776,3810.0
345000.0,2,1.5,830,1034,2.0,3,8,830,0.0,2009,1130,2534,4814 days 16:47:18.689811,105,1.3333333333333333,0.0,-300,-1500,830.0
825000.0,4,3.5,3920,11086,2.0,3,1,3920,0.0,1999,3740,10880,8467 days 16:47:18.689811,075,1.1428571428571428,0.0,180,206,3920.0
560000.0,3,2.0,2870,95396,1.0,4,9,1350,1520.0,1980,2870,102366,15407 days 16:47:18.689811,269,1.5,0.8881578947368421,0,-6970,-170.0
599000.0,3,2.0,2560,14680,1.0,3,8,1330,1230.0,1987,2390,13848,12850 days 16:47:18.689811,189,1.5,1.08130081300813,170,832,100.0
211000.0,3,1.5,1350,7620,1.0,5,6,1350,0.0,1941,1350,7620,29651 days 16:47:18.689811,132,2.0,0.0,0,0,1350.0
425000.0,4,2.25,1240,21190,1.0,3,8,910,330.0,1974,1760,8200,17598 days 16:47:18.689811,114,1.7777777777777777,2.757575757575758,-520,12990,580.0
750000.0,4,2.75,3210,8520,1.0,4,7,1810,1400.0,1976,2450,7360,16868 days 16:47:18.689811,007,1.4545454545454546,1.292857142857143,760,1160,410.0
479000.0,3,2.5,1690,3322,2.0,3,7,1690,0.0,2003,1650,3446,7006 days 16:47:18.689811,016,1.2,0.0,40,-124,1690.0
612500.0,4,2.5,2550,10623,2.0,3,9,2550,0.0,1992,2750,8100,11024 days 16:47:18.689811,058,1.6,0.0,-200,2523,2550.0
605000.0,5,1.75,3240,34510,2.0,4,7,2690,550.0,1963,2650,28250,21616 days 16:47:18.689811,125,2.857142857142857,4.890909090909091,590,6260,2140.0
1360000.0,4,2.5,3560,8960,2.0,3,1,3560,0.0,2001,1660,7680,7736 days 16:47:18.689811,054,1.6,0.0,1900,1280,3560.0
389900.0,3,2.5,2160,59241,1.0,3,7,2160,0.0,2007,2290,125017,5545 days 16:47:18.689811,336,1.2,0.0,-130,-65776,2160.0
710000.0,4,2.5,3060,5000,2.0,3,9,3060,0.0,2006,2870,5548,5910 days 16:47:18.689811,349,1.6,0.0,190,-548,3060.0
295000.0,3,2.5,1690,8564,2.0,4,7,1690,0.0,1992,1690,7532,11024 days 16:47:18.689811,125,1.2,0.0,0,1032,1690.0
275250.0,3,2.25,1520,7199,2.0,4,7,1520,0.0,1992,1410,6751,11024 days 16:47:18.689811,183,1.3333333333333333,0.0,110,448,1520.0
250000.0,4,2.5,2040,5770,2.0,3,7,2040,0.0,1994,1570,6753,10293 days 16:47:18.689811,255,1.6,0.0,470,-983,2040.0
709000.0,3,2.0,2360,18000,1.0,4,8,2180,180.0,1951,2600,17300,25999 days 16:47:18.689811,051,1.5,12.11111111111111,-240,700,2000.0
399500.0,4,1.75,1360,4840,1.5,4,7,1360,0.0,1928,1320,4840,34400 days 16:47:18.689811,189,2.2857142857142856,0.0,40,0,1360.0
225000.0,3,2.5,2000,9202,2.0,4,7,2000,0.0,1992,1750,7827,11024 days 16:47:18.689811,129,1.2,0.0,250,1375,2000.0
500000.0,3,2.5,1650,4648,2.0,3,8,1650,0.0,2001,1800,5637,7736 days 16:47:18.689811,012,1.2,0.0,-150,-989,1650.0
364900.0,3,3.0,2500,8304,2.0,3,8,2500,0.0,1997,2290,7855,9197 days 16:47:18.689811,160,1.0,0.0,210,449,2500.0
356000.0,3,1.5,1140,7500,1.0,3,7,1140,0.0,1976,1380,7500,16868 days 16:47:18.689811,317,2.0,0.0,-240,0,1140.0
616750.0,3,1.5,2140,47743,1.5,3,9,2140,0.0,1978,1060,6016,16137 days 16:47:18.689811,033,2.0,0.0,1080,41727,2140.0
755000.0,3,2.75,2870,6600,2.0,3,8,2870,0.0,1984,2570,7925,13946 days 16:47:18.689811,336,1.0909090909090908,0.0,300,-1325,2870.0
327500.0,2,1.0,830,8183,1.0,5,6,830,0.0,1950,1180,8184,26364 days 16:47:18.689811,224,2.0,0.0,-350,-1,830.0
605000.0,3,2.25,1960,10139,2.0,3,8,1960,0.0,1984,2080,9753,13946 days 16:47:18.689811,105,1.3333333333333333,0.0,-120,386,1960.0
179950.0,4,1.5,1130,5200,1.0,3,6,1130,0.0,1968,1140,5200,19790 days 16:47:18.689811,103,2.6666666666666665,0.0,-10,0,1130.0
349950.0,4,2.0,1764,15600,1.0,5,7,1764,0.0,1942,1490,22387,29286 days 16:47:18.689811,071,2.0,0.0,274,-6787,1764.0
1080000.0,3,2.75,2770,5800,1.0,4,8,1650,1120.0,1959,2340,5800,23077 days 16:47:18.689811,097,1.0909090909090908,1.4732142857142858,430,0,530.0
425000.0,3,2.5,2650,12247,2.0,3,9,2650,0.0,2002,2920,8965,7371 days 16:47:18.689811,120,1.2,0.0,-270,3282,2650.0
990000.0,3,2.75,2500,6350,2.0,5,9,2370,130.0,1979,2090,5454,15772 days 16:47:18.689811,260,1.0909090909090908,18.23076923076923,410,896,2240.0
410000.0,3,1.0,2710,19000,2.0,4,7,2710,0.0,1950,2150,19000,26364 days 16:47:18.689811,178,3.0,0.0,560,0,2710.0
590000.0,3,2.25,2490,8800,2.0,4,8,2490,0.0,1975,2690,10000,17233 days 16:47:18.689811,315,1.3333333333333333,0.0,-200,-1200,2490.0
242000.0,3,1.75,1500,7560,1.0,3,7,1500,0.0,1979,1500,7560,15772 days 16:47:18.689811,098,1.7142857142857142,0.0,0,0,1500.0
775000.0,3,2.0,1160,13747,1.0,5,5,580,580.0,1931,2961,16320,33304 days 16:47:18.689811,329,1.5,1.0,-1801,-2573,0.0
680000.0,4,1.5,1880,6200,1.0,5,8,1440,440.0,1954,2070,6500,24903 days 16:47:18.689811,176,2.6666666666666665,3.272727272727273,-190,-300,1000.0
217000.0,3,2.5,1340,4200,2.0,3,7,1340,0.0,2002,990,4520,7371 days 16:47:18.689811,086,1.2,0.0,350,-320,1340.0
395000.0,3,2.5,1960,3953,2.0,3,8,1960,0.0,1999,1690,3593,8467 days 16:47:18.689811,111,1.2,0.0,270,360,1960.0
572500.0,3,2.25,2030,9791,1.0,4,8,1500,530.0,1984,2030,11031,13946 days 16:47:18.689811,139,1.3333333333333333,2.830188679245283,0,-1240,970.0
559900.0,5,3.0,2200,6380,1.0,3,7,1440,760.0,1987,1960,5800,12850 days 16:47:18.689811,252,1.6666666666666667,1.894736842105263,240,580,680.0
845000.0,3,2.0,2540,4750,1.5,5,9,1840,700.0,1930,2190,4750,33669 days 16:47:18.689811,175,1.5,2.6285714285714286,350,0,1140.0
241000.0,3,2.0,1520,7131,1.0,3,8,1520,0.0,1993,1890,7379,10658 days 16:47:18.689811,209,1.5,0.0,-370,-248,1520.0
1330000.0,3,2.25,2360,5504,2.0,4,8,2080,280.0,1913,2840,5470,39878 days 16:47:18.689811,274,1.3333333333333333,7.428571428571429,-480,34,1800.0
475000.0,3,1.75,1340,2805,1.5,3,7,1340,0.0,1919,1650,2805,37687 days 16:47:18.689811,119,1.7142857142857142,0.0,-310,0,1340.0
575000.0,2,1.5,1400,5810,2.0,3,7,1400,0.0,1940,1470,3920,30017 days 16:47:18.689811,049,1.3333333333333333,0.0,-70,1890,1400.0
455000.0,4,2.75,3030,117378,1.0,4,8,1680,1350.0,1959,2060,110957,23077 days 16:47:18.689811,240,1.4545454545454546,1.2444444444444445,970,6421,330.0
839000.0,3,2.5,3200,203425,1.0,3,1,3200,0.0,2000,3200,203425,8102 days 16:47:18.689811,175,1.2,0.0,0,0,3200.0
475000.0,4,1.5,1580,10260,1.0,4,7,1030,550.0,1955,1520,7000,24538 days 16:47:18.689811,120,2.6666666666666665,1.8727272727272728,60,3260,480.0
600000.0,2,1.0,2120,6897,1.0,4,7,1060,1060.0,1923,1900,4462,36226 days 16:47:18.689811,342,2.0,1.0,220,2435,0.0
515000.0,2,1.0,1640,5200,1.0,4,7,1040,600.0,1937,1780,5040,31112 days 16:47:18.689811,310,2.0,1.7333333333333334,-140,160,440.0
565000.0,4,2.0,1710,3875,1.5,4,7,1710,0.0,1907,1710,3812,42070 days 16:47:18.689811,280,2.0,0.0,0,63,1710.0
498000.0,2,2.0,1140,8282,1.0,3,6,1140,0.0,1924,1650,9000,35861 days 16:47:18.689811,143,1.0,0.0,-510,-718,1140.0
739000.0,4,3.0,2720,3800,2.0,5,8,1800,920.0,1919,1940,4001,37687 days 16:47:18.689811,157,1.3333333333333333,1.9565217391304348,780,-201,880.0
355000.0,2,1.75,1650,4000,1.0,4,7,950,700.0,1947,1060,4110,27460 days 16:47:18.689811,155,1.1428571428571428,1.3571428571428572,590,-110,250.0
263000.0,3,1.75,1790,7485,1.0,4,8,1330,460.0,1979,1970,8097,15772 days 16:47:18.689811,196,1.7142857142857142,2.891304347826087,-180,-612,870.0
375000.0,4,1.75,1680,6834,1.5,3,7,1680,0.0,1948,950,7425,27095 days 16:47:18.689811,248,2.2857142857142856,0.0,730,-591,1680.0
322000.0,3,1.75,2200,12231,1.0,4,7,1250,950.0,1964,2200,9825,21251 days 16:47:18.689811,273,1.7142857142857142,1.3157894736842106,0,2406,300.0
290000.0,2,1.0,770,4800,1.0,3,7,770,0.0,1943,1390,4800,28921 days 16:47:18.689811,294,2.0,0.0,-620,0,770.0
809950.0,4,2.5,3280,6181,2.0,3,1,3280,0.0,2001,3110,7570,7736 days 16:47:18.689811,162,1.6,0.0,170,-1389,3280.0
969500.0,3,3.25,2080,3025,2.0,4,8,1220,860.0,1984,2680,6518,13946 days 16:47:18.689811,282,0.9230769230769231,1.4186046511627908,-600,-3493,360.0
665000.0,4,2.5,2790,43091,2.0,4,9,2790,0.0,1989,2750,35290,12119 days 16:47:18.689811,164,1.6,0.0,40,7801,2790.0
635000.0,5,3.5,4150,13232,2.0,3,1,4150,0.0,2006,3840,15121,5910 days 16:47:18.689811,037,1.4285714285714286,0.0,310,-1889,4150.0
272450.0,3,2.25,1780,7332,2.0,3,7,1780,0.0,1987,1510,7625,12850 days 16:47:18.689811,302,1.3333333333333333,0.0,270,-293,1780.0
427000.0,4,1.75,1460,9750,1.0,4,7,1460,0.0,1967,1820,9840,20155 days 16:47:18.689811,114,2.2857142857142856,0.0,-360,-90,1460.0
261500.0,3,1.0,1410,8174,1.0,3,8,1410,0.0,1958,1500,8058,23442 days 16:47:18.689811,091,3.0,0.0,-90,116,1410.0
488800.0,4,2.25,2170,9665,1.0,4,8,1300,870.0,1976,2170,12054,16868 days 16:47:18.689811,171,1.7777777777777777,1.4942528735632183,0,-2389,430.0
340000.0,2,1.0,690,5200,1.0,3,6,690,0.0,1918,1380,5700,38052 days 16:47:18.689811,056,2.0,0.0,-690,-500,690.0
398950.0,4,3.0,3000,10297,2.0,3,8,3000,0.0,2003,2520,8366,7006 days 16:47:18.689811,223,1.3333333333333333,0.0,480,1931,3000.0
217000.0,3,1.0,870,5200,1.0,5,6,870,0.0,1969,1020,5200,19424 days 16:47:18.689811,080,3.0,0.0,-150,0,870.0
799000.0,4,2.5,3170,94855,1.0,4,9,1910,1260.0,1978,2590,65340,16137 days 16:47:18.689811,075,1.6,1.5158730158730158,580,29515,650.0
160000.0,4,1.0,1540,7350,1.0,4,6,770,770.0,1969,910,8000,19424 days 16:47:18.689811,364,4.0,1.0,630,-650,0.0
447000.0,3,1.0,1270,8800,1.0,3,7,1270,0.0,1968,1560,8250,19790 days 16:47:18.689811,245,3.0,0.0,-290,550,1270.0
765000.0,3,1.75,2190,6450,1.0,3,8,1480,710.0,1957,2190,6450,23807 days 16:47:18.689811,114,1.7142857142857142,2.084507042253521,0,0,770.0
1320000.0,4,3.5,4410,36200,2.0,3,1,4410,0.0,1989,4760,35860,12119 days 16:47:18.689811,171,1.1428571428571428,0.0,-350,340,4410.0
445000.0,4,2.5,2790,8111,2.0,3,9,2480,310.0,2004,2550,7634,6641 days 16:47:18.689811,234,1.6,8.0,240,477,2170.0
310000.0,3,1.0,1510,6000,1.0,3,8,1170,340.0,1953,1125,6000,25268 days 16:47:18.689811,087,3.0,3.4411764705882355,385,0,830.0
380000.0,2,1.75,1800,7191,1.0,4,7,990,810.0,1952,1940,7400,25634 days 16:47:18.689811,099,1.1428571428571428,1.2222222222222223,-140,-209,180.0
325000.0,4,1.0,2410,6975,1.0,3,7,1510,900.0,1957,1880,6255,23807 days 16:47:18.689811,328,4.0,1.6777777777777778,530,720,610.0
345000.0,4,2.75,2250,7412,1.0,4,8,1480,770.0,1975,2070,7632,17233 days 16:47:18.689811,168,1.4545454545454546,1.922077922077922,180,-220,710.0
300000.0,3,1.0,950,4760,1.5,3,6,950,0.0,1929,1080,4760,34034 days 16:47:18.689811,322,3.0,0.0,-130,0,950.0
530000.0,4,1.75,2860,48351,1.0,3,8,1710,1150.0,1978,2460,43560,16137 days 16:47:18.689811,178,2.2857142857142856,1.4869565217391305,400,4791,560.0
583500.0,4,1.75,2860,48351,1.0,3,8,1710,1150.0,1978,2460,43560,16137 days 16:47:18.689811,099,2.2857142857142856,1.4869565217391305,400,4791,560.0
410000.0,2,1.0,1560,10125,1.0,4,7,1130,430.0,1954,1680,10125,24903 days 16:47:18.689811,048,2.0,2.627906976744186,-120,0,700.0
535000.0,2,1.5,1940,5700,1.0,3,7,970,970.0,1937,1250,5700,31112 days 16:47:18.689811,262,1.3333333333333333,1.0,690,0,0.0
2050000.0,4,3.25,3580,19989,1.5,4,7,3480,100.0,1915,2410,6389,39148 days 16:47:18.689811,015,1.2307692307692308,34.8,1170,13600,3380.0
345000.0,4,2.5,2040,5523,2.0,3,7,2040,0.0,1999,1720,6646,8467 days 16:47:18.689811,184,1.6,0.0,320,-1123,2040.0
539000.0,5,1.0,1700,11727,1.5,4,7,1700,0.0,1954,1740,8212,24903 days 16:47:18.689811,100,5.0,0.0,-40,3515,1700.0
590000.0,4,2.5,3700,12500,1.0,5,8,1920,1780.0,1973,2020,8350,17963 days 16:47:18.689811,297,1.6,1.0786516853932584,1680,4150,140.0
187000.0,2,1.75,1050,2926,1.0,4,8,1050,0.0,1974,1150,3802,17598 days 16:47:18.689811,227,1.1428571428571428,0.0,-100,-876,1050.0
270000.0,3,2.0,1690,9583,1.0,4,7,1690,0.0,1969,1690,9583,19424 days 16:47:18.689811,129,1.5,0.0,0,0,1690.0
520000.0,3,1.75,1490,1036,2.0,3,1,1090,400.0,2008,1460,1206,5180 days 16:47:18.689811,183,1.7142857142857142,2.725,30,-170,690.0
515000.0,5,2.0,2220,6000,1.5,4,7,1390,830.0,1925,1600,6000,35495 days 16:47:18.689811,363,2.5,1.6746987951807228,620,0,560.0
990000.0,3,2.5,2160,6000,1.5,4,8,1880,280.0,1939,2300,6000,30382 days 16:47:18.689811,198,1.2,6.714285714285714,-140,0,1600.0
382000.0,2,1.0,870,10492,1.0,3,7,870,0.0,1937,1300,7987,31112 days 16:47:18.689811,127,2.0,0.0,-430,2505,870.0
1210000.0,3,1.75,1900,13600,1.0,4,8,1900,0.0,1956,2510,16600,24173 days 16:47:18.689811,100,1.7142857142857142,0.0,-610,-3000,1900.0
900000.0,4,3.5,3370,5000,2.0,3,8,2470,900.0,2008,1820,5000,5180 days 16:47:18.689811,177,1.1428571428571428,2.7444444444444445,1550,0,1570.0
675000.0,3,2.75,3370,5350,1.5,4,7,2310,1060.0,1910,1720,5618,40974 days 16:47:18.689811,111,1.0909090909090908,2.1792452830188678,1650,-268,1250.0
460000.0,2,1.0,880,3300,1.0,4,7,880,0.0,1909,1960,5500,41339 days 16:47:18.689811,318,2.0,0.0,-1080,-2200,880.0
234000.0,2,1.0,940,5375,1.0,4,5,940,0.0,1952,1200,7500,25634 days 16:47:18.689811,154,2.0,0.0,-260,-2125,940.0
399000.0,3,1.0,1340,7191,1.0,3,7,1340,0.0,1974,1340,7215,17598 days 16:47:18.689811,119,3.0,0.0,0,-24,1340.0
253500.0,3,1.5,1440,12040,1.0,4,7,1440,0.0,1959,1720,12040,23077 days 16:47:18.689811,092,2.0,0.0,-280,0,1440.0
475000.0,3,1.5,1750,12632,1.0,4,7,1750,0.0,1952,1740,12196,25634 days 16:47:18.689811,232,2.0,0.0,10,436,1750.0
740000.0,5,3.5,3990,5000,2.0,3,8,2910,1080.0,2004,1310,5000,6641 days 16:47:18.689811,089,1.4285714285714286,2.6944444444444446,2680,0,1830.0
799000.0,3,2.5,2860,4442,2.0,3,8,2860,0.0,2000,1440,4400,8102 days 16:47:18.689811,164,1.2,0.0,1420,42,2860.0
390000.0,4,2.5,1940,3864,2.0,3,8,1940,0.0,2003,1900,3864,7006 days 16:47:18.689811,113,1.6,0.0,40,0,1940.0
421000.0,2,1.5,1400,11245,1.0,5,7,1400,0.0,1947,1220,11241,27460 days 16:47:18.689811,258,1.3333333333333333,0.0,180,4,1400.0
296500.0,3,2.5,1770,6033,2.0,4,7,1770,0.0,1987,1590,6510,12850 days 16:47:18.689811,028,1.2,0.0,180,-477,1770.0
895000.0,4,2.0,1710,4178,1.5,4,8,1710,0.0,1926,1760,4178,35130 days 16:47:18.689811,225,2.0,0.0,-50,0,1710.0
386000.0,4,2.5,2810,11897,2.0,3,8,2810,0.0,2003,1770,4240,7006 days 16:47:18.689811,223,1.6,0.0,1040,7657,2810.0
424000.0,3,1.0,1580,13912,1.0,4,8,1580,0.0,1955,2130,16420,24538 days 16:47:18.689811,282,3.0,0.0,-550,-2508,1580.0
749000.0,3,1.0,1580,5000,1.5,3,7,1580,0.0,1926,1280,4000,35130 days 16:47:18.689811,161,3.0,0.0,300,1000,1580.0
523000.0,3,1.0,1440,8681,1.5,3,7,1440,0.0,1937,1700,7770,31112 days 16:47:18.689811,314,3.0,0.0,-260,911,1440.0
389000.0,4,2.5,2420,9147,2.0,3,1,2420,0.0,1998,1400,7200,8832 days 16:47:18.689811,301,1.6,0.0,1020,1947,2420.0
270000.0,4,1.5,1930,15000,1.0,5,7,1930,0.0,1946,1620,7500,27825 days 16:47:18.689811,237,2.6666666666666665,0.0,310,7500,1930.0
275000.0,3,1.0,1190,27215,1.0,5,7,1190,0.0,1943,1450,56628,28921 days 16:47:18.689811,253,3.0,0.0,-260,-29413,1190.0
287500.0,4,2.5,2240,6944,1.0,3,7,1310,930.0,1979,1780,7477,15772 days 16:47:18.689811,248,1.6,1.4086021505376345,460,-533,380.0
345000.0,2,2.5,2550,216344,2.5,3,7,2550,0.0,1993,1750,289978,10658 days 16:47:18.689811,267,0.8,0.0,800,-73634,2550.0
427000.0,2,1.0,920,3780,1.0,3,6,920,0.0,1910,1570,2640,40974 days 16:47:18.689811,147,2.0,0.0,-650,1140,920.0
508450.0,4,1.75,1520,9600,1.0,4,7,1000,520.0,1955,1510,9000,24538 days 16:47:18.689811,248,2.2857142857142856,1.9230769230769231,10,600,480.0
705000.0,3,2.0,1460,6250,1.5,4,7,1460,0.0,1912,1690,4750,40244 days 16:47:18.689811,356,1.5,0.0,-230,1500,1460.0
550000.0,1,1.5,1900,40600,1.5,5,9,1450,450.0,1977,2920,40427,16502 days 16:47:18.689811,302,0.6666666666666666,3.2222222222222223,-1020,173,1000.0
380000.0,3,1.5,1430,11173,1.0,1,7,1430,0.0,1955,1520,11659,24538 days 16:47:18.689811,121,2.0,0.0,-90,-486,1430.0
539900.0,3,2.5,2500,4203,2.0,3,8,2500,0.0,2001,2460,4798,7736 days 16:47:18.689811,210,1.2,0.0,40,-595,2500.0
330000.0,2,1.0,720,7250,1.0,3,5,720,0.0,1943,1760,7250,28921 days 16:47:18.689811,246,2.0,0.0,-1040,0,720.0
455000.0,2,1.0,1140,5720,1.0,3,7,850,290.0,1947,1410,5832,27460 days 16:47:18.689811,153,2.0,2.9310344827586206,-270,-112,560.0
510000.0,4,4.0,3530,10935,2.0,3,1,3530,0.0,1992,3360,11250,11024 days 16:47:18.689811,280,1.0,0.0,170,-315,3530.0
315000.0,3,2.0,1220,14645,1.0,3,6,1220,0.0,1970,1980,24960,19059 days 16:47:18.689811,092,1.5,0.0,-760,-10315,1220.0
206000.0,3,1.0,1320,7000,1.0,4,7,1320,0.0,1967,1260,7455,20155 days 16:47:18.689811,168,3.0,0.0,60,-455,1320.0
592500.0,4,3.0,2170,8240,1.0,4,8,1370,800.0,1968,2020,7944,19790 days 16:47:18.689811,142,1.3333333333333333,1.7125,150,296,570.0
744000.0,3,2.5,2020,7512,2.0,4,8,2020,0.0,1981,2410,8500,15041 days 16:47:18.689811,296,1.2,0.0,-390,-988,2020.0
334500.0,3,2.5,1990,3694,2.0,3,8,1990,0.0,1989,2110,3842,12119 days 16:47:18.689811,300,1.2,0.0,-120,-148,1990.0
886000.0,4,2.0,2660,3900,1.5,4,7,1480,1180.0,1923,2350,3900,36226 days 16:47:18.689811,156,2.0,1.2542372881355932,310,0,300.0
600000.0,4,2.5,2360,13500,1.0,4,8,1780,580.0,1973,2780,12400,17963 days 16:47:18.689811,294,1.6,3.0689655172413794,-420,1100,1200.0
850000.0,3,2.0,2740,101930,1.0,3,9,2740,0.0,1999,2140,83635,8467 days 16:47:18.689811,112,1.5,0.0,600,18295,2740.0
550000.0,3,1.75,1360,5850,1.0,4,7,1000,360.0,1938,1540,5850,30747 days 16:47:18.689811,098,1.7142857142857142,2.7777777777777777,-180,0,640.0
184900.0,2,1.0,1230,5000,1.0,5,6,1230,0.0,1911,1230,5413,40609 days 16:47:18.689811,233,2.0,0.0,0,-413,1230.0
245000.0,3,1.5,1260,7964,1.0,4,7,1260,0.0,1955,1510,8776,24538 days 16:47:18.689811,128,2.0,0.0,-250,-812,1260.0
370000.0,2,1.0,1040,4172,1.0,3,7,1040,0.0,1946,3120,4800,27825 days 16:47:18.689811,266,2.0,0.0,-2080,-628,1040.0
480000.0,4,2.5,2700,9700,1.0,3,8,1670,1030.0,1978,2470,9228,16137 days 16:47:18.689811,111,1.6,1.6213592233009708,230,472,640.0
579000.0,3,1.75,1800,4429,2.0,4,7,1800,0.0,1906,1310,4429,42435 days 16:47:18.689811,325,1.7142857142857142,0.0,490,0,1800.0
339275.0,3,1.5,1590,7260,1.0,3,7,1080,510.0,1964,1590,7594,21251 days 16:47:18.689811,282,2.0,2.1176470588235294,0,-334,570.0
425000.0,3,2.75,1360,542322,1.0,4,7,1140,220.0,1955,1700,60548,24538 days 16:47:18.689811,054,1.0909090909090908,5.181818181818182,-340,481774,920.0
170000.0,3,1.75,1370,10780,1.0,3,7,1370,0.0,1959,1370,10317,23077 days 16:47:18.689811,020,1.7142857142857142,0.0,0,463,1370.0
950000.0,4,2.5,3320,7644,2.0,3,1,3320,0.0,1995,3320,9472,9928 days 16:47:18.689811,134,1.6,0.0,0,-1828,3320.0
623000.0,4,2.5,2980,9235,1.0,4,8,1690,1290.0,1977,2690,10046,16502 days 16:47:18.689811,259,1.6,1.310077519379845,290,-811,400.0
477000.0,3,2.5,1350,2053,3.0,3,8,1350,0.0,2005,1350,4150,6275 days 16:47:18.689811,139,1.2,0.0,0,-2097,1350.0
330000.0,3,1.0,1160,9600,1.0,4,7,1160,0.0,1967,1160,9730,20155 days 16:47:18.689811,283,3.0,0.0,0,-130,1160.0
600000.0,3,2.25,1480,5400,2.0,4,8,1480,0.0,1914,1280,3600,39513 days 16:47:18.689811,163,1.3333333333333333,0.0,200,1800,1480.0
570000.0,3,2.0,1640,2808,1.0,4,7,820,820.0,1924,2270,5328,35861 days 16:47:18.689811,188,1.5,1.0,-630,-2520,0.0
515000.0,4,2.5,2680,7178,2.0,3,8,2680,0.0,2004,2540,7133,6641 days 16:47:18.689811,148,1.6,0.0,140,45,2680.0
805000.0,4,2.25,2440,9889,1.0,3,7,1540,900.0,1952,1710,6284,25634 days 16:47:18.689811,119,1.7777777777777777,1.711111111111111,730,3605,640.0
555000.0,4,2.5,2920,24074,2.0,3,9,2920,0.0,1997,2760,26023,9197 days 16:47:18.689811,037,1.6,0.0,160,-1949,2920.0
245000.0,3,2.25,1780,9598,2.0,4,7,1780,0.0,1985,1820,7533,13580 days 16:47:18.689811,035,1.3333333333333333,0.0,-40,2065,1780.0
638150.0,4,2.5,2170,7275,1.0,3,8,1820,350.0,1978,2390,7275,16137 days 16:47:18.689811,199,1.6,5.2,-220,0,1470.0
1650000.0,4,4.5,5550,16065,2.0,3,9,3880,1670.0,2003,3470,16488,7006 days 16:47:18.689811,121,0.8888888888888888,2.3233532934131738,2080,-423,2210.0
269950.0,4,2.5,2060,13500,1.0,3,7,1260,800.0,1968,1610,10714,19790 days 16:47:18.689811,223,1.6,1.575,450,2786,460.0
195000.0,3,1.5,1050,5525,1.0,5,6,1050,0.0,1969,1100,5200,19424 days 16:47:18.689811,263,2.0,0.0,-50,325,1050.0
159100.0,2,1.0,790,7095,1.0,3,6,790,0.0,1944,1150,7200,28556 days 16:47:18.689811,070,2.0,0.0,-360,-105,790.0
550000.0,3,1.0,1010,6120,1.0,3,6,1010,0.0,1942,1260,5977,29286 days 16:47:18.689811,065,3.0,0.0,-250,143,1010.0
299000.0,2,1.0,1040,4600,1.0,4,6,1040,0.0,1950,1390,5897,26364 days 16:47:18.689811,213,2.0,0.0,-350,-1297,1040.0
1380000.0,4,3.5,3130,4500,2.0,3,9,2060,1070.0,2014,1500,4500,2988 days 16:47:18.689811,021,1.1428571428571428,1.925233644859813,1630,0,990.0
249500.0,2,1.0,900,4500,1.0,3,6,900,0.0,1951,860,4500,25999 days 16:47:18.689811,097,2.0,0.0,40,0,900.0
700000.0,4,1.0,1470,5450,1.5,3,7,1470,0.0,1918,2160,5450,38052 days 16:47:18.689811,056,4.0,0.0,-690,0,1470.0
275000.0,4,1.0,1080,26114,1.5,5,5,1080,0.0,1900,1720,20360,44626 days 16:47:18.689811,206,4.0,0.0,-640,5754,1080.0
565000.0,3,2.25,2440,8378,1.0,3,7,1480,960.0,1962,2510,9602,21981 days 16:47:18.689811,078,1.3333333333333333,1.5416666666666667,-70,-1224,520.0
425000.0,4,1.75,2520,11017,1.0,4,7,1320,1200.0,1956,1660,8775,24173 days 16:47:18.689811,123,2.2857142857142856,1.1,860,2242,120.0
620047.0,4,1.75,1760,6000,1.0,3,7,880,880.0,1946,2040,6000,27825 days 16:47:18.689811,058,2.2857142857142856,1.0,-280,0,0.0
480000.0,3,2.25,1820,13362,1.0,3,8,1220,600.0,1977,2050,15000,16502 days 16:47:18.689811,266,1.3333333333333333,2.033333333333333,-230,-1638,620.0
515000.0,3,2.25,1820,13362,1.0,3,8,1220,600.0,1977,2050,15000,16502 days 16:47:18.689811,097,1.3333333333333333,2.033333333333333,-230,-1638,620.0
420000.0,4,2.5,3040,24123,2.0,3,8,3040,0.0,1999,2420,10026,8467 days 16:47:18.689811,134,1.6,0.0,620,14097,3040.0
610000.0,5,3.25,3490,23400,1.0,4,8,1890,1600.0,1957,2660,12400,23807 days 16:47:18.689811,026,1.5384615384615385,1.18125,830,11000,290.0
849000.0,4,1.5,2440,8040,1.0,4,8,1440,1000.0,1950,2140,7920,26364 days 16:47:18.689811,274,2.6666666666666665,1.44,300,120,440.0
718000.0,3,1.75,2280,3446,2.0,3,8,2280,0.0,1949,1610,6670,26729 days 16:47:18.689811,323,1.7142857142857142,0.0,670,-3224,2280.0
295000.0,3,2.25,1980,8000,1.0,4,9,1560,420.0,1974,2360,8000,17598 days 16:47:18.689811,126,1.3333333333333333,3.7142857142857144,-380,0,1140.0
871000.0,5,1.75,2360,6150,1.0,5,7,1180,1180.0,1940,2100,5500,30017 days 16:47:18.689811,120,2.857142857142857,1.0,260,650,0.0
430000.0,3,3.75,3890,7140,1.0,3,8,2390,1500.0,1943,1820,7320,28921 days 16:47:18.689811,148,0.8,1.5933333333333333,2070,-180,890.0
440000.0,4,2.5,2300,10880,1.0,4,7,1190,1110.0,1961,1960,10400,22346 days 16:47:18.689811,237,1.6,1.072072072072072,340,480,80.0
405000.0,2,1.0,910,6490,1.0,3,7,910,0.0,1942,1040,6490,29286 days 16:47:18.689811,147,2.0,0.0,-130,0,910.0
340000.0,3,2.0,1140,11620,1.0,3,7,1140,0.0,1994,1140,8400,10293 days 16:47:18.689811,223,1.5,0.0,0,3220,1140.0
675000.0,4,2.5,2390,5249,2.0,3,9,2390,0.0,2006,2600,5342,5910 days 16:47:18.689811,191,1.6,0.0,-210,-93,2390.0
480000.0,3,1.0,1150,4945,1.0,3,7,1150,0.0,1943,1390,4945,28921 days 16:47:18.689811,147,3.0,0.0,-240,0,1150.0
362500.0,5,2.0,2330,8586,1.0,4,7,1270,1060.0,1961,1550,8287,22346 days 16:47:18.689811,293,2.5,1.1981132075471699,780,299,210.0
752888.0,3,2.5,2420,9000,2.0,4,9,2420,0.0,1987,2630,9000,12850 days 16:47:18.689811,234,1.2,0.0,-210,0,2420.0
255000.0,4,1.75,960,8863,1.0,5,6,580,380.0,1949,1720,8249,26729 days 16:47:18.689811,322,2.2857142857142856,1.5263157894736843,-760,614,200.0
283700.0,1,1.75,1010,10900,1.0,4,6,1010,0.0,1968,1410,8359,19790 days 16:47:18.689811,225,0.5714285714285714,0.0,-400,2541,1010.0
335000.0,4,2.5,2370,6000,2.0,3,8,2370,0.0,2001,2190,6070,7736 days 16:47:18.689811,237,1.6,0.0,180,-70,2370.0
285000.0,3,1.75,2880,18296,1.0,3,8,1580,1300.0,1958,1380,9592,23442 days 16:47:18.689811,154,1.7142857142857142,1.2153846153846153,1500,8704,280.0
278000.0,4,2.25,2400,7738,1.5,3,8,2400,0.0,1964,2170,8452,21251 days 16:47:18.689811,225,1.7777777777777777,0.0,230,-714,2400.0
731000.0,5,2.5,3670,8960,1.5,3,8,3670,0.0,1973,2340,9425,17963 days 16:47:18.689811,086,2.0,0.0,1330,-465,3670.0
335000.0,3,1.5,1140,15890,1.0,3,7,840,300.0,1985,1200,15247,13580 days 16:47:18.689811,069,2.0,2.8,-60,643,540.0
334200.0,3,1.75,1410,45302,1.0,3,7,1410,0.0,1980,2240,49222,15407 days 16:47:18.689811,082,1.7142857142857142,0.0,-830,-3920,1410.0
642000.0,6,1.0,1530,4305,1.5,4,7,1530,0.0,1921,1530,3800,36956 days 16:47:18.689811,056,6.0,0.0,0,505,1530.0
540000.0,4,1.75,1720,4240,1.5,4,7,1460,260.0,1925,1930,4280,35495 days 16:47:18.689811,153,2.2857142857142856,5.615384615384615,-210,-40,1200.0
299000.0,3,2.5,1620,79993,1.0,4,6,1620,0.0,1960,1620,15680,22712 days 16:47:18.689811,090,1.2,0.0,0,64313,1620.0
560000.0,3,1.75,1570,4375,1.0,3,7,970,600.0,1940,1790,5750,30017 days 16:47:18.689811,020,1.7142857142857142,1.6166666666666667,-220,-1375,370.0
852000.0,5,2.75,1990,3750,1.5,4,7,1990,0.0,1913,1820,5000,39878 days 16:47:18.689811,234,1.8181818181818181,0.0,170,-1250,1990.0
306000.0,2,1.0,930,5650,1.0,3,7,930,0.0,1941,1340,6400,29651 days 16:47:18.689811,117,2.0,0.0,-410,-750,930.0
440000.0,3,1.75,1550,7820,1.0,4,7,1210,340.0,1981,1550,6900,15041 days 16:47:18.689811,253,1.7142857142857142,3.5588235294117645,0,920,870.0
517000.0,4,1.0,1650,8250,1.0,3,7,1650,0.0,1966,2240,9776,20520 days 16:47:18.689811,118,4.0,0.0,-590,-1526,1650.0
360000.0,2,1.0,930,6098,1.0,4,6,930,0.0,1919,1730,9000,37687 days 16:47:18.689811,286,2.0,0.0,-800,-2902,930.0
645000.0,4,1.5,2550,4000,1.5,4,7,1760,790.0,1926,1840,4000,35130 days 16:47:18.689811,302,2.6666666666666665,2.2278481012658227,710,0,970.0
217000.0,2,1.0,720,4760,1.0,5,5,720,0.0,1942,840,4760,29286 days 16:47:18.689811,311,2.0,0.0,-120,0,720.0
255000.0,2,1.0,620,4760,1.0,3,6,620,0.0,1941,620,4760,29651 days 16:47:18.689811,322,2.0,0.0,0,0,620.0
625000.0,3,2.5,2360,12164,2.0,3,1,2360,0.0,1987,2400,11260,12850 days 16:47:18.689811,202,1.2,0.0,-40,904,2360.0
680000.0,3,1.75,1760,8400,1.0,4,8,1460,300.0,1960,1980,8400,22712 days 16:47:18.689811,161,1.7142857142857142,4.866666666666666,-220,0,1160.0
440000.0,3,1.75,2100,29735,1.0,4,7,1080,1020.0,1957,2100,11250,23807 days 16:47:18.689811,254,1.7142857142857142,1.0588235294117647,0,18485,60.0
615000.0,5,2.25,2480,12070,2.0,3,9,2480,0.0,1978,2570,12000,16137 days 16:47:18.689811,169,2.2222222222222223,0.0,-90,70,2480.0
239000.0,3,1.0,1040,6860,2.0,3,6,1040,0.0,1942,1030,6512,29286 days 16:47:18.689811,154,3.0,0.0,10,348,1040.0
462500.0,3,2.5,1656,108900,1.0,4,7,1656,0.0,1985,2030,29859,13580 days 16:47:18.689811,103,1.2,0.0,-374,79041,1656.0
619400.0,4,2.0,2090,3610,1.5,5,7,1790,300.0,1927,1660,3767,34765 days 16:47:18.689811,162,2.0,5.966666666666667,430,-157,1490.0
975000.0,6,2.75,2520,54160,2.0,3,7,2520,0.0,1954,2790,26809,24903 days 16:47:18.689811,184,2.1818181818181817,0.0,-270,27351,2520.0
330000.0,2,1.0,700,4000,1.0,3,6,700,0.0,1943,1060,6000,28921 days 16:47:18.689811,286,2.0,0.0,-360,-2000,700.0
985000.0,4,3.25,4030,36762,2.0,3,1,4030,0.0,1988,4090,40371,12485 days 16:47:18.689811,205,1.2307692307692308,0.0,-60,-3609,4030.0
430000.0,2,1.0,760,7114,1.0,3,6,760,0.0,1946,780,7102,27825 days 16:47:18.689811,082,2.0,0.0,-20,12,760.0
2460000.0,4,5.25,6500,14986,2.0,3,1,5180,1320.0,2001,2270,8119,7736 days 16:47:18.689811,189,0.7619047619047619,3.9242424242424243,4230,6867,3860.0
778000.0,3,2.0,1840,6000,2.0,5,7,1720,120.0,1946,1390,6000,27825 days 16:47:18.689811,204,1.5,14.333333333333334,450,0,1600.0
219000.0,3,2.0,1090,7350,1.0,4,7,1090,0.0,1990,1490,7741,11754 days 16:47:18.689811,209,1.5,0.0,-400,-391,1090.0
1600000.0,4,2.5,2980,13341,1.5,5,8,1800,1180.0,1928,2340,19810,34400 days 16:47:18.689811,260,1.6,1.5254237288135593,640,-6469,620.0
715000.0,4,2.25,1900,8272,1.0,4,9,1460,440.0,1966,2040,8479,20520 days 16:47:18.689811,030,1.7777777777777777,3.3181818181818183,-140,-207,1020.0
950000.0,4,2.5,2790,15653,2.0,4,1,2790,0.0,1964,3520,15653,21251 days 16:47:18.689811,226,1.6,0.0,-730,0,2790.0
425000.0,2,1.0,1280,5026,1.0,4,8,1020,260.0,1951,1540,6380,25999 days 16:47:18.689811,346,2.0,3.923076923076923,-260,-1354,760.0
239000.0,3,1.0,1510,15022,1.0,3,7,1510,0.0,1962,1510,12970,21981 days 16:47:18.689811,198,3.0,0.0,0,2052,1510.0
310000.0,1,1.0,920,8282,1.5,3,6,920,0.0,1944,2260,14025,28556 days 16:47:18.689811,350,1.0,0.0,-1340,-5743,920.0
400000.0,2,1.0,700,8120,1.0,3,7,700,0.0,1927,1130,5599,34765 days 16:47:18.689811,054,2.0,0.0,-430,2521,700.0
428000.0,2,1.75,1980,44550,2.0,5,7,1280,700.0,1977,1680,25343,16502 days 16:47:18.689811,328,1.1428571428571428,1.8285714285714285,300,19207,580.0
600000.0,3,1.0,1440,4300,1.5,3,8,1440,0.0,1929,1640,4500,34034 days 16:47:18.689811,224,3.0,0.0,-200,-200,1440.0
415000.0,4,4.0,2740,8250,2.0,4,9,2740,0.0,1990,2290,8250,11754 days 16:47:18.689811,026,1.0,0.0,450,0,2740.0
401000.0,2,1.0,1400,8220,1.0,3,7,1400,0.0,1949,1760,8220,26729 days 16:47:18.689811,220,2.0,0.0,-360,0,1400.0
292000.0,3,1.75,2270,7156,1.0,3,7,1370,900.0,1948,1210,7156,27095 days 16:47:18.689811,349,1.7142857142857142,1.5222222222222221,1060,0,470.0
291750.0,3,2.25,1310,12825,1.0,3,7,1310,0.0,1950,1600,11250,26364 days 16:47:18.689811,203,1.3333333333333333,0.0,-290,1575,1310.0
227000.0,3,1.75,1680,7455,1.0,4,8,1680,0.0,1968,2040,8214,19790 days 16:47:18.689811,049,1.7142857142857142,0.0,-360,-759,1680.0
675000.0,3,2.25,2260,13209,1.0,3,9,2260,0.0,1977,2820,12534,16502 days 16:47:18.689811,198,1.3333333333333333,0.0,-560,675,2260.0
397500.0,3,2.25,1350,980,2.0,3,8,1050,300.0,2007,1350,1245,5545 days 16:47:18.689811,279,1.3333333333333333,3.5,0,-265,750.0
206000.0,2,1.5,1820,8867,2.0,3,7,1820,0.0,1921,1430,9288,36956 days 16:47:18.689811,169,1.3333333333333333,0.0,390,-421,1820.0
1190000.0,3,3.5,3380,3333,3.0,3,1,2800,580.0,2008,2790,5000,5180 days 16:47:18.689811,211,0.8571428571428571,4.827586206896552,590,-1667,2220.0
360000.0,4,1.75,2140,49658,1.0,5,7,2140,0.0,1959,1720,99316,23077 days 16:47:18.689811,197,2.2857142857142856,0.0,420,-49658,2140.0
427500.0,4,2.5,2430,3249,2.0,3,8,2430,0.0,2010,2650,3844,4449 days 16:47:18.689811,281,1.6,0.0,-220,-595,2430.0
115000.0,2,1.0,940,6000,1.0,3,6,940,0.0,1943,1310,6000,28921 days 16:47:18.689811,206,2.0,0.0,-370,0,940.0
559000.0,3,1.5,2070,5386,1.0,4,7,1140,930.0,1948,1770,5386,27095 days 16:47:18.689811,160,2.0,1.2258064516129032,300,0,210.0
420000.0,4,1.0,1510,1501,1.5,3,7,1510,0.0,1906,1560,1602,42435 days 16:47:18.689811,300,4.0,0.0,-50,-101,1510.0
550000.0,4,1.75,2550,39460,1.0,3,8,1890,660.0,1982,2560,38638,14676 days 16:47:18.689811,310,2.2857142857142856,2.8636363636363638,-10,822,1230.0
282150.0,2,1.0,700,5940,1.0,3,7,700,0.0,1948,1070,5995,27095 days 16:47:18.689811,265,2.0,0.0,-370,-55,700.0
260000.0,3,1.0,1150,3090,1.0,3,6,1150,0.0,1910,1150,5664,40974 days 16:47:18.689811,054,3.0,0.0,0,-2574,1150.0
428000.0,3,2.5,2340,3466,2.0,3,7,2340,0.0,2004,1970,3739,6641 days 16:47:18.689811,275,1.2,0.0,370,-273,2340.0
319950.0,3,3.25,1510,1245,3.0,3,7,1510,0.0,2007,1510,1245,5545 days 16:47:18.689811,288,0.9230769230769231,0.0,0,0,1510.0
1350000.0,3,2.0,2070,9600,1.0,3,7,1590,480.0,1946,3000,16215,27825 days 16:47:18.689811,213,1.5,3.3125,-930,-6615,1110.0
552000.0,2,1.0,1150,5000,1.0,4,7,1050,100.0,1924,1463,4320,35861 days 16:47:18.689811,254,2.0,10.5,-313,680,950.0
637000.0,4,2.75,2190,2867,1.5,5,7,1470,720.0,1929,1600,3800,34034 days 16:47:18.689811,040,1.4545454545454546,2.0416666666666665,590,-933,750.0
213000.0,4,1.75,1980,9000,1.0,2,7,1480,500.0,1978,1980,9360,16137 days 16:47:18.689811,160,2.2857142857142856,2.96,0,-360,980.0
215000.0,3,1.0,960,7200,1.0,4,6,960,0.0,1958,1060,7620,23442 days 16:47:18.689811,118,3.0,0.0,-100,-420,960.0
590000.0,3,1.75,2180,6120,1.0,3,8,1380,800.0,1949,2020,6122,26729 days 16:47:18.689811,048,1.7142857142857142,1.725,160,-2,580.0
390000.0,4,2.5,2560,43560,2.0,3,8,2560,0.0,1989,2130,10150,12119 days 16:47:18.689811,325,1.6,0.0,430,33410,2560.0
287000.0,4,2.25,2270,11997,1.0,4,7,1540,730.0,1959,1920,9634,23077 days 16:47:18.689811,265,1.7777777777777777,2.1095890410958904,350,2363,810.0
580000.0,5,2.75,3550,9600,2.0,3,7,3550,0.0,1960,3370,9600,22712 days 16:47:18.689811,198,1.8181818181818181,0.0,180,0,3550.0
424000.0,3,2.0,1330,5632,1.0,3,8,1330,0.0,1988,1900,4842,12485 days 16:47:18.689811,301,1.5,0.0,-570,790,1330.0
610000.0,4,2.5,2110,6360,2.0,3,8,2110,0.0,1988,2050,7000,12485 days 16:47:18.689811,068,1.6,0.0,60,-640,2110.0
1320000.0,4,3.25,3470,11843,1.0,3,1,2270,1200.0,1989,3910,13247,12119 days 16:47:18.689811,210,1.2307692307692308,1.8916666666666666,-440,-1404,1070.0
623500.0,4,3.0,1550,3350,1.0,3,7,860,690.0,1918,1310,5000,38052 days 16:47:18.689811,352,1.3333333333333333,1.2463768115942029,240,-1650,170.0
260000.0,2,1.0,570,81893,1.0,3,6,570,0.0,1936,2040,115434,31478 days 16:47:18.689811,216,2.0,0.0,-1470,-33541,570.0
906000.0,3,2.5,2030,1800,3.0,3,9,2030,0.0,2013,1450,1441,3353 days 16:47:18.689811,070,1.2,0.0,580,359,2030.0
330000.0,3,2.0,1500,11233,1.0,3,7,1500,0.0,1987,1580,14013,12850 days 16:47:18.689811,096,1.5,0.0,-80,-2780,1500.0
275000.0,2,1.0,920,7688,1.0,3,6,920,0.0,1955,1040,7440,24538 days 16:47:18.689811,063,2.0,0.0,-120,248,920.0
290000.0,3,1.0,1470,8200,1.0,3,7,1040,430.0,1953,1420,8200,25268 days 16:47:18.689811,323,3.0,2.4186046511627906,50,0,610.0
599950.0,2,1.0,1150,3775,1.0,3,7,1150,0.0,1917,2240,3753,38417 days 16:47:18.689811,260,2.0,0.0,-1090,22,1150.0
550000.0,4,3.0,4180,35169,2.0,3,1,4180,0.0,1986,3010,35190,13215 days 16:47:18.689811,267,1.3333333333333333,0.0,1170,-21,4180.0
289000.0,3,1.75,1690,3449,1.0,3,7,1690,0.0,1987,1530,4093,12850 days 16:47:18.689811,203,1.7142857142857142,0.0,160,-644,1690.0
411000.0,4,2.75,2150,9915,1.0,5,8,1240,910.0,1976,1980,9325,16868 days 16:47:18.689811,153,1.4545454545454546,1.3626373626373627,170,590,330.0
826000.0,3,3.25,2330,4000,1.0,3,1,1730,600.0,1964,2080,4000,21251 days 16:47:18.689811,084,0.9230769230769231,2.8833333333333333,250,0,1130.0
400000.0,4,2.0,2680,13680,2.0,4,7,2350,330.0,1943,1430,11000,28921 days 16:47:18.689811,191,2.0,7.121212121212121,1250,2680,2020.0
342000.0,3,2.5,1740,2226,2.0,3,8,1320,420.0,2008,1740,1789,5180 days 16:47:18.689811,226,1.2,3.142857142857143,0,437,900.0
475000.0,2,1.75,1320,3420,1.0,3,7,1080,240.0,1955,2070,6000,24538 days 16:47:18.689811,283,1.1428571428571428,4.5,-750,-2580,840.0
1210000.0,4,3.5,3150,5500,2.0,3,9,3150,0.0,2014,1550,4200,2988 days 16:47:18.689811,189,1.1428571428571428,0.0,1600,1300,3150.0
455000.0,4,3.0,2480,9238,1.0,5,7,2050,430.0,1913,1820,12214,39878 days 16:47:18.689811,204,1.3333333333333333,4.767441860465116,660,-2976,1620.0
850000.0,4,3.0,3330,4000,1.0,3,8,1790,1540.0,1958,1610,4000,23442 days 16:47:18.689811,175,1.3333333333333333,1.1623376623376624,1720,0,250.0
185000.0,3,1.0,1010,6400,1.0,3,7,1010,0.0,1971,1820,6500,18694 days 16:47:18.689811,008,3.0,0.0,-810,-100,1010.0
850000.0,6,3.25,4920,20590,1.0,4,9,2730,2190.0,1960,3700,14994,22712 days 16:47:18.689811,196,1.8461538461538463,1.2465753424657535,1220,5596,540.0
239900.0,4,1.75,1570,18730,1.0,3,7,1200,370.0,1960,1920,18295,22712 days 16:47:18.689811,217,2.2857142857142856,3.2432432432432434,-350,435,830.0
765000.0,5,3.75,3580,14275,2.0,3,1,3190,390.0,1999,2740,14300,8467 days 16:47:18.689811,135,1.3333333333333333,8.179487179487179,840,-25,2800.0
437000.0,3,1.75,2220,17568,1.0,4,8,2220,0.0,1967,2070,11745,20155 days 16:47:18.689811,188,1.7142857142857142,0.0,150,5823,2220.0
240000.0,3,1.5,1010,10350,1.0,3,7,1010,0.0,1969,1640,7700,19424 days 16:47:18.689811,195,2.0,0.0,-630,2650,1010.0
395000.0,2,1.0,1440,7808,1.0,4,7,860,580.0,1949,1550,7682,26729 days 16:47:18.689811,118,2.0,1.4827586206896552,-110,126,280.0
320000.0,3,1.0,1230,7492,1.0,3,7,1230,0.0,1955,1710,7238,24538 days 16:47:18.689811,006,3.0,0.0,-480,254,1230.0
525000.0,3,1.75,1710,7350,1.0,3,8,1280,430.0,1981,2100,7560,15041 days 16:47:18.689811,295,1.7142857142857142,2.9767441860465116,-390,-210,850.0
260000.0,3,3.0,2390,8993,2.0,3,8,1680,710.0,1988,1820,10362,12485 days 16:47:18.689811,112,1.0,2.3661971830985915,570,-1369,970.0
450000.0,3,2.75,2840,39324,1.0,3,9,2200,640.0,1988,2840,39413,12485 days 16:47:18.689811,089,1.0909090909090908,3.4375,0,-89,1560.0
560000.0,4,2.5,2300,7989,2.0,3,9,2300,0.0,1990,2280,8835,11754 days 16:47:18.689811,174,1.6,0.0,20,-846,2300.0
310000.0,5,3.0,2270,5001,1.0,3,7,1360,910.0,1989,1950,5500,12119 days 16:47:18.689811,104,1.6666666666666667,1.4945054945054945,320,-499,450.0
440000.0,3,2.5,2290,6302,2.0,3,9,2290,0.0,1997,2700,7500,9197 days 16:47:18.689811,103,1.2,0.0,-410,-1198,2290.0
458450.0,4,1.0,1330,9715,1.0,4,7,970,360.0,1957,1590,8400,23807 days 16:47:18.689811,342,4.0,2.6944444444444446,-260,1315,610.0
200000.0,3,1.0,1200,10703,1.5,2,7,1200,0.0,1918,1380,8068,38052 days 16:47:18.689811,085,3.0,0.0,-180,2635,1200.0
430000.0,3,2.25,2160,6527,2.0,4,7,1580,580.0,1987,1950,9675,12850 days 16:47:18.689811,340,1.3333333333333333,2.7241379310344827,210,-3148,1000.0
360000.0,3,1.0,1120,10500,1.0,4,7,1120,0.0,1966,1320,10500,20520 days 16:47:18.689811,057,3.0,0.0,-200,0,1120.0
311000.0,4,2.5,2090,11645,1.0,3,7,1200,890.0,1962,1450,9481,21981 days 16:47:18.689811,009,1.6,1.348314606741573,640,2164,310.0
615000.0,3,3.25,1470,1152,3.0,3,8,1470,0.0,2003,1470,1506,7006 days 16:47:18.689811,203,0.9230769230769231,0.0,0,-354,1470.0
575000.0,3,1.75,2270,10136,2.0,3,8,2270,0.0,1979,2260,9600,15772 days 16:47:18.689811,330,1.7142857142857142,0.0,10,536,2270.0
2030000.0,4,3.75,4100,22798,1.5,5,1,2540,1560.0,1934,3880,18730,32208 days 16:47:18.689811,168,1.0666666666666667,1.6282051282051282,220,4068,980.0
430000.0,3,1.75,1440,4025,1.0,4,6,720,720.0,1917,1500,5750,38417 days 16:47:18.689811,265,1.7142857142857142,1.0,-60,-1725,0.0
400000.0,3,1.5,1200,4800,1.0,4,7,1200,0.0,1962,1510,7668,21981 days 16:47:18.689811,154,2.0,0.0,-310,-2868,1200.0
340000.0,3,1.75,1720,10710,1.0,3,7,860,860.0,1957,1480,10359,23807 days 16:47:18.689811,240,1.7142857142857142,1.0,240,351,0.0
351000.0,1,0.75,930,6600,1.0,3,6,930,0.0,1924,1590,6600,35861 days 16:47:18.689811,124,1.3333333333333333,0.0,-660,0,930.0
440000.0,4,2.5,2400,8038,2.0,3,8,2400,0.0,2002,2040,7756,7371 days 16:47:18.689811,255,1.6,0.0,360,282,2400.0
298000.0,4,2.5,1960,11798,2.0,3,8,1960,0.0,1999,2360,11785,8467 days 16:47:18.689811,112,1.6,0.0,-400,13,1960.0
300000.0,4,1.75,1890,9205,1.0,3,8,1260,630.0,1964,1430,6775,21251 days 16:47:18.689811,014,2.2857142857142856,2.0,460,2430,630.0
310000.0,3,2.25,1590,3056,2.0,3,7,1590,0.0,2001,1540,2890,7736 days 16:47:18.689811,296,1.3333333333333333,0.0,50,166,1590.0
500000.0,4,2.5,2590,9354,2.0,4,9,2590,0.0,1993,2730,9264,10658 days 16:47:18.689811,220,1.6,0.0,-140,90,2590.0
399900.0,3,1.0,860,1664,1.5,3,7,860,0.0,1927,1540,4080,34765 days 16:47:18.689811,125,3.0,0.0,-680,-2416,860.0
343000.0,3,2.5,1270,2509,2.0,3,8,1270,0.0,2004,1420,2206,6641 days 16:47:18.689811,168,1.2,0.0,-150,303,1270.0
415000.0,2,2.25,1130,2191,2.0,3,8,1130,0.0,2010,1140,1710,4449 days 16:47:18.689811,363,0.8888888888888888,0.0,-10,481,1130.0
410000.0,3,2.5,1860,15457,2.0,3,8,1860,0.0,1997,2040,14055,9197 days 16:47:18.689811,280,1.2,0.0,-180,1402,1860.0
320000.0,2,1.0,1802,11225,1.0,3,7,1802,0.0,1961,1810,7332,22346 days 16:47:18.689811,008,2.0,0.0,-8,3893,1802.0
1990000.0,5,3.0,4480,5000,2.5,5,1,3420,1060.0,1902,3220,5600,43896 days 16:47:18.689811,177,1.6666666666666667,3.2264150943396226,1260,-600,2360.0
253000.0,2,1.0,1310,7128,1.0,4,7,940,370.0,1980,1400,7161,15407 days 16:47:18.689811,183,2.0,2.5405405405405403,-90,-33,570.0
630000.0,3,2.5,2320,32772,2.0,3,9,2320,0.0,1992,2610,33305,11024 days 16:47:18.689811,258,1.2,0.0,-290,-533,2320.0
216000.0,2,1.0,1130,12500,1.0,4,7,1130,0.0,1953,1270,10798,25268 days 16:47:18.689811,006,2.0,0.0,-140,1702,1130.0
540000.0,3,2.5,2180,11100,1.0,3,8,1230,950.0,1983,1930,12000,14311 days 16:47:18.689811,117,1.2,1.2947368421052632,250,-900,280.0
212000.0,3,1.5,1830,12233,1.5,4,5,1830,0.0,1930,1520,12233,33669 days 16:47:18.689811,273,2.0,0.0,310,0,1830.0
300000.0,3,2.75,2340,12282,1.0,3,8,1470,870.0,1978,2640,8887,16137 days 16:47:18.689811,029,1.0909090909090908,1.6896551724137931,-300,3395,600.0
969950.0,3,2.5,2830,3750,3.0,3,1,2830,0.0,2014,1780,5100,2988 days 16:47:18.689811,239,1.2,0.0,1050,-1350,2830.0
715000.0,3,1.0,1610,7680,1.0,3,6,900,710.0,1956,1940,2880,24173 days 16:47:18.689811,220,3.0,1.267605633802817,-330,4800,190.0
1320000.0,5,2.75,2410,19447,2.0,3,1,2290,120.0,1968,2980,19447,19790 days 16:47:18.689811,237,1.8181818181818181,19.083333333333332,-570,0,2170.0
1440000.0,4,2.75,2660,9547,1.0,3,8,1930,730.0,1968,2410,10001,19790 days 16:47:18.689811,335,1.4545454545454546,2.643835616438356,250,-454,1200.0
305000.0,3,1.0,1030,5350,1.0,3,7,1030,0.0,1924,1030,5250,35861 days 16:47:18.689811,196,3.0,0.0,0,100,1030.0
458000.0,3,4.0,1390,1569,2.0,3,9,1150,240.0,2006,1620,1855,5910 days 16:47:18.689811,338,0.75,4.791666666666667,-230,-286,910.0
275000.0,3,1.75,1580,8775,1.0,3,6,1220,360.0,1942,1180,8775,29286 days 16:47:18.689811,104,1.7142857142857142,3.388888888888889,400,0,860.0
550000.0,3,2.75,2330,4780,2.0,3,8,1730,600.0,1930,1100,5336,33669 days 16:47:18.689811,287,1.0909090909090908,2.8833333333333333,1230,-556,1130.0
742000.0,3,3.25,1540,704,3.0,3,9,1540,0.0,2011,1540,1456,4084 days 16:47:18.689811,155,0.9230769230769231,0.0,0,-752,1540.0
700000.0,3,1.0,1570,4000,2.0,5,8,1570,0.0,1908,1640,4000,41705 days 16:47:18.689811,206,3.0,0.0,-70,0,1570.0
640000.0,4,3.0,2940,5763,1.0,5,8,1640,1300.0,1955,2020,7320,24538 days 16:47:18.689811,316,1.3333333333333333,1.2615384615384615,920,-1557,340.0
352000.0,3,0.75,1240,7200,1.0,3,7,1240,0.0,1947,1210,7200,27460 days 16:47:18.689811,100,4.0,0.0,30,0,1240.0
301500.0,3,1.0,1410,7419,1.0,3,7,1050,360.0,1969,1800,8000,19424 days 16:47:18.689811,032,3.0,2.9166666666666665,-390,-581,690.0
630000.0,4,2.5,2190,9880,1.0,4,8,1410,780.0,1979,2190,9198,15772 days 16:47:18.689811,183,1.6,1.8076923076923077,0,682,630.0
340000.0,3,2.5,3040,6255,2.0,3,7,3040,0.0,1999,2670,6259,8467 days 16:47:18.689811,054,1.2,0.0,370,-4,3040.0
477500.0,4,1.75,1860,9364,1.0,3,7,1080,780.0,1953,1800,9364,25268 days 16:47:18.689811,069,2.2857142857142856,1.3846153846153846,60,0,300.0
285000.0,3,2.5,1690,7460,1.0,3,7,870,820.0,1997,1900,7302,9197 days 16:47:18.689811,225,1.2,1.0609756097560976,-210,158,50.0
255000.0,3,2.75,1900,16117,1.0,4,7,1900,0.0,1958,1640,19166,23442 days 16:47:18.689811,283,1.0909090909090908,0.0,260,-3049,1900.0
315000.0,3,2.5,1600,7982,2.0,3,8,1600,0.0,1993,1890,9830,10658 days 16:47:18.689811,209,1.2,0.0,-290,-1848,1600.0
830000.0,6,3.0,2530,9000,1.0,3,6,2530,0.0,1978,1886,6000,16137 days 16:47:18.689811,351,2.0,0.0,644,3000,2530.0
539950.0,3,2.25,1860,1558,3.0,3,8,1860,0.0,2014,1760,2456,2988 days 16:47:18.689811,041,1.3333333333333333,0.0,100,-898,1860.0
980000.0,3,2.25,2390,4590,2.0,3,8,2090,300.0,1941,2280,5179,29651 days 16:47:18.689811,226,1.3333333333333333,6.966666666666667,110,-589,1790.0
735000.0,4,2.5,3100,8529,2.0,3,9,3100,0.0,1990,2710,8344,11754 days 16:47:18.689811,199,1.6,0.0,390,185,3100.0
536000.0,5,2.25,2650,9140,1.0,3,8,1350,1300.0,1965,2700,7800,20885 days 16:47:18.689811,022,2.2222222222222223,1.0384615384615385,-50,1340,50.0
575000.0,3,2.0,1520,5000,1.5,3,7,1140,380.0,1945,1530,4650,28190 days 16:47:18.689811,054,1.5,3.0,-10,350,760.0
500000.0,2,1.0,1510,4000,1.0,3,6,930,580.0,1924,1300,4000,35861 days 16:47:18.689811,268,2.0,1.603448275862069,210,0,350.0
285500.0,4,1.75,1960,7950,1.0,4,8,1960,0.0,1967,1960,8400,20155 days 16:47:18.689811,167,2.2857142857142856,0.0,0,-450,1960.0
498000.0,4,2.75,2270,7375,1.0,4,7,1290,980.0,1973,1750,7760,17963 days 16:47:18.689811,134,1.4545454545454546,1.316326530612245,520,-385,310.0
412000.0,2,1.0,910,6282,1.0,4,7,910,0.0,1939,970,6281,30382 days 16:47:18.689811,233,2.0,0.0,-60,1,910.0
607000.0,4,2.5,2100,8220,1.0,4,8,1300,800.0,1975,2160,8348,17233 days 16:47:18.689811,082,1.6,1.625,-60,-128,500.0
199000.0,3,1.0,1000,8512,1.0,3,6,1000,0.0,1991,1490,10395,11389 days 16:47:18.689811,175,3.0,0.0,-490,-1883,1000.0
492500.0,4,2.75,2760,18306,1.0,3,7,1630,1130.0,1978,2470,9856,16137 days 16:47:18.689811,202,1.4545454545454546,1.4424778761061947,290,8450,500.0
585000.0,4,2.5,2840,11044,2.0,3,8,2840,0.0,2001,1934,9605,7736 days 16:47:18.689811,170,1.6,0.0,906,1439,2840.0
326995.0,3,2.5,1860,5321,2.0,3,7,1860,0.0,2000,1940,5205,8102 days 16:47:18.689811,342,1.2,0.0,-80,116,1860.0
372500.0,4,2.25,1920,9660,1.0,4,8,1920,0.0,1968,1890,7800,19790 days 16:47:18.689811,225,1.7777777777777777,0.0,30,1860,1920.0
528000.0,2,0.75,840,40642,1.0,4,6,840,0.0,1937,1850,64069,31112 days 16:47:18.689811,178,2.6666666666666665,0.0,-1010,-23427,840.0
400000.0,3,1.5,2390,32109,1.0,3,7,2390,0.0,1975,1370,32109,17233 days 16:47:18.689811,267,2.0,0.0,1020,0,2390.0
344000.0,4,2.5,2100,8501,2.0,5,7,2100,0.0,1993,2130,8560,10658 days 16:47:18.689811,302,1.6,0.0,-30,-59,2100.0
409950.0,4,3.0,2430,7163,2.0,3,8,2430,0.0,2003,2430,6028,7006 days 16:47:18.689811,245,1.3333333333333333,0.0,0,1135,2430.0
625000.0,3,2.0,1880,4000,1.0,3,8,1280,600.0,1950,1920,4000,26364 days 16:47:18.689811,196,1.5,2.1333333333333333,-40,0,680.0
304950.0,3,1.75,1350,9000,1.0,3,7,1350,0.0,1987,1370,9500,12850 days 16:47:18.689811,132,1.7142857142857142,0.0,-20,-500,1350.0
381500.0,2,2.0,2160,35183,1.0,3,9,2160,0.0,1985,2450,34992,13580 days 16:47:18.689811,272,1.0,0.0,-290,191,2160.0
215000.0,3,1.75,1430,13399,1.0,4,7,900,530.0,1946,1720,6415,27825 days 16:47:18.689811,204,1.7142857142857142,1.6981132075471699,-290,6984,370.0
345000.0,5,1.75,2840,12870,2.0,4,7,2840,0.0,1925,2170,9612,35495 days 16:47:18.689811,117,2.857142857142857,0.0,670,3258,2840.0
363000.0,3,0.75,2510,20000,2.0,4,7,2510,0.0,1961,2130,20000,22346 days 16:47:18.689811,075,4.0,0.0,380,0,2510.0
240000.0,3,1.0,1690,20063,1.5,4,7,1690,0.0,1913,1700,15899,39878 days 16:47:18.689811,036,3.0,0.0,-10,4164,1690.0
548050.0,2,2.0,1930,5479,1.0,3,8,1930,0.0,2005,1900,5479,6275 days 16:47:18.689811,035,1.0,0.0,30,0,1930.0
314000.0,2,1.0,720,4920,1.0,3,6,720,0.0,1941,670,4920,29651 days 16:47:18.689811,300,2.0,0.0,50,0,720.0
800000.0,4,2.5,2990,16809,2.0,3,1,2990,0.0,1990,3340,18752,11754 days 16:47:18.689811,177,1.6,0.0,-350,-1943,2990.0
400000.0,5,1.75,2300,6720,2.0,3,7,2300,0.0,1905,1200,6000,42800 days 16:47:18.689811,196,2.857142857142857,0.0,1100,720,2300.0
247000.0,1,1.0,460,4120,1.0,3,4,460,0.0,1937,990,4120,31112 days 16:47:18.689811,318,1.0,0.0,-530,0,460.0
540000.0,2,1.75,1240,4120,1.0,4,7,890,350.0,1906,1640,3740,42435 days 16:47:18.689811,091,1.1428571428571428,2.5428571428571427,-400,380,540.0
410000.0,4,2.5,1900,15123,2.0,3,8,1900,0.0,1995,1900,16477,9928 days 16:47:18.689811,199,1.6,0.0,0,-1354,1900.0
525000.0,3,1.75,2120,9146,1.0,3,8,1260,860.0,1981,2040,10485,15041 days 16:47:18.689811,275,1.7142857142857142,1.4651162790697674,80,-1339,400.0
820000.0,4,2.5,2440,5737,2.0,4,8,1700,740.0,1929,2020,5543,34034 days 16:47:18.689811,100,1.6,2.2972972972972974,420,194,960.0
1250000.0,4,2.25,3300,15375,1.5,3,8,2820,480.0,1933,3250,15375,32573 days 16:47:18.689811,069,1.7777777777777777,5.875,50,0,2340.0
244000.0,2,1.0,1180,10200,1.0,4,7,1180,0.0,1955,1330,10200,24538 days 16:47:18.689811,352,2.0,0.0,-150,0,1180.0
275000.0,1,1.0,520,4800,1.0,3,5,520,0.0,1930,800,4960,33669 days 16:47:18.689811,352,1.0,0.0,-280,-160,520.0
577000.0,2,1.75,2070,23160,1.0,3,7,1260,810.0,1946,1690,5458,27825 days 16:47:18.689811,281,1.1428571428571428,1.5555555555555556,380,17702,450.0
446950.0,5,2.5,2250,7945,1.0,4,7,1360,890.0,1977,1820,7866,16502 days 16:47:18.689811,336,2.0,1.5280898876404494,430,79,470.0
457000.0,3,2.5,2050,5694,2.0,3,8,2050,0.0,2004,2680,7187,6641 days 16:47:18.689811,210,1.2,0.0,-630,-1493,2050.0
320000.0,4,1.5,1310,137214,1.5,4,7,1310,0.0,1926,1310,9450,35130 days 16:47:18.689811,118,2.6666666666666665,0.0,0,127764,1310.0
210000.0,3,1.5,1250,9484,1.0,4,7,1250,0.0,1969,1320,9600,19424 days 16:47:18.689811,248,2.0,0.0,-70,-116,1250.0
220000.0,4,2.5,2130,9100,1.0,3,8,1290,840.0,1978,1770,7700,16137 days 16:47:18.689811,265,1.6,1.5357142857142858,360,1400,450.0
589000.0,3,2.0,2250,8800,1.0,4,7,1250,1000.0,1925,2250,4800,35495 days 16:47:18.689811,164,1.5,1.25,0,4000,250.0
435000.0,4,2.0,1880,3840,1.0,3,7,970,910.0,1904,1670,1820,43166 days 16:47:18.689811,181,2.0,1.065934065934066,210,2020,60.0
375000.0,3,1.0,1520,10798,1.0,3,7,1520,0.0,1953,1670,9876,25268 days 16:47:18.689811,197,3.0,0.0,-150,922,1520.0
1740000.0,4,3.5,4010,9654,2.0,3,1,4010,0.0,2007,1870,9873,5545 days 16:47:18.689811,290,1.1428571428571428,0.0,2140,-219,4010.0
545000.0,2,1.75,1660,5581,1.0,3,8,1660,0.0,2005,1670,4871,6275 days 16:47:18.689811,345,1.1428571428571428,0.0,-10,710,1660.0
970000.0,3,2.25,3400,10000,2.0,3,1,3400,0.0,1983,1860,5100,14311 days 16:47:18.689811,295,1.3333333333333333,0.0,1540,4900,3400.0
705000.0,2,1.75,2320,6755,1.0,5,8,1380,940.0,1946,1990,5000,27825 days 16:47:18.689811,199,1.1428571428571428,1.4680851063829787,330,1755,440.0
915557.0,5,3.25,3740,11536,2.0,4,9,2540,1200.0,1984,2920,11258,13946 days 16:47:18.689811,075,1.5384615384615385,2.1166666666666667,820,278,1340.0
259000.0,4,1.5,1810,9000,1.5,3,7,1810,0.0,1960,1520,9780,22712 days 16:47:18.689811,040,2.6666666666666665,0.0,290,-780,1810.0
1700000.0,2,2.25,3170,3000,2.0,5,1,1990,1180.0,1900,2980,5061,44626 days 16:47:18.689811,164,0.8888888888888888,1.6864406779661016,190,-2061,810.0
427000.0,3,1.75,1680,8610,1.0,4,7,1290,390.0,1969,1640,8809,19424 days 16:47:18.689811,335,1.7142857142857142,3.3076923076923075,40,-199,900.0
390000.0,2,1.0,930,3100,1.0,3,6,930,0.0,1911,1670,3800,40609 days 16:47:18.689811,223,2.0,0.0,-740,-700,930.0
363000.0,3,2.5,2390,8000,2.0,3,8,2390,0.0,1995,2070,7585,9928 days 16:47:18.689811,043,1.2,0.0,320,415,2390.0
612000.0,4,2.5,2680,3626,1.5,4,7,1680,1000.0,1928,1950,4500,34400 days 16:47:18.689811,219,1.6,1.68,730,-874,680.0
380000.0,4,1.75,1790,10186,1.0,4,8,1790,0.0,1965,1790,9142,20885 days 16:47:18.689811,259,2.2857142857142856,0.0,0,1044,1790.0
230000.0,4,3.0,1680,6003,1.0,3,7,1150,530.0,1997,1820,6207,9197 days 16:47:18.689811,230,1.3333333333333333,2.169811320754717,-140,-204,620.0
580000.0,3,1.75,1570,2600,1.5,4,8,1570,0.0,1931,1490,4000,33304 days 16:47:18.689811,104,1.7142857142857142,0.0,80,-1400,1570.0
770000.0,3,1.0,2230,3200,2.0,3,8,1630,600.0,1918,2280,5400,38052 days 16:47:18.689811,323,3.0,2.716666666666667,-50,-2200,1030.0
207200.0,4,2.0,1260,8400,1.0,3,6,1260,0.0,1991,1120,8400,11389 days 16:47:18.689811,267,2.0,0.0,140,0,1260.0
525000.0,3,2.0,1790,11430,1.0,3,7,1190,600.0,1985,1700,12114,13580 days 16:47:18.690809,064,1.5,1.9833333333333334,90,-684,590.0
925000.0,3,2.5,2440,7419,1.0,3,7,1520,920.0,1961,2440,4880,22346 days 16:47:18.690809,040,1.2,1.6521739130434783,0,2539,600.0
883000.0,4,2.25,2410,4000,2.0,5,8,1650,760.0,1910,1820,4000,40974 days 16:47:18.690809,245,1.7777777777777777,2.1710526315789473,590,0,890.0
455000.0,4,2.5,1780,2992,2.0,3,7,1780,0.0,2003,1610,2961,7006 days 16:47:18.690809,128,1.6,0.0,170,31,1780.0
343500.0,3,2.5,1900,5194,2.0,3,7,1900,0.0,2004,2230,5194,6641 days 16:47:18.690809,265,1.2,0.0,-330,0,1900.0
244000.0,2,1.0,960,8450,1.0,5,6,960,0.0,1950,1090,8450,26364 days 16:47:18.690809,318,2.0,0.0,-130,0,960.0
397000.0,3,1.75,1640,11730,1.0,5,7,1640,0.0,1967,1640,7770,20155 days 16:47:18.690809,323,1.7142857142857142,0.0,0,3960,1640.0
180500.0,2,1.0,850,5000,1.0,3,6,850,0.0,1976,1160,5000,16868 days 16:47:18.690809,075,2.0,0.0,-310,0,850.0
310000.0,3,2.75,2150,6576,1.0,4,7,1900,250.0,1926,2150,9071,35130 days 16:47:18.690809,063,1.0909090909090908,7.6,0,-2495,1650.0
315000.0,4,2.5,2780,3969,2.0,3,7,2780,0.0,2005,2260,4160,6275 days 16:47:18.690809,028,1.6,0.0,520,-191,2780.0
718000.0,3,1.0,1030,4958,1.0,5,7,1030,0.0,1952,2230,6987,25634 days 16:47:18.690809,154,3.0,0.0,-1200,-2029,1030.0
279950.0,3,1.75,1930,7267,1.0,4,7,1330,600.0,1977,1600,7698,16502 days 16:47:18.690809,282,1.7142857142857142,2.216666666666667,330,-431,730.0
689000.0,3,2.5,2080,9612,1.0,4,8,1700,380.0,1940,2560,10202,30017 days 16:47:18.690809,294,1.2,4.473684210526316,-480,-590,1320.0
828000.0,4,2.5,3520,9901,2.0,3,1,3520,0.0,1998,3490,9667,8832 days 16:47:18.690809,230,1.6,0.0,30,234,3520.0
150000.0,2,1.0,890,8100,1.0,3,6,890,0.0,1942,1260,8100,29286 days 16:47:18.690809,176,2.0,0.0,-370,0,890.0
505400.0,3,1.75,1640,3400,1.0,4,7,930,710.0,1926,1380,3750,35130 days 16:47:18.690809,060,1.7142857142857142,1.3098591549295775,260,-350,220.0
1680000.0,5,3.25,4860,23723,2.0,4,1,3820,1040.0,1989,4040,13860,12119 days 16:47:18.690809,133,1.5384615384615385,3.673076923076923,820,9863,2780.0
217450.0,3,1.0,1040,5000,1.0,3,7,1040,0.0,1959,1440,5000,23077 days 16:47:18.690809,135,3.0,0.0,-400,0,1040.0
677000.0,4,2.5,2820,4174,2.0,3,9,2820,0.0,2004,2560,4853,6641 days 16:47:18.690809,352,1.6,0.0,260,-679,2820.0
361000.0,2,2.5,1320,48787,1.0,3,8,1320,0.0,2004,1830,155073,6641 days 16:47:18.690809,117,0.8,0.0,-510,-106286,1320.0
620000.0,3,2.5,2590,7237,2.0,3,8,2590,0.0,2004,1670,7648,6641 days 16:47:18.690809,160,1.2,0.0,920,-411,2590.0
176000.0,3,2.25,1540,5449,1.0,2,7,1180,360.0,1989,1460,6740,12119 days 16:47:18.690809,344,1.3333333333333333,3.2777777777777777,80,-1291,820.0
330000.0,3,1.0,960,7218,1.0,4,7,960,0.0,1969,1580,9104,19424 days 16:47:18.690809,104,3.0,0.0,-620,-1886,960.0
290000.0,3,2.5,1190,8175,1.0,3,7,1190,0.0,1986,2230,9520,13215 days 16:47:18.690809,302,1.2,0.0,-1040,-1345,1190.0
711000.0,4,2.5,2770,9532,2.0,4,9,2770,0.0,1988,2770,9219,12485 days 16:47:18.690809,196,1.6,0.0,0,313,2770.0
295000.0,3,1.75,1060,8100,2.0,4,7,1060,0.0,1983,1410,8100,14311 days 16:47:18.690809,112,1.7142857142857142,0.0,-350,0,1060.0
1100000.0,5,3.25,4010,12110,2.0,3,1,4010,0.0,2003,4010,12334,7006 days 16:47:18.690809,315,1.5384615384615385,0.0,0,-224,4010.0
257500.0,3,2.0,1140,7078,1.0,4,7,1140,0.0,1991,1460,7078,11389 days 16:47:18.690809,268,1.5,0.0,-320,0,1140.0
240000.0,4,1.0,1910,16320,1.5,3,6,1910,0.0,1934,1380,9000,32208 days 16:47:18.690809,160,4.0,0.0,530,7320,1910.0
645000.0,4,2.5,2340,8955,2.0,3,9,2340,0.0,1990,2340,8955,11754 days 16:47:18.690809,346,1.6,0.0,0,0,2340.0
499000.0,2,1.75,1170,2400,1.0,4,7,740,430.0,1903,1570,3919,43531 days 16:47:18.690809,126,1.1428571428571428,1.7209302325581395,-400,-1519,310.0
321000.0,3,1.0,1290,9526,1.5,3,7,1290,0.0,1961,1290,9508,22346 days 16:47:18.690809,293,3.0,0.0,0,18,1290.0
449000.0,3,2.5,1810,1658,3.0,3,8,1810,0.0,1998,1470,1585,8832 days 16:47:18.690809,234,1.2,0.0,340,73,1810.0
515000.0,3,2.5,1820,5280,1.0,4,7,910,910.0,1949,1600,4820,26729 days 16:47:18.690809,007,1.2,1.0,220,460,0.0
456000.0,4,1.5,2220,12385,1.0,3,8,1270,950.0,1978,2030,8831,16137 days 16:47:18.690809,275,2.6666666666666665,1.3368421052631578,190,3554,320.0
865000.0,3,3.75,3830,219106,2.0,3,9,3830,0.0,1977,2440,219106,16502 days 16:47:18.690809,204,0.8,0.0,1390,0,3830.0
515500.0,4,2.5,2920,7700,2.0,3,9,2920,0.0,2003,2920,8943,7006 days 16:47:18.690809,169,1.6,0.0,0,-1243,2920.0
576925.0,4,2.5,2630,6100,2.0,3,8,2630,0.0,2004,2360,5765,6641 days 16:47:18.690809,323,1.6,0.0,270,335,2630.0
243000.0,3,1.75,1320,10416,1.0,3,7,1320,0.0,1996,1670,7991,9563 days 16:47:18.690809,002,1.7142857142857142,0.0,-350,2425,1320.0
253400.0,3,2.0,1400,8640,1.0,5,7,1400,0.0,1968,1270,9375,19790 days 16:47:18.690809,148,1.5,0.0,130,-735,1400.0
292000.0,3,2.5,1600,3580,2.0,3,7,1600,0.0,2000,2020,4327,8102 days 16:47:18.690809,103,1.2,0.0,-420,-747,1600.0
271500.0,3,2.5,1490,8005,1.0,3,7,1090,400.0,1976,1880,7905,16868 days 16:47:18.690809,337,1.2,2.725,-390,100,690.0
765000.0,2,2.5,2170,6750,1.0,3,8,2170,0.0,2012,2150,6074,3719 days 16:47:18.690809,239,0.8,0.0,20,676,2170.0
375000.0,3,3.25,1280,1730,2.0,3,8,1090,190.0,2005,1280,2121,6275 days 16:47:18.690809,071,0.9230769230769231,5.7368421052631575,0,-391,900.0
382880.0,3,2.0,1620,9566,1.0,4,7,1620,0.0,1968,1660,10011,19790 days 16:47:18.690809,131,1.5,0.0,-40,-445,1620.0
852500.0,3,2.5,2630,10100,1.0,4,9,1580,1050.0,1967,2400,9700,20155 days 16:47:18.690809,160,1.2,1.5047619047619047,230,400,530.0
475000.0,3,1.5,1240,8738,1.0,3,7,1240,0.0,1959,1440,9344,23077 days 16:47:18.690809,328,2.0,0.0,-200,-606,1240.0
462000.0,3,1.75,1300,2580,1.0,5,7,820,480.0,1919,1180,2820,37687 days 16:47:18.690809,143,1.7142857142857142,1.7083333333333333,120,-240,340.0
762400.0,3,1.75,2430,14607,1.0,3,8,1230,1200.0,1949,2750,17425,26729 days 16:47:18.690809,162,1.7142857142857142,1.025,-320,-2818,30.0
330000.0,4,1.5,1890,7540,1.0,4,7,1890,0.0,1967,1890,8515,20155 days 16:47:18.690809,030,2.6666666666666665,0.0,0,-975,1890.0
473000.0,3,2.25,1890,12236,1.0,3,8,1890,0.0,1978,2390,12323,16137 days 16:47:18.690809,206,1.3333333333333333,0.0,-500,-87,1890.0
550000.0,3,1.5,2440,7200,1.0,3,7,2440,0.0,1949,1920,6900,26729 days 16:47:18.690809,325,2.0,0.0,520,300,2440.0
449500.0,3,2.25,1780,7280,1.0,3,7,1340,440.0,1972,2060,7280,18329 days 16:47:18.690809,174,1.3333333333333333,3.0454545454545454,-280,0,900.0
744000.0,4,2.75,2830,13059,2.0,3,1,2830,0.0,1998,3840,11596,8832 days 16:47:18.690809,141,1.4545454545454546,0.0,-1010,1463,2830.0
700000.0,4,2.0,2490,4700,1.0,4,7,1690,800.0,1952,2240,5000,25634 days 16:47:18.690809,127,2.0,2.1125,250,-300,890.0
511100.0,4,2.5,1560,12220,1.5,4,7,1560,0.0,1965,1920,12220,20885 days 16:47:18.690809,273,1.6,0.0,-360,0,1560.0
317950.0,3,2.5,1980,4500,2.0,3,7,1980,0.0,2012,2200,4500,3719 days 16:47:18.690809,259,1.2,0.0,-220,0,1980.0
542950.0,3,2.5,2070,39768,2.0,3,8,2070,0.0,1988,2740,44866,12485 days 16:47:18.690809,287,1.2,0.0,-670,-5098,2070.0
490000.0,3,1.75,1490,11360,1.0,3,8,1490,0.0,1975,2350,10320,17233 days 16:47:18.690809,227,1.7142857142857142,0.0,-860,1040,1490.0
760000.0,4,3.5,3090,4060,2.0,3,8,2420,670.0,1992,1720,4080,11024 days 16:47:18.690809,050,1.1428571428571428,3.611940298507463,1370,-20,1750.0
475000.0,3,2.25,1580,8659,1.0,4,7,1220,360.0,1961,1970,9650,22346 days 16:47:18.690809,111,1.3333333333333333,3.388888888888889,-390,-991,860.0
1700000.0,5,4.5,5190,23716,2.0,3,1,3390,1800.0,1987,4460,22748,12850 days 16:47:18.690809,129,1.1111111111111112,1.8833333333333333,730,968,1590.0
435000.0,3,2.75,2692,6197,2.0,3,9,2692,0.0,2007,2336,5700,5545 days 16:47:18.690809,085,1.0909090909090908,0.0,356,497,2692.0
399000.0,3,2.5,1740,3690,2.0,3,8,1740,0.0,2000,2100,4944,8102 days 16:47:18.690809,305,1.2,0.0,-360,-1254,1740.0
627000.0,3,2.0,1940,3800,1.0,4,7,1050,890.0,1927,1700,3800,34765 days 16:47:18.690809,238,1.5,1.1797752808988764,240,0,160.0
346500.0,4,2.5,2150,5100,1.5,3,7,1290,860.0,1991,1920,5100,11389 days 16:47:18.690809,275,1.6,1.5,230,0,430.0
412000.0,3,1.5,1320,8000,1.0,3,7,1320,0.0,1957,1720,8100,23807 days 16:47:18.690809,104,2.0,0.0,-400,-100,1320.0
845000.0,4,2.5,3360,40471,2.0,4,1,3360,0.0,1994,3150,36823,10293 days 16:47:18.690809,034,1.6,0.0,210,3648,3360.0
373000.0,3,1.75,1850,9655,1.0,3,7,1100,750.0,1959,1480,8683,23077 days 16:47:18.690809,309,1.7142857142857142,1.4666666666666666,370,972,350.0
725000.0,4,2.25,2880,8882,2.0,4,8,2480,400.0,1965,2460,9610,20885 days 16:47:18.690809,220,1.7777777777777777,6.2,420,-728,2080.0
376000.0,6,2.5,2420,11662,1.0,4,7,1420,1000.0,1965,1630,11662,20885 days 16:47:18.690809,225,2.4,1.42,790,0,420.0
552500.0,3,1.0,2020,4120,1.5,4,7,1520,500.0,1929,1200,4635,34034 days 16:47:18.690809,217,3.0,3.04,820,-515,1020.0
365000.0,5,2.0,2280,19000,1.5,3,6,2280,0.0,1924,1790,11800,35861 days 16:47:18.690809,177,2.5,0.0,490,7200,2280.0
700000.0,4,2.5,3010,46173,2.0,3,9,3010,0.0,1996,2590,49222,9563 days 16:47:18.690809,141,1.6,0.0,420,-3049,3010.0
315000.0,4,2.25,2550,9736,1.0,4,8,2550,0.0,1967,1770,9686,20155 days 16:47:18.690809,064,1.7777777777777777,0.0,780,50,2550.0
262500.0,4,2.0,1540,5110,1.0,3,7,1540,0.0,1957,1540,5110,23807 days 16:47:18.690809,090,2.0,0.0,0,0,1540.0
660000.0,3,2.25,2280,6150,2.0,3,8,2280,0.0,1984,1920,6150,13946 days 16:47:18.690809,308,1.3333333333333333,0.0,360,0,2280.0
340000.0,4,2.5,2450,6941,2.0,3,7,2450,0.0,2006,3300,6941,5910 days 16:47:18.690809,103,1.6,0.0,-850,0,2450.0
660500.0,5,2.5,2950,5500,1.5,5,7,1720,1230.0,1918,2200,5000,38052 days 16:47:18.690809,183,2.0,1.3983739837398375,750,500,490.0
280000.0,1,1.0,690,1950,1.0,3,6,690,0.0,1928,1650,4864,34400 days 16:47:18.690809,178,1.0,0.0,-960,-2914,690.0
230000.0,2,1.0,1470,25661,1.5,3,4,1470,0.0,1932,1670,43301,32939 days 16:47:18.690809,310,2.0,0.0,-200,-17640,1470.0
417000.0,3,2.25,1840,11403,2.0,3,8,1840,0.0,1993,2150,11403,10658 days 16:47:18.690809,265,1.3333333333333333,0.0,-310,0,1840.0
252000.0,3,1.0,1170,9730,1.0,3,7,1170,0.0,1968,1680,10125,19790 days 16:47:18.690809,195,3.0,0.0,-510,-395,1170.0
791000.0,5,1.75,2344,4800,1.5,4,7,1544,800.0,1921,1770,4200,36956 days 16:47:18.690809,079,2.857142857142857,1.93,574,600,744.0
415000.0,1,1.0,1230,3774,1.0,4,6,830,400.0,1924,1300,3774,35861 days 16:47:18.690809,253,1.0,2.075,-70,0,430.0
339000.0,3,1.75,1150,13278,1.0,5,7,1150,0.0,1966,1560,12400,20520 days 16:47:18.690809,205,1.7142857142857142,0.0,-410,878,1150.0
158000.0,3,1.0,1140,10477,1.0,3,6,1140,0.0,1942,1190,9750,29286 days 16:47:18.690809,124,3.0,0.0,-50,727,1140.0
535000.0,3,1.0,1660,5100,1.0,3,7,1260,400.0,1957,1230,5100,23807 days 16:47:18.690809,223,3.0,3.15,430,0,860.0
818900.0,3,1.0,1080,4120,1.0,3,7,980,100.0,1919,1280,3090,37687 days 16:47:18.690809,063,3.0,9.8,-200,1030,880.0
550000.0,4,2.0,1720,4000,1.0,3,7,1420,300.0,1950,1350,1281,26364 days 16:47:18.690809,112,2.0,4.733333333333333,370,2719,1120.0
240000.0,2,1.0,590,8717,1.0,3,6,590,0.0,1953,1370,6760,25268 days 16:47:18.690809,065,2.0,0.0,-780,1957,590.0
590000.0,3,3.25,1290,1230,2.0,3,9,1090,200.0,2008,1710,1797,5180 days 16:47:18.690809,260,0.9230769230769231,5.45,-420,-567,890.0
369300.0,3,1.5,1480,21320,1.0,4,7,1480,0.0,1967,1850,17825,20155 days 16:47:18.690809,055,2.0,0.0,-370,3495,1480.0
510000.0,4,2.5,2600,118666,1.0,3,7,1400,1200.0,1981,2440,131116,15041 days 16:47:18.690809,104,1.6,1.1666666666666667,160,-12450,200.0
542500.0,3,2.5,2040,10086,2.0,3,8,2040,0.0,1987,1940,10272,12850 days 16:47:18.690809,188,1.2,0.0,100,-186,2040.0
262500.0,3,1.0,970,7854,1.0,4,7,970,0.0,1980,1480,7800,15407 days 16:47:18.690809,002,3.0,0.0,-510,54,970.0
900000.0,6,3.0,2620,4350,1.0,3,7,1760,860.0,1957,1760,4300,23807 days 16:47:18.690809,042,2.0,2.046511627906977,860,50,900.0
1100000.0,4,3.5,4560,41636,2.0,3,9,4170,390.0,1995,2990,11381,9928 days 16:47:18.690809,287,1.1428571428571428,10.692307692307692,1570,30255,3780.0
368000.0,3,1.75,1750,14400,1.0,4,7,1750,0.0,1951,2030,14400,25999 days 16:47:18.690809,225,1.7142857142857142,0.0,-280,0,1750.0
825000.0,4,3.5,3620,6499,2.5,3,9,3620,0.0,2003,2330,7200,7006 days 16:47:18.690809,295,1.1428571428571428,0.0,1290,-701,3620.0
343500.0,3,2.0,1660,7509,1.0,3,7,1660,0.0,2002,2380,8598,7371 days 16:47:18.690809,014,1.5,0.0,-720,-1089,1660.0
273500.0,4,1.0,1360,6000,1.0,4,6,1020,340.0,1944,1230,6000,28556 days 16:47:18.690809,338,4.0,3.0,130,0,680.0
1000000.0,3,2.5,2044,5610,2.0,4,9,2044,0.0,1996,2440,5610,9563 days 16:47:18.690809,020,1.2,0.0,-396,0,2044.0
770000.0,5,3.0,2370,6000,1.5,3,8,1340,1030.0,1926,1350,4500,35130 days 16:47:18.690809,302,1.6666666666666667,1.3009708737864079,1020,1500,310.0
400000.0,3,2.0,1170,3868,1.5,4,7,1170,0.0,1925,1400,3800,35495 days 16:47:18.690809,063,1.5,0.0,-230,68,1170.0
225000.0,3,1.0,1660,7210,1.0,3,7,1100,560.0,1963,1660,7245,21616 days 16:47:18.690809,133,3.0,1.9642857142857142,0,-35,540.0
345000.0,4,1.0,2020,18150,1.0,4,7,2020,0.0,1955,1530,11970,24538 days 16:47:18.690809,064,4.0,0.0,490,6180,2020.0
450000.0,3,2.5,2530,8116,2.0,3,8,2530,0.0,2001,2280,8791,7736 days 16:47:18.690809,274,1.2,0.0,250,-675,2530.0
334850.0,2,1.0,870,5635,1.0,3,7,870,0.0,1948,1310,5750,27095 days 16:47:18.690809,199,2.0,0.0,-440,-115,870.0
605000.0,5,3.0,3670,9600,1.0,3,8,1980,1690.0,1955,1730,4933,24538 days 16:47:18.690809,007,1.6666666666666667,1.1715976331360947,1940,4667,290.0
760000.0,5,3.5,3180,14000,2.0,5,1,3180,0.0,1997,3670,14450,9197 days 16:47:18.690809,325,1.4285714285714286,0.0,-490,-450,3180.0
390000.0,2,1.5,1870,12960,1.5,4,6,1350,520.0,1926,1380,7800,35130 days 16:47:18.690809,279,1.3333333333333333,2.5961538461538463,490,5160,830.0
488000.0,3,2.5,1940,5660,2.0,3,8,1940,0.0,2001,2110,4581,7736 days 16:47:18.690809,216,1.2,0.0,-170,1079,1940.0
3300000.0,3,3.25,4220,41300,1.0,4,1,2460,1760.0,1958,3810,30401,23442 days 16:47:18.690809,364,0.9230769230769231,1.3977272727272727,410,10899,700.0
1060000.0,5,4.5,4820,13165,2.0,4,1,3950,870.0,1990,3880,13810,11754 days 16:47:18.690809,053,1.1111111111111112,4.540229885057471,940,-645,3080.0
608000.0,3,2.0,2400,217800,2.0,3,8,1590,810.0,1975,2340,207781,17233 days 16:47:18.690809,081,1.5,1.962962962962963,60,10019,780.0
1390000.0,3,2.25,2930,6000,2.0,3,1,1920,1010.0,2000,1870,5040,8102 days 16:47:18.690809,234,1.3333333333333333,1.900990099009901,1060,960,910.0
299950.0,2,1.0,800,3000,1.0,3,6,800,0.0,1904,1640,3400,43166 days 16:47:18.690809,258,2.0,0.0,-840,-400,800.0
818000.0,3,3.25,2200,4800,2.0,3,7,1910,290.0,1943,1410,4800,28921 days 16:47:18.690809,118,0.9230769230769231,6.586206896551724,790,0,1620.0
355000.0,3,2.5,2400,9701,1.0,3,9,2400,0.0,1990,2400,8258,11754 days 16:47:18.690809,148,1.2,0.0,0,1443,2400.0
1860000.0,5,3.25,5570,9600,2.0,5,9,3860,1710.0,1952,3170,10400,25634 days 16:47:18.690809,288,1.5384615384615385,2.257309941520468,2400,-800,2150.0
660000.0,3,3.25,1980,2850,3.0,3,7,1980,0.0,1987,1630,4560,12850 days 16:47:18.690809,174,0.9230769230769231,0.0,350,-1710,1980.0
2370000.0,3,2.25,3530,17450,1.0,3,9,1840,1690.0,1930,3530,17310,33669 days 16:47:18.690809,182,1.3333333333333333,1.0887573964497042,0,140,150.0
1210000.0,4,2.5,3430,35120,2.0,3,1,3430,0.0,1984,3920,35230,13946 days 16:47:18.690809,114,1.6,0.0,-490,-110,3430.0
255950.0,3,2.5,1720,3676,2.0,3,7,1720,0.0,1992,1720,3510,11024 days 16:47:18.690809,176,1.2,0.0,0,166,1720.0
475000.0,3,1.5,1930,11092,1.0,3,7,1500,430.0,1983,1230,10964,14311 days 16:47:18.690809,233,2.0,3.488372093023256,700,128,1070.0
362950.0,4,1.75,2140,159865,1.0,4,7,1140,1000.0,1960,1830,15569,22712 days 16:47:18.690809,363,2.2857142857142856,1.14,310,144296,140.0
452000.0,3,1.75,1110,9012,1.0,4,7,1110,0.0,1966,1800,8679,20520 days 16:47:18.690809,182,1.7142857142857142,0.0,-690,333,1110.0
315000.0,3,1.75,1970,8200,1.0,3,7,1270,700.0,1964,1890,8348,21251 days 16:47:18.690809,216,1.7142857142857142,1.8142857142857143,80,-148,570.0
330950.0,3,2.5,1630,2844,2.0,3,7,1630,0.0,2003,1610,2582,7006 days 16:47:18.690809,029,1.2,0.0,20,262,1630.0
535000.0,5,2.25,2520,49222,2.0,4,8,2520,0.0,1978,2780,55321,16137 days 16:47:18.690809,162,2.2222222222222223,0.0,-260,-6099,2520.0
479000.0,4,2.25,2270,9464,1.5,4,7,1520,750.0,1940,1770,9464,30017 days 16:47:18.690809,056,1.7777777777777777,2.026666666666667,500,0,770.0
340000.0,3,2.5,1212,1174,3.0,3,7,1212,0.0,2004,1256,1226,6641 days 16:47:18.690809,167,1.2,0.0,-44,-52,1212.0
312000.0,4,2.0,1890,8362,1.0,3,7,1890,0.0,1966,1600,9257,20520 days 16:47:18.690809,259,2.0,0.0,290,-895,1890.0
305000.0,3,2.25,1370,6600,2.0,4,7,1370,0.0,1993,1370,6600,10658 days 16:47:18.690809,077,1.3333333333333333,0.0,0,0,1370.0
529999.0,3,2.5,1710,1664,2.0,5,8,1300,410.0,2003,1470,5400,7006 days 16:47:18.690809,156,1.2,3.1707317073170733,240,-3736,890.0
587100.0,2,1.0,1190,6967,1.0,3,7,1190,0.0,1946,1700,6968,27825 days 16:47:18.690809,204,2.0,0.0,-510,-1,1190.0
459800.0,3,2.0,1690,16061,1.0,3,7,1690,0.0,1984,1280,12436,13946 days 16:47:18.690809,322,1.5,0.0,410,3625,1690.0
451000.0,4,1.75,1680,7800,1.0,3,7,1330,350.0,1966,1680,7210,20520 days 16:47:18.690809,346,2.2857142857142856,3.8,0,590,980.0
2480000.0,3,3.25,4340,4947,2.0,3,1,3060,1280.0,1993,1680,5250,10658 days 16:47:18.690809,168,0.9230769230769231,2.390625,2660,-303,1780.0
525000.0,3,2.25,2040,435600,2.0,4,7,2040,0.0,1983,2020,223027,14311 days 16:47:18.690809,356,1.3333333333333333,0.0,20,212573,2040.0
250000.0,2,1.0,1110,26051,1.0,3,6,1110,0.0,1951,2240,12255,25999 days 16:47:18.690809,149,2.0,0.0,-1130,13796,1110.0
475000.0,5,2.0,2040,6180,2.0,4,7,2040,0.0,1908,1870,4365,41705 days 16:47:18.690809,321,2.5,0.0,170,1815,2040.0
235000.0,4,1.5,1920,11595,1.0,4,7,1920,0.0,1962,1400,10550,21981 days 16:47:18.690809,071,2.6666666666666665,0.0,520,1045,1920.0
230000.0,3,1.5,1330,9548,1.0,5,7,1330,0.0,1967,1420,9548,20155 days 16:47:18.690809,192,2.0,0.0,-90,0,1330.0
581000.0,4,1.0,1630,2566,1.5,3,7,1630,0.0,1921,1220,2314,36956 days 16:47:18.690809,182,4.0,0.0,410,252,1630.0
415000.0,3,1.0,1520,9030,1.0,3,7,1520,0.0,1956,1470,8712,24173 days 16:47:18.690809,183,3.0,0.0,50,318,1520.0
522500.0,3,1.0,1520,9030,1.0,3,7,1520,0.0,1956,1470,8712,24173 days 16:47:18.690809,289,3.0,0.0,50,318,1520.0
383000.0,3,1.5,1340,7725,1.0,4,8,1340,0.0,1967,1990,7725,20155 days 16:47:18.690809,005,2.0,0.0,-650,0,1340.0
315000.0,3,1.75,2500,8289,1.0,4,7,1250,1250.0,1958,1710,8205,23442 days 16:47:18.690809,303,1.7142857142857142,1.0,790,84,0.0
591000.0,3,2.0,1460,3600,2.0,3,7,1460,0.0,1902,1590,1210,43896 days 16:47:18.690809,265,1.5,0.0,-130,2390,1460.0
750000.0,4,2.25,3140,12150,2.0,3,9,3140,0.0,1979,2370,12054,15772 days 16:47:18.690809,353,1.7777777777777777,0.0,770,96,3140.0
430000.0,3,1.75,2150,4333,1.0,3,7,1200,950.0,1956,1480,6500,24173 days 16:47:18.690809,136,1.7142857142857142,1.263157894736842,670,-2167,250.0
712000.0,4,2.5,3140,32336,1.5,3,1,3140,0.0,1995,2340,19965,9928 days 16:47:18.690809,121,1.6,0.0,800,12371,3140.0
510000.0,3,2.5,2310,53578,1.0,4,8,1340,970.0,1981,2660,49658,15041 days 16:47:18.690809,096,1.2,1.3814432989690721,-350,3920,370.0
480000.0,2,1.0,710,4800,1.0,2,6,710,0.0,1950,1480,1721,26364 days 16:47:18.690809,023,2.0,0.0,-770,3079,710.0
538000.0,3,1.0,1460,7200,1.0,3,7,1260,200.0,1906,1430,4650,42435 days 16:47:18.690809,164,3.0,6.3,30,2550,1060.0
464000.0,2,2.75,730,5000,1.0,3,7,730,0.0,1929,980,5000,34034 days 16:47:18.690809,339,0.7272727272727273,0.0,-250,0,730.0
476000.0,3,2.5,1440,3840,2.0,3,7,1440,0.0,2001,1600,3131,7736 days 16:47:18.690809,002,1.2,0.0,-160,709,1440.0
349500.0,3,2.0,1130,16875,1.0,4,7,1130,0.0,1947,1600,14300,27460 days 16:47:18.690809,085,1.5,0.0,-470,2575,1130.0
270000.0,3,2.25,1810,8262,2.0,4,8,1810,0.0,1981,1820,8262,15041 days 16:47:18.690809,038,1.3333333333333333,0.0,-10,0,1810.0
740000.0,3,2.5,2710,18480,2.0,3,1,2000,710.0,1978,2710,18077,16137 days 16:47:18.690809,323,1.2,2.816901408450704,0,403,1290.0
395000.0,4,2.5,2740,8336,2.0,4,9,2740,0.0,1990,2460,9189,11754 days 16:47:18.690809,286,1.6,0.0,280,-853,2740.0
498000.0,3,2.5,1690,4088,2.0,3,7,1690,0.0,2004,1950,4088,6641 days 16:47:18.690809,100,1.2,0.0,-260,0,1690.0
339900.0,3,2.5,1470,4675,2.0,3,7,1470,0.0,1999,1500,4385,8467 days 16:47:18.690809,030,1.2,0.0,-30,290,1470.0
539000.0,3,2.5,2830,9972,2.0,3,9,2830,0.0,2006,3557,9159,5910 days 16:47:18.690809,245,1.2,0.0,-727,813,2830.0
400000.0,3,1.0,1410,9704,1.0,3,8,1140,270.0,1983,1910,13639,14311 days 16:47:18.690809,057,3.0,4.222222222222222,-500,-3935,870.0
225000.0,3,2.5,2170,11745,1.0,4,7,1410,760.0,1967,1860,8643,20155 days 16:47:18.690809,049,1.2,1.855263157894737,310,3102,650.0
330000.0,3,2.25,1340,4080,1.5,3,6,1170,170.0,1907,1670,4080,42070 days 16:47:18.690809,253,1.3333333333333333,6.882352941176471,-330,0,1000.0
1390000.0,3,3.0,2480,5500,2.0,3,1,1730,750.0,1950,2950,5670,26364 days 16:47:18.690809,177,1.0,2.3066666666666666,-470,-170,980.0
490000.0,3,2.75,1990,31200,1.0,3,8,1990,0.0,1986,3120,29625,13215 days 16:47:18.690809,120,1.0909090909090908,0.0,-1130,1575,1990.0
260000.0,4,2.75,2240,7200,1.0,3,7,1140,1100.0,1967,1580,7416,20155 days 16:47:18.690809,354,1.4545454545454546,1.0363636363636364,660,-216,40.0
469900.0,4,2.5,2990,8913,2.0,4,9,2990,0.0,1991,2740,8030,11389 days 16:47:18.690809,178,1.6,0.0,250,883,2990.0
493000.0,6,1.75,2120,3801,1.5,4,7,1220,900.0,1925,1850,4181,35495 days 16:47:18.690809,316,3.4285714285714284,1.3555555555555556,270,-380,320.0
740000.0,4,2.25,2920,46355,2.0,4,9,2920,0.0,1998,2310,184694,8832 days 16:47:18.690809,148,1.7777777777777777,0.0,610,-138339,2920.0
148900.0,4,1.75,1700,6000,1.0,3,7,1700,0.0,1967,1280,6000,20155 days 16:47:18.690809,345,2.2857142857142856,0.0,420,0,1700.0
475000.0,2,2.5,1620,14467,2.0,3,7,1620,0.0,1981,1470,13615,15041 days 16:47:18.690809,322,0.8,0.0,150,852,1620.0
415000.0,2,1.0,760,4000,1.0,3,7,760,0.0,1944,1520,4000,28556 days 16:47:18.690809,357,2.0,0.0,-760,0,760.0
229500.0,3,1.0,1230,6000,1.0,4,7,1230,0.0,1967,1240,6000,20155 days 16:47:18.690809,188,3.0,0.0,-10,0,1230.0
1360000.0,5,3.75,4960,13990,2.0,3,1,3760,1200.0,2001,5200,18116,7736 days 16:47:18.690809,226,1.3333333333333333,3.1333333333333333,-240,-4126,2560.0
385000.0,4,2.5,2030,11375,1.0,3,7,1330,700.0,1969,1500,9160,19424 days 16:47:18.690809,344,1.6,1.9,530,2215,630.0
230000.0,3,2.25,1830,11331,1.0,3,7,1250,580.0,1965,2240,16433,20885 days 16:47:18.690809,117,1.3333333333333333,2.1551724137931036,-410,-5102,670.0
425000.0,2,1.0,970,2700,1.0,4,7,770,200.0,1926,1570,3348,35130 days 16:47:18.690809,220,2.0,3.85,-600,-648,570.0
189900.0,2,1.0,1000,4179,1.0,5,5,1000,0.0,1914,1010,6327,39513 days 16:47:18.690809,203,2.0,0.0,-10,-2148,1000.0
238000.0,2,1.0,750,6480,1.0,3,6,750,0.0,1943,1050,6390,28921 days 16:47:18.690809,002,2.0,0.0,-300,90,750.0
968060.0,4,2.5,2620,16200,1.0,4,7,1570,1050.0,1950,3050,11875,26364 days 16:47:18.690809,231,1.6,1.4952380952380953,-430,4325,520.0
921000.0,4,1.5,2220,9496,1.0,4,7,1490,730.0,1954,1800,8286,24903 days 16:47:18.690809,167,2.6666666666666665,2.041095890410959,420,1210,760.0
380000.0,5,1.75,3000,6000,1.0,5,7,1500,1500.0,1958,2230,7125,23442 days 16:47:18.690809,127,2.857142857142857,1.0,770,-1125,0.0
285000.0,1,1.0,1060,54846,1.0,3,5,1060,0.0,1935,2258,31762,31843 days 16:47:18.690809,321,1.0,0.0,-1198,23084,1060.0
449000.0,4,2.5,1980,5400,2.0,3,8,1980,0.0,1998,1980,5400,8832 days 16:47:18.690809,295,1.6,0.0,0,0,1980.0
625000.0,4,1.0,1600,5500,1.5,4,7,1600,0.0,1946,1900,5500,27825 days 16:47:18.690809,190,4.0,0.0,-300,0,1600.0
318989.0,4,2.25,2000,9000,1.0,4,8,2000,0.0,1978,2190,8374,16137 days 16:47:18.690809,141,1.7777777777777777,0.0,-190,626,2000.0
445000.0,3,1.5,1310,1266,2.0,3,8,1120,190.0,2002,1310,1378,7371 days 16:47:18.690809,283,2.0,5.894736842105263,0,-112,930.0
750000.0,3,1.0,1120,8549,1.0,3,7,1120,0.0,1952,1440,8640,25634 days 16:47:18.690809,036,3.0,0.0,-320,-91,1120.0
959000.0,3,2.5,3320,11875,1.0,5,1,3320,0.0,1979,3730,11875,15772 days 16:47:18.690809,065,1.2,0.0,-410,0,3320.0
330000.0,3,2.5,2370,9102,2.0,3,9,2370,0.0,1990,2530,9883,11754 days 16:47:18.690809,336,1.2,0.0,-160,-781,2370.0
280000.0,3,1.0,940,7913,1.0,3,6,940,0.0,1948,940,7913,27095 days 16:47:18.690809,336,3.0,0.0,0,0,940.0
556000.0,3,2.25,2020,3600,2.0,3,8,2020,0.0,1998,2070,3699,8832 days 16:47:18.690809,141,1.3333333333333333,0.0,-50,-99,2020.0
1860000.0,4,5.25,5240,320917,2.0,3,1,5240,0.0,2006,1930,68824,5910 days 16:47:18.690809,210,0.7619047619047619,0.0,3310,252093,5240.0
637000.0,4,3.5,4083,68377,2.0,3,1,4083,0.0,2005,2430,41382,6275 days 16:47:18.690809,262,1.1428571428571428,0.0,1653,26995,4083.0
405000.0,3,2.0,1450,6081,1.0,4,7,1450,0.0,1969,1880,6000,19424 days 16:47:18.690809,338,1.5,0.0,-430,81,1450.0
397000.0,5,1.0,1170,6757,1.0,4,6,800,370.0,1944,1590,6794,28556 days 16:47:18.690809,178,5.0,2.1621621621621623,-420,-37,430.0
895990.0,4,2.75,3555,6565,2.0,3,9,3555,0.0,2014,3625,5637,2988 days 16:47:18.690809,205,1.4545454545454546,0.0,-70,928,3555.0
259000.0,3,2.0,1610,14046,2.0,3,7,1610,0.0,1933,2410,9000,32573 days 16:47:18.690809,240,1.5,0.0,-800,5046,1610.0
420000.0,2,1.0,960,112384,1.0,3,7,960,0.0,1955,1210,24875,24538 days 16:47:18.690809,295,2.0,0.0,-250,87509,960.0
518000.0,3,2.5,1680,2096,2.0,3,8,1380,300.0,2008,1360,2096,5180 days 16:47:18.690809,139,1.2,4.6,320,0,1080.0
425000.0,3,1.75,1380,8182,1.0,5,7,1380,0.0,1942,1300,8188,29286 days 16:47:18.690809,203,1.7142857142857142,0.0,80,-6,1380.0
182500.0,2,1.0,1040,13920,1.0,3,6,1040,0.0,1973,1100,7575,17963 days 16:47:18.690809,220,2.0,0.0,-60,6345,1040.0
549900.0,3,1.5,1380,3031,1.5,4,7,1380,0.0,1929,1440,4005,34034 days 16:47:18.690809,197,2.0,0.0,-60,-974,1380.0
445000.0,3,1.75,1850,16863,1.0,4,7,1280,570.0,1980,1790,9000,15407 days 16:47:18.690809,259,1.7142857142857142,2.245614035087719,60,7863,710.0
452000.0,2,1.75,1740,5400,1.0,4,7,990,750.0,1946,1980,5400,27825 days 16:47:18.690809,157,1.1428571428571428,1.32,-240,0,240.0
559000.0,3,2.5,2010,5200,2.0,3,8,2010,0.0,1989,1860,4400,12119 days 16:47:18.690809,254,1.2,0.0,150,800,2010.0
3300000.0,5,6.25,8020,21738,2.0,3,1,8020,0.0,2001,4160,18969,7736 days 16:47:18.690809,183,0.8,0.0,3860,2769,8020.0
250000.0,4,1.75,1860,7350,1.0,4,7,1090,770.0,1977,1710,7350,16502 days 16:47:18.690809,288,2.2857142857142856,1.4155844155844155,150,0,320.0
1230000.0,5,4.0,4390,6656,2.0,3,9,2930,1460.0,2008,1560,6656,5180 days 16:47:18.690809,266,1.25,2.006849315068493,2830,0,1470.0
276500.0,4,2.25,2380,128937,1.0,4,7,2380,0.0,1960,1030,114998,22712 days 16:47:18.690809,132,1.7777777777777777,0.0,1350,13939,2380.0
543200.0,6,2.25,2820,15600,1.5,5,7,1970,850.0,1940,2520,7797,30017 days 16:47:18.690809,128,2.6666666666666665,2.3176470588235296,300,7803,1120.0
250000.0,1,1.0,750,4000,1.0,3,6,750,0.0,1918,1770,4850,38052 days 16:47:18.690809,152,1.0,0.0,-1020,-850,750.0
625000.0,4,2.5,1750,9000,1.0,3,8,1410,340.0,1977,2120,9600,16502 days 16:47:18.690809,209,1.6,4.147058823529412,-370,-600,1070.0
530100.0,3,1.0,1540,3399,1.5,3,7,1200,340.0,1926,1500,3914,35130 days 16:47:18.690809,164,3.0,3.5294117647058822,40,-515,860.0
549900.0,2,1.75,1140,936,2.0,3,8,940,200.0,2014,1160,1327,2988 days 16:47:18.690809,202,1.1428571428571428,4.7,-20,-391,740.0
430000.0,4,1.5,1560,6534,1.0,4,7,1560,0.0,1962,1560,6969,21981 days 16:47:18.690809,070,2.6666666666666665,0.0,0,-435,1560.0
835000.0,3,2.5,2960,6856,2.0,3,1,2960,0.0,2009,3320,6856,4814 days 16:47:18.690809,344,1.2,0.0,-360,0,2960.0
409500.0,4,2.75,2140,13000,1.0,3,7,1320,820.0,1968,2360,11000,19790 days 16:47:18.690809,127,1.4545454545454546,1.6097560975609757,-220,2000,500.0
329000.0,4,2.5,1600,6765,1.0,3,7,830,770.0,1947,1600,8942,27460 days 16:47:18.690809,140,1.6,1.077922077922078,0,-2177,60.0
940000.0,4,2.75,2080,4000,1.5,3,8,2080,0.0,1912,1730,5000,40244 days 16:47:18.690809,142,1.4545454545454546,0.0,350,-1000,2080.0
539950.0,3,2.0,1560,3200,1.5,3,7,1560,0.0,1910,1240,3600,40974 days 16:47:18.690809,225,1.5,0.0,320,-400,1560.0
579950.0,4,2.5,2880,213444,1.0,5,8,2140,740.0,1984,2810,213444,13946 days 16:47:18.690809,104,1.6,2.891891891891892,70,0,1400.0
881000.0,5,3.0,2510,4125,1.5,5,8,1590,920.0,1925,2190,5415,35495 days 16:47:18.690809,162,1.6666666666666667,1.7282608695652173,320,-1290,670.0
362500.0,3,1.0,960,5424,1.5,3,6,960,0.0,1916,1550,5687,38783 days 16:47:18.690809,216,3.0,0.0,-590,-263,960.0
243950.0,2,1.0,1120,35500,1.0,5,6,1120,0.0,1961,1680,66022,22346 days 16:47:18.690809,111,2.0,0.0,-560,-30522,1120.0
658000.0,4,2.75,3310,6166,2.0,3,9,3310,0.0,2008,3200,7027,5180 days 16:47:18.690809,149,1.4545454545454546,0.0,110,-861,3310.0
218250.0,3,1.5,1080,9774,1.0,3,7,1080,0.0,1968,1190,9611,19790 days 16:47:18.690809,328,2.0,0.0,-110,163,1080.0
655000.0,4,2.5,2860,12394,2.0,3,1,2860,0.0,1999,3070,8515,8467 days 16:47:18.690809,142,1.6,0.0,-210,3879,2860.0
255000.0,3,2.0,1490,7599,1.0,3,7,1490,0.0,1990,1560,7710,11754 days 16:47:18.690809,064,1.5,0.0,-70,-111,1490.0
215000.0,3,1.0,1210,7175,1.0,3,7,1210,0.0,1918,1640,5850,38052 days 16:47:18.690809,015,3.0,0.0,-430,1325,1210.0
1270000.0,3,1.75,2240,5657,1.5,4,8,1910,330.0,1941,2970,5657,29651 days 16:47:18.690809,054,1.7142857142857142,5.787878787878788,-730,0,1580.0
2920000.0,4,4.75,4575,24085,2.5,5,1,3905,670.0,1926,3900,9687,35130 days 16:47:18.690809,192,0.8421052631578947,5.8283582089552235,675,14398,3235.0
424305.0,3,2.5,1600,5960,2.0,5,8,1600,0.0,1910,1410,13056,40974 days 16:47:18.690809,092,1.2,0.0,190,-7096,1600.0
560000.0,4,2.5,2260,3713,2.0,3,9,2260,0.0,2003,2260,3713,7006 days 16:47:18.690809,156,1.6,0.0,0,0,2260.0
130000.0,3,1.0,1200,7000,2.0,1,7,1200,0.0,1908,3290,6000,41705 days 16:47:18.690809,267,3.0,0.0,-2090,1000,1200.0
468000.0,4,2.5,2480,176418,1.5,5,8,2480,0.0,1927,1640,112384,34765 days 16:47:18.690809,124,1.6,0.0,840,64034,2480.0
480000.0,5,3.0,2240,15435,1.0,5,7,1390,850.0,1952,2240,10750,25634 days 16:47:18.690809,343,1.6666666666666667,1.6352941176470588,0,4685,540.0
475000.0,3,1.75,1550,4054,1.5,4,7,1550,0.0,1926,1510,3889,35130 days 16:47:18.690809,223,1.7142857142857142,0.0,40,165,1550.0
285000.0,4,1.75,2130,8151,1.0,4,7,1330,800.0,1967,1600,8587,20155 days 16:47:18.690809,056,2.2857142857142856,1.6625,530,-436,530.0
765000.0,5,3.0,2870,5700,1.0,3,7,1950,920.0,1964,1730,5529,21251 days 16:47:18.690809,181,1.6666666666666667,2.119565217391304,1140,171,1030.0
208000.0,2,1.0,1160,5750,1.0,4,6,1160,0.0,1924,1160,8250,35861 days 16:47:18.690809,086,2.0,0.0,0,-2500,1160.0
372000.0,3,2.5,2430,5000,2.0,3,8,2430,0.0,2001,2910,5620,7736 days 16:47:18.690809,276,1.2,0.0,-480,-620,2430.0
470000.0,2,1.0,900,5512,1.0,3,7,900,0.0,1947,1270,5512,27460 days 16:47:18.690809,343,2.0,0.0,-370,0,900.0
451000.0,5,2.75,2830,8925,1.5,3,7,2830,0.0,1967,1700,8539,20155 days 16:47:18.690809,177,1.8181818181818181,0.0,1130,386,2830.0
442200.0,4,1.75,1620,8132,1.0,3,8,1620,0.0,1974,1920,8400,17598 days 16:47:18.690809,239,2.2857142857142856,0.0,-300,-268,1620.0
330000.0,4,2.5,2510,8580,2.0,4,8,2510,0.0,1991,2290,7809,11389 days 16:47:18.690809,237,1.6,0.0,220,771,2510.0
335000.0,3,1.75,1790,5120,1.0,4,6,940,850.0,1949,1160,5120,26729 days 16:47:18.690809,267,1.7142857142857142,1.1058823529411765,630,0,90.0
280000.0,3,2.0,1640,13249,1.0,3,7,1640,0.0,1995,1640,9240,9928 days 16:47:18.690809,318,1.5,0.0,0,4009,1640.0
625000.0,3,1.75,2240,6050,1.0,4,8,1250,990.0,1950,1720,6050,26364 days 16:47:18.690809,234,1.7142857142857142,1.2626262626262625,520,0,260.0
345000.0,3,2.5,1870,3584,2.0,3,8,1870,0.0,2003,1900,3920,7006 days 16:47:18.690809,246,1.2,0.0,-30,-336,1870.0
255950.0,4,1.0,1500,11050,1.0,5,7,1500,0.0,1964,1970,20800,21251 days 16:47:18.690809,297,4.0,0.0,-470,-9750,1500.0
570000.0,4,1.0,1490,6000,1.5,3,7,1490,0.0,1918,1700,6000,38052 days 16:47:18.690809,005,4.0,0.0,-210,0,1490.0
685000.0,3,1.5,2230,8558,2.0,3,8,2230,0.0,1960,2200,8558,22712 days 16:47:18.690809,090,2.0,0.0,30,0,2230.0
273148.0,3,1.75,1710,7210,1.0,4,7,1240,470.0,1974,1840,7245,17598 days 16:47:18.690809,245,1.7142857142857142,2.6382978723404253,-130,-35,770.0
246500.0,3,2.5,1620,7686,2.0,3,7,1620,0.0,1989,1370,7686,12119 days 16:47:18.690809,176,1.2,0.0,250,0,1620.0
349950.0,5,2.5,2250,7176,1.0,3,7,1310,940.0,1983,1550,9081,14311 days 16:47:18.690809,096,2.0,1.3936170212765957,700,-1905,370.0
545000.0,4,2.0,1700,2350,1.0,3,6,850,850.0,1926,1600,4160,35130 days 16:47:18.690809,041,2.0,1.0,100,-1810,0.0
403000.0,3,2.5,1502,1400,3.0,3,7,1502,0.0,2005,1377,1466,6275 days 16:47:18.690809,058,1.2,0.0,125,-66,1502.0
299950.0,4,2.5,1900,4054,2.0,3,7,1900,0.0,2003,2520,4085,7006 days 16:47:18.690809,042,1.6,0.0,-620,-31,1900.0
792000.0,3,2.5,3320,12840,1.0,3,1,2600,720.0,1990,3230,14933,11754 days 16:47:18.690809,121,1.2,3.611111111111111,90,-2093,1880.0
418000.0,5,2.5,1980,10205,1.0,4,7,1080,900.0,1929,1310,5413,34034 days 16:47:18.690809,275,2.0,1.2,670,4792,180.0
332500.0,4,1.0,1670,8102,1.5,3,6,1670,0.0,1944,1310,7906,28556 days 16:47:18.690809,117,4.0,0.0,360,196,1670.0
337000.0,3,2.5,2235,43560,1.0,5,7,990,1245.0,1975,1460,29621,17233 days 16:47:18.690809,027,1.2,0.7951807228915663,775,13939,-255.0
212000.0,2,1.0,1070,7386,1.0,3,6,1070,0.0,1949,1330,6351,26729 days 16:47:18.690809,021,2.0,0.0,-260,1035,1070.0
542000.0,2,2.25,1800,2819,2.0,4,9,1800,0.0,1979,1800,2755,15772 days 16:47:18.690809,069,0.8888888888888888,0.0,0,64,1800.0
622500.0,4,2.5,2980,8107,2.0,3,9,2980,0.0,2000,2750,7760,8102 days 16:47:18.690809,142,1.6,0.0,230,347,2980.0
260000.0,3,1.75,1670,8511,1.0,3,7,1340,330.0,1985,1580,7218,13580 days 16:47:18.690809,241,1.7142857142857142,4.0606060606060606,90,1293,1010.0
525000.0,3,1.75,2620,38350,1.0,4,8,1320,1300.0,1977,2170,36962,16502 days 16:47:18.690809,125,1.7142857142857142,1.0153846153846153,450,1388,20.0
975000.0,5,3.5,5470,35071,2.0,3,1,4590,880.0,1976,3600,35074,16868 days 16:47:18.690809,318,1.4285714285714286,5.215909090909091,1870,-3,3710.0
1140000.0,4,1.75,3080,6500,1.0,4,9,1700,1380.0,1941,2960,5711,29651 days 16:47:18.690809,252,2.2857142857142856,1.2318840579710144,120,789,320.0
500000.0,3,1.0,940,10360,1.0,4,7,940,0.0,1964,2019,10360,21251 days 16:47:18.690809,062,3.0,0.0,-1079,0,940.0
554000.0,5,2.25,1870,11411,1.0,4,8,1170,700.0,1961,2420,10793,22346 days 16:47:18.690809,169,2.2222222222222223,1.6714285714285715,-550,618,470.0
343000.0,4,2.5,2070,4500,2.0,3,7,2070,0.0,2004,2760,5173,6641 days 16:47:18.690809,156,1.6,0.0,-690,-673,2070.0
515000.0,2,1.75,950,15219,1.0,3,8,950,0.0,2009,1560,12416,4814 days 16:47:18.690809,114,1.1428571428571428,0.0,-610,2803,950.0
492000.0,2,1.0,1290,6272,1.0,4,6,890,400.0,1922,1260,5376,36591 days 16:47:18.690809,193,2.0,2.225,30,896,490.0
655000.0,4,3.0,2570,8022,1.0,4,8,1370,1200.0,1984,2090,8022,13946 days 16:47:18.690809,044,1.3333333333333333,1.1416666666666666,480,0,170.0
290000.0,3,2.5,1600,6848,2.0,3,7,1600,0.0,2000,1700,7210,8102 days 16:47:18.690809,126,1.2,0.0,-100,-362,1600.0
952500.0,4,1.5,2550,5055,2.0,4,1,2550,0.0,1910,1970,4431,40974 days 16:47:18.690809,182,2.6666666666666665,0.0,580,624,2550.0
235000.0,2,1.0,1010,7500,1.0,3,7,1010,0.0,1941,1220,6000,29651 days 16:47:18.690809,234,2.0,0.0,-210,1500,1010.0
323000.0,3,1.5,1720,7110,1.0,3,8,1720,0.0,1955,1730,6840,24538 days 16:47:18.690809,091,2.0,0.0,-10,270,1720.0
1050000.0,3,2.5,2200,1970,2.0,3,9,1610,590.0,2008,1890,3505,5180 days 16:47:18.690809,126,1.2,2.7288135593220337,310,-1535,1020.0
200000.0,2,1.0,1400,9600,1.5,4,6,1400,0.0,1941,1230,9600,29651 days 16:47:18.690809,029,2.0,0.0,170,0,1400.0
419995.0,3,2.25,1830,7500,1.0,4,7,1330,500.0,1968,1830,8720,19790 days 16:47:18.690809,338,1.3333333333333333,2.66,0,-1220,830.0
1500000.0,3,3.0,3110,9015,1.0,4,1,1590,1520.0,1980,3150,11447,15407 days 16:47:18.690809,069,1.0,1.0460526315789473,-40,-2432,70.0
455000.0,3,2.5,1600,7829,2.0,3,7,1600,0.0,1987,1580,9104,12850 days 16:47:18.690809,224,1.2,0.0,20,-1275,1600.0
660000.0,3,3.5,3600,37982,2.0,4,8,3600,0.0,1996,2050,18019,9563 days 16:47:18.690809,084,0.8571428571428571,0.0,1550,19963,3600.0
319000.0,3,1.0,1390,12823,1.0,4,7,1390,0.0,1968,1390,10095,19790 days 16:47:18.690809,133,3.0,0.0,0,2728,1390.0
390000.0,3,1.75,2092,250905,1.0,3,7,2092,0.0,1981,2092,217800,15041 days 16:47:18.690809,357,1.7142857142857142,0.0,0,33105,2092.0
718500.0,3,1.5,1200,6240,1.0,3,8,1030,170.0,1952,2810,6240,25634 days 16:47:18.690809,178,2.0,6.0588235294117645,-1610,0,860.0
474000.0,2,1.0,1090,3160,1.0,3,7,840,250.0,1926,1070,3160,35130 days 16:47:18.690809,337,2.0,3.36,20,0,590.0
615750.0,4,2.0,2140,6360,2.0,3,7,1840,300.0,1945,1690,6360,28190 days 16:47:18.690809,237,2.0,6.133333333333334,450,0,1540.0
551000.0,3,2.5,2010,17362,2.0,3,8,2010,0.0,1994,1920,7200,10293 days 16:47:18.690809,318,1.2,0.0,90,10162,2010.0
230000.0,3,2.25,1500,7210,1.0,3,7,1150,350.0,1984,1500,7210,13946 days 16:47:18.690809,042,1.3333333333333333,3.2857142857142856,0,0,800.0
790000.0,4,2.5,3500,9198,2.0,3,9,3500,0.0,2004,3990,8598,6641 days 16:47:18.690809,192,1.6,0.0,-490,600,3500.0
1230000.0,3,2.5,2660,1967,3.0,3,9,1870,790.0,2007,1640,1369,5545 days 16:47:18.690809,085,1.2,2.367088607594937,1020,598,1080.0
325000.0,3,2.25,1440,6443,2.0,3,7,1440,0.0,1995,1700,6749,9928 days 16:47:18.690809,357,1.3333333333333333,0.0,-260,-306,1440.0
705000.0,4,2.75,2780,6207,2.0,3,8,2780,0.0,2001,2660,5592,7736 days 16:47:18.690809,213,1.4545454545454546,0.0,120,615,2780.0
259000.0,4,1.75,1580,8856,2.0,3,7,1580,0.0,1979,1390,9490,15772 days 16:47:18.690809,345,2.2857142857142856,0.0,190,-634,1580.0
306000.0,3,1.5,1250,8700,1.0,4,7,1250,0.0,1959,1300,8700,23077 days 16:47:18.690809,338,2.0,0.0,-50,0,1250.0
315000.0,3,1.0,970,6828,1.0,3,6,970,0.0,1928,1160,11666,34400 days 16:47:18.690809,349,3.0,0.0,-190,-4838,970.0
392500.0,3,1.0,1100,7650,1.0,3,7,1100,0.0,1952,1430,7650,25634 days 16:47:18.690809,103,3.0,0.0,-330,0,1100.0
1070000.0,4,2.25,3240,12930,2.0,4,9,2730,510.0,1968,2610,12884,19790 days 16:47:18.690809,316,1.7777777777777777,5.352941176470588,630,46,2220.0
350500.0,2,2.5,1290,1445,3.0,3,8,1290,0.0,1999,1470,1503,8467 days 16:47:18.690809,197,0.8,0.0,-180,-58,1290.0
825000.0,4,3.5,3810,9792,2.0,3,9,3810,0.0,1938,1950,9792,30747 days 16:47:18.690809,169,1.1428571428571428,0.0,1860,0,3810.0
235000.0,4,1.0,1500,6360,1.5,3,6,1500,0.0,1944,1190,6360,28556 days 16:47:18.690809,220,4.0,0.0,310,0,1500.0
650000.0,3,2.0,2660,257875,1.0,4,8,1530,1130.0,1976,1710,64033,16868 days 16:47:18.690809,061,1.5,1.3539823008849559,950,193842,400.0
675000.0,4,3.0,2400,3340,1.0,4,7,1200,1200.0,1964,1520,3758,21251 days 16:47:18.690809,132,1.3333333333333333,1.0,880,-418,0.0
265000.0,4,1.0,1860,8505,1.0,4,7,1860,0.0,1955,1560,8505,24538 days 16:47:18.690809,274,4.0,0.0,300,0,1860.0
822500.0,2,1.0,1450,7098,1.0,3,7,1450,0.0,1924,2390,6098,35861 days 16:47:18.690809,224,2.0,0.0,-940,1000,1450.0
705000.0,3,2.75,2260,4000,2.0,4,8,1540,720.0,1956,2120,4000,24173 days 16:47:18.690809,118,1.0909090909090908,2.138888888888889,140,0,820.0
2630000.0,6,4.75,5540,7200,2.5,4,1,3950,1590.0,1909,2930,7200,41339 days 16:47:18.690809,342,1.263157894736842,2.4842767295597485,2610,0,2360.0
685000.0,2,1.5,1300,1676,1.0,3,7,1300,0.0,1943,1260,1740,28921 days 16:47:18.690809,174,1.3333333333333333,0.0,40,-64,1300.0
630000.0,4,2.0,1610,5000,2.0,5,7,1610,0.0,1946,1300,4950,27825 days 16:47:18.690809,293,2.0,0.0,310,50,1610.0
1250000.0,4,3.25,3820,24166,2.0,4,1,3310,510.0,1990,2900,18786,11754 days 16:47:18.690809,128,1.2307692307692308,6.490196078431373,920,5380,2800.0
359000.0,4,2.5,1820,11325,1.0,3,8,1390,430.0,1976,1990,10802,16868 days 16:47:18.690809,012,1.6,3.2325581395348837,-170,523,960.0
784500.0,4,5.0,5820,13906,2.0,3,1,3750,2070.0,1993,2980,13000,10658 days 16:47:18.690809,075,0.8,1.8115942028985508,2840,906,1680.0
850000.0,3,2.0,2470,8800,2.0,3,9,2470,0.0,1961,2340,10980,22346 days 16:47:18.690809,184,1.5,0.0,130,-2180,2470.0
410000.0,3,2.5,3040,6054,2.0,3,9,3040,0.0,2005,2650,6054,6275 days 16:47:18.690809,246,1.2,0.0,390,0,3040.0
252000.0,4,1.75,1120,8250,1.0,4,7,1120,0.0,1966,1330,7975,20520 days 16:47:18.690809,190,2.2857142857142856,0.0,-210,275,1120.0
618000.0,5,1.75,1880,18295,1.0,4,7,1880,0.0,1955,2180,20674,24538 days 16:47:18.690809,224,2.857142857142857,0.0,-300,-2379,1880.0
265000.0,3,1.0,1070,4800,1.0,3,6,970,100.0,1947,1120,1198,27460 days 16:47:18.690809,275,3.0,9.7,-50,3602,870.0
465000.0,3,2.0,1560,8509,1.0,3,8,790,770.0,1969,1410,7428,19424 days 16:47:18.690809,261,1.5,1.025974025974026,150,1081,20.0
240000.0,2,1.0,870,6552,1.0,3,6,870,0.0,1947,1500,6678,27460 days 16:47:18.690809,035,2.0,0.0,-630,-126,870.0
217000.0,3,1.0,1000,12000,1.0,3,7,1000,0.0,1959,1490,14940,23077 days 16:47:18.690809,212,3.0,0.0,-490,-2940,1000.0
415000.0,4,2.25,2520,4200,1.5,4,7,1510,1010.0,1909,1460,4200,41339 days 16:47:18.690809,218,1.7777777777777777,1.495049504950495,1060,0,500.0
274000.0,2,2.0,1700,7992,1.0,4,7,950,750.0,1980,1700,8030,15407 days 16:47:18.690809,356,1.0,1.2666666666666666,0,-38,200.0
420000.0,5,3.0,2150,6117,1.0,3,7,1370,780.0,2003,1990,6064,7006 days 16:47:18.690809,054,1.6666666666666667,1.7564102564102564,160,53,590.0
1060000.0,4,2.75,1590,6000,1.5,4,8,1590,0.0,1925,1590,4000,35495 days 16:47:18.690809,077,1.4545454545454546,0.0,0,2000,1590.0
1420000.0,4,5.25,4670,43950,2.0,3,1,4670,0.0,1989,4900,35000,12119 days 16:47:18.690809,156,0.7619047619047619,0.0,-230,8950,4670.0
295000.0,3,1.5,1670,10800,1.0,4,8,1670,0.0,1956,1670,9169,24173 days 16:47:18.690809,009,2.0,0.0,0,1631,1670.0
400000.0,3,2.0,1010,12252,1.0,3,8,1010,0.0,1980,1840,11497,15407 days 16:47:18.690809,075,1.5,0.0,-830,755,1010.0
595000.0,3,2.5,2550,6677,2.0,3,8,2550,0.0,2002,1930,7217,7371 days 16:47:18.690809,085,1.2,0.0,620,-540,2550.0
1730000.0,4,3.0,3700,20570,1.0,4,1,1850,1850.0,1976,3080,17595,16868 days 16:47:18.690809,168,1.3333333333333333,1.0,620,2975,0.0
261000.0,3,1.75,1350,7686,1.0,3,7,1350,0.0,1987,1370,7686,12850 days 16:47:18.690809,365,1.7142857142857142,0.0,-20,0,1350.0
780000.0,5,2.5,1660,4000,1.5,5,8,1660,0.0,1929,1210,4000,34034 days 16:47:18.690809,289,2.0,0.0,450,0,1660.0
589000.0,3,1.5,1390,5040,1.0,3,7,1090,300.0,1947,1910,4800,27460 days 16:47:18.690809,322,2.0,3.6333333333333333,-520,240,790.0
230000.0,3,1.75,1720,9125,1.0,4,7,1140,580.0,1981,1120,7506,15041 days 16:47:18.690809,064,1.7142857142857142,1.9655172413793103,600,1619,560.0
690000.0,4,3.5,2980,2147,2.5,3,1,2490,490.0,2006,2880,2428,5910 days 16:47:18.690809,291,1.1428571428571428,5.081632653061225,100,-281,2000.0
524000.0,4,2.25,2190,15491,2.0,3,8,2190,0.0,1981,2090,15039,15041 days 16:47:18.690809,029,1.7777777777777777,0.0,100,452,2190.0
380000.0,2,2.5,1230,987,2.0,3,7,1060,170.0,2011,1290,1328,4084 days 16:47:18.690809,142,0.8,6.235294117647059,-60,-341,890.0
357500.0,3,1.0,1000,4080,1.0,4,7,740,260.0,1945,1480,4080,28190 days 16:47:18.690809,316,3.0,2.8461538461538463,-480,0,480.0
330000.0,3,2.0,2500,10697,1.0,3,8,2500,0.0,1994,2560,9772,10293 days 16:47:18.690809,300,1.5,0.0,-60,925,2500.0
635000.0,5,1.75,2240,4750,1.0,4,7,1120,1120.0,1920,1980,4750,37322 days 16:47:18.690809,068,2.857142857142857,1.0,260,0,0.0
934000.0,9,3.0,2820,4480,2.0,3,7,1880,940.0,1918,2460,4400,38052 days 16:47:18.690809,072,3.0,2.0,360,80,940.0
401000.0,3,1.5,1470,6867,1.0,3,8,1470,0.0,1955,1470,6523,24538 days 16:47:18.690809,279,2.0,0.0,0,344,1470.0
270000.0,3,2.0,1820,7750,1.0,3,8,1820,0.0,1992,2080,8084,11024 days 16:47:18.690809,009,1.5,0.0,-260,-334,1820.0
705000.0,4,2.0,2060,6000,1.0,4,8,1370,690.0,1954,2060,6600,24903 days 16:47:18.690809,287,2.0,1.9855072463768115,0,-600,680.0
325000.0,3,2.0,1670,17071,1.0,3,7,1100,570.0,1988,1660,15593,12485 days 16:47:18.690809,303,1.5,1.9298245614035088,10,1478,530.0
384950.0,3,1.0,1540,7740,1.0,4,7,1540,0.0,1909,1220,7740,41339 days 16:47:18.690809,245,3.0,0.0,320,0,1540.0
310000.0,3,1.0,1210,9730,1.0,4,7,1210,0.0,1953,1470,9730,25268 days 16:47:18.690809,196,3.0,0.0,-260,0,1210.0
829950.0,4,2.5,3430,42775,2.0,3,1,3430,0.0,1992,3190,36820,11024 days 16:47:18.690809,279,1.6,0.0,240,5955,3430.0
353000.0,3,2.5,2550,6021,2.0,3,7,2550,0.0,2002,2080,6021,7371 days 16:47:18.690809,089,1.2,0.0,470,0,2550.0
170500.0,2,1.0,1060,7700,1.0,3,7,820,240.0,1981,1370,8833,15041 days 16:47:18.690809,188,2.0,3.4166666666666665,-310,-1133,580.0
885250.0,4,2.5,3670,49658,2.0,3,1,3670,0.0,1999,3040,49658,8467 days 16:47:18.690809,197,1.6,0.0,630,0,3670.0
2700000.0,4,3.25,4420,7850,2.0,3,1,3150,1270.0,2001,2760,8525,7736 days 16:47:18.690809,159,1.2307692307692308,2.4803149606299213,1660,-675,1880.0
245000.0,3,1.5,1550,9126,1.0,5,7,1550,0.0,1957,1450,9282,23807 days 16:47:18.690809,268,2.0,0.0,100,-156,1550.0
469000.0,3,2.5,1190,1290,3.0,3,8,1190,0.0,2008,1410,1923,5180 days 16:47:18.690809,290,1.2,0.0,-220,-633,1190.0
455000.0,3,1.0,1300,3550,1.5,3,7,1300,0.0,1927,1410,4080,34765 days 16:47:18.690809,159,3.0,0.0,-110,-530,1300.0
305000.0,4,2.5,2430,5959,2.0,3,8,2430,0.0,2002,2100,5414,7371 days 16:47:18.690809,325,1.6,0.0,330,545,2430.0
840000.0,7,4.5,4290,37607,1.5,5,1,4290,0.0,1982,2810,40510,14676 days 16:47:18.690809,150,1.5555555555555556,0.0,1480,-2903,4290.0
905000.0,5,3.5,3500,10155,2.0,3,1,2570,930.0,1996,2940,10753,9563 days 16:47:18.690809,174,1.4285714285714286,2.763440860215054,560,-598,1640.0
219200.0,3,2.0,1680,7000,1.5,4,7,1680,0.0,1968,1540,7480,19790 days 16:47:18.690809,365,1.5,0.0,140,-480,1680.0
455000.0,3,1.5,1250,8004,1.0,3,7,1250,0.0,1965,1450,7931,20885 days 16:47:18.690809,054,2.0,0.0,-200,73,1250.0
195000.0,2,1.0,1020,8100,1.0,3,6,1020,0.0,1940,1200,12500,30017 days 16:47:18.690809,178,2.0,0.0,-180,-4400,1020.0
799000.0,3,1.0,1510,4178,2.0,3,8,1510,0.0,1902,2140,4916,43896 days 16:47:18.690809,317,3.0,0.0,-630,-738,1510.0
285000.0,2,1.0,910,8155,1.0,4,6,910,0.0,1948,1240,8155,27095 days 16:47:18.690809,178,2.0,0.0,-330,0,910.0
300000.0,3,1.5,1320,15053,1.0,3,7,1320,0.0,1979,1250,13368,15772 days 16:47:18.690809,265,2.0,0.0,70,1685,1320.0
83000.0,2,1.0,900,8580,1.0,3,5,900,0.0,1918,2060,6533,38052 days 16:47:18.690809,149,2.0,0.0,-1160,2047,900.0
220000.0,2,1.0,890,4804,1.0,4,7,890,0.0,1928,1010,3844,34400 days 16:47:18.690809,104,2.0,0.0,-120,960,890.0
174500.0,2,2.5,1240,2689,2.0,3,7,1240,0.0,1986,1430,3609,13215 days 16:47:18.690809,154,0.8,0.0,-190,-920,1240.0
695000.0,4,2.5,2960,10760,2.0,3,9,2960,0.0,1987,2480,9528,12850 days 16:47:18.690809,117,1.6,0.0,480,1232,2960.0
255000.0,3,1.5,1020,11410,1.0,3,7,1020,0.0,1959,1290,8400,23077 days 16:47:18.690809,338,2.0,0.0,-270,3010,1020.0
539000.0,5,2.25,2590,7245,1.0,3,8,1510,1080.0,1973,1930,7245,17963 days 16:47:18.690809,056,2.2222222222222223,1.3981481481481481,660,0,430.0
552700.0,2,1.0,1100,2800,1.0,3,7,1100,0.0,1925,1110,1673,35495 days 16:47:18.690809,076,2.0,0.0,-10,1127,1100.0
571500.0,3,1.0,1300,6710,1.0,4,6,1300,0.0,1952,1630,9946,25634 days 16:47:18.690809,154,3.0,0.0,-330,-3236,1300.0
263700.0,3,1.0,1200,6561,1.0,3,6,1200,0.0,1950,1340,9450,26364 days 16:47:18.690809,072,3.0,0.0,-140,-2889,1200.0
3300000.0,8,4.0,7710,11750,3.5,5,1,6090,1620.0,1904,4210,8325,43166 days 16:47:18.690809,293,2.0,3.759259259259259,3500,3425,4470.0
186950.0,2,2.0,1390,1302,2.0,3,7,1390,0.0,1986,1390,1302,13215 days 16:47:18.690809,148,1.0,0.0,0,0,1390.0
520000.0,3,1.75,1430,53628,2.0,3,8,1430,0.0,1985,2100,53628,13580 days 16:47:18.690809,314,1.7142857142857142,0.0,-670,0,1430.0
210000.0,2,0.75,840,49658,1.0,2,6,840,0.0,1948,1240,11000,27095 days 16:47:18.690809,219,2.6666666666666665,0.0,-400,38658,840.0
3650000.0,5,3.75,5020,8694,2.0,3,1,3970,1050.0,2007,4190,11275,5545 days 16:47:18.690809,131,1.3333333333333333,3.780952380952381,830,-2581,2920.0
543000.0,4,2.25,2060,8767,2.0,3,8,2060,0.0,1983,1610,8062,14311 days 16:47:18.690809,223,1.7777777777777777,0.0,450,705,2060.0
330000.0,4,2.25,2000,10679,1.0,3,7,1350,650.0,1960,1650,8875,22712 days 16:47:18.690809,113,1.7777777777777777,2.076923076923077,350,1804,700.0
529000.0,3,2.0,1530,3400,1.0,3,7,990,540.0,1907,1880,4212,42070 days 16:47:18.690809,218,1.5,1.8333333333333333,-350,-812,450.0
295000.0,1,1.0,700,2500,1.0,4,7,700,0.0,1907,1340,5000,42070 days 16:47:18.690809,178,1.0,0.0,-640,-2500,700.0
365000.0,3,1.0,950,8450,1.0,3,7,950,0.0,1962,1610,10080,21981 days 16:47:18.690809,265,3.0,0.0,-660,-1630,950.0
473000.0,3,3.0,1380,1081,3.0,3,8,1380,0.0,2005,1390,1140,6275 days 16:47:18.690809,288,1.0,0.0,-10,-59,1380.0
403500.0,3,1.0,1830,8004,1.0,3,8,1200,630.0,1960,1860,7971,22712 days 16:47:18.690809,174,3.0,1.9047619047619047,-30,33,570.0
544000.0,3,1.5,1790,8203,1.5,3,7,1790,0.0,1910,1960,6047,40974 days 16:47:18.690809,153,2.0,0.0,-170,2156,1790.0
621000.0,3,1.0,1340,4000,1.5,4,7,1340,0.0,1927,1510,4000,34765 days 16:47:18.690809,296,3.0,0.0,-170,0,1340.0
672600.0,3,2.25,1520,5750,2.0,3,8,1400,120.0,1908,1420,5650,41705 days 16:47:18.690809,213,1.3333333333333333,11.666666666666666,100,100,1280.0
689800.0,2,1.75,1370,3125,1.0,3,7,1090,280.0,1950,1730,5966,26364 days 16:47:18.690809,097,1.1428571428571428,3.892857142857143,-360,-2841,810.0
613000.0,3,1.5,1470,4480,1.0,4,7,1130,340.0,1918,2120,4480,38052 days 16:47:18.690809,127,2.0,3.323529411764706,-650,0,790.0
808000.0,4,2.25,2500,8866,2.0,4,9,2500,0.0,1987,2630,8847,12850 days 16:47:18.690809,182,1.7777777777777777,0.0,-130,19,2500.0
301000.0,3,1.0,1060,9241,1.0,4,7,1060,0.0,1956,1900,6484,24173 days 16:47:18.690809,206,3.0,0.0,-840,2757,1060.0
340000.0,3,1.75,1210,9635,1.0,4,7,1210,0.0,1987,1550,10707,12850 days 16:47:18.690809,268,1.7142857142857142,0.0,-340,-1072,1210.0
206000.0,3,1.0,920,8400,1.0,3,7,920,0.0,1963,1260,8400,21616 days 16:47:18.690809,357,3.0,0.0,-340,0,920.0
550000.0,3,1.5,1340,6000,1.0,4,7,1340,0.0,1960,1590,9000,22712 days 16:47:18.690809,307,2.0,0.0,-250,-3000,1340.0
325000.0,2,1.0,960,4800,1.5,2,6,960,0.0,1912,1440,4800,40244 days 16:47:18.690809,358,2.0,0.0,-480,0,960.0
475000.0,3,2.5,1630,7586,2.0,3,8,1630,0.0,1986,2090,7330,13215 days 16:47:18.690809,285,1.2,0.0,-460,256,1630.0
432100.0,3,1.75,1840,7350,1.0,3,8,1310,530.0,1976,1860,7000,16868 days 16:47:18.690809,211,1.7142857142857142,2.4716981132075473,-20,350,780.0
359000.0,3,2.0,3085,7280,1.0,4,7,1560,1525.0,1959,1480,7900,23077 days 16:47:18.690809,062,1.5,1.022950819672131,1605,-620,35.0
490000.0,3,1.0,920,4800,1.0,4,6,780,140.0,1926,1370,4800,35130 days 16:47:18.690809,005,3.0,5.571428571428571,-450,0,640.0
648360.0,4,1.75,2260,7005,1.0,4,7,1130,1130.0,1947,2330,9180,27460 days 16:47:18.690809,142,2.2857142857142856,1.0,-70,-2175,0.0
340000.0,3,1.75,1730,11986,1.0,5,6,1730,0.0,1918,2490,9264,38052 days 16:47:18.690809,280,1.7142857142857142,0.0,-760,2722,1730.0
545000.0,3,2.0,1610,8069,1.0,5,7,1090,520.0,1955,1510,8803,24538 days 16:47:18.690809,093,1.5,2.0961538461538463,100,-734,570.0
115000.0,2,0.75,550,7980,1.0,3,5,550,0.0,1952,1330,7980,25634 days 16:47:18.690809,196,2.6666666666666665,0.0,-780,0,550.0
705640.0,3,2.25,2400,12350,1.0,4,8,1420,980.0,1968,2615,12043,19790 days 16:47:18.690809,050,1.3333333333333333,1.4489795918367347,-215,307,440.0
300000.0,3,2.25,1960,1585,2.0,3,7,1750,210.0,2003,1760,1958,7006 days 16:47:18.690809,211,1.3333333333333333,8.333333333333334,200,-373,1540.0
1650000.0,4,2.75,3190,14904,1.0,4,9,1940,1250.0,1949,2600,11195,26729 days 16:47:18.690809,212,1.4545454545454546,1.552,590,3709,690.0
1140000.0,4,3.5,3160,4200,2.0,3,8,2180,980.0,1999,2180,5200,8467 days 16:47:18.690809,107,1.1428571428571428,2.2244897959183674,980,-1000,1200.0
280000.0,3,1.75,1550,7410,1.5,5,7,1550,0.0,1944,1250,7467,28556 days 16:47:18.690809,230,1.7142857142857142,0.0,300,-57,1550.0
245000.0,4,1.75,1930,7650,1.0,4,8,1280,650.0,1981,1860,8800,15041 days 16:47:18.690809,353,2.2857142857142856,1.9692307692307693,70,-1150,630.0
564000.0,4,1.0,1170,4590,1.5,4,7,1170,0.0,1925,1430,4080,35495 days 16:47:18.690809,303,4.0,0.0,-260,510,1170.0
849000.0,3,1.75,2520,4534,1.0,5,9,1460,1060.0,1954,1870,5023,24903 days 16:47:18.690809,262,1.7142857142857142,1.3773584905660377,650,-489,400.0
698000.0,3,1.75,1220,7447,1.0,4,7,1220,0.0,1964,1340,7200,21251 days 16:47:18.690809,099,1.7142857142857142,0.0,-120,247,1220.0
319000.0,3,1.0,960,8556,1.0,3,7,960,0.0,1971,1320,7528,18694 days 16:47:18.690809,268,3.0,0.0,-360,1028,960.0
1450000.0,3,3.5,4110,15720,1.0,3,1,2230,1880.0,2000,2500,15400,8102 days 16:47:18.690809,055,0.8571428571428571,1.1861702127659575,1610,320,350.0
695000.0,4,3.5,3310,21050,2.0,5,9,2400,910.0,1992,2260,23400,11024 days 16:47:18.690809,191,1.1428571428571428,2.6373626373626373,1050,-2350,1490.0
680000.0,4,2.75,2220,5310,1.0,5,7,1170,1050.0,1951,1540,4200,25999 days 16:47:18.690809,089,1.4545454545454546,1.1142857142857143,680,1110,120.0
287500.0,4,2.25,2250,12000,2.0,3,8,2250,0.0,1985,2140,11871,13580 days 16:47:18.690809,300,1.7777777777777777,0.0,110,129,2250.0
465000.0,3,3.25,1510,1850,2.0,3,8,1230,280.0,2001,1540,1840,7736 days 16:47:18.690809,316,0.9230769230769231,4.392857142857143,-30,10,950.0
335000.0,3,1.0,1350,14212,1.0,4,6,1350,0.0,1981,1520,14404,15041 days 16:47:18.690809,268,3.0,0.0,-170,-192,1350.0
602000.0,4,1.75,2420,37800,1.0,4,8,1880,540.0,1981,2780,35532,15041 days 16:47:18.690809,178,2.2857142857142856,3.4814814814814814,-360,2268,1340.0
482000.0,3,2.5,2950,6545,2.0,3,8,2950,0.0,2003,2400,6550,7006 days 16:47:18.690809,056,1.2,0.0,550,-5,2950.0
220000.0,5,1.0,1260,8382,1.5,3,7,1260,0.0,1918,910,8382,38052 days 16:47:18.690809,252,5.0,0.0,350,0,1260.0
206000.0,4,2.0,1700,6025,1.0,3,6,1700,0.0,1978,1320,5956,16137 days 16:47:18.690809,140,2.0,0.0,380,69,1700.0
1100000.0,4,3.0,3320,5760,2.0,3,9,2120,1200.0,1954,2400,6144,24903 days 16:47:18.690809,083,1.3333333333333333,1.7666666666666666,920,-384,920.0
491150.0,3,2.5,1470,3971,2.0,3,7,1470,0.0,2003,1650,3148,7006 days 16:47:18.690809,079,1.2,0.0,-180,823,1470.0
390000.0,4,2.75,2500,12848,1.0,3,8,2120,380.0,1975,2370,12497,17233 days 16:47:18.690809,224,1.4545454545454546,5.578947368421052,130,351,1740.0
393000.0,4,2.5,2641,8091,2.0,3,7,2641,0.0,1998,2641,8535,8832 days 16:47:18.690809,127,1.6,0.0,0,-444,2641.0
635000.0,4,2.0,2260,8457,2.0,3,9,2260,0.0,1992,2410,7713,11024 days 16:47:18.690809,198,2.0,0.0,-150,744,2260.0
490000.0,2,1.0,1160,5000,1.0,4,8,1160,0.0,1937,1750,5000,31112 days 16:47:18.690809,136,2.0,0.0,-590,0,1160.0
770000.0,4,3.5,3680,2242,2.5,3,9,2670,1010.0,1930,1350,1288,33669 days 16:47:18.690809,268,1.1428571428571428,2.6435643564356437,2330,954,1660.0
665000.0,2,2.0,1615,4590,1.5,5,8,1615,0.0,1906,1470,4590,42435 days 16:47:18.690809,338,1.0,0.0,145,0,1615.0
287000.0,3,1.0,1250,26862,1.0,3,7,1250,0.0,1965,1530,24463,20885 days 16:47:18.690809,274,3.0,0.0,-280,2399,1250.0
410000.0,3,1.0,1230,7020,1.0,3,7,1090,140.0,1924,1390,5850,35861 days 16:47:18.690809,294,3.0,7.785714285714286,-160,1170,950.0
562000.0,3,2.0,2510,5200,1.0,5,8,1470,1040.0,1925,990,5400,35495 days 16:47:18.690809,056,1.5,1.4134615384615385,1520,-200,430.0
475000.0,2,2.0,1540,54450,2.0,3,7,1540,0.0,1983,2280,29918,14311 days 16:47:18.690809,150,1.0,0.0,-740,24532,1540.0
387500.0,3,3.25,1860,2218,3.0,3,8,1860,0.0,2001,1860,2218,7736 days 16:47:18.690809,287,0.9230769230769231,0.0,0,0,1860.0
580000.0,5,2.0,2700,10875,1.0,4,7,1540,1160.0,1962,2040,7464,21981 days 16:47:18.690809,168,2.5,1.3275862068965518,660,3411,380.0
930000.0,3,2.5,3290,6830,2.0,3,1,3290,0.0,2000,3200,6227,8102 days 16:47:18.690809,172,1.2,0.0,90,603,3290.0
625000.0,3,1.75,2700,18893,1.0,4,7,2110,590.0,1948,2260,17494,27095 days 16:47:18.690809,044,1.7142857142857142,3.5762711864406778,440,1399,1520.0
325000.0,3,2.0,1570,5600,1.0,3,8,1570,0.0,1999,2010,5600,8467 days 16:47:18.690809,337,1.5,0.0,-440,0,1570.0
235000.0,3,1.75,1950,8712,1.0,3,7,1950,0.0,1960,1820,11520,22712 days 16:47:18.690809,178,1.7142857142857142,0.0,130,-2808,1950.0
450000.0,2,1.0,1380,4390,1.0,4,8,880,500.0,1931,1390,5234,33304 days 16:47:18.690809,176,2.0,1.76,-10,-844,380.0
745000.0,4,2.75,2410,5650,1.5,5,8,2070,340.0,1909,1960,5650,41339 days 16:47:18.690809,071,1.4545454545454546,6.088235294117647,450,0,1730.0
223000.0,4,2.0,1200,8470,1.0,4,7,1200,0.0,1961,1110,8400,22346 days 16:47:18.690809,204,2.0,0.0,90,70,1200.0
630000.0,4,1.75,1770,12278,1.0,3,7,1350,420.0,1937,1670,9336,31112 days 16:47:18.690809,209,2.2857142857142856,3.2142857142857144,100,2942,930.0
413450.0,3,2.5,1540,1614,3.0,3,8,1470,70.0,2008,1540,1418,5180 days 16:47:18.690809,128,1.2,21.0,0,196,1400.0
720000.0,5,2.75,2860,5379,2.0,3,9,2860,0.0,2005,2980,6018,6275 days 16:47:18.690809,223,1.8181818181818181,0.0,-120,-639,2860.0
339000.0,3,1.5,1740,21980,1.0,4,7,1740,0.0,1973,1400,16100,17963 days 16:47:18.690809,106,2.0,0.0,340,5880,1740.0
1120000.0,4,3.5,2830,4000,1.5,3,7,1840,990.0,1919,2340,4000,37687 days 16:47:18.690809,125,1.1428571428571428,1.8585858585858586,490,0,850.0
839000.0,5,4.0,4280,11307,2.0,3,1,2710,1570.0,1996,3080,11307,9563 days 16:47:18.690809,223,1.25,1.7261146496815287,1200,0,1140.0
2950000.0,4,3.25,3890,25470,2.0,5,1,3030,860.0,1923,4140,19281,36226 days 16:47:18.690809,245,1.2307692307692308,3.5232558139534884,-250,6189,2170.0
568000.0,4,2.0,2340,50233,1.0,4,7,1170,1170.0,1966,2470,62290,20520 days 16:47:18.690809,150,2.0,1.0,-130,-12057,0.0
269000.0,3,2.0,1410,10577,1.0,3,7,1410,0.0,1994,1660,6757,10293 days 16:47:18.690809,096,1.5,0.0,-250,3820,1410.0
382000.0,2,2.0,1350,2560,1.0,4,8,1350,0.0,1974,1800,2560,17598 days 16:47:18.690809,096,1.0,0.0,-450,0,1350.0
574000.0,2,2.25,1100,1114,2.0,3,8,900,200.0,2009,1230,1800,4814 days 16:47:18.690809,103,0.8888888888888888,4.5,-130,-686,700.0
405000.0,3,2.5,2070,4697,2.0,3,7,2070,0.0,2002,2230,4437,7371 days 16:47:18.690809,265,1.2,0.0,-160,260,2070.0
572000.0,3,2.5,2360,9938,1.0,3,8,1690,670.0,1987,2280,9626,12850 days 16:47:18.690809,209,1.2,2.5223880597014925,80,312,1020.0
675000.0,4,2.25,2760,12100,2.0,4,9,2760,0.0,1976,2850,12410,16868 days 16:47:18.690809,339,1.7777777777777777,0.0,-90,-310,2760.0
165000.0,4,1.0,1220,7980,1.5,3,6,1220,0.0,1944,1210,7920,28556 days 16:47:18.690809,245,4.0,0.0,10,60,1220.0
260000.0,4,1.0,1220,7980,1.5,3,6,1220,0.0,1944,1210,7920,28556 days 16:47:18.690809,063,4.0,0.0,10,60,1220.0
196000.0,3,1.0,1220,6719,1.0,3,6,1220,0.0,1953,1580,7200,25268 days 16:47:18.690809,063,3.0,0.0,-360,-481,1220.0
515000.0,3,2.5,3020,12184,2.0,3,8,3020,0.0,2003,2980,10029,7006 days 16:47:18.690809,055,1.2,0.0,40,2155,3020.0
810000.0,4,3.5,3470,7396,2.0,3,8,2520,950.0,1979,2360,10541,15772 days 16:47:18.690809,337,1.1428571428571428,2.6526315789473682,1110,-3145,1570.0
365650.0,4,2.25,2380,7700,2.0,4,8,2380,0.0,1977,2100,7700,16502 days 16:47:18.690809,070,1.7777777777777777,0.0,280,0,2380.0
651000.0,3,3.0,2260,1834,2.0,3,8,1660,600.0,2002,2260,1834,7371 days 16:47:18.690809,209,1.0,2.7666666666666666,0,0,1060.0
240000.0,2,1.0,720,6345,1.0,3,6,720,0.0,1943,720,6345,28921 days 16:47:18.690809,282,2.0,0.0,0,0,720.0
299000.0,3,2.0,1730,6007,1.0,3,8,1730,0.0,2004,2000,6245,6641 days 16:47:18.690809,302,1.5,0.0,-270,-238,1730.0
768000.0,3,2.5,2660,10928,2.0,3,9,1830,830.0,1988,2800,10025,12485 days 16:47:18.690809,216,1.2,2.2048192771084336,-140,903,1000.0
397380.0,2,1.0,1030,5072,1.0,3,6,1030,0.0,1924,1220,6781,35861 days 16:47:18.690809,301,2.0,0.0,-190,-1709,1030.0
476000.0,4,3.0,2890,6885,1.0,3,7,1590,1300.0,1945,2180,6885,28190 days 16:47:18.690809,182,1.3333333333333333,1.2230769230769232,710,0,290.0
315000.0,3,1.0,890,5200,1.0,3,7,890,0.0,1957,1420,6000,23807 days 16:47:18.690809,006,3.0,0.0,-530,-800,890.0
240000.0,3,2.25,1410,7290,1.0,3,7,940,470.0,1980,1550,7375,15407 days 16:47:18.690809,269,1.3333333333333333,2.0,-140,-85,470.0
325000.0,2,1.0,810,4080,1.0,4,6,810,0.0,1941,1400,4080,29651 days 16:47:18.690809,189,2.0,0.0,-590,0,810.0
160000.0,3,1.75,1370,8006,2.0,3,7,1370,0.0,1990,1530,8006,11754 days 16:47:18.690809,281,1.7142857142857142,0.0,-160,0,1370.0
435000.0,3,2.5,2260,5100,2.0,3,8,2260,0.0,2007,2260,5100,5545 days 16:47:18.690809,009,1.2,0.0,0,0,2260.0
427500.0,3,1.75,1430,16200,1.0,4,7,1430,0.0,1967,1690,13125,20155 days 16:47:18.690809,100,1.7142857142857142,0.0,-260,3075,1430.0
450000.0,5,2.5,2510,10240,1.0,4,8,1410,1100.0,1984,2170,10500,13946 days 16:47:18.690809,107,2.0,1.2818181818181817,340,-260,310.0
688000.0,3,1.5,1760,4880,1.5,3,8,1290,470.0,1928,1840,4998,34400 days 16:47:18.690809,262,2.0,2.74468085106383,-80,-118,820.0
285000.0,4,1.0,1430,3600,1.0,3,6,980,450.0,1947,1170,4000,27460 days 16:47:18.690809,098,4.0,2.1777777777777776,260,-400,530.0
530000.0,3,3.25,1510,1125,3.0,3,8,1510,0.0,2006,1390,1174,5910 days 16:47:18.690809,232,0.9230769230769231,0.0,120,-49,1510.0
195000.0,4,1.75,1320,7694,1.0,3,7,1320,0.0,1928,1620,8468,34400 days 16:47:18.690809,092,2.2857142857142856,0.0,-300,-774,1320.0
250200.0,3,1.5,1180,7384,1.0,5,7,1180,0.0,1959,1150,7455,23077 days 16:47:18.690809,240,2.0,0.0,30,-71,1180.0
1100000.0,3,2.25,1560,8570,1.0,5,7,1080,480.0,1977,2660,9621,16502 days 16:47:18.690809,028,1.3333333333333333,2.25,-1100,-1051,600.0
732500.0,3,2.5,2470,10321,2.0,3,9,2470,0.0,1988,2450,8440,12485 days 16:47:18.690809,316,1.2,0.0,20,1881,2470.0
194250.0,3,2.25,2190,8834,1.0,3,7,1390,800.0,1987,1490,8766,12850 days 16:47:18.690809,303,1.3333333333333333,1.7375,700,68,590.0
526000.0,4,2.0,1610,8000,1.0,3,7,1190,420.0,1966,1560,7896,20520 days 16:47:18.690809,068,2.0,2.8333333333333335,50,104,770.0
520000.0,4,2.75,2700,9882,2.0,3,7,2700,0.0,1958,2250,10797,23442 days 16:47:18.690809,124,1.4545454545454546,0.0,450,-915,2700.0
526000.0,3,1.75,1530,6125,1.0,3,7,1120,410.0,1958,1360,6125,23442 days 16:47:18.690809,317,1.7142857142857142,2.731707317073171,170,0,710.0
1140000.0,5,4.0,7320,217800,2.0,3,1,7320,0.0,1992,3270,34500,11024 days 16:47:18.690809,189,1.25,0.0,4050,183300,7320.0
645500.0,4,2.5,2990,8622,2.0,3,9,2990,0.0,2000,2980,8622,8102 days 16:47:18.690809,316,1.6,0.0,10,0,2990.0
570000.0,1,1.0,720,7540,1.0,4,6,720,0.0,1905,1120,9736,42800 days 16:47:18.690809,112,1.0,0.0,-400,-2196,720.0
325000.0,3,2.0,1750,9000,1.5,4,5,1750,0.0,1936,1830,8100,31478 days 16:47:18.690809,079,1.5,0.0,-80,900,1750.0
725000.0,2,1.0,2410,5930,2.0,3,9,1930,480.0,2007,1540,5892,5545 days 16:47:18.690809,350,2.0,4.020833333333333,870,38,1450.0
192000.0,3,1.75,1240,10361,1.0,3,6,1240,0.0,1987,1240,8834,12850 days 16:47:18.690809,330,1.7142857142857142,0.0,0,1527,1240.0
560000.0,2,1.0,1010,9219,1.0,4,7,1010,0.0,1960,1610,9219,22712 days 16:47:18.690809,190,2.0,0.0,-600,0,1010.0
283450.0,5,2.75,2770,6116,1.0,3,7,1490,1280.0,1979,1920,6486,15772 days 16:47:18.690809,335,1.8181818181818181,1.1640625,850,-370,210.0
863000.0,4,1.75,2800,5400,1.0,3,9,1400,1400.0,1924,1490,5400,35861 days 16:47:18.690809,248,2.2857142857142856,1.0,1310,0,0.0
815000.0,4,2.0,1400,4800,2.0,3,7,1400,0.0,1986,1620,2595,13215 days 16:47:18.690809,301,2.0,0.0,-220,2205,1400.0
245000.0,2,1.0,1020,7679,1.0,5,6,1020,0.0,1942,1280,6497,29286 days 16:47:18.690809,106,2.0,0.0,-260,1182,1020.0
1320000.0,4,3.0,2860,10292,1.0,4,8,2860,0.0,1953,1840,10273,25268 days 16:47:18.690809,342,1.3333333333333333,0.0,1020,19,2860.0
1160000.0,4,3.5,4270,12305,2.0,3,1,4270,0.0,1994,4190,13137,10293 days 16:47:18.690809,311,1.1428571428571428,0.0,80,-832,4270.0
480000.0,3,2.5,2270,4488,2.0,3,7,2270,0.0,1999,2360,4427,8467 days 16:47:18.690809,246,1.2,0.0,-90,61,2270.0
600000.0,4,2.5,2560,5593,2.0,3,7,2560,0.0,2001,2800,5890,7736 days 16:47:18.690809,157,1.6,0.0,-240,-297,2560.0
329950.0,2,1.0,900,5220,1.0,4,6,900,0.0,1956,1480,6660,24173 days 16:47:18.690809,175,2.0,0.0,-580,-1440,900.0
299500.0,4,2.5,2010,12085,2.0,3,8,2010,0.0,1986,1910,12133,13215 days 16:47:18.690809,234,1.6,0.0,100,-48,2010.0
460000.0,3,2.5,1690,5131,1.0,3,7,1690,0.0,1941,860,5137,29651 days 16:47:18.690809,261,1.2,0.0,830,-6,1690.0
515000.0,5,3.5,2310,5249,2.0,3,8,1560,750.0,2000,1900,7296,8102 days 16:47:18.690809,105,1.4285714285714286,2.08,410,-2047,810.0
405000.0,3,2.25,1520,1245,3.0,3,8,1520,0.0,2004,1520,1470,6641 days 16:47:18.690809,174,1.3333333333333333,0.0,0,-225,1520.0
483000.0,4,1.5,1220,3780,1.5,3,7,1220,0.0,1927,1400,3185,34765 days 16:47:18.690809,300,2.6666666666666665,0.0,-180,595,1220.0
377000.0,4,2.5,2170,11511,2.0,3,8,2170,0.0,1992,1900,8961,11024 days 16:47:18.690809,034,1.6,0.0,270,2550,2170.0
568000.0,4,1.75,2790,17476,1.0,3,7,1450,1340.0,1956,2790,16401,24173 days 16:47:18.690809,189,2.2857142857142856,1.0820895522388059,0,1075,110.0
355000.0,2,1.75,1760,4600,1.0,4,7,850,910.0,1926,1150,4800,35130 days 16:47:18.690809,309,1.1428571428571428,0.9340659340659341,610,-200,-60.0
640000.0,4,1.75,2100,3000,1.5,4,7,1500,600.0,1911,1690,4000,40609 days 16:47:18.690809,218,2.2857142857142856,2.5,410,-1000,900.0
270000.0,4,1.0,1430,5909,1.0,3,6,1070,360.0,1947,1460,8433,27460 days 16:47:18.690809,021,4.0,2.9722222222222223,-30,-2524,710.0
559950.0,5,3.5,2450,8193,2.0,3,9,2450,0.0,2005,2310,8193,6275 days 16:47:18.690809,014,1.4285714285714286,0.0,140,0,2450.0
515000.0,4,3.0,1820,8261,1.0,3,7,1420,400.0,1969,1920,7961,19424 days 16:47:18.690809,287,1.3333333333333333,3.55,-100,300,1020.0
352000.0,4,1.75,1850,5712,1.0,3,7,1850,0.0,1954,1510,6038,24903 days 16:47:18.690809,238,2.2857142857142856,0.0,340,-326,1850.0
595888.0,3,1.75,1870,9000,1.0,5,9,1870,0.0,1958,2030,8160,23442 days 16:47:18.690809,176,1.7142857142857142,0.0,-160,840,1870.0
588000.0,4,2.25,2580,7344,2.0,3,8,2580,0.0,1977,2390,7507,16502 days 16:47:18.690809,203,1.7777777777777777,0.0,190,-163,2580.0
1050000.0,4,3.25,3680,8580,1.0,5,1,1840,1840.0,1959,2700,9100,23077 days 16:47:18.690809,022,1.2307692307692308,1.0,980,-520,0.0
260000.0,3,1.5,1750,7000,2.0,3,8,1750,0.0,1983,1840,9305,14311 days 16:47:18.690809,251,2.0,0.0,-90,-2305,1750.0
1600000.0,4,3.5,3890,3600,2.0,3,9,2860,1030.0,2005,2460,6050,6275 days 16:47:18.690809,048,1.1428571428571428,2.7766990291262137,1430,-2450,1830.0
380000.0,2,1.0,1000,4800,1.0,3,6,1000,0.0,1952,1000,4800,25634 days 16:47:18.690809,104,2.0,0.0,0,0,1000.0
802000.0,2,2.5,2210,6327,1.0,3,8,2210,0.0,2003,2170,6327,7006 days 16:47:18.690809,153,0.8,0.0,40,0,2210.0
710000.0,4,2.75,2460,3600,2.0,3,8,1640,820.0,1907,1890,3600,42070 days 16:47:18.690809,106,1.4545454545454546,2.0,570,0,820.0
600000.0,3,2.5,2630,77972,2.0,3,9,2630,0.0,2004,2250,75794,6641 days 16:47:18.690809,160,1.2,0.0,380,2178,2630.0
707900.0,3,1.0,1750,5355,2.0,4,7,1750,0.0,1929,2240,4590,34034 days 16:47:18.690809,245,3.0,0.0,-490,765,1750.0
179950.0,2,1.0,1100,7323,1.0,3,7,780,320.0,1982,1410,7227,14676 days 16:47:18.690809,324,2.0,2.4375,-310,96,460.0
683000.0,4,2.5,2620,10489,2.0,3,9,2620,0.0,1990,2430,7701,11754 days 16:47:18.690809,257,1.6,0.0,190,2788,2620.0
222400.0,3,2.0,1200,9566,1.0,3,7,1200,0.0,1995,1590,9518,9928 days 16:47:18.690809,154,1.5,0.0,-390,48,1200.0
517000.0,2,1.5,1920,3408,1.0,4,7,960,960.0,1912,1130,3408,40244 days 16:47:18.690809,189,1.3333333333333333,1.0,790,0,0.0
410000.0,3,2.75,1690,5763,1.0,5,7,1180,510.0,1985,1560,7518,13580 days 16:47:18.690809,302,1.0909090909090908,2.3137254901960786,130,-1755,670.0
480000.0,3,1.75,1680,2552,1.0,4,7,840,840.0,1952,1220,3880,25634 days 16:47:18.690809,279,1.7142857142857142,1.0,460,-1328,0.0
430000.0,3,1.75,3440,10428,1.5,5,8,3440,0.0,1974,2160,8400,17598 days 16:47:18.690809,055,1.7142857142857142,0.0,1280,2028,3440.0
439950.0,5,1.75,2190,7500,1.0,3,7,1290,900.0,1979,1790,8820,15772 days 16:47:18.690809,117,2.857142857142857,1.4333333333333333,400,-1320,390.0
797500.0,4,2.5,3270,8223,2.0,3,1,3270,0.0,1998,3460,8872,8832 days 16:47:18.690809,111,1.6,0.0,-190,-649,3270.0
379000.0,4,1.5,1280,5460,1.5,5,7,1080,200.0,1920,1470,5934,37322 days 16:47:18.690809,191,2.6666666666666665,5.4,-190,-474,880.0
575000.0,1,1.0,1310,8667,1.5,1,6,1310,0.0,1918,1130,4800,38052 days 16:47:18.690809,350,1.0,0.0,180,3867,1310.0
247500.0,3,1.0,1660,11060,1.0,4,7,1110,550.0,1962,1890,11060,21981 days 16:47:18.690809,084,3.0,2.018181818181818,-230,0,560.0
385000.0,4,2.75,2700,37011,2.0,3,9,2700,0.0,1984,2700,37457,13946 days 16:47:18.690809,174,1.4545454545454546,0.0,0,-446,2700.0
423000.0,4,1.75,1940,6909,1.0,4,7,970,970.0,1941,1460,6906,29651 days 16:47:18.690809,140,2.2857142857142856,1.0,480,3,0.0
550000.0,3,1.75,1520,5618,1.0,3,7,1170,350.0,1953,1550,5618,25268 days 16:47:18.690809,349,1.7142857142857142,3.342857142857143,-30,0,820.0
693000.0,3,2.25,2090,45535,1.0,5,8,1280,810.0,1952,3090,12889,25634 days 16:47:18.690809,283,1.3333333333333333,1.5802469135802468,-1000,32646,470.0
543000.0,2,1.0,1070,4700,1.0,5,7,1070,0.0,1910,1370,4700,40974 days 16:47:18.690809,086,2.0,0.0,-300,0,1070.0
465000.0,5,1.75,2000,10246,1.0,3,7,1200,800.0,1953,2340,9030,25268 days 16:47:18.690809,086,2.857142857142857,1.5,-340,1216,400.0
280000.0,3,2.5,1020,2217,2.0,3,7,720,300.0,2004,1060,1524,6641 days 16:47:18.690809,117,1.2,2.4,-40,693,420.0
1390000.0,3,1.25,2400,6653,3.0,3,1,2400,0.0,1992,1910,6653,11024 days 16:47:18.690809,322,2.4,0.0,490,0,2400.0
665000.0,6,3.0,2480,9720,2.0,3,8,2480,0.0,1972,2480,9200,18329 days 16:47:18.690809,030,2.0,0.0,0,520,2480.0
237950.0,3,1.75,1310,7314,1.0,5,6,1310,0.0,1960,1010,7314,22712 days 16:47:18.690809,071,1.7142857142857142,0.0,300,0,1310.0
440000.0,4,2.75,2420,10200,1.0,3,8,1220,1200.0,1962,2240,9750,21981 days 16:47:18.690809,002,1.4545454545454546,1.0166666666666666,180,450,20.0
618000.0,2,1.0,1890,4700,1.0,4,7,1030,860.0,1928,2150,4700,34400 days 16:47:18.690809,012,2.0,1.197674418604651,-260,0,170.0
572000.0,3,2.25,1860,4000,1.5,5,7,1020,840.0,1920,1180,4000,37322 days 16:47:18.690809,317,1.3333333333333333,1.2142857142857142,680,0,180.0
725000.0,3,1.5,2500,4774,1.5,3,7,1450,1050.0,1940,1300,4000,30017 days 16:47:18.690809,147,2.0,1.380952380952381,1200,774,400.0
454000.0,3,1.0,1970,22144,1.0,4,7,1970,0.0,1970,1970,13500,19059 days 16:47:18.690809,176,3.0,0.0,0,8644,1970.0
535000.0,4,1.0,1660,10656,1.5,4,7,1180,480.0,1920,1120,8816,37322 days 16:47:18.690809,022,4.0,2.4583333333333335,540,1840,700.0
249000.0,3,2.5,1850,7200,1.0,3,7,1500,350.0,1979,2140,7500,15772 days 16:47:18.690809,352,1.2,4.285714285714286,-290,-300,1150.0
395000.0,4,2.75,1970,37026,1.0,4,8,1970,0.0,1961,1970,51836,22346 days 16:47:18.690809,190,1.4545454545454546,0.0,0,-14810,1970.0
690000.0,3,2.0,1890,6620,1.0,4,8,1890,0.0,1954,2590,7188,24903 days 16:47:18.690809,365,1.5,0.0,-700,-568,1890.0
526500.0,3,1.5,1310,7236,1.0,4,7,1170,140.0,1928,1680,8431,34400 days 16:47:18.690809,276,2.0,8.357142857142858,-370,-1195,1030.0
325000.0,4,1.5,1870,7220,2.0,3,7,1870,0.0,1956,1550,7592,24173 days 16:47:18.690809,219,2.6666666666666665,0.0,320,-372,1870.0
495000.0,3,3.0,1520,4080,2.0,5,7,1520,0.0,1948,1320,4080,27095 days 16:47:18.690809,041,1.0,0.0,200,0,1520.0
825000.0,5,3.0,3070,8474,2.0,3,9,3070,0.0,2011,3070,8527,4084 days 16:47:18.690809,294,1.6666666666666667,0.0,0,-53,3070.0
383000.0,3,1.5,1400,14850,1.5,4,7,1400,0.0,1910,1350,14850,40974 days 16:47:18.690809,357,2.0,0.0,50,0,1400.0
320000.0,3,1.75,1960,11931,1.0,3,7,980,980.0,1954,1460,4498,24903 days 16:47:18.690809,118,1.7142857142857142,1.0,500,7433,0.0
475000.0,3,2.5,2680,87117,1.0,3,7,1340,1340.0,1989,2580,87117,12119 days 16:47:18.690809,342,1.2,1.0,100,0,0.0
275000.0,3,2.5,2030,6326,2.0,3,7,2030,0.0,1993,1810,6825,10658 days 16:47:18.690809,141,1.2,0.0,220,-499,2030.0
1150000.0,2,2.25,2320,9300,1.5,5,9,1920,400.0,1937,2790,9300,31112 days 16:47:18.690809,288,0.8888888888888888,4.8,-470,0,1520.0
455000.0,3,1.75,1760,11371,1.0,5,8,1760,0.0,1959,2220,19884,23077 days 16:47:18.690809,329,1.7142857142857142,0.0,-460,-8513,1760.0
262000.0,5,1.0,1870,7800,1.0,3,7,1580,290.0,1962,1740,7808,21981 days 16:47:18.690809,183,5.0,5.448275862068965,130,-8,1290.0
390000.0,4,1.0,1280,4840,1.0,3,7,940,340.0,1950,1360,4840,26364 days 16:47:18.690809,258,4.0,2.764705882352941,-80,0,600.0
300000.0,3,2.25,1730,10030,1.0,4,8,1730,0.0,1985,2090,8823,13580 days 16:47:18.690809,296,1.3333333333333333,0.0,-360,1207,1730.0
746300.0,3,1.75,2060,5721,1.0,3,9,1140,920.0,1964,2060,8124,21251 days 16:47:18.690809,232,1.7142857142857142,1.2391304347826086,0,-2403,220.0
267000.0,3,1.5,1030,8223,1.0,4,7,1030,0.0,1952,1460,9463,25634 days 16:47:18.690809,251,2.0,0.0,-430,-1240,1030.0
525000.0,3,2.5,1720,7950,1.5,4,7,1720,0.0,1972,1790,7030,18329 days 16:47:18.690809,092,1.2,0.0,-70,920,1720.0
570000.0,3,1.75,1210,7350,1.0,3,7,1210,0.0,1977,1610,7313,16502 days 16:47:18.690809,114,1.7142857142857142,0.0,-400,37,1210.0
360000.0,4,2.25,2620,8100,1.0,4,7,1550,1070.0,1964,1650,8100,21251 days 16:47:18.690809,300,1.7777777777777777,1.4485981308411215,970,0,480.0
1050000.0,3,1.0,1860,44431,1.0,4,6,1860,0.0,1947,2000,44431,27460 days 16:47:18.690809,085,3.0,0.0,-140,0,1860.0
699950.0,3,2.5,2510,4106,2.0,3,9,2510,0.0,2003,2470,4106,7006 days 16:47:18.690809,307,1.2,0.0,40,0,2510.0
375000.0,4,2.5,2040,109336,1.5,4,8,2040,0.0,1973,2370,133729,17963 days 16:47:18.690809,167,1.6,0.0,-330,-24393,2040.0
625000.0,4,1.75,2410,6770,1.0,4,7,1220,1190.0,1924,1440,6770,35861 days 16:47:18.690809,349,2.2857142857142856,1.0252100840336134,970,0,30.0
464050.0,2,1.0,780,2750,1.0,4,7,780,0.0,1928,1320,4440,34400 days 16:47:18.690809,289,2.0,0.0,-540,-1690,780.0
470000.0,5,2.5,2210,9655,1.0,3,8,1460,750.0,1976,2080,8633,16868 days 16:47:18.690809,122,2.0,1.9466666666666668,130,1022,710.0
330000.0,4,2.0,1590,9100,1.0,3,7,1040,550.0,1967,1670,9100,20155 days 16:47:18.690809,252,2.0,1.8909090909090909,-80,0,490.0
537000.0,4,1.75,2230,7957,1.0,4,7,2230,0.0,1967,2230,8040,20155 days 16:47:18.690809,258,2.2857142857142856,0.0,0,-83,2230.0
250000.0,3,2.0,1560,32137,1.0,5,7,910,650.0,1976,1470,29150,16868 days 16:47:18.690809,064,1.5,1.4,90,2987,260.0
835000.0,4,2.5,2950,48351,2.0,3,1,2950,0.0,1986,2870,34417,13215 days 16:47:18.690809,012,1.6,0.0,80,13934,2950.0
770000.0,4,1.0,1480,3750,1.5,4,7,1480,0.0,1912,1570,3750,40244 days 16:47:18.690809,075,4.0,0.0,-90,0,1480.0
650000.0,4,2.0,2850,4497,1.5,3,7,1730,1120.0,1910,2450,6000,40974 days 16:47:18.690809,322,2.0,1.5446428571428572,400,-1503,610.0
335000.0,3,1.75,2390,30409,1.0,3,7,1560,830.0,1953,1750,13500,25268 days 16:47:18.690809,311,1.7142857142857142,1.8795180722891567,640,16909,730.0
350000.0,3,1.75,1740,29597,1.0,4,7,1740,0.0,1965,1560,20741,20885 days 16:47:18.690809,336,1.7142857142857142,0.0,180,8856,1740.0
415000.0,5,2.75,2060,8906,1.0,4,7,1220,840.0,1978,1840,8906,16137 days 16:47:18.690809,205,1.8181818181818181,1.4523809523809523,220,0,380.0
788000.0,4,2.5,2680,8778,2.0,4,8,2680,0.0,1977,2680,10020,16502 days 16:47:18.690809,323,1.6,0.0,0,-1242,2680.0
640000.0,4,2.75,3150,7379,1.5,4,7,2430,720.0,1915,1990,7379,39148 days 16:47:18.690809,287,1.4545454545454546,3.375,1160,0,1710.0
388000.0,4,2.5,2440,7155,2.0,3,8,2440,0.0,1993,2450,8109,10658 days 16:47:18.690809,143,1.6,0.0,-10,-954,2440.0
360000.0,6,1.75,2230,10080,1.0,3,7,1390,840.0,1969,2110,8475,19424 days 16:47:18.690809,329,3.4285714285714284,1.6547619047619047,120,1605,550.0
692500.0,6,1.75,2230,10080,1.0,3,7,1390,840.0,1969,2110,8475,19424 days 16:47:18.690809,083,3.4285714285714284,1.6547619047619047,120,1605,550.0
425000.0,4,1.5,1600,6180,1.5,3,6,1600,0.0,1946,1410,6180,27825 days 16:47:18.690809,175,2.6666666666666665,0.0,190,0,1600.0
645000.0,4,1.5,1600,6180,1.5,3,6,1600,0.0,1946,1410,6180,27825 days 16:47:18.690809,070,2.6666666666666665,0.0,190,0,1600.0
340000.0,3,1.0,1580,8308,1.5,3,7,1580,0.0,1948,1200,8308,27095 days 16:47:18.690809,014,3.0,0.0,380,0,1580.0
713000.0,4,3.25,2840,54400,1.0,4,8,2840,0.0,1984,2550,43560,13946 days 16:47:18.690809,005,1.2307692307692308,0.0,290,10840,2840.0
430000.0,3,2.75,2550,11160,2.0,3,8,2550,0.0,1994,1020,7440,10293 days 16:47:18.690809,141,1.0909090909090908,0.0,1530,3720,2550.0
280000.0,3,2.25,1700,7210,1.0,4,7,1250,450.0,1974,2070,7300,17598 days 16:47:18.690809,065,1.3333333333333333,2.7777777777777777,-370,-90,800.0
215000.0,3,2.0,1470,2052,1.5,3,7,1470,0.0,1986,1390,2052,13215 days 16:47:18.690809,057,1.5,0.0,80,0,1470.0
306000.0,3,2.5,1680,11193,2.0,3,8,1680,0.0,1984,2080,8084,13946 days 16:47:18.690809,148,1.2,0.0,-400,3109,1680.0
299900.0,3,1.0,1110,8593,1.0,3,7,1110,0.0,1979,1780,8593,15772 days 16:47:18.690809,176,3.0,0.0,-670,0,1110.0
534000.0,5,1.75,2120,8625,1.0,3,7,1200,920.0,1959,1930,8625,23077 days 16:47:18.690809,237,2.857142857142857,1.3043478260869565,190,0,280.0
1160000.0,3,2.75,2380,5572,2.0,3,9,1930,450.0,1939,3370,5500,30382 days 16:47:18.690809,209,1.0909090909090908,4.288888888888889,-990,72,1480.0
1170000.0,3,2.5,2670,5000,2.0,5,9,2000,670.0,1942,2320,5000,29286 days 16:47:18.690809,197,1.2,2.985074626865672,350,0,1330.0
199990.0,2,1.0,890,6430,1.0,3,6,890,0.0,1935,1460,6430,31843 days 16:47:18.690809,192,2.0,0.0,-570,0,890.0
946000.0,4,3.0,3140,9058,1.0,3,9,2140,1000.0,1989,2760,10018,12119 days 16:47:18.690809,224,1.3333333333333333,2.14,380,-960,1140.0
295000.0,4,1.0,1260,7800,1.5,3,7,1260,0.0,1947,1639,7492,27460 days 16:47:18.690809,051,4.0,0.0,-379,308,1260.0
475000.0,2,1.0,920,5157,1.0,3,6,920,0.0,1909,1700,5150,41339 days 16:47:18.690809,049,2.0,0.0,-780,7,920.0
750000.0,5,3.5,2990,212137,2.0,3,8,2450,540.0,1994,1060,69260,10293 days 16:47:18.690809,119,1.4285714285714286,4.537037037037037,1930,142877,1910.0
1230000.0,4,2.5,3120,49456,2.0,4,9,2590,530.0,1974,2030,32181,17598 days 16:47:18.690809,301,1.6,4.886792452830188,1090,17275,2060.0
183500.0,3,1.0,1010,7520,1.0,4,6,1010,0.0,1975,1370,8469,17233 days 16:47:18.690809,082,3.0,0.0,-360,-949,1010.0
450000.0,2,1.0,1010,3627,1.0,4,6,1010,0.0,1924,1630,4040,35861 days 16:47:18.690809,086,2.0,0.0,-620,-413,1010.0
180000.0,3,1.0,1020,5500,1.5,3,7,1020,0.0,1961,1160,5500,22346 days 16:47:18.690809,008,3.0,0.0,-140,0,1020.0
707000.0,5,4.5,3540,21217,2.0,4,8,2940,600.0,1926,1290,12040,35130 days 16:47:18.690809,005,1.1111111111111112,4.9,2250,9177,2340.0
230000.0,2,0.75,900,3527,1.0,3,6,900,0.0,1939,1220,4080,30382 days 16:47:18.690809,063,2.6666666666666665,0.0,-320,-553,900.0
192500.0,3,1.0,1100,9750,1.0,4,7,1100,0.0,1966,1190,9750,20520 days 16:47:18.690809,343,3.0,0.0,-90,0,1100.0
759000.0,3,1.5,1980,5800,1.0,4,8,1520,460.0,1949,2280,5800,26729 days 16:47:18.690809,274,2.0,3.3043478260869565,-300,0,1060.0
462000.0,5,1.75,1250,10530,1.0,4,7,1250,0.0,1966,1560,8190,20520 days 16:47:18.690809,139,2.857142857142857,0.0,-310,2340,1250.0
229000.0,4,1.5,1820,22814,1.5,3,7,1820,0.0,1920,1770,9150,37322 days 16:47:18.690809,354,2.6666666666666665,0.0,50,13664,1820.0
399950.0,2,2.25,1140,1184,2.0,3,8,1010,130.0,1999,1140,1339,8467 days 16:47:18.690809,293,0.8888888888888888,7.769230769230769,0,-155,880.0
512000.0,2,2.25,1170,1313,3.0,3,8,1170,0.0,2007,1310,1304,5545 days 16:47:18.690809,202,0.8888888888888888,0.0,-140,9,1170.0
410000.0,5,2.75,2910,5802,2.0,3,7,2910,0.0,2006,2910,5000,5910 days 16:47:18.690809,206,1.8181818181818181,0.0,0,802,2910.0
210000.0,2,1.0,970,5500,1.0,3,7,970,0.0,1956,1180,6000,24173 days 16:47:18.690809,175,2.0,0.0,-210,-500,970.0
685000.0,3,2.5,2520,10175,1.0,3,8,1630,890.0,1979,2220,8388,15772 days 16:47:18.690809,096,1.2,1.8314606741573034,300,1787,740.0
488000.0,2,2.0,1360,4688,1.0,3,7,780,580.0,1944,1340,4750,28556 days 16:47:18.690809,138,1.0,1.3448275862068966,20,-62,200.0
247500.0,3,2.25,1620,6000,1.0,3,7,1280,340.0,1998,1710,6318,8832 days 16:47:18.690809,061,1.3333333333333333,3.764705882352941,-90,-318,940.0
489000.0,4,2.0,2120,11479,1.0,4,7,1060,1060.0,1940,1540,11000,30017 days 16:47:18.690809,171,2.0,1.0,580,479,0.0
725000.0,4,1.75,2700,6000,1.0,4,8,1450,1250.0,1953,2080,6000,25268 days 16:47:18.690809,329,2.2857142857142856,1.16,620,0,200.0
199950.0,3,1.5,1370,10317,1.5,3,6,1370,0.0,1958,1370,9884,23442 days 16:47:18.690809,099,2.0,0.0,0,433,1370.0
670000.0,5,3.0,2520,13001,2.0,3,8,2010,510.0,1973,2170,8215,17963 days 16:47:18.690809,091,1.6666666666666667,3.9411764705882355,350,4786,1500.0
275000.0,3,2.0,1540,10410,1.0,4,7,1540,0.0,1967,1590,7725,20155 days 16:47:18.690809,363,1.5,0.0,-50,2685,1540.0
1000000.0,3,1.75,2610,6360,2.0,3,8,2130,480.0,1924,3010,6000,35861 days 16:47:18.690809,097,1.7142857142857142,4.4375,-400,360,1650.0
255000.0,3,2.0,1490,8371,1.5,3,7,1490,0.0,1984,1350,7846,13946 days 16:47:18.690809,143,1.5,0.0,140,525,1490.0
465000.0,3,1.75,2760,9137,1.0,3,7,1380,1380.0,1960,1980,9137,22712 days 16:47:18.690809,317,1.7142857142857142,1.0,780,0,0.0
259000.0,3,1.75,1260,3604,1.0,3,7,1260,0.0,2012,1430,3767,3719 days 16:47:18.690809,042,1.7142857142857142,0.0,-170,-163,1260.0
695000.0,3,3.5,2630,4713,2.0,3,9,2030,600.0,2008,2450,4187,5180 days 16:47:18.690809,325,0.8571428571428571,3.3833333333333333,180,526,1430.0
505000.0,3,1.75,1800,7210,1.0,3,7,1370,430.0,1976,1820,8100,16868 days 16:47:18.690809,121,1.7142857142857142,3.186046511627907,-20,-890,940.0
631500.0,2,1.0,1130,2640,1.0,4,8,1130,0.0,1927,1680,3200,34765 days 16:47:18.690809,175,2.0,0.0,-550,-560,1130.0
630500.0,3,1.0,1180,3600,1.5,3,7,1180,0.0,1926,1900,3600,35130 days 16:47:18.690809,289,3.0,0.0,-720,0,1180.0
999000.0,4,2.75,2800,19168,2.0,3,1,2800,0.0,1992,2010,16020,11024 days 16:47:18.690809,167,1.4545454545454546,0.0,790,3148,2800.0
740000.0,3,1.5,1830,4000,1.0,4,7,1350,480.0,1910,1570,3672,40974 days 16:47:18.690809,191,2.0,2.8125,260,328,870.0
650000.0,3,2.5,2220,6380,1.5,4,8,1660,560.0,1931,950,6380,33304 days 16:47:18.690809,272,1.2,2.9642857142857144,1270,0,1100.0
554000.0,2,2.0,1870,5580,1.0,3,8,1870,0.0,2004,1670,4500,6641 days 16:47:18.690809,217,1.0,0.0,200,1080,1870.0
400000.0,3,2.5,2580,214315,1.5,3,8,2580,0.0,1946,2580,70131,27825 days 16:47:18.690809,335,1.2,0.0,0,144184,2580.0
529941.0,3,2.0,1660,10000,1.0,4,7,1010,650.0,1961,2020,9720,22346 days 16:47:18.690809,054,1.5,1.5538461538461539,-360,280,360.0
310000.0,3,1.0,1330,3740,1.5,3,6,1330,0.0,1903,1330,5053,43531 days 16:47:18.690809,293,3.0,0.0,0,-1313,1330.0
389000.0,3,1.0,1330,3740,1.5,3,6,1330,0.0,1903,1330,5053,43531 days 16:47:18.690809,112,3.0,0.0,0,-1313,1330.0
731781.0,3,3.0,2630,4972,2.0,3,9,2630,0.0,2006,2880,4972,5910 days 16:47:18.690809,252,1.0,0.0,-250,0,2630.0
502501.0,2,1.0,1100,4750,1.0,3,7,1100,0.0,1946,1830,4750,27825 days 16:47:18.690809,112,2.0,0.0,-730,0,1100.0
443000.0,3,1.75,1810,7950,1.0,4,7,1810,0.0,1968,1680,7725,19790 days 16:47:18.690809,321,1.7142857142857142,0.0,130,225,1810.0
607000.0,3,2.0,2060,4080,1.0,5,7,1060,1000.0,1921,1400,4080,36956 days 16:47:18.690809,227,1.5,1.06,660,0,60.0
2150000.0,3,3.5,4660,5500,2.0,5,1,3040,1620.0,1909,2980,5500,41339 days 16:47:18.690809,183,0.8571428571428571,1.876543209876543,1680,0,1420.0
585000.0,4,2.5,2370,15200,1.0,3,8,1660,710.0,1975,2360,13879,17233 days 16:47:18.690809,253,1.6,2.3380281690140845,10,1321,950.0
1030000.0,3,2.5,2430,10500,2.0,3,9,2430,0.0,1989,3440,12842,12119 days 16:47:18.690809,170,1.2,0.0,-1010,-2342,2430.0
315000.0,3,2.5,1880,7000,2.0,3,8,1880,0.0,1993,1880,7000,10658 days 16:47:18.690809,163,1.2,0.0,0,0,1880.0
180000.0,2,1.0,1150,5695,1.0,4,6,1150,0.0,1958,1150,5695,23442 days 16:47:18.690809,294,2.0,0.0,0,0,1150.0
322500.0,3,2.0,1350,14200,1.0,3,7,1350,0.0,1989,2100,15101,12119 days 16:47:18.690809,133,1.5,0.0,-750,-901,1350.0
568500.0,3,2.75,2180,7519,1.0,4,7,1310,870.0,1981,1510,7107,15041 days 16:47:18.690809,153,1.0909090909090908,1.5057471264367817,670,412,440.0
813000.0,4,2.75,3370,6675,1.0,4,8,1920,1450.0,1948,2250,5550,27095 days 16:47:18.690809,162,1.4545454545454546,1.3241379310344827,1120,1125,470.0
1090000.0,5,2.25,3650,13068,1.0,4,1,1850,1800.0,1976,2760,13927,16868 days 16:47:18.690809,104,2.2222222222222223,1.0277777777777777,890,-859,50.0
424000.0,4,2.0,2100,4857,2.0,3,8,2100,0.0,1965,1450,5965,20885 days 16:47:18.690809,177,2.0,0.0,650,-1108,2100.0
235000.0,2,1.0,670,5600,1.0,3,6,670,0.0,1903,1960,7176,43531 days 16:47:18.691807,198,2.0,0.0,-1290,-1576,670.0
740000.0,3,3.5,2420,4000,2.0,5,9,1820,600.0,1907,2030,4550,42070 days 16:47:18.691807,272,0.8571428571428571,3.033333333333333,390,-550,1220.0
415000.0,1,1.0,760,3000,1.0,3,7,760,0.0,1900,1270,3000,44626 days 16:47:18.691807,225,1.0,0.0,-510,0,760.0
432000.0,3,2.75,2200,14925,1.0,3,6,1100,1100.0,1982,1520,14212,14676 days 16:47:18.691807,142,1.0909090909090908,1.0,680,713,0.0
1270000.0,5,3.25,4410,35192,2.0,3,1,3880,530.0,1990,4410,59677,11754 days 16:47:18.691807,124,1.5384615384615385,7.320754716981132,0,-24485,3350.0
676500.0,3,1.75,1300,2446,1.0,3,8,880,420.0,1961,2440,5051,22346 days 16:47:18.691807,258,1.7142857142857142,2.0952380952380953,-1140,-2605,460.0
419000.0,2,1.0,720,4592,1.0,4,6,720,0.0,1943,1030,5816,28921 days 16:47:18.691807,324,2.0,0.0,-310,-1224,720.0
650000.0,3,2.5,2180,37042,2.0,3,9,2180,0.0,1998,2880,32688,8832 days 16:47:18.691807,079,1.2,0.0,-700,4354,2180.0
239000.0,2,1.0,1130,15190,1.0,4,7,1130,0.0,1954,1490,16920,24903 days 16:47:18.691807,234,2.0,0.0,-360,-1730,1130.0
900000.0,4,2.5,2230,4372,2.0,5,8,1540,690.0,1935,2020,4372,31843 days 16:47:18.691807,190,1.6,2.2318840579710146,210,0,850.0
330000.0,5,1.75,2100,7347,1.0,3,7,1070,1030.0,1981,2170,9418,15041 days 16:47:18.691807,118,2.857142857142857,1.0388349514563107,-70,-2071,40.0
510000.0,3,1.75,2060,58341,1.0,3,8,1100,960.0,1982,1230,14904,14676 days 16:47:18.691807,338,1.7142857142857142,1.1458333333333333,830,43437,140.0
465000.0,4,2.5,3060,6000,2.0,3,9,3060,0.0,2012,3040,6000,3719 days 16:47:18.691807,178,1.6,0.0,20,0,3060.0
1700000.0,3,2.75,2810,18731,2.0,4,1,2810,0.0,1974,3120,14810,17598 days 16:47:18.691807,174,1.0909090909090908,0.0,-310,3921,2810.0
490000.0,3,2.25,2550,8588,1.0,3,9,2550,0.0,1989,3050,8588,12119 days 16:47:18.691807,239,1.3333333333333333,0.0,-500,0,2550.0
2680000.0,5,3.0,4290,20445,2.0,4,1,4290,0.0,1985,3620,22325,13580 days 16:47:18.691807,190,1.6666666666666667,0.0,670,-1880,4290.0
1000000.0,3,2.25,3040,52302,1.0,3,9,3040,0.0,2005,2070,38600,6275 days 16:47:18.691807,334,1.3333333333333333,0.0,970,13702,3040.0
469950.0,4,2.75,2530,14178,2.0,3,8,2530,0.0,1997,2530,14055,9197 days 16:47:18.691807,189,1.4545454545454546,0.0,0,123,2530.0
244950.0,4,2.5,1790,19177,1.0,4,7,1790,0.0,1966,1760,11726,20520 days 16:47:18.691807,064,1.6,0.0,30,7451,1790.0
575000.0,3,1.0,1530,2400,1.0,4,7,890,640.0,1928,1240,2400,34400 days 16:47:18.691807,107,3.0,1.390625,290,0,250.0
361000.0,5,2.75,2380,7500,1.0,3,7,1300,1080.0,1984,2400,6000,13946 days 16:47:18.691807,084,1.8181818181818181,1.2037037037037037,-20,1500,220.0
650000.0,5,2.25,2400,13450,1.0,5,7,1200,1200.0,1957,1950,10361,23807 days 16:47:18.691807,086,2.2222222222222223,1.0,450,3089,0.0
230005.0,2,1.0,1030,6000,1.0,2,7,830,200.0,1951,1770,5000,25999 days 16:47:18.691807,082,2.0,4.15,-740,1000,630.0
293000.0,4,2.5,3250,235063,1.0,3,9,3250,0.0,1973,1600,44287,17963 days 16:47:18.691807,147,1.6,0.0,1650,190776,3250.0
445000.0,3,3.0,1970,24318,1.0,3,8,1970,0.0,2010,2150,14695,4449 days 16:47:18.691807,136,1.0,0.0,-180,9623,1970.0
280000.0,4,1.5,1940,6386,1.0,3,7,1140,800.0,1954,1340,6165,24903 days 16:47:18.691807,226,2.6666666666666665,1.425,600,221,340.0
520000.0,3,2.25,1850,10855,1.0,3,8,1370,480.0,1985,1850,8209,13580 days 16:47:18.691807,197,1.3333333333333333,2.8541666666666665,0,2646,890.0
780000.0,4,3.25,3900,40962,2.0,3,1,3900,0.0,1991,1730,11775,11389 days 16:47:18.691807,217,1.2307692307692308,0.0,2170,29187,3900.0
625000.0,3,1.75,3160,76230,1.0,4,8,2160,1000.0,1978,1990,45789,16137 days 16:47:18.691807,190,1.7142857142857142,2.16,1170,30441,1160.0
239950.0,3,1.75,1440,7200,1.0,3,7,1440,0.0,1986,1640,9167,13215 days 16:47:18.691807,100,1.7142857142857142,0.0,-200,-1967,1440.0
335000.0,3,1.5,2040,6000,1.0,3,7,1340,700.0,1957,1190,6000,23807 days 16:47:18.691807,167,2.0,1.9142857142857144,850,0,640.0
612000.0,3,2.5,2120,7401,2.0,3,8,2120,0.0,1989,2010,7972,12119 days 16:47:18.691807,107,1.2,0.0,110,-571,2120.0
200000.0,2,1.0,830,8000,1.0,3,6,830,0.0,1954,1300,8000,24903 days 16:47:18.691807,216,2.0,0.0,-470,0,830.0
345000.0,3,1.75,3140,8571,1.0,4,8,1670,1470.0,1985,2590,7949,13580 days 16:47:18.691807,191,1.7142857142857142,1.1360544217687074,550,622,200.0
520000.0,4,2.5,2410,6440,1.0,3,8,1550,860.0,1974,2330,6938,17598 days 16:47:18.691807,028,1.6,1.802325581395349,80,-498,690.0
855000.0,4,2.25,2190,4080,2.0,3,8,1800,390.0,1918,2100,4080,38052 days 16:47:18.691807,169,1.7777777777777777,4.615384615384615,90,0,1410.0
567500.0,4,1.75,2190,5060,1.0,3,7,1190,1000.0,1950,1510,4600,26364 days 16:47:18.691807,127,2.2857142857142856,1.19,680,460,190.0
208000.0,3,1.5,1210,7247,1.0,4,7,1210,0.0,1967,1370,7869,20155 days 16:47:18.691807,314,2.0,0.0,-160,-622,1210.0
452000.0,3,1.75,1880,16239,1.0,3,7,880,1000.0,1922,1260,7528,36591 days 16:47:18.691807,233,1.7142857142857142,0.88,620,8711,-120.0
555000.0,3,3.0,2410,12183,2.0,3,9,2410,0.0,1988,2540,9979,12485 days 16:47:18.691807,209,1.0,0.0,-130,2204,2410.0
519000.0,5,2.75,2620,8861,1.0,5,8,1350,1270.0,1979,1940,10800,15772 days 16:47:18.691807,248,1.8181818181818181,1.062992125984252,680,-1939,80.0
474950.0,3,2.25,1850,2575,2.0,3,9,1850,0.0,2013,1080,4120,3353 days 16:47:18.691807,337,1.3333333333333333,0.0,770,-1545,1850.0
419000.0,3,2.25,1760,16418,1.0,3,7,1190,570.0,1990,2260,20747,11754 days 16:47:18.691807,021,1.3333333333333333,2.087719298245614,-500,-4329,620.0
390000.0,2,1.0,860,1800,1.0,3,7,860,0.0,1909,2160,3120,41339 days 16:47:18.691807,254,2.0,0.0,-1300,-1320,860.0
539000.0,7,2.25,2620,6890,2.0,4,7,2620,0.0,1961,2070,7910,22346 days 16:47:18.691807,293,3.111111111111111,0.0,550,-1020,2620.0
569000.0,4,1.75,2400,21196,1.0,5,8,1590,810.0,1956,2200,19134,24173 days 16:47:18.691807,213,2.2857142857142856,1.962962962962963,200,2062,780.0
611000.0,3,1.0,1850,5000,1.5,3,7,1850,0.0,1922,1850,5000,36591 days 16:47:18.691807,342,3.0,0.0,0,0,1850.0
760000.0,3,2.5,4040,147856,2.0,3,9,4040,0.0,2004,3000,125452,6641 days 16:47:18.691807,301,1.2,0.0,1040,22404,4040.0
732000.0,3,2.0,1940,55756,1.0,5,9,1940,0.0,1954,2330,10018,24903 days 16:47:18.691807,138,1.5,0.0,-390,45738,1940.0
1680000.0,3,2.5,3490,8343,2.0,4,9,2150,1340.0,1939,2990,13104,30382 days 16:47:18.691807,189,1.2,1.6044776119402986,500,-4761,810.0
919950.0,5,2.75,3170,7062,2.0,3,9,3170,0.0,2014,3210,6891,2988 days 16:47:18.691807,246,1.8181818181818181,0.0,-40,171,3170.0
400000.0,4,2.5,2530,7563,1.0,3,7,1440,1090.0,1978,1960,7811,16137 days 16:47:18.691807,161,1.6,1.3211009174311927,570,-248,350.0
785000.0,4,2.5,3230,21781,2.0,3,9,3230,0.0,1993,3230,21780,10658 days 16:47:18.691807,210,1.6,0.0,0,1,3230.0
835000.0,3,2.25,2120,54014,2.0,4,9,2120,0.0,1964,3280,50690,21251 days 16:47:18.691807,180,1.3333333333333333,0.0,-1160,3324,2120.0
640500.0,2,1.75,1640,6750,1.0,4,8,1340,300.0,1939,1760,7490,30382 days 16:47:18.691807,042,1.1428571428571428,4.466666666666667,-120,-740,1040.0
310000.0,4,2.5,2130,9013,2.0,3,8,2130,0.0,1988,2350,8982,12485 days 16:47:18.691807,075,1.6,0.0,-220,31,2130.0
355000.0,4,1.0,1440,7215,1.5,3,7,1440,0.0,1969,1150,7215,19424 days 16:47:18.691807,289,4.0,0.0,290,0,1440.0
685000.0,3,1.75,1940,7313,1.0,4,8,1440,500.0,1960,2160,7200,22712 days 16:47:18.691807,149,1.7142857142857142,2.88,-220,113,940.0
202500.0,3,1.0,1120,8576,1.0,3,6,1120,0.0,1943,1050,8812,28921 days 16:47:18.691807,290,3.0,0.0,70,-236,1120.0
540000.0,3,2.5,2400,5817,2.0,3,8,2400,0.0,1998,2420,5817,8832 days 16:47:18.691807,125,1.2,0.0,-20,0,2400.0
295000.0,4,2.5,1810,4871,2.0,3,8,1810,0.0,1999,1850,5003,8467 days 16:47:18.691807,321,1.6,0.0,-40,-132,1810.0
518000.0,3,1.0,1270,6612,1.5,3,7,1270,0.0,1927,2100,7680,34765 days 16:47:18.691807,114,3.0,0.0,-830,-1068,1270.0
250000.0,2,1.75,1350,4023,1.0,3,7,1350,0.0,2005,1370,3570,6275 days 16:47:18.691807,121,1.1428571428571428,0.0,-20,453,1350.0
330000.0,2,2.0,1550,435600,1.5,2,7,1550,0.0,1972,1600,217800,18329 days 16:47:18.691807,128,1.0,0.0,-50,217800,1550.0
481000.0,2,1.0,1620,3880,1.0,4,7,920,700.0,1924,1330,3880,35861 days 16:47:18.691807,325,2.0,1.3142857142857143,290,0,220.0
898000.0,3,2.25,2650,12845,1.0,3,9,1770,880.0,1977,2650,12902,16502 days 16:47:18.691807,296,1.3333333333333333,2.0113636363636362,0,-57,890.0
570000.0,5,1.75,2510,9750,1.5,3,8,2510,0.0,1969,1900,9750,19424 days 16:47:18.691807,216,2.857142857142857,0.0,610,0,2510.0
475000.0,4,2.5,2040,16200,2.0,3,8,2040,0.0,1997,2530,15389,9197 days 16:47:18.691807,066,1.6,0.0,-490,811,2040.0
265000.0,3,2.5,1660,5250,2.0,4,8,1660,0.0,1988,1630,5505,12485 days 16:47:18.691807,040,1.2,0.0,30,-255,1660.0
380000.0,3,2.5,1980,17342,2.0,3,1,1580,400.0,1984,2060,17313,13946 days 16:47:18.691807,261,1.2,3.95,-80,29,1180.0
790000.0,4,2.5,2690,8036,2.0,4,9,2690,0.0,1987,2420,8087,12850 days 16:47:18.691807,231,1.6,0.0,270,-51,2690.0
620000.0,2,2.25,2910,6110,2.0,4,9,2910,0.0,1985,2090,5763,13580 days 16:47:18.691807,071,0.8888888888888888,0.0,820,347,2910.0
709050.0,4,3.5,2720,9000,2.0,3,8,2670,50.0,1997,1960,7772,9197 days 16:47:18.691807,231,1.1428571428571428,53.4,760,1228,2620.0
296500.0,3,1.0,1280,5100,1.0,3,7,1280,0.0,1948,1380,7140,27095 days 16:47:18.691807,218,3.0,0.0,-100,-2040,1280.0
475000.0,3,2.5,2160,35912,2.0,3,8,2160,0.0,1982,2230,35244,14676 days 16:47:18.691807,225,1.2,0.0,-70,668,2160.0
440000.0,3,2.25,1760,10835,1.0,4,8,1290,470.0,1976,2050,10488,16868 days 16:47:18.691807,295,1.3333333333333333,2.74468085106383,-290,347,820.0
405000.0,2,1.0,800,6016,1.0,3,6,800,0.0,1942,1470,3734,29286 days 16:47:18.691807,342,2.0,0.0,-670,2282,800.0
269500.0,2,1.0,930,4000,1.0,3,6,730,200.0,1943,1100,5000,28921 days 16:47:18.691807,133,2.0,3.65,-170,-1000,530.0
520000.0,5,1.75,2040,5280,1.0,4,7,1020,1020.0,1961,1720,7344,22346 days 16:47:18.691807,323,2.857142857142857,1.0,320,-2064,0.0
229500.0,1,1.0,1180,22000,1.0,3,6,1180,0.0,1948,1890,11761,27095 days 16:47:18.691807,216,1.0,0.0,-710,10239,1180.0
335000.0,4,1.75,2000,10890,1.0,4,7,1390,610.0,1961,1520,9250,22346 days 16:47:18.691807,282,2.2857142857142856,2.278688524590164,480,1640,780.0
680000.0,4,2.75,3310,50951,2.0,3,9,3310,0.0,1998,3230,39340,8832 days 16:47:18.691807,294,1.4545454545454546,0.0,80,11611,3310.0
1390000.0,4,3.5,3130,3900,2.0,3,9,2550,580.0,2008,1830,3900,5180 days 16:47:18.691807,072,1.1428571428571428,4.396551724137931,1300,0,1970.0
740000.0,4,2.5,2300,9900,1.0,3,8,1600,700.0,1961,2510,7500,22346 days 16:47:18.691807,349,1.6,2.2857142857142856,-210,2400,900.0
270000.0,3,2.25,2140,9990,1.0,4,8,2140,0.0,1962,2060,9990,21981 days 16:47:18.691807,076,1.3333333333333333,0.0,80,0,2140.0
510000.0,4,2.0,2210,5572,1.5,3,7,1760,450.0,1911,1760,4713,40609 days 16:47:18.691807,124,2.0,3.911111111111111,450,859,1310.0
300000.0,2,1.0,970,13700,1.0,3,6,970,0.0,1949,1570,10880,26729 days 16:47:18.691807,141,2.0,0.0,-600,2820,970.0
1300000.0,5,2.25,2690,10800,1.0,4,8,2020,670.0,1956,3380,9134,24173 days 16:47:18.691807,082,2.2222222222222223,3.014925373134328,-690,1666,1350.0
675000.0,4,2.0,1890,5188,1.5,4,7,1670,220.0,1940,1800,4848,30017 days 16:47:18.691807,231,2.0,7.590909090909091,90,340,1450.0
925850.0,6,3.25,3140,14923,2.0,3,1,3140,0.0,1991,2980,10758,11389 days 16:47:18.691807,308,1.8461538461538463,0.0,160,4165,3140.0
255500.0,2,1.0,1440,43560,1.0,4,7,1150,290.0,1965,1870,56628,20885 days 16:47:18.691807,199,2.0,3.9655172413793105,-430,-13068,860.0
450000.0,3,2.5,2910,17172,2.0,3,1,2910,0.0,1989,2910,20048,12119 days 16:47:18.691807,134,1.2,0.0,0,-2876,2910.0
280000.0,3,1.0,1310,22652,1.0,3,7,1310,0.0,1968,1600,103672,19790 days 16:47:18.691807,309,3.0,0.0,-290,-81020,1310.0
245000.0,4,2.25,2140,8800,2.0,4,7,2140,0.0,1963,2060,9790,21616 days 16:47:18.691807,005,1.7777777777777777,0.0,80,-990,2140.0
344950.0,3,1.0,1090,6712,1.0,4,7,1090,0.0,1972,1440,7350,18329 days 16:47:18.691807,076,3.0,0.0,-350,-638,1090.0
381000.0,3,1.75,1330,7216,1.0,3,7,1330,0.0,1969,1500,8000,19424 days 16:47:18.691807,223,1.7142857142857142,0.0,-170,-784,1330.0
1950000.0,4,4.0,4690,6900,2.0,3,1,3480,1210.0,2001,2800,11240,7736 days 16:47:18.691807,364,1.0,2.87603305785124,1890,-4340,2270.0
1500000.0,3,1.5,1910,21374,1.0,1,8,1910,0.0,1955,2850,16167,24538 days 16:47:18.691807,042,2.0,0.0,-940,5207,1910.0
232603.0,3,1.75,1750,11461,2.0,4,7,1750,0.0,1976,2140,11276,16868 days 16:47:18.691807,170,1.7142857142857142,0.0,-390,185,1750.0
220000.0,5,2.5,1760,10200,1.5,3,6,1760,0.0,1925,1370,7620,35495 days 16:47:18.691807,346,2.0,0.0,390,2580,1760.0
600000.0,4,1.75,1810,7700,1.0,5,8,1390,420.0,1977,2080,7700,16502 days 16:47:18.691807,223,2.2857142857142856,3.3095238095238093,-270,0,970.0
239000.0,3,2.5,1360,5754,2.0,3,7,1360,0.0,1994,1360,7050,10293 days 16:47:18.691807,309,1.2,0.0,0,-1296,1360.0
400000.0,3,1.75,1730,9211,1.0,3,8,1730,0.0,1961,1440,9211,22346 days 16:47:18.691807,238,1.7142857142857142,0.0,290,0,1730.0
2180000.0,6,2.75,4710,11000,2.0,3,1,3690,1020.0,1931,2950,5300,33304 days 16:47:18.691807,189,2.1818181818181817,3.6176470588235294,1760,5700,2670.0
350000.0,3,1.0,1010,8551,1.0,5,7,1010,0.0,1953,1310,8504,25268 days 16:47:18.691807,251,3.0,0.0,-300,47,1010.0
562000.0,3,2.5,2400,97138,2.0,5,8,2400,0.0,1983,2230,54450,14311 days 16:47:18.691807,248,1.2,0.0,170,42688,2400.0
380000.0,3,1.5,1540,8400,1.0,5,7,1540,0.0,1968,1690,7689,19790 days 16:47:18.691807,253,2.0,0.0,-150,711,1540.0
511200.0,4,1.75,1480,7875,1.0,3,7,740,740.0,1927,1680,5851,34765 days 16:47:18.691807,288,2.2857142857142856,1.0,-200,2024,0.0
680000.0,4,2.5,2520,5000,2.0,3,9,2520,0.0,2004,2910,5001,6641 days 16:47:18.691807,287,1.6,0.0,-390,-1,2520.0
350000.0,3,3.25,1210,941,2.0,3,8,1000,210.0,2002,1650,1493,7371 days 16:47:18.691807,207,0.9230769230769231,4.761904761904762,-440,-552,790.0
410000.0,5,2.5,2670,184140,1.0,3,8,1410,1260.0,1980,1860,35719,15407 days 16:47:18.691807,050,2.0,1.119047619047619,810,148421,150.0
1050000.0,4,2.5,3030,12590,1.5,4,1,3030,0.0,1988,2980,11635,12485 days 16:47:18.691807,142,1.6,0.0,50,955,3030.0
391265.0,3,2.0,1440,3900,1.0,3,8,1440,0.0,2002,1350,3900,7371 days 16:47:18.691807,301,1.5,0.0,90,0,1440.0
1410000.0,4,2.25,3250,16684,2.0,3,9,3250,0.0,1979,2890,16927,15772 days 16:47:18.691807,177,1.7777777777777777,0.0,360,-243,3250.0
575000.0,3,2.0,1750,5750,1.0,5,7,870,880.0,1956,1750,5750,24173 days 16:47:18.691807,118,1.5,0.9886363636363636,0,0,-10.0
316000.0,4,1.5,2120,46173,2.0,3,7,2120,0.0,1974,2000,46173,17598 days 16:47:18.691807,128,2.6666666666666665,0.0,120,0,2120.0
165000.0,3,1.0,1050,5156,1.5,3,7,1050,0.0,1919,1050,5502,37687 days 16:47:18.691807,106,3.0,0.0,0,-346,1050.0
850000.0,3,2.25,1950,3600,1.5,5,8,1430,520.0,1911,1950,3600,40609 days 16:47:18.691807,224,1.3333333333333333,2.75,0,0,910.0
210000.0,3,1.0,1020,6000,1.0,3,5,1020,0.0,1900,2070,7200,44626 days 16:47:18.691807,216,3.0,0.0,-1050,-1200,1020.0
325000.0,4,2.5,1820,9161,1.0,4,7,1220,600.0,1975,1860,7650,17233 days 16:47:18.691807,236,1.6,2.033333333333333,-40,1511,620.0
682000.0,4,2.5,2390,53941,2.0,3,8,2390,0.0,1989,2610,104108,12119 days 16:47:18.691807,097,1.6,0.0,-220,-50167,2390.0
430000.0,3,2.5,1400,7508,2.0,4,7,1400,0.0,1987,1710,7700,12850 days 16:47:18.691807,199,1.2,0.0,-310,-192,1400.0
325500.0,3,1.5,1540,8110,1.0,4,7,1190,350.0,1959,1290,8110,23077 days 16:47:18.691807,329,2.0,3.4,250,0,840.0
385000.0,3,1.75,2370,6360,1.0,3,7,1280,1090.0,1954,1990,6360,24903 days 16:47:18.691807,201,1.7142857142857142,1.1743119266055047,380,0,190.0
435000.0,1,1.0,670,1800,1.0,5,6,670,0.0,1905,1330,3360,42800 days 16:47:18.691807,082,1.0,0.0,-660,-1560,670.0
550000.0,4,1.0,2420,15520,2.0,4,7,2420,0.0,1945,1630,9965,28190 days 16:47:18.691807,202,4.0,0.0,790,5555,2420.0
503000.0,4,2.75,2100,7350,1.0,5,7,1240,860.0,1978,2490,7350,16137 days 16:47:18.691807,202,1.4545454545454546,1.441860465116279,-390,0,380.0
676000.0,4,2.5,2800,5368,2.0,3,8,2800,0.0,2003,2790,5368,7006 days 16:47:18.691807,231,1.6,0.0,10,0,2800.0
180000.0,3,1.0,940,11055,1.5,4,7,940,0.0,1959,1420,9100,23077 days 16:47:18.691807,317,3.0,0.0,-480,1955,940.0
234000.0,3,2.0,1640,5280,1.5,5,6,1640,0.0,1910,1160,7875,40974 days 16:47:18.691807,162,1.5,0.0,480,-2595,1640.0
734200.0,4,2.5,2760,5000,1.5,5,7,1680,1080.0,1928,1850,5000,34400 days 16:47:18.691807,132,1.6,1.5555555555555556,910,0,600.0
920000.0,3,3.25,3660,66211,2.0,3,1,3660,0.0,2003,3660,107153,7006 days 16:47:18.691807,210,0.9230769230769231,0.0,0,-40942,3660.0
1920000.0,4,2.5,3070,34412,1.0,4,9,2070,1000.0,1950,3780,27940,26364 days 16:47:18.691807,167,1.6,2.07,-710,6472,1070.0
224000.0,3,1.75,1100,10125,1.0,4,7,1100,0.0,1969,1520,10125,19424 days 16:47:18.691807,343,1.7142857142857142,0.0,-420,0,1100.0
1400000.0,3,2.75,3130,19530,1.0,3,8,1690,1440.0,1947,2980,18782,27460 days 16:47:18.691807,098,1.0909090909090908,1.1736111111111112,150,748,250.0
185000.0,3,1.0,1320,7155,1.0,4,6,1320,0.0,1961,1070,8100,22346 days 16:47:18.691807,262,3.0,0.0,250,-945,1320.0
554600.0,3,1.75,1470,5000,1.5,5,7,1470,0.0,1900,1530,5000,44626 days 16:47:18.691807,230,1.7142857142857142,0.0,-60,0,1470.0
268000.0,3,1.75,1480,8009,1.0,3,7,980,500.0,1980,1790,7678,15407 days 16:47:18.691807,237,1.7142857142857142,1.96,-310,331,480.0
675000.0,4,2.25,2260,8715,1.0,4,8,1530,730.0,1976,2220,8650,16868 days 16:47:18.691807,258,1.7777777777777777,2.095890410958904,40,65,800.0
620000.0,4,2.25,2210,10039,1.0,4,8,1710,500.0,1967,2070,10965,20155 days 16:47:18.691807,192,1.7777777777777777,3.42,140,-926,1210.0
396450.0,3,1.75,1540,12446,1.0,5,8,1540,0.0,1967,1330,11508,20155 days 16:47:18.691807,141,1.7142857142857142,0.0,210,938,1540.0
565000.0,5,1.75,1910,9720,1.0,4,7,1390,520.0,1955,1750,9720,24538 days 16:47:18.691807,232,2.857142857142857,2.673076923076923,160,0,870.0
410000.0,3,1.75,1760,3520,1.0,3,7,1160,600.0,1966,1840,5000,20520 days 16:47:18.691807,236,1.7142857142857142,1.9333333333333333,-80,-1480,560.0
1190000.0,4,3.0,2240,6000,1.5,4,8,1270,970.0,1914,2240,4250,39513 days 16:47:18.691807,139,1.3333333333333333,1.309278350515464,0,1750,300.0
225000.0,2,1.0,1396,111949,1.0,3,7,1396,0.0,1940,2020,111949,30017 days 16:47:18.691807,141,2.0,0.0,-624,0,1396.0
640000.0,4,2.75,3040,7274,2.0,3,9,2320,720.0,1986,2830,10080,13215 days 16:47:18.691807,192,1.4545454545454546,3.2222222222222223,210,-2806,1600.0
374000.0,2,1.0,1140,5650,1.0,3,6,980,160.0,1920,1220,5700,37322 days 16:47:18.691807,253,2.0,6.125,-80,-50,820.0
415000.0,4,2.0,1780,12161,1.0,5,7,1160,620.0,1950,1780,8170,26364 days 16:47:18.691807,105,2.0,1.8709677419354838,0,3991,540.0
592500.0,4,2.5,3370,35150,1.0,5,8,1770,1600.0,1993,2920,41241,10658 days 16:47:18.691807,231,1.6,1.10625,450,-6091,170.0
365000.0,3,2.5,1484,1761,3.0,3,7,1484,0.0,2003,1484,4320,7006 days 16:47:18.691807,247,1.2,0.0,0,-2559,1484.0
600000.0,4,2.5,2230,12753,1.0,4,7,1180,1050.0,1981,1860,12753,15041 days 16:47:18.691807,257,1.6,1.1238095238095238,370,0,130.0
465000.0,4,2.5,2820,39413,2.0,4,9,2820,0.0,1989,2910,39413,12119 days 16:47:18.691807,350,1.6,0.0,-90,0,2820.0
254999.0,3,1.0,1580,7560,1.0,4,7,1000,580.0,1976,1580,7560,16868 days 16:47:18.691807,112,3.0,1.7241379310344827,0,0,420.0
279000.0,4,2.5,2040,8076,2.0,3,7,2040,0.0,1994,2040,8408,10293 days 16:47:18.691807,259,1.6,0.0,0,-332,2040.0
460000.0,3,2.5,2720,40813,2.0,3,8,2720,0.0,2001,2250,40511,7736 days 16:47:18.691807,365,1.2,0.0,470,302,2720.0
507000.0,4,2.25,1490,956,2.0,3,7,1020,470.0,2005,1510,1350,6275 days 16:47:18.691807,209,1.7777777777777777,2.1702127659574466,-20,-394,550.0
291000.0,3,1.75,1560,9788,1.0,3,7,1560,0.0,1964,1840,11180,21251 days 16:47:18.691807,140,1.7142857142857142,0.0,-280,-1392,1560.0
350000.0,2,1.5,830,1077,2.0,3,7,830,0.0,2006,830,1366,5910 days 16:47:18.691807,336,1.3333333333333333,0.0,0,-289,830.0
90000.0,3,1.0,980,2490,2.0,4,6,980,0.0,1969,980,3154,19424 days 16:47:18.691807,333,3.0,0.0,0,-664,980.0
329000.0,3,1.75,1980,7000,1.0,4,8,1360,620.0,1977,1880,7200,16502 days 16:47:18.691807,218,1.7142857142857142,2.193548387096774,100,-200,740.0
909000.0,4,2.5,3680,11648,2.0,3,1,3680,0.0,1986,2830,11251,13215 days 16:47:18.691807,226,1.6,0.0,850,397,3680.0
187000.0,2,1.0,860,5400,1.0,4,5,860,0.0,1953,960,5400,25268 days 16:47:18.691807,288,2.0,0.0,-100,0,860.0
580000.0,3,1.75,1850,5100,1.0,3,7,1020,830.0,1909,1850,5100,41339 days 16:47:18.691807,190,1.7142857142857142,1.2289156626506024,0,0,190.0
345000.0,3,2.5,1620,5992,2.0,3,7,1620,0.0,2001,1620,4644,7736 days 16:47:18.691807,246,1.2,0.0,0,1348,1620.0
497000.0,4,2.5,2240,7200,2.0,3,8,2240,0.0,1995,1860,6600,9928 days 16:47:18.691807,135,1.6,0.0,380,600,2240.0
345000.0,3,1.0,1010,3060,1.5,3,6,1010,0.0,1904,1330,4590,43166 days 16:47:18.691807,227,3.0,0.0,-320,-1530,1010.0
313500.0,3,1.75,1610,7350,1.0,3,8,1610,0.0,1974,2120,7350,17598 days 16:47:18.691807,323,1.7142857142857142,0.0,-510,0,1610.0
910000.0,3,2.5,2720,7250,2.0,3,9,2720,0.0,1990,2870,7250,11754 days 16:47:18.691807,092,1.2,0.0,-150,0,2720.0
399950.0,3,1.5,2080,5244,1.0,3,7,1190,890.0,1959,1850,6982,23077 days 16:47:18.691807,155,2.0,1.3370786516853932,230,-1738,300.0
268000.0,4,2.0,1930,6600,1.0,4,7,1030,900.0,1967,1220,6600,20155 days 16:47:18.691807,147,2.0,1.1444444444444444,710,0,130.0
559000.0,4,1.75,2250,8458,1.0,3,8,1450,800.0,1954,1950,7198,24903 days 16:47:18.691807,363,2.2857142857142856,1.8125,300,1260,650.0
309000.0,3,2.25,1980,8755,1.0,4,7,1300,680.0,1963,2030,8671,21616 days 16:47:18.691807,190,1.3333333333333333,1.911764705882353,-50,84,620.0
410000.0,3,2.5,1960,4400,2.0,3,7,1960,0.0,2006,2060,4400,5910 days 16:47:18.691807,160,1.2,0.0,-100,0,1960.0
259000.0,3,1.0,1320,8625,1.0,4,7,1320,0.0,1957,1370,8295,23807 days 16:47:18.691807,140,3.0,0.0,-50,330,1320.0
950000.0,5,2.0,2940,5500,2.0,4,9,2340,600.0,1909,2940,5500,41339 days 16:47:18.691807,328,2.5,3.9,0,0,1740.0
320000.0,4,1.0,1460,7200,1.5,4,7,1460,0.0,1955,1690,7357,24538 days 16:47:18.691807,336,4.0,0.0,-230,-157,1460.0
1150000.0,4,2.5,2330,30122,1.0,3,8,1490,840.0,1951,2430,6726,25999 days 16:47:18.691807,103,1.6,1.7738095238095237,-100,23396,650.0
394250.0,3,2.0,2620,10107,1.0,3,7,2620,0.0,1982,1730,7812,14676 days 16:47:18.691807,328,1.5,0.0,890,2295,2620.0
315000.0,1,1.0,700,3876,1.0,3,6,700,0.0,1910,1150,3952,40974 days 16:47:18.691807,310,1.0,0.0,-450,-76,700.0
480000.0,2,2.0,1140,12000,1.0,3,6,1140,0.0,1943,1880,6125,28921 days 16:47:18.691807,358,1.0,0.0,-740,5875,1140.0
556000.0,3,2.5,2750,35440,2.0,3,9,2750,0.0,1994,2710,35440,10293 days 16:47:18.691807,216,1.2,0.0,40,0,2750.0
450000.0,3,2.5,2480,5647,2.0,3,7,2480,0.0,2002,2510,5018,7371 days 16:47:18.691807,300,1.2,0.0,-30,629,2480.0
420000.0,3,1.5,1130,5413,1.0,3,7,940,190.0,1946,1400,7168,27825 days 16:47:18.691807,274,2.0,4.947368421052632,-270,-1755,750.0
890000.0,6,3.75,2770,5000,1.0,3,8,1870,900.0,1969,1570,2108,19424 days 16:47:18.691807,076,1.6,2.077777777777778,1200,2892,970.0
410000.0,4,2.25,2150,27345,2.0,5,8,2150,0.0,1976,2200,11923,16868 days 16:47:18.691807,254,1.7777777777777777,0.0,-50,15422,2150.0
308900.0,3,2.5,2250,7294,2.0,3,8,2250,0.0,1994,2140,7363,10293 days 16:47:18.691807,162,1.2,0.0,110,-69,2250.0
1160000.0,4,2.5,2960,26742,1.0,3,8,1480,1480.0,1949,2500,9460,26729 days 16:47:18.691807,295,1.6,1.0,460,17282,0.0
665000.0,2,2.5,2300,6984,1.0,3,8,2300,0.0,2006,1820,4950,5910 days 16:47:18.691807,028,0.8,0.0,480,2034,2300.0
577000.0,3,1.75,1740,5500,1.0,5,7,970,770.0,1953,1740,7250,25268 days 16:47:18.691807,246,1.7142857142857142,1.2597402597402598,0,-1750,200.0
959000.0,3,2.5,2830,3750,3.0,3,1,2830,0.0,2014,1780,5000,2988 days 16:47:18.691807,260,1.2,0.0,1050,-1250,2830.0
471000.0,2,1.75,1240,6417,1.0,5,7,1240,0.0,1924,1800,6417,35861 days 16:47:18.691807,177,1.1428571428571428,0.0,-560,0,1240.0
560000.0,3,2.5,2180,7169,2.0,3,8,2180,0.0,1990,2150,5914,11754 days 16:47:18.691807,111,1.2,0.0,30,1255,2180.0
955000.0,5,2.25,2510,9887,2.0,3,8,2510,0.0,1972,2510,10006,18329 days 16:47:18.691807,134,2.2222222222222223,0.0,0,-119,2510.0
1240000.0,7,5.5,6630,13782,2.0,3,1,4930,1700.0,2004,4470,8639,6641 days 16:47:18.691807,171,1.2727272727272727,2.9,2160,5143,3230.0
579000.0,3,2.5,2300,18540,1.0,3,8,1800,500.0,1961,2460,18540,22346 days 16:47:18.691807,365,1.2,3.6,-160,0,1300.0
335000.0,4,2.25,3220,7889,2.0,3,8,3220,0.0,1978,2120,7651,16137 days 16:47:18.691807,118,1.7777777777777777,0.0,1100,238,3220.0
485000.0,3,2.5,2270,7887,2.0,3,8,2270,0.0,2004,2550,7133,6641 days 16:47:18.691807,258,1.2,0.0,-280,754,2270.0
552000.0,3,2.5,1840,9900,1.0,3,9,1840,0.0,1978,2730,9900,16137 days 16:47:18.691807,183,1.2,0.0,-890,0,1840.0
950000.0,4,3.25,3820,15293,2.0,3,1,3820,0.0,2003,2790,7142,7006 days 16:47:18.691807,195,1.2307692307692308,0.0,1030,8151,3820.0
203700.0,3,2.0,1660,7958,1.0,3,7,1130,530.0,1983,1550,7647,14311 days 16:47:18.691807,075,1.5,2.1320754716981134,110,311,600.0
412000.0,4,3.5,3360,9767,2.0,3,9,2450,910.0,1990,2580,8757,11754 days 16:47:18.691807,190,1.1428571428571428,2.6923076923076925,780,1010,1540.0
237500.0,3,2.0,1350,8960,1.0,4,7,1350,0.0,1986,1470,8288,13215 days 16:47:18.691807,006,1.5,0.0,-120,672,1350.0
866800.0,4,3.5,2970,5000,2.0,3,9,2200,770.0,2001,1470,4560,7736 days 16:47:18.691807,227,1.1428571428571428,2.857142857142857,1500,440,1430.0
425000.0,3,1.0,1000,5100,1.0,3,7,860,140.0,1946,1000,5100,27825 days 16:47:18.691807,069,3.0,6.142857142857143,0,0,720.0
200000.0,3,2.0,1190,6833,1.0,3,7,1190,0.0,1995,1540,8000,9928 days 16:47:18.691807,176,1.5,0.0,-350,-1167,1190.0
280000.0,3,1.75,1670,6034,1.0,3,7,990,680.0,1957,1230,6034,23807 days 16:47:18.691807,272,1.7142857142857142,1.4558823529411764,440,0,310.0
140000.0,3,1.5,1200,2002,2.0,3,8,1200,0.0,1966,1270,1848,20520 days 16:47:18.691807,330,2.0,0.0,-70,154,1200.0
370000.0,5,2.5,2250,10400,1.0,3,8,1280,970.0,1973,2140,9592,17963 days 16:47:18.691807,318,2.0,1.3195876288659794,110,808,310.0
550000.0,2,0.75,1040,4000,1.0,3,7,930,110.0,1909,1700,4800,41339 days 16:47:18.691807,259,2.6666666666666665,8.454545454545455,-660,-800,820.0
1410000.0,2,2.5,3180,9400,2.0,5,1,2610,570.0,1985,3760,9450,13580 days 16:47:18.691807,183,0.8,4.578947368421052,-580,-50,2040.0
1510000.0,2,2.5,3180,9400,2.0,5,1,2610,570.0,1985,3760,9450,13580 days 16:47:18.691807,081,0.8,4.578947368421052,-580,-50,2040.0
510000.0,4,1.5,2040,8800,1.0,4,7,1020,1020.0,1961,1490,8800,22346 days 16:47:18.691807,148,2.6666666666666665,1.0,550,0,0.0
351000.0,3,1.0,1160,10518,1.0,3,7,1160,0.0,1960,1670,9380,22712 days 16:47:18.691807,197,3.0,0.0,-510,1138,1160.0
210000.0,3,1.0,880,10800,1.0,3,6,880,0.0,1942,1100,8820,29286 days 16:47:18.691807,084,3.0,0.0,-220,1980,880.0
449999.0,4,1.75,2290,36900,1.5,5,7,1690,600.0,1938,2170,12434,30747 days 16:47:18.691807,127,2.2857142857142856,2.816666666666667,120,24466,1090.0
137000.0,3,1.0,950,7620,1.0,3,6,950,0.0,1954,1260,7620,24903 days 16:47:18.691807,139,3.0,0.0,-310,0,950.0
270000.0,3,1.0,1010,14510,1.0,5,7,1010,0.0,1974,2020,44866,17598 days 16:47:18.691807,351,3.0,0.0,-1010,-30356,1010.0
565000.0,5,3.0,2560,12480,1.0,3,8,1590,970.0,2012,2500,17299,3719 days 16:47:18.691807,339,1.6666666666666667,1.6391752577319587,60,-4819,620.0
940000.0,4,1.5,2430,3600,2.5,3,8,2430,0.0,1980,2020,4800,15407 days 16:47:18.691807,099,2.6666666666666665,0.0,410,-1200,2430.0
385000.0,2,1.0,830,26329,1.0,4,6,830,0.0,1928,2030,27338,34400 days 16:47:18.691807,167,2.0,0.0,-1200,-1009,830.0
400000.0,3,3.0,2090,7634,1.0,3,8,1450,640.0,2001,2090,9600,7736 days 16:47:18.691807,234,1.0,2.265625,0,-1966,810.0
365000.0,3,2.0,2030,8649,1.0,3,7,2030,0.0,1998,1760,7200,8832 days 16:47:18.691807,080,1.5,0.0,270,1449,2030.0
353250.0,2,1.0,1060,1600,2.0,3,7,1060,0.0,1979,1360,3360,15772 days 16:47:18.691807,142,2.0,0.0,-300,-1760,1060.0
455000.0,2,1.5,1090,6750,1.0,3,7,950,140.0,1942,1640,6750,29286 days 16:47:18.691807,119,1.3333333333333333,6.785714285714286,-550,0,810.0
475000.0,4,3.5,3400,234352,2.0,3,8,2500,900.0,1991,1300,39639,11389 days 16:47:18.691807,147,1.1428571428571428,2.7777777777777777,2100,194713,1600.0
571500.0,4,1.75,1920,7455,1.0,4,7,960,960.0,1939,1920,7455,30382 days 16:47:18.691807,328,2.2857142857142856,1.0,0,0,0.0
441000.0,2,1.0,1150,3000,1.0,3,6,780,370.0,1915,1150,5000,39148 days 16:47:18.691807,087,2.0,2.108108108108108,0,-2000,410.0
550000.0,3,2.25,1880,11556,2.0,3,8,1880,0.0,1987,1880,12000,12850 days 16:47:18.691807,099,1.3333333333333333,0.0,0,-444,1880.0
736000.0,2,1.0,1500,4000,1.0,3,8,1100,400.0,1933,1980,4000,32573 days 16:47:18.691807,183,2.0,2.75,-480,0,700.0
375000.0,3,1.75,2190,17550,1.0,3,7,2190,0.0,1989,1700,17550,12119 days 16:47:18.691807,055,1.7142857142857142,0.0,490,0,2190.0
717500.0,3,2.5,2530,9932,2.0,3,8,2530,0.0,1995,2140,7950,9928 days 16:47:18.691807,036,1.2,0.0,390,1982,2530.0
581000.0,2,1.75,1930,11200,1.0,3,8,1430,500.0,1951,2840,12408,25999 days 16:47:18.691807,325,1.1428571428571428,2.86,-910,-1208,930.0
629000.0,3,2.0,1510,4560,2.0,4,7,1510,0.0,1909,1990,5000,41339 days 16:47:18.691807,206,1.5,0.0,-480,-440,1510.0
3800000.0,3,4.25,5510,35000,2.0,3,1,4910,600.0,1997,3430,45302,9197 days 16:47:18.691807,254,0.7058823529411765,8.183333333333334,2080,-10302,4310.0
225000.0,3,2.0,1100,5200,1.0,3,6,1100,0.0,1969,1050,5330,19424 days 16:47:18.691807,342,1.5,0.0,50,-130,1100.0
315000.0,3,2.5,1730,6368,2.0,3,7,1730,0.0,1993,1780,6597,10658 days 16:47:18.691807,169,1.2,0.0,-50,-229,1730.0
425000.0,3,2.5,1480,1386,3.0,3,8,1480,0.0,2005,1470,1593,6275 days 16:47:18.691807,069,1.2,0.0,10,-207,1480.0
346500.0,3,1.0,1150,11802,1.0,4,7,1150,0.0,1932,1880,6082,32939 days 16:47:18.691807,176,3.0,0.0,-730,5720,1150.0
550000.0,3,2.25,1950,26500,1.0,4,8,1570,380.0,1965,2160,12751,20885 days 16:47:18.691807,005,1.3333333333333333,4.131578947368421,-210,13749,1190.0
565000.0,3,1.75,2380,10450,1.0,3,8,1400,980.0,1977,2150,9600,16502 days 16:47:18.691807,040,1.7142857142857142,1.4285714285714286,230,850,420.0
1000000.0,4,2.0,3100,8000,1.5,5,7,2040,1060.0,1939,1650,4000,30382 days 16:47:18.691807,358,2.0,1.9245283018867925,1450,4000,980.0
400000.0,2,2.0,2010,3797,1.5,3,7,1450,560.0,1922,1660,4650,36591 days 16:47:18.691807,217,1.0,2.5892857142857144,350,-853,890.0
724950.0,4,2.0,2270,5760,2.0,4,8,2270,0.0,1909,1420,5760,41339 days 16:47:18.691807,325,2.0,0.0,850,0,2270.0
623000.0,3,1.75,2050,16313,1.0,2,8,2050,0.0,1973,3180,10264,17963 days 16:47:18.691807,189,1.7142857142857142,0.0,-1130,6049,2050.0
295000.0,2,1.0,650,5400,1.0,3,6,650,0.0,1950,1310,4906,26364 days 16:47:18.691807,175,2.0,0.0,-660,494,650.0
700000.0,4,3.25,2780,7875,2.0,3,9,2780,0.0,2006,1000,7500,5910 days 16:47:18.691807,141,1.2307692307692308,0.0,1780,375,2780.0
482000.0,2,1.5,1300,1229,2.0,3,8,1160,140.0,2000,1430,1255,8102 days 16:47:18.691807,098,1.3333333333333333,8.285714285714286,-130,-26,1020.0
770000.0,3,2.5,2730,11380,2.0,3,1,2730,0.0,1995,2800,10070,9928 days 16:47:18.691807,233,1.2,0.0,-70,1310,2730.0
310000.0,4,2.5,3140,22100,1.0,4,8,1820,1320.0,1960,2700,25500,22712 days 16:47:18.691807,290,1.6,1.378787878787879,440,-3400,500.0
720000.0,4,2.25,2410,8400,2.0,5,8,2410,0.0,1965,1910,8056,20885 days 16:47:18.691807,189,1.7777777777777777,0.0,500,344,2410.0
355000.0,3,1.0,1180,5965,1.5,4,6,1180,0.0,1928,1270,7710,34400 days 16:47:18.691807,078,3.0,0.0,-90,-1745,1180.0
512000.0,4,2.5,2600,4506,2.0,3,9,2600,0.0,2005,2470,6041,6275 days 16:47:18.691807,210,1.6,0.0,130,-1535,2600.0
303000.0,2,1.5,1400,1650,3.0,3,7,1400,0.0,1999,1430,1650,8467 days 16:47:18.691807,350,1.3333333333333333,0.0,-30,0,1400.0
299000.0,5,2.5,2220,9360,1.0,4,7,1110,1110.0,1968,1780,7704,19790 days 16:47:18.691807,169,2.0,1.0,440,1656,0.0
285000.0,3,2.5,1660,6263,2.0,3,8,1660,0.0,2003,2190,6192,7006 days 16:47:18.691807,174,1.2,0.0,-530,71,1660.0
680000.0,3,1.75,2330,9652,1.0,4,8,1590,740.0,1968,2420,9631,19790 days 16:47:18.691807,267,1.7142857142857142,2.1486486486486487,-90,21,850.0
285000.0,4,1.75,1440,6720,1.0,5,6,720,720.0,1954,1820,6784,24903 days 16:47:18.691807,245,2.2857142857142856,1.0,-380,-64,0.0
707000.0,4,2.25,2920,17023,1.0,4,9,1690,1230.0,1977,2710,10681,16502 days 16:47:18.691807,329,1.7777777777777777,1.3739837398373984,210,6342,460.0
690000.0,3,2.0,1760,6428,1.0,4,7,980,780.0,1942,1760,6004,29286 days 16:47:18.691807,127,1.5,1.2564102564102564,0,424,200.0
872000.0,4,2.25,2860,40284,2.0,3,1,2860,0.0,1983,2670,92782,14311 days 16:47:18.691807,112,1.7777777777777777,0.0,190,-52498,2860.0
290000.0,4,1.75,2090,12750,1.0,3,8,1360,730.0,1967,2040,12300,20155 days 16:47:18.691807,308,2.2857142857142856,1.8630136986301369,50,450,630.0
925000.0,3,2.75,3280,10558,1.0,4,9,2040,1240.0,1979,3150,9998,15772 days 16:47:18.691807,026,1.0909090909090908,1.6451612903225807,130,560,800.0
340500.0,3,1.0,1770,12458,1.0,3,7,1770,0.0,1957,2000,8225,23807 days 16:47:18.691807,353,3.0,0.0,-230,4233,1770.0
365000.0,2,1.0,920,6600,1.0,4,6,920,0.0,1910,1370,5500,40974 days 16:47:18.691807,325,2.0,0.0,-450,1100,920.0
725000.0,3,1.75,1690,8489,1.0,4,7,1690,0.0,1959,1850,8536,23077 days 16:47:18.691807,191,1.7142857142857142,0.0,-160,-47,1690.0
811000.0,3,3.0,2470,7410,2.0,5,8,1860,610.0,1977,2390,7800,16502 days 16:47:18.691807,183,1.0,3.0491803278688523,80,-390,1250.0
299000.0,3,1.0,1040,9514,1.0,4,7,1040,0.0,1969,1040,9514,19424 days 16:47:18.691807,344,3.0,0.0,0,0,1040.0
287500.0,4,2.0,1220,9147,1.0,5,7,1220,0.0,1953,1220,8576,25268 days 16:47:18.691807,111,2.0,0.0,0,571,1220.0
879950.0,4,2.25,3500,13875,1.0,4,9,1830,1670.0,1938,2960,15000,30747 days 16:47:18.691807,140,1.7777777777777777,1.095808383233533,540,-1125,160.0
135900.0,2,1.0,760,3800,1.0,3,6,760,0.0,1950,1220,7410,26364 days 16:47:18.691807,314,2.0,0.0,-460,-3610,760.0
1230000.0,4,2.25,3070,16028,1.0,3,9,1870,1200.0,1976,3070,19822,16868 days 16:47:18.691807,132,1.7777777777777777,1.5583333333333333,0,-3794,670.0
522500.0,4,1.75,2100,6480,1.0,5,7,1300,800.0,1947,1840,7500,27460 days 16:47:18.691807,290,2.2857142857142856,1.625,260,-1020,500.0
399500.0,4,1.5,1660,6617,1.0,5,7,1660,0.0,1947,950,7440,27460 days 16:47:18.691807,071,2.6666666666666665,0.0,710,-823,1660.0
450000.0,3,1.0,1430,5960,1.5,4,7,1430,0.0,1917,1140,3960,38417 days 16:47:18.691807,124,3.0,0.0,290,2000,1430.0
289999.0,3,2.0,1490,9285,1.0,3,8,1490,0.0,1995,2040,6681,9928 days 16:47:18.691807,086,1.5,0.0,-550,2604,1490.0
540000.0,2,1.0,1170,4750,1.0,3,6,1170,0.0,1903,1170,2023,43531 days 16:47:18.691807,055,2.0,0.0,0,2727,1170.0
324950.0,3,1.0,1240,7500,1.0,4,7,1240,0.0,1976,1240,9750,16868 days 16:47:18.691807,206,3.0,0.0,0,-2250,1240.0
718500.0,3,2.0,2910,6600,2.0,4,7,1920,990.0,1900,1370,5500,44626 days 16:47:18.691807,164,1.5,1.9393939393939394,1540,1100,930.0
495000.0,3,2.0,2660,192099,1.0,4,9,2660,0.0,1964,2570,43561,21251 days 16:47:18.691807,190,1.5,0.0,90,148538,2660.0
260000.0,6,2.0,2220,8797,1.0,3,7,2220,0.0,1977,1170,5123,16502 days 16:47:18.691807,141,3.0,0.0,1050,3674,2220.0
430000.0,4,1.5,1920,10000,1.0,4,7,1070,850.0,1954,1450,10836,24903 days 16:47:18.691807,122,2.6666666666666665,1.2588235294117647,470,-836,220.0
402500.0,3,3.25,2780,4002,2.0,3,8,2780,0.0,2009,1890,4090,4814 days 16:47:18.691807,154,0.9230769230769231,0.0,890,-88,2780.0
1420000.0,4,3.0,3110,4408,2.5,4,1,2510,600.0,1931,3250,5669,33304 days 16:47:18.691807,223,1.3333333333333333,4.183333333333334,-140,-1261,1910.0
275000.0,3,2.25,1820,9766,1.0,4,7,1450,370.0,1987,1860,8236,12850 days 16:47:18.691807,301,1.3333333333333333,3.918918918918919,-40,1530,1080.0
250000.0,3,2.25,1765,7652,2.0,3,7,1765,0.0,1996,1765,7719,9563 days 16:47:18.691807,154,1.3333333333333333,0.0,0,-67,1765.0
665000.0,3,2.75,1800,9550,1.0,4,7,1320,480.0,1966,1890,9902,20520 days 16:47:18.691807,143,1.0909090909090908,2.75,-90,-352,840.0
425000.0,3,2.5,2650,144183,1.0,3,8,2650,0.0,1967,1940,41210,20155 days 16:47:18.691807,034,1.2,0.0,710,102973,2650.0
760000.0,2,1.0,1410,3600,1.5,4,7,1310,100.0,1925,1740,4200,35495 days 16:47:18.691807,203,2.0,13.1,-330,-600,1210.0
447000.0,3,2.5,1650,3076,2.0,3,7,1650,0.0,2003,1560,3064,7006 days 16:47:18.691807,226,1.2,0.0,90,12,1650.0
205000.0,3,1.0,1180,8240,1.0,4,7,1180,0.0,1967,1180,7840,20155 days 16:47:18.691807,189,3.0,0.0,0,400,1180.0
191000.0,3,1.5,800,8850,1.0,4,6,800,0.0,1959,820,8775,23077 days 16:47:18.691807,126,2.0,0.0,-20,75,800.0
350000.0,2,1.75,1430,7921,1.0,3,7,1430,0.0,1983,1290,8040,14311 days 16:47:18.691807,075,1.1428571428571428,0.0,140,-119,1430.0
789888.0,5,3.5,3300,7860,2.0,3,9,2410,890.0,2001,2540,9920,7736 days 16:47:18.691807,089,1.4285714285714286,2.707865168539326,760,-2060,1520.0
443000.0,2,1.0,1220,10170,1.0,3,7,980,240.0,1948,1990,9064,27095 days 16:47:18.691807,082,2.0,4.083333333333333,-770,1106,740.0
695000.0,4,3.5,3530,7202,2.0,3,9,2660,870.0,2000,2810,8100,8102 days 16:47:18.691807,272,1.1428571428571428,3.057471264367816,720,-898,1790.0
560000.0,4,2.0,1380,4048,1.5,4,7,1380,0.0,1906,1440,3956,42435 days 16:47:18.691807,044,2.0,0.0,-60,92,1380.0
550000.0,3,1.75,1410,5000,1.0,4,7,810,600.0,1923,1760,5000,36226 days 16:47:18.691807,195,1.7142857142857142,1.35,-350,0,210.0
850000.0,2,2.5,3360,6750,2.0,3,9,3360,0.0,2004,2510,6750,6641 days 16:47:18.691807,205,0.8,0.0,850,0,3360.0
352750.0,4,2.75,2270,24237,1.0,4,7,1360,910.0,1977,2050,8016,16502 days 16:47:18.691807,110,1.4545454545454546,1.4945054945054945,220,16221,450.0
550000.0,4,2.5,2890,9045,2.0,3,8,2890,0.0,2001,2840,10114,7736 days 16:47:18.691807,230,1.6,0.0,50,-1069,2890.0
250000.0,3,1.0,1010,8711,1.0,5,6,1010,0.0,1944,1250,8053,28556 days 16:47:18.691807,191,3.0,0.0,-240,658,1010.0
962800.0,4,2.5,3780,23623,2.0,3,9,3780,0.0,1997,3370,10210,9197 days 16:47:18.691807,237,1.6,0.0,410,13413,3780.0
299500.0,3,1.75,1880,11700,1.0,4,7,1880,0.0,1968,2230,35200,19790 days 16:47:18.691807,308,1.7142857142857142,0.0,-350,-23500,1880.0
250000.0,2,1.0,800,5220,1.0,3,6,800,0.0,1943,1910,5376,28921 days 16:47:18.691807,307,2.0,0.0,-1110,-156,800.0
745000.0,5,4.0,4720,493534,2.0,5,9,3960,760.0,1975,2160,219542,17233 days 16:47:18.691807,016,1.25,5.2105263157894735,2560,273992,3200.0
279475.0,2,1.0,1060,10600,1.5,3,6,1060,0.0,1968,1560,21344,19790 days 16:47:18.691807,048,2.0,0.0,-500,-10744,1060.0
450000.0,3,2.25,2530,27227,2.0,3,8,2530,0.0,1987,2160,30192,12850 days 16:47:18.691807,336,1.3333333333333333,0.0,370,-2965,2530.0
307700.0,5,2.25,1980,13132,1.0,4,7,1260,720.0,1962,1880,11325,21981 days 16:47:18.691807,238,2.2222222222222223,1.75,100,1807,540.0
665000.0,3,1.0,1650,5102,1.0,4,8,1300,350.0,1953,1440,5102,25268 days 16:47:18.691807,345,3.0,3.7142857142857144,210,0,950.0
375000.0,3,2.75,1890,3930,2.0,3,8,1890,0.0,1999,2100,4259,8467 days 16:47:18.691807,205,1.0909090909090908,0.0,-210,-329,1890.0
420000.0,4,2.5,3360,11637,2.0,3,1,3360,0.0,1990,3530,11205,11754 days 16:47:18.691807,062,1.6,0.0,-170,432,3360.0
148000.0,2,1.0,630,4200,1.0,3,6,630,0.0,1930,970,4200,33669 days 16:47:18.691807,189,2.0,0.0,-340,0,630.0
707000.0,3,1.5,1980,4000,2.0,3,8,1980,0.0,1919,1980,3600,37687 days 16:47:18.691807,210,2.0,0.0,0,400,1980.0
399000.0,3,1.0,990,4250,1.0,4,7,840,150.0,1924,990,4500,35861 days 16:47:18.691807,316,3.0,5.6,0,-250,690.0
853000.0,4,2.25,3440,35025,2.0,3,1,3440,0.0,1988,3210,35005,12485 days 16:47:18.691807,082,1.7777777777777777,0.0,230,20,3440.0
400000.0,3,1.0,1300,14138,1.0,4,7,1300,0.0,1943,2440,12196,28921 days 16:47:18.691807,356,3.0,0.0,-1140,1942,1300.0
615000.0,2,1.75,2040,28593,1.5,4,7,2040,0.0,1919,2040,35124,37687 days 16:47:18.691807,132,1.1428571428571428,0.0,0,-6531,2040.0
463000.0,3,1.0,1250,7700,1.0,4,7,1250,0.0,1955,1520,7700,24538 days 16:47:18.691807,006,3.0,0.0,-270,0,1250.0
600000.0,4,2.5,1960,14242,1.0,4,8,1290,670.0,1958,2490,10907,23442 days 16:47:18.691807,154,1.6,1.9253731343283582,-530,3335,620.0
429000.0,5,2.5,2720,8120,1.0,3,7,1360,1360.0,1970,2020,8120,19059 days 16:47:18.691807,301,2.0,1.0,700,0,0.0
980000.0,4,4.25,3250,11780,2.0,3,8,2360,890.0,1944,1800,9000,28556 days 16:47:18.691807,247,0.9411764705882353,2.651685393258427,1450,2780,1470.0
359500.0,6,3.75,3190,4700,2.0,3,8,3190,0.0,2003,2680,5640,7006 days 16:47:18.691807,111,1.6,0.0,510,-940,3190.0
715000.0,4,2.5,2570,7980,2.0,3,9,2570,0.0,1998,2760,6866,8832 days 16:47:18.691807,311,1.6,0.0,-190,1114,2570.0
240000.0,3,1.75,1420,6984,1.0,4,7,980,440.0,1980,1430,7875,15407 days 16:47:18.691807,084,1.7142857142857142,2.227272727272727,-10,-891,540.0
455000.0,4,2.0,2120,9442,1.0,5,7,1060,1060.0,1968,1290,9600,19790 days 16:47:18.691807,349,2.0,1.0,830,-158,0.0
610000.0,3,2.5,2080,167270,1.0,3,7,2080,0.0,2000,2080,55321,8102 days 16:47:18.691807,290,1.2,0.0,0,111949,2080.0
675000.0,3,2.75,2740,5735,2.0,3,9,2740,0.0,2004,2210,5026,6641 days 16:47:18.691807,070,1.0909090909090908,0.0,530,709,2740.0
283500.0,3,1.75,1250,5375,1.0,3,7,1250,0.0,1985,1320,6258,13580 days 16:47:18.691807,029,1.7142857142857142,0.0,-70,-883,1250.0
235000.0,2,1.0,2150,4500,1.5,3,7,1260,890.0,1917,1590,5010,38417 days 16:47:18.691807,238,2.0,1.4157303370786516,560,-510,370.0
827000.0,4,2.5,3230,12100,1.0,3,9,1870,1360.0,1977,2670,10200,16502 days 16:47:18.691807,177,1.6,1.375,560,1900,510.0
353000.0,2,1.0,860,8511,1.0,3,7,860,0.0,1949,1554,8499,26729 days 16:47:18.691807,253,2.0,0.0,-694,12,860.0
747500.0,4,2.5,2810,11902,2.0,4,9,2810,0.0,1993,2990,10754,10658 days 16:47:18.691807,266,1.6,0.0,-180,1148,2810.0
341000.0,2,1.0,1040,4000,1.0,3,6,1040,0.0,1914,1740,4000,39513 days 16:47:18.691807,102,2.0,0.0,-700,0,1040.0
182000.0,3,1.0,1160,18055,1.0,2,5,1160,0.0,1950,1340,10324,26364 days 16:47:18.691807,328,3.0,0.0,-180,7731,1160.0
250000.0,3,2.0,1470,2781,2.0,3,6,1470,0.0,2003,1360,3008,7006 days 16:47:18.691807,336,1.5,0.0,110,-227,1470.0
655000.0,4,3.5,2350,13402,2.0,3,8,1670,680.0,1994,2250,9474,10293 days 16:47:18.691807,141,1.1428571428571428,2.4558823529411766,100,3928,990.0
405000.0,3,2.25,1660,8307,1.0,4,8,1660,0.0,1961,2510,7800,22346 days 16:47:18.691807,127,1.3333333333333333,0.0,-850,507,1660.0
390000.0,4,1.75,2020,9750,1.0,3,7,1100,920.0,1975,1670,9600,17233 days 16:47:18.691807,230,2.2857142857142856,1.1956521739130435,350,150,180.0
275400.0,2,1.0,890,8180,1.0,3,7,890,0.0,1947,1130,8180,27460 days 16:47:18.691807,281,2.0,0.0,-240,0,890.0
791000.0,3,2.25,2430,5500,2.0,3,8,1810,620.0,1989,2040,5500,12119 days 16:47:18.691807,155,1.3333333333333333,2.9193548387096775,390,0,1190.0
424500.0,3,1.75,1460,7700,1.0,3,7,1460,0.0,1979,1720,7280,15772 days 16:47:18.691807,128,1.7142857142857142,0.0,-260,420,1460.0
430000.0,3,1.0,980,7200,1.0,4,7,980,0.0,1950,1180,6572,26364 days 16:47:18.691807,168,3.0,0.0,-200,628,980.0
865000.0,4,2.5,2580,10631,2.0,4,9,2580,0.0,1992,4220,10631,11024 days 16:47:18.691807,125,1.6,0.0,-1640,0,2580.0
163000.0,2,2.0,1250,7543,1.0,3,7,1250,0.0,1962,1250,7506,21981 days 16:47:18.691807,063,1.0,0.0,0,37,1250.0
920000.0,4,2.75,3140,9085,1.0,5,8,1570,1570.0,1961,2430,9350,22346 days 16:47:18.691807,251,1.4545454545454546,1.0,710,-265,0.0
1030000.0,5,3.25,2680,3011,2.0,3,9,1870,810.0,1910,3440,5165,40974 days 16:47:18.691807,345,1.5384615384615385,2.308641975308642,-760,-2154,1060.0
325000.0,3,1.75,1810,8048,1.0,4,7,1290,520.0,1983,1550,9081,14311 days 16:47:18.691807,205,1.7142857142857142,2.480769230769231,260,-1033,770.0
315000.0,5,2.5,2090,4698,2.0,3,7,2090,0.0,1998,2070,4698,8832 days 16:47:18.691807,154,2.0,0.0,20,0,2090.0
179000.0,4,1.75,1790,7175,1.5,3,6,1410,380.0,1900,1790,8417,44626 days 16:47:18.691807,210,2.2857142857142856,3.710526315789474,0,-1242,1030.0
276000.0,2,1.0,870,2676,1.0,3,7,820,50.0,2004,1500,1719,6641 days 16:47:18.691807,282,2.0,16.4,-630,957,770.0
335000.0,4,1.5,3160,19745,1.5,4,6,1840,1320.0,1968,1540,8611,19790 days 16:47:18.691807,062,2.6666666666666665,1.393939393939394,1620,11134,520.0
430000.0,3,2.0,2350,12480,1.0,3,7,1600,750.0,1981,2160,12000,15041 days 16:47:18.691807,318,1.5,2.1333333333333333,190,480,850.0
266490.0,3,2.5,1810,4113,2.0,3,7,1810,0.0,2004,1880,4465,6641 days 16:47:18.691807,322,1.2,0.0,-70,-352,1810.0
655000.0,4,2.75,3160,8197,1.0,3,8,1580,1580.0,1962,2050,8197,21981 days 16:47:18.691807,218,1.4545454545454546,1.0,1110,0,0.0
635500.0,3,2.0,1660,3600,1.0,3,7,1000,660.0,1939,1700,4356,30382 days 16:47:18.691807,318,1.5,1.5151515151515151,-40,-756,340.0
235000.0,5,2.5,2500,9583,1.0,3,7,1300,1200.0,1979,2120,19352,15772 days 16:47:18.691807,177,2.0,1.0833333333333333,380,-9769,100.0
885000.0,3,2.5,2880,11443,2.0,4,9,2880,0.0,1986,2840,12530,13215 days 16:47:18.691807,117,1.2,0.0,40,-1087,2880.0
352500.0,3,1.0,1470,8400,1.0,4,7,1470,0.0,1953,1470,8400,25268 days 16:47:18.691807,230,3.0,0.0,0,0,1470.0
450000.0,3,2.5,1460,7573,2.0,3,8,1460,0.0,1983,1910,7668,14311 days 16:47:18.691807,190,1.2,0.0,-450,-95,1460.0
3640000.0,5,6.0,5490,19897,2.0,3,1,5490,0.0,2005,2910,17600,6275 days 16:47:18.691807,284,0.8333333333333334,0.0,2580,2297,5490.0
1050000.0,3,2.25,2480,15022,1.0,3,9,1330,1150.0,1967,2500,8178,20155 days 16:47:18.691807,262,1.3333333333333333,1.1565217391304348,-20,6844,180.0
476000.0,2,2.25,1140,1332,3.0,3,8,1140,0.0,1999,1140,1267,8467 days 16:47:18.691807,325,0.8888888888888888,0.0,0,65,1140.0
375000.0,3,2.5,1830,13042,2.0,3,8,1830,0.0,1990,1940,6996,11754 days 16:47:18.691807,127,1.2,0.0,-110,6046,1830.0
600600.0,4,3.5,3110,6829,2.0,3,8,3110,0.0,2014,2910,7425,2988 days 16:47:18.691807,252,1.1428571428571428,0.0,200,-596,3110.0
567000.0,4,1.75,2630,11213,1.0,4,8,1430,1200.0,1948,2240,15186,27095 days 16:47:18.691807,321,2.2857142857142856,1.1916666666666667,390,-3973,230.0
650000.0,4,1.75,2390,12000,1.0,3,8,1470,920.0,1979,2110,12000,15772 days 16:47:18.691807,206,2.2857142857142856,1.5978260869565217,280,0,550.0
190000.0,5,2.0,1750,10284,1.0,4,5,1750,0.0,1943,1560,9010,28921 days 16:47:18.691807,155,2.5,0.0,190,1274,1750.0
858000.0,4,3.5,4370,422967,1.0,4,1,2580,1790.0,1978,3260,422967,16137 days 16:47:18.691807,274,1.1428571428571428,1.441340782122905,1110,0,790.0
435500.0,1,1.75,1020,4512,1.0,3,7,770,250.0,1937,1230,5029,31112 days 16:47:18.691807,015,0.5714285714285714,3.08,-210,-517,520.0
685000.0,3,2.0,2500,6733,1.0,3,8,1770,730.0,1979,1770,6343,15772 days 16:47:18.691807,070,1.5,2.4246575342465753,730,390,1040.0
252000.0,3,2.0,1540,7210,2.0,4,7,1540,0.0,1984,1500,7210,13946 days 16:47:18.691807,323,1.5,0.0,40,0,1540.0
512500.0,4,2.25,2200,6900,2.0,4,8,2200,0.0,1975,2400,6900,17233 days 16:47:18.691807,255,1.7777777777777777,0.0,-200,0,2200.0
423800.0,3,2.5,1940,7415,2.0,3,8,1940,0.0,1965,1940,8425,20885 days 16:47:18.691807,213,1.2,0.0,0,-1010,1940.0
460000.0,3,2.25,1453,2225,2.0,4,8,1453,0.0,1986,1860,2526,13215 days 16:47:18.691807,124,1.3333333333333333,0.0,-407,-301,1453.0
434000.0,3,2.75,1830,3200,2.0,3,8,1830,0.0,1991,2030,3331,11389 days 16:47:18.691807,203,1.0909090909090908,0.0,-200,-131,1830.0
244000.0,3,1.0,2000,15900,1.0,3,6,1000,1000.0,1948,1760,10500,27095 days 16:47:18.691807,104,3.0,1.0,240,5400,0.0
348125.0,3,1.0,1400,8451,1.5,3,7,1400,0.0,1953,1590,8433,25268 days 16:47:18.691807,048,3.0,0.0,-190,18,1400.0
585000.0,4,3.25,2400,29252,2.0,4,8,2400,0.0,1982,2280,45000,14676 days 16:47:18.691807,129,1.2307692307692308,0.0,120,-15748,2400.0
230000.0,3,1.0,1390,16000,1.0,4,6,1390,0.0,1960,1420,10000,22712 days 16:47:18.691807,128,3.0,0.0,-30,6000,1390.0
450000.0,3,2.0,1680,11250,1.0,4,8,1680,0.0,1967,1760,12160,20155 days 16:47:18.691807,217,1.5,0.0,-80,-910,1680.0
393000.0,5,2.0,1820,5054,1.0,4,7,910,910.0,1970,1180,5628,19059 days 16:47:18.691807,082,2.5,1.0,640,-574,0.0
517000.0,2,1.0,1140,3750,1.0,4,7,1140,0.0,1925,1660,4000,35495 days 16:47:18.691807,355,2.0,0.0,-520,-250,1140.0
400000.0,3,1.0,1060,12690,1.0,3,7,1060,0.0,1969,1920,10200,19424 days 16:47:18.691807,258,3.0,0.0,-860,2490,1060.0
890000.0,2,1.75,3050,50965,2.0,3,1,3050,0.0,1991,3050,40107,11389 days 16:47:18.691807,063,1.1428571428571428,0.0,0,10858,3050.0
205950.0,3,1.0,970,11963,1.0,4,6,970,0.0,1970,1210,11963,19059 days 16:47:18.691807,069,3.0,0.0,-240,0,970.0
209000.0,3,1.0,1320,3954,1.5,3,6,1320,0.0,1912,1270,5184,40244 days 16:47:18.691807,337,3.0,0.0,50,-1230,1320.0
430000.0,4,1.75,1890,6000,1.0,4,6,1110,780.0,1947,1560,6356,27460 days 16:47:18.691807,163,2.2857142857142856,1.4230769230769231,330,-356,330.0
534000.0,4,1.75,2040,2750,1.5,4,6,1260,780.0,1926,1940,3750,35130 days 16:47:18.691807,060,2.2857142857142856,1.6153846153846154,100,-1000,480.0
735000.0,4,3.0,2370,3672,1.5,5,7,1650,720.0,1916,2140,4182,38783 days 16:47:18.691807,178,1.3333333333333333,2.2916666666666665,230,-510,930.0
873000.0,3,2.25,2720,54450,2.0,3,1,2720,0.0,1997,3170,60548,9197 days 16:47:18.691807,055,1.3333333333333333,0.0,-450,-6098,2720.0
475000.0,4,2.25,1970,7532,1.0,3,8,1390,580.0,1983,1970,8248,14311 days 16:47:18.691807,322,1.7777777777777777,2.396551724137931,0,-716,810.0
325000.0,3,1.75,2180,10230,1.0,4,7,1090,1090.0,1961,2130,7200,22346 days 16:47:18.691807,150,1.7142857142857142,1.0,50,3030,0.0
500000.0,3,2.25,2990,216057,2.0,3,9,2990,0.0,1994,2840,215622,10293 days 16:47:18.691807,226,1.3333333333333333,0.0,150,435,2990.0
279000.0,4,2.75,2180,8475,1.0,4,7,1330,850.0,1987,1500,7140,12850 days 16:47:18.691807,020,1.4545454545454546,1.5647058823529412,680,1335,480.0
350000.0,3,2.0,1440,5469,1.0,3,8,1440,0.0,1988,1980,6198,12485 days 16:47:18.691807,104,1.5,0.0,-540,-729,1440.0
660000.0,4,2.25,3180,13653,2.0,3,9,3180,0.0,1978,2910,12350,16137 days 16:47:18.691807,111,1.7777777777777777,0.0,270,1303,3180.0
324950.0,2,1.5,1643,14616,1.0,4,7,1643,0.0,1954,2270,9940,24903 days 16:47:18.691807,049,1.3333333333333333,0.0,-627,4676,1643.0
500000.0,4,2.0,1530,7816,1.0,3,7,1530,0.0,1955,1480,7816,24538 days 16:47:18.691807,027,2.0,0.0,50,0,1530.0
187300.0,2,1.0,1310,7697,1.0,3,6,850,460.0,1950,1270,6410,26364 days 16:47:18.691807,199,2.0,1.8478260869565217,40,1287,390.0
345600.0,5,3.5,2800,5120,2.5,3,9,2800,0.0,1903,1780,5120,43531 days 16:47:18.691807,140,1.4285714285714286,0.0,1020,0,2800.0
400000.0,3,1.5,1510,7642,1.0,3,7,1510,0.0,1959,2180,8357,23077 days 16:47:18.691807,328,2.0,0.0,-670,-715,1510.0
935000.0,5,3.0,2700,5001,2.0,3,1,2700,0.0,2009,1610,5191,4814 days 16:47:18.691807,022,1.6666666666666667,0.0,1090,-190,2700.0
374000.0,4,1.75,2220,15600,1.0,5,7,1140,1080.0,1963,1670,4800,21616 days 16:47:18.691807,196,2.2857142857142856,1.0555555555555556,550,10800,60.0
328000.0,3,1.75,1440,45302,2.0,3,7,1440,0.0,1977,2080,49658,16502 days 16:47:18.691807,160,1.7142857142857142,0.0,-640,-4356,1440.0
257500.0,3,2.0,1300,9334,1.0,5,7,1300,0.0,1981,2210,9636,15041 days 16:47:18.691807,238,1.5,0.0,-910,-302,1300.0
1000000.0,4,2.5,2230,3600,2.0,5,8,1630,600.0,1906,2410,4800,42435 days 16:47:18.691807,251,1.6,2.716666666666667,-180,-1200,1030.0
216500.0,2,1.75,1390,4482,1.0,4,8,1390,0.0,1980,1390,4680,15407 days 16:47:18.691807,177,1.1428571428571428,0.0,0,-198,1390.0
1190000.0,3,2.25,2760,40946,2.0,5,1,2760,0.0,1978,3030,42253,16137 days 16:47:18.691807,141,1.3333333333333333,0.0,-270,-1307,2760.0
360000.0,4,2.5,3200,7282,2.0,3,9,3200,0.0,2007,3030,7290,5545 days 16:47:18.691807,211,1.6,0.0,170,-8,3200.0
699999.0,3,0.75,1240,4000,1.0,4,7,1240,0.0,1968,1460,4000,19790 days 16:47:18.691807,022,4.0,0.0,-220,0,1240.0
535000.0,3,2.5,1960,47044,2.0,4,8,1960,0.0,1978,2020,29004,16137 days 16:47:18.691807,275,1.2,0.0,-60,18040,1960.0
464950.0,3,2.0,2190,19800,1.0,3,7,2190,0.0,1994,1640,9719,10293 days 16:47:18.691807,078,1.5,0.0,550,10081,2190.0
925000.0,4,2.5,3540,18168,2.0,3,1,3540,0.0,1996,4130,11180,9563 days 16:47:18.691807,336,1.6,0.0,-590,6988,3540.0
930000.0,3,3.25,2640,4080,2.0,3,9,1840,800.0,1912,1990,4080,40244 days 16:47:18.691807,128,0.9230769230769231,2.3,650,0,1040.0
727500.0,3,2.0,2660,5000,1.5,3,8,1940,720.0,1910,2270,5000,40974 days 16:47:18.691807,265,1.5,2.6944444444444446,390,0,1220.0
325000.0,4,1.75,1670,9500,1.0,3,7,1670,0.0,1976,1620,9500,16868 days 16:47:18.691807,071,2.2857142857142856,0.0,50,0,1670.0
695000.0,3,3.25,3080,12100,2.0,3,8,2080,1000.0,1984,2100,6581,13946 days 16:47:18.691807,248,0.9230769230769231,2.08,980,5519,1080.0
585000.0,4,2.75,2890,6825,1.0,3,8,1560,1330.0,1973,1900,10120,17963 days 16:47:18.691807,176,1.4545454545454546,1.1729323308270676,990,-3295,230.0
319000.0,3,2.25,1800,9597,1.0,3,7,1200,600.0,1963,1700,13502,21616 days 16:47:18.691807,269,1.3333333333333333,2.0,100,-3905,600.0
265000.0,6,2.5,2000,7650,1.5,4,7,1790,210.0,1960,1710,7650,22712 days 16:47:18.691807,006,2.4,8.523809523809524,290,0,1580.0
359000.0,5,1.75,1940,6654,1.5,4,7,1940,0.0,1953,2300,9500,25268 days 16:47:18.691807,177,2.857142857142857,0.0,-360,-2846,1940.0
390000.0,5,1.75,1940,6654,1.5,4,7,1940,0.0,1953,2300,9500,25268 days 16:47:18.691807,116,2.857142857142857,0.0,-360,-2846,1940.0
374500.0,3,1.0,960,9531,1.0,5,7,960,0.0,1969,1670,9250,19424 days 16:47:18.691807,028,3.0,0.0,-710,281,960.0
661000.0,2,1.5,1750,46173,2.0,4,8,1750,0.0,1964,2220,42224,21251 days 16:47:18.691807,234,1.3333333333333333,0.0,-470,3949,1750.0
900000.0,3,2.5,2320,5000,2.0,3,8,1620,700.0,1907,2160,5000,42070 days 16:47:18.691807,337,1.2,2.3142857142857145,160,0,920.0
600000.0,5,2.5,2380,8204,1.0,3,8,1540,840.0,1957,2270,8204,23807 days 16:47:18.691807,103,2.0,1.8333333333333333,110,0,700.0
2000000.0,5,4.25,6490,10862,2.0,4,1,3940,2550.0,1991,3290,14080,11389 days 16:47:18.691807,136,1.1764705882352942,1.5450980392156863,3200,-3218,1390.0
512500.0,4,1.75,1620,4240,1.5,5,7,1620,0.0,1916,1450,4240,38783 days 16:47:18.691807,128,2.2857142857142856,0.0,170,0,1620.0
229500.0,3,1.75,1770,33224,1.0,4,8,1770,0.0,1968,1690,22069,19790 days 16:47:18.691807,155,1.7142857142857142,0.0,80,11155,1770.0
589000.0,3,2.5,2320,5663,2.0,3,8,2320,0.0,2003,2500,4500,7006 days 16:47:18.691807,212,1.2,0.0,-180,1163,2320.0
539950.0,3,2.5,1330,2183,3.0,3,8,1330,0.0,2014,1310,5000,2988 days 16:47:18.691807,082,1.2,0.0,20,-2817,1330.0
640000.0,4,2.5,3420,21344,2.0,3,9,3420,0.0,2002,2110,21344,7371 days 16:47:18.691807,293,1.6,0.0,1310,0,3420.0
218250.0,3,1.0,1270,7344,1.0,3,7,970,300.0,1967,1290,7300,20155 days 16:47:18.691807,008,3.0,3.2333333333333334,-20,44,670.0
675000.0,4,3.5,2550,3600,2.0,3,8,1880,670.0,1997,2090,6000,9197 days 16:47:18.691807,056,1.1428571428571428,2.8059701492537314,460,-2400,1210.0
338000.0,5,2.0,1860,9000,2.0,3,7,1860,0.0,1980,1390,9752,15407 days 16:47:18.691807,198,2.5,0.0,470,-752,1860.0
231750.0,3,1.0,1020,7615,1.0,3,7,1020,0.0,1981,1470,9515,15041 days 16:47:18.691807,090,3.0,0.0,-450,-1900,1020.0
199900.0,1,1.0,720,7140,1.0,3,6,720,0.0,1930,1140,7577,33669 days 16:47:18.691807,318,1.0,0.0,-420,-437,720.0
1060000.0,4,3.5,4460,16271,2.0,3,1,4460,0.0,2001,4540,17122,7736 days 16:47:18.691807,274,1.1428571428571428,0.0,-80,-851,4460.0
263000.0,4,2.75,1830,7315,1.0,5,7,1250,580.0,1979,1730,7208,15772 days 16:47:18.691807,275,1.4545454545454546,2.1551724137931036,100,107,670.0
279950.0,3,1.5,1520,7200,1.0,4,7,1160,360.0,1990,1460,7200,11754 days 16:47:18.691807,232,2.0,3.2222222222222223,60,0,800.0
395000.0,3,1.5,1080,2940,1.5,4,7,1080,0.0,1920,1400,4930,37322 days 16:47:18.691807,140,2.0,0.0,-320,-1990,1080.0
252500.0,3,2.0,1900,8002,1.0,3,7,1900,0.0,1991,1900,6086,11389 days 16:47:18.691807,177,1.5,0.0,0,1916,1900.0
1150000.0,4,3.75,5300,37034,2.0,3,1,5300,0.0,1989,3730,37034,12119 days 16:47:18.691807,071,1.0666666666666667,0.0,1570,0,5300.0
205000.0,3,1.0,1370,10708,1.0,3,7,1370,0.0,1969,1770,14482,19424 days 16:47:18.691807,238,3.0,0.0,-400,-3774,1370.0
654000.0,5,2.5,2960,8968,1.0,4,8,1640,1320.0,1965,1890,9077,20885 days 16:47:18.691807,240,2.0,1.2424242424242424,1070,-109,320.0
200000.0,3,1.0,960,213008,1.0,2,6,960,0.0,1933,1520,57499,32573 days 16:47:18.691807,076,3.0,0.0,-560,155509,960.0
700000.0,3,2.5,2190,7982,2.0,3,8,2190,0.0,2004,2090,8888,6641 days 16:47:18.691807,203,1.2,0.0,100,-906,2190.0
2720000.0,4,3.25,3990,18115,2.0,4,1,3990,0.0,1989,3450,16087,12119 days 16:47:18.691807,276,1.2307692307692308,0.0,540,2028,3990.0
306000.0,2,1.75,1200,2622,1.0,5,7,800,400.0,1956,1310,1926,24173 days 16:47:18.691807,343,1.1428571428571428,2.0,-110,696,400.0
270000.0,3,2.5,1780,5015,2.0,3,7,1780,0.0,2010,2010,5250,4449 days 16:47:18.691807,096,1.2,0.0,-230,-235,1780.0
340000.0,3,2.25,2630,9916,2.0,4,9,2630,0.0,1988,2470,10810,12485 days 16:47:18.691807,302,1.3333333333333333,0.0,160,-894,2630.0
450000.0,4,2.5,2300,19250,1.0,4,7,2300,0.0,1955,1460,19250,24538 days 16:47:18.691807,162,1.6,0.0,840,0,2300.0
580000.0,4,2.75,3210,6825,1.0,5,7,1810,1400.0,1975,1840,8000,17233 days 16:47:18.691807,205,1.4545454545454546,1.292857142857143,1370,-1175,410.0
435000.0,4,1.75,2290,4400,1.0,3,7,1290,1000.0,1959,1820,4000,23077 days 16:47:18.691807,307,2.2857142857142856,1.29,470,400,290.0
690000.0,4,2.5,2780,4688,2.0,3,9,2780,0.0,2003,3000,6029,7006 days 16:47:18.691807,230,1.6,0.0,-220,-1341,2780.0
403000.0,3,2.25,1840,13020,1.0,3,8,1390,450.0,1980,2210,13020,15407 days 16:47:18.691807,048,1.3333333333333333,3.088888888888889,-370,0,940.0
440000.0,3,2.75,1560,7392,1.0,5,7,1030,530.0,1972,1870,7520,18329 days 16:47:18.691807,163,1.0909090909090908,1.9433962264150944,-310,-128,500.0
178500.0,3,1.0,1200,8470,1.0,5,7,1200,0.0,1961,1200,7952,22346 days 16:47:18.691807,296,3.0,0.0,0,518,1200.0
270000.0,4,2.5,1900,8282,1.0,3,7,1900,0.0,1968,1420,8350,19790 days 16:47:18.691807,275,1.6,0.0,480,-68,1900.0
260000.0,3,1.75,1360,15210,1.0,3,7,1360,0.0,1987,1610,7800,12850 days 16:47:18.691807,049,1.7142857142857142,0.0,-250,7410,1360.0
339950.0,5,2.5,2990,7292,2.0,4,8,2990,0.0,1990,2150,8190,11754 days 16:47:18.691807,241,2.0,0.0,840,-898,2990.0
250000.0,3,1.0,1640,26127,2.0,3,6,1640,0.0,1975,1620,25788,17233 days 16:47:18.691807,234,3.0,0.0,20,339,1640.0
680000.0,3,3.5,3650,103672,1.0,3,1,2050,1600.0,2011,2550,16140,4084 days 16:47:18.691807,014,0.8571428571428571,1.28125,1100,87532,450.0
660000.0,10,3.0,2920,3745,2.0,4,7,1860,1060.0,1913,1810,3745,39878 days 16:47:18.691807,363,3.3333333333333335,1.7547169811320755,1110,0,800.0
1230000.0,3,3.5,3680,11491,2.0,3,1,3680,0.0,1999,3710,10030,8467 days 16:47:18.691807,197,0.8571428571428571,0.0,-30,1461,3680.0
550000.0,3,2.0,1830,9152,1.0,5,8,1830,0.0,1959,1770,9220,23077 days 16:47:18.691807,143,1.5,0.0,60,-68,1830.0
675000.0,5,2.75,2570,12906,2.0,3,8,2570,0.0,1987,2580,12927,12850 days 16:47:18.691807,002,1.8181818181818181,0.0,-10,-21,2570.0
981000.0,3,3.25,2730,9588,2.0,3,1,1900,830.0,1984,2730,12736,13946 days 16:47:18.691807,100,0.9230769230769231,2.289156626506024,0,-3148,1070.0
168000.0,3,1.0,1150,8000,1.5,4,6,1150,0.0,1913,1170,9600,39878 days 16:47:18.691807,084,3.0,0.0,-20,-1600,1150.0
1000000.0,4,3.0,4260,18687,2.0,3,1,4260,0.0,1996,3490,16772,9563 days 16:47:18.691807,142,1.3333333333333333,0.0,770,1915,4260.0
320000.0,3,1.0,1260,9600,1.0,3,7,1260,0.0,1970,1530,9790,19059 days 16:47:18.691807,091,3.0,0.0,-270,-190,1260.0
959000.0,6,3.25,4440,17424,1.0,4,9,2220,2220.0,1959,2660,10768,23077 days 16:47:18.691807,035,1.8461538461538463,1.0,1780,6656,0.0
372000.0,4,1.0,2300,7680,1.0,3,7,1270,1030.0,1959,1840,5120,23077 days 16:47:18.691807,099,4.0,1.233009708737864,460,2560,240.0
391500.0,3,2.5,1920,9625,2.0,3,8,1920,0.0,1993,1920,10343,10658 days 16:47:18.691807,188,1.2,0.0,0,-718,1920.0
390000.0,2,1.0,1080,4725,1.5,3,7,1080,0.0,1944,1520,4961,28556 days 16:47:18.691807,086,2.0,0.0,-440,-236,1080.0
302000.0,2,1.0,890,5000,1.0,4,6,890,0.0,1947,1160,5000,27460 days 16:47:18.691807,310,2.0,0.0,-270,0,890.0
495000.0,3,3.5,1650,1577,2.0,3,7,1100,550.0,2012,1580,1280,3719 days 16:47:18.691807,307,0.8571428571428571,2.0,70,297,550.0
504500.0,3,2.5,1820,1545,3.0,3,8,1640,180.0,1998,1440,1290,8832 days 16:47:18.691807,247,1.2,9.11111111111111,380,255,1460.0
555000.0,4,1.75,2320,4800,1.5,3,7,2170,150.0,1918,1390,4800,38052 days 16:47:18.691807,077,2.2857142857142856,14.466666666666667,930,0,2020.0
1550000.0,4,3.5,3260,5000,2.0,5,9,2630,630.0,1937,2600,5000,31112 days 16:47:18.691807,076,1.1428571428571428,4.174603174603175,660,0,2000.0
550000.0,3,1.5,1730,5750,1.0,3,7,1250,480.0,1947,1370,5750,27460 days 16:47:18.691807,252,2.0,2.6041666666666665,360,0,770.0
1800000.0,4,2.5,3320,8325,2.5,5,1,3320,0.0,1905,3680,6050,42800 days 16:47:18.691807,202,1.6,0.0,-360,2275,3320.0
655000.0,1,1.0,1660,5422,1.0,4,7,830,830.0,1908,1100,5356,41705 days 16:47:18.691807,119,1.0,1.0,560,66,0.0
685000.0,3,2.5,3290,90796,2.0,4,1,3290,0.0,1992,2700,55023,11024 days 16:47:18.691807,044,1.2,0.0,590,35773,3290.0
721000.0,4,2.0,2280,8339,1.0,4,7,1220,1060.0,1954,1970,8340,24903 days 16:47:18.691807,121,2.0,1.150943396226415,310,-1,160.0
1520000.0,4,4.25,3650,5328,1.5,3,9,2330,1320.0,1907,1710,3600,42070 days 16:47:18.691807,195,0.9411764705882353,1.7651515151515151,1940,1728,1010.0
365000.0,4,2.5,1620,219542,2.0,3,7,1620,0.0,1980,2240,217800,15407 days 16:47:18.691807,054,1.6,0.0,-620,1742,1620.0
458000.0,3,2.0,2020,8555,1.0,4,7,1220,800.0,1957,1600,8148,23807 days 16:47:18.691807,164,1.5,1.525,420,407,420.0
280000.0,2,1.0,1150,12861,1.0,3,6,1150,0.0,1959,1170,7574,23077 days 16:47:18.691807,099,2.0,0.0,-20,5287,1150.0
628000.0,4,1.75,1940,3060,1.0,4,7,1000,940.0,1911,1320,3060,40609 days 16:47:18.691807,099,2.2857142857142856,1.0638297872340425,620,0,60.0
781500.0,4,2.5,3440,6332,2.0,3,1,3440,0.0,2001,3310,6528,7736 days 16:47:18.691807,049,1.6,0.0,130,-196,3440.0
295000.0,3,1.75,2000,7560,1.0,4,7,1300,700.0,1968,1900,8301,19790 days 16:47:18.691807,175,1.7142857142857142,1.8571428571428572,100,-741,600.0
435000.0,2,1.0,750,2786,1.0,5,7,750,0.0,1947,1700,4653,27460 days 16:47:18.691807,093,2.0,0.0,-950,-1867,750.0
300000.0,3,1.75,1420,7200,1.0,3,7,1000,420.0,1979,1550,8640,15772 days 16:47:18.691807,081,1.7142857142857142,2.380952380952381,-130,-1440,580.0
208500.0,2,1.0,880,4814,1.0,4,5,880,0.0,1906,1010,6160,42435 days 16:47:18.691807,085,2.0,0.0,-130,-1346,880.0
930000.0,2,2.5,2680,11214,1.0,3,9,2680,0.0,2006,2305,6908,5910 days 16:47:18.691807,154,0.8,0.0,375,4306,2680.0
316000.0,2,2.0,860,3000,1.0,3,6,860,0.0,1906,1290,3500,42435 days 16:47:18.691807,042,1.0,0.0,-430,-500,860.0
249900.0,3,2.0,1310,6738,1.0,4,7,1310,0.0,1990,1290,8067,11754 days 16:47:18.691807,174,1.5,0.0,20,-1329,1310.0
675000.0,3,2.25,1780,4252,2.0,4,8,1540,240.0,1989,2220,4000,12119 days 16:47:18.691807,212,1.3333333333333333,6.416666666666667,-440,252,1300.0
447000.0,3,2.25,1440,4667,2.0,3,7,1440,0.0,1985,1610,4756,13580 days 16:47:18.691807,303,1.3333333333333333,0.0,-170,-89,1440.0
675000.0,3,2.0,1510,3817,1.5,3,8,1510,0.0,1905,1510,3817,42800 days 16:47:18.691807,107,1.5,0.0,0,0,1510.0
546000.0,4,2.5,2100,1397,3.0,3,8,1580,520.0,2008,1490,1201,5180 days 16:47:18.691807,111,1.6,3.0384615384615383,610,196,1060.0
310000.0,3,2.0,1310,1361,3.0,3,7,1310,0.0,2003,1370,1608,7006 days 16:47:18.691807,365,1.5,0.0,-60,-247,1310.0
190000.0,3,1.0,1280,5100,1.0,3,7,880,400.0,1961,1360,6120,22346 days 16:47:18.691807,006,3.0,2.2,-80,-1020,480.0
650000.0,3,1.5,1320,8114,1.0,3,8,1320,0.0,1951,2110,8114,25999 days 16:47:18.691807,169,2.0,0.0,-790,0,1320.0
585000.0,3,2.5,1740,2350,2.0,3,8,1130,610.0,1995,1740,3201,9928 days 16:47:18.691807,275,1.2,1.8524590163934427,0,-851,520.0
1430000.0,4,2.5,2910,7364,2.0,3,1,2910,0.0,2003,2480,8400,7006 days 16:47:18.691807,310,1.6,0.0,430,-1036,2910.0
565000.0,4,2.5,2500,12090,1.0,3,9,2500,0.0,1983,3380,12760,14311 days 16:47:18.691807,012,1.6,0.0,-880,-670,2500.0
174900.0,3,1.0,1100,6000,1.5,2,6,1100,0.0,1926,960,5880,35130 days 16:47:18.691807,315,3.0,0.0,140,120,1100.0
360000.0,3,2.25,1381,1180,3.0,3,8,1381,0.0,2007,1381,1180,5545 days 16:47:18.691807,267,1.3333333333333333,0.0,0,0,1381.0
234000.0,3,1.0,960,9624,1.0,3,7,960,0.0,1953,1540,9624,25268 days 16:47:18.691807,119,3.0,0.0,-580,0,960.0
575000.0,8,3.0,3840,15990,1.0,3,7,2530,1310.0,1961,1380,8172,22346 days 16:47:18.691807,329,2.6666666666666665,1.9312977099236641,2460,7818,1220.0
315000.0,3,2.5,2200,5954,2.0,3,7,2200,0.0,2004,2200,5046,6641 days 16:47:18.691807,062,1.2,0.0,0,908,2200.0
225000.0,3,1.0,1250,7820,1.0,3,7,1250,0.0,1967,1300,7920,20155 days 16:47:18.691807,084,3.0,0.0,-50,-100,1250.0
370000.0,3,1.5,2380,14500,1.0,4,7,1850,530.0,1961,1830,13600,22346 days 16:47:18.691807,177,2.0,3.490566037735849,550,900,1320.0
606000.0,3,1.0,1500,3920,1.0,3,7,1000,500.0,1947,1640,4017,27460 days 16:47:18.692804,143,3.0,2.0,-140,-97,500.0
272500.0,3,2.0,1410,7622,1.0,4,7,1410,0.0,1983,1830,8330,14311 days 16:47:18.692804,154,1.5,0.0,-420,-708,1410.0
475000.0,3,1.75,1680,3420,1.0,3,7,960,720.0,1992,1680,4080,11024 days 16:47:18.692804,082,1.7142857142857142,1.3333333333333333,0,-660,240.0
270000.0,3,1.0,1500,13500,1.0,4,7,1500,0.0,1968,1350,13680,19790 days 16:47:18.692804,156,3.0,0.0,150,-180,1500.0
624000.0,4,1.75,2710,9216,1.0,3,8,1440,1270.0,1961,1960,6350,22346 days 16:47:18.692804,230,2.2857142857142856,1.1338582677165354,750,2866,170.0
355000.0,3,1.75,1730,7416,1.5,3,7,1730,0.0,1954,1390,6490,24903 days 16:47:18.692804,183,1.7142857142857142,0.0,340,926,1730.0
345000.0,3,1.0,960,3844,1.0,3,7,960,0.0,1972,1020,3844,18329 days 16:47:18.692804,308,3.0,0.0,-60,0,960.0
342000.0,4,2.5,2380,7792,2.0,3,8,2380,0.0,1993,2260,7378,10658 days 16:47:18.692804,324,1.6,0.0,120,414,2380.0
316000.0,3,1.75,1120,98445,1.5,4,7,1120,0.0,1917,1620,34200,38417 days 16:47:18.692804,307,1.7142857142857142,0.0,-500,64245,1120.0
539950.0,4,2.5,2960,37430,2.0,3,9,2960,0.0,1990,2800,36384,11754 days 16:47:18.692804,212,1.6,0.0,160,1046,2960.0
221347.0,3,2.0,1580,6655,1.0,3,6,790,790.0,1944,1090,6655,28556 days 16:47:18.692804,049,1.5,1.0,490,0,0.0
330000.0,3,2.5,1870,4657,2.0,3,8,1870,0.0,2000,2290,4795,8102 days 16:47:18.692804,199,1.2,0.0,-420,-138,1870.0
279000.0,4,2.5,1810,13000,1.0,4,8,1470,340.0,1977,1850,13000,16502 days 16:47:18.692804,199,1.6,4.323529411764706,-40,0,1130.0
850000.0,4,3.0,2550,3784,1.5,4,8,1750,800.0,1900,2100,4560,44626 days 16:47:18.692804,287,1.3333333333333333,2.1875,450,-776,950.0
746000.0,3,1.75,1910,12321,1.0,4,7,1100,810.0,1952,1910,11761,25634 days 16:47:18.692804,043,1.7142857142857142,1.3580246913580247,0,560,290.0
478000.0,2,2.0,1200,1867,1.0,3,7,600,600.0,1924,1790,2221,35861 days 16:47:18.692804,274,1.0,1.0,-590,-354,0.0
820000.0,4,2.75,2420,4635,1.5,5,7,2420,0.0,1905,1590,3150,42800 days 16:47:18.692804,016,1.4545454545454546,0.0,830,1485,2420.0
2160000.0,3,3.5,3080,6495,2.0,3,1,2530,550.0,1996,4120,8620,9563 days 16:47:18.692804,232,0.8571428571428571,4.6,-1040,-2125,1980.0
820000.0,3,3.0,3850,38830,2.0,3,1,3850,0.0,2000,2970,14050,8102 days 16:47:18.692804,296,1.0,0.0,880,24780,3850.0
887000.0,3,2.0,3000,22040,2.0,4,8,2470,530.0,1942,2600,7947,29286 days 16:47:18.692804,108,1.5,4.660377358490566,400,14093,1940.0
159000.0,3,1.0,1360,20000,1.0,4,7,1360,0.0,1953,1530,9997,25268 days 16:47:18.692804,205,3.0,0.0,-170,10003,1360.0
824000.0,7,4.25,3670,4000,2.0,3,8,2800,870.0,1964,2010,4000,21251 days 16:47:18.692804,168,1.6470588235294117,3.218390804597701,1660,0,1930.0
812000.0,4,2.5,2270,5000,2.0,3,9,2270,0.0,2014,1210,5000,2988 days 16:47:18.692804,268,1.6,0.0,1060,0,2270.0
242000.0,4,2.5,1750,11400,2.0,4,7,1750,0.0,1975,1890,9024,17233 days 16:47:18.692804,349,1.6,0.0,-140,2376,1750.0
625000.0,4,2.5,3550,8048,2.0,3,9,3550,0.0,2007,3920,7871,5545 days 16:47:18.692804,140,1.6,0.0,-370,177,3550.0
399888.0,4,1.0,2370,30200,1.5,4,7,1570,800.0,1948,1640,9719,27095 days 16:47:18.692804,346,4.0,1.9625,730,20481,770.0
289000.0,3,2.25,1670,6600,2.0,4,7,1670,0.0,1990,1670,6801,11754 days 16:47:18.692804,265,1.3333333333333333,0.0,0,-201,1670.0
400000.0,3,2.0,1860,12944,1.0,3,9,1860,0.0,2002,2500,29279,7371 days 16:47:18.692804,216,1.5,0.0,-640,-16335,1860.0
1550000.0,3,2.5,4460,26027,2.0,3,1,4460,0.0,1992,3770,26027,11024 days 16:47:18.692804,141,1.2,0.0,690,0,4460.0
345000.0,2,1.0,1080,4000,1.0,3,7,1080,0.0,1940,1530,4240,30017 days 16:47:18.692804,148,2.0,0.0,-450,-240,1080.0
875000.0,3,2.75,2280,4280,1.0,5,7,1280,1000.0,1917,1650,4280,38417 days 16:47:18.692804,148,1.0909090909090908,1.28,630,0,280.0
628990.0,4,2.5,2540,32647,2.0,3,9,2540,0.0,1996,2740,32647,9563 days 16:47:18.692804,069,1.6,0.0,-200,0,2540.0
535000.0,2,3.5,2560,5000,1.0,4,6,1280,1280.0,1944,1390,4000,28556 days 16:47:18.692804,204,0.5714285714285714,1.0,1170,1000,0.0
770126.0,4,2.75,2390,9300,1.0,3,8,1430,960.0,1979,1910,9348,15772 days 16:47:18.692804,280,1.4545454545454546,1.4895833333333333,480,-48,470.0
710000.0,4,2.5,2870,8995,1.0,5,8,1870,1000.0,1968,2670,9672,19790 days 16:47:18.692804,191,1.6,1.87,200,-677,870.0
465000.0,3,1.75,1510,4800,1.0,3,7,860,650.0,1925,1510,4800,35495 days 16:47:18.692804,169,1.7142857142857142,1.323076923076923,0,0,210.0
359000.0,3,1.75,2200,11520,1.0,4,7,2200,0.0,1952,1690,8038,25634 days 16:47:18.692804,226,1.7142857142857142,0.0,510,3482,2200.0
151000.0,2,0.75,720,5040,1.0,3,4,720,0.0,1949,1290,4120,26729 days 16:47:18.692804,060,2.6666666666666665,0.0,-570,920,720.0
820000.0,3,2.5,2970,9600,2.0,3,9,2970,0.0,1994,2970,9707,10293 days 16:47:18.692804,227,1.2,0.0,0,-107,2970.0
160000.0,3,1.5,960,6497,1.0,4,7,960,0.0,1970,1160,7080,19059 days 16:47:18.692804,085,2.0,0.0,-200,-583,960.0
535000.0,4,1.75,1420,5000,1.5,4,7,1420,0.0,1945,1490,5000,28190 days 16:47:18.692804,182,2.2857142857142856,0.0,-70,0,1420.0
365000.0,3,2.25,1800,9010,1.0,3,7,1300,500.0,1975,1950,10240,17233 days 16:47:18.692804,113,1.3333333333333333,2.6,-150,-1230,800.0
708000.0,4,2.5,3090,5600,2.0,3,9,3090,0.0,2005,3080,5788,6275 days 16:47:18.692804,051,1.6,0.0,10,-188,3090.0
215000.0,3,1.0,1200,7280,1.0,4,7,1200,0.0,1967,1200,8400,20155 days 16:47:18.692804,190,3.0,0.0,0,-1120,1200.0
1950000.0,4,3.5,4065,18713,2.0,4,1,4065,0.0,1987,3070,18713,12850 days 16:47:18.692804,206,1.1428571428571428,0.0,995,0,4065.0
390000.0,4,2.5,2570,22215,2.0,5,7,2570,0.0,1958,2460,6533,23442 days 16:47:18.692804,269,1.6,0.0,110,15682,2570.0
570000.0,3,2.0,1530,5401,1.0,4,7,1530,0.0,1937,1640,5467,31112 days 16:47:18.692804,133,1.5,0.0,-110,-66,1530.0
383000.0,3,1.75,1500,13430,1.0,3,7,1500,0.0,1977,1500,13430,16502 days 16:47:18.692804,176,1.7142857142857142,0.0,0,0,1500.0
370000.0,4,3.0,2490,5706,2.0,3,9,2490,0.0,2005,2650,5880,6275 days 16:47:18.692804,099,1.3333333333333333,0.0,-160,-174,2490.0
454000.0,4,2.5,3040,12522,2.0,3,7,3040,0.0,2000,2490,9742,8102 days 16:47:18.692804,042,1.6,0.0,550,2780,3040.0
1400000.0,5,3.25,4140,32700,1.0,3,1,2190,1950.0,1973,3220,22077,17963 days 16:47:18.692804,083,1.5384615384615385,1.123076923076923,920,10623,240.0
371000.0,4,1.75,1690,10854,1.0,3,7,1690,0.0,1977,2390,7000,16502 days 16:47:18.692804,209,2.2857142857142856,0.0,-700,3854,1690.0
530000.0,3,1.75,1430,10350,1.0,3,7,1430,0.0,1959,1890,10350,23077 days 16:47:18.692804,125,1.7142857142857142,0.0,-460,0,1430.0
608000.0,4,2.75,2490,9714,1.0,4,8,1400,1090.0,1983,2060,15300,14311 days 16:47:18.692804,161,1.4545454545454546,1.2844036697247707,430,-5586,310.0
450000.0,3,1.75,1350,7200,1.0,5,7,1350,0.0,1954,1100,7200,24903 days 16:47:18.692804,315,1.7142857142857142,0.0,250,0,1350.0
780000.0,4,2.5,3140,14421,2.0,3,1,3140,0.0,1994,3140,17417,10293 days 16:47:18.692804,211,1.6,0.0,0,-2996,3140.0
290000.0,4,2.5,2340,52272,2.0,2,8,2340,0.0,1978,2480,40500,16137 days 16:47:18.692804,241,1.6,0.0,-140,11772,2340.0
225000.0,3,1.75,1610,14182,1.0,4,7,1100,510.0,1978,1510,8400,16137 days 16:47:18.692804,259,1.7142857142857142,2.156862745098039,100,5782,590.0
805000.0,4,2.5,3320,38032,2.0,4,1,3320,0.0,1991,3270,37804,11389 days 16:47:18.692804,254,1.6,0.0,50,228,3320.0
660000.0,3,2.5,2390,15669,2.0,3,9,2390,0.0,1991,2640,12500,11389 days 16:47:18.692804,097,1.2,0.0,-250,3169,2390.0
299000.0,3,1.75,1180,13927,1.0,5,7,1180,0.0,1962,1400,13173,21981 days 16:47:18.692804,164,1.7142857142857142,0.0,-220,754,1180.0
530000.0,2,2.25,1260,1312,3.0,3,8,1260,0.0,2007,1300,1312,5545 days 16:47:18.692804,262,0.8888888888888888,0.0,-40,0,1260.0
680000.0,3,2.5,1800,4400,1.0,5,7,1350,450.0,1970,1920,4400,19059 days 16:47:18.692804,290,1.2,3.0,-120,0,900.0
199900.0,4,1.75,1790,12000,1.0,5,6,1790,0.0,1944,1550,9840,28556 days 16:47:18.692804,047,2.2857142857142856,0.0,240,2160,1790.0
224000.0,3,1.75,1760,6300,1.0,3,7,1060,700.0,1963,1340,7300,21616 days 16:47:18.692804,008,1.7142857142857142,1.5142857142857142,420,-1000,360.0
244000.0,3,1.75,1540,8885,1.0,4,7,1440,100.0,1980,1540,12734,15407 days 16:47:18.692804,241,1.7142857142857142,14.4,0,-3849,1340.0
485000.0,4,1.75,1260,3880,1.0,5,7,860,400.0,1918,1000,3880,38052 days 16:47:18.692804,098,2.2857142857142856,2.15,260,0,460.0
330000.0,4,2.5,2240,7589,2.0,3,8,2240,0.0,1994,2250,7300,10293 days 16:47:18.692804,012,1.6,0.0,-10,289,2240.0
509000.0,4,2.0,1630,1724,1.5,3,6,1030,600.0,1915,1780,3810,39148 days 16:47:18.692804,365,2.0,1.7166666666666666,-150,-2086,430.0
440000.0,4,2.5,2350,7203,2.0,3,8,2350,0.0,1989,2260,7274,12119 days 16:47:18.692804,321,1.6,0.0,90,-71,2350.0
244000.0,3,2.0,1350,8587,1.0,3,7,1350,0.0,1998,1350,8587,8832 days 16:47:18.692804,344,1.5,0.0,0,0,1350.0
399700.0,4,1.75,1320,4800,1.0,4,7,870,450.0,1930,940,4800,33669 days 16:47:18.692804,198,2.2857142857142856,1.9333333333333333,380,0,420.0
519000.0,4,2.5,1950,2617,1.5,4,7,1250,700.0,1910,1520,1438,40974 days 16:47:18.692804,176,1.6,1.7857142857142858,430,1179,550.0
211000.0,4,1.0,2100,9200,1.0,3,7,1050,1050.0,1959,1540,10033,23077 days 16:47:18.692804,128,4.0,1.0,560,-833,0.0
950000.0,3,2.5,3480,7800,1.0,4,7,1750,1730.0,1941,3010,9918,29651 days 16:47:18.692804,189,1.2,1.0115606936416186,470,-2118,20.0
410000.0,3,2.5,1830,2839,2.0,3,8,1830,0.0,1999,1830,3011,8467 days 16:47:18.692804,245,1.2,0.0,0,-172,1830.0
750000.0,4,2.0,2640,5000,2.0,3,7,2040,600.0,1949,1330,5000,26729 days 16:47:18.692804,084,2.0,3.4,1310,0,1440.0
133400.0,3,1.0,900,2550,1.0,4,6,900,0.0,1978,1120,2550,16137 days 16:47:18.692804,253,3.0,0.0,-220,0,900.0
240000.0,3,2.0,1553,6550,1.0,3,7,1553,0.0,1900,1010,10546,44626 days 16:47:18.692804,114,1.5,0.0,543,-3996,1553.0
539000.0,3,2.5,1710,2300,2.0,3,8,1570,140.0,2005,2120,2856,6275 days 16:47:18.692804,155,1.2,11.214285714285714,-410,-556,1430.0
688000.0,4,3.0,3400,292723,2.0,3,1,3400,0.0,1998,1760,69696,8832 days 16:47:18.692804,226,1.3333333333333333,0.0,1640,223027,3400.0
465000.0,3,1.5,1270,5112,1.0,3,7,1270,0.0,1950,1580,5080,26364 days 16:47:18.692804,133,2.0,0.0,-310,32,1270.0
936000.0,3,1.75,2960,12420,1.0,4,8,1480,1480.0,1952,2700,9106,25634 days 16:47:18.692804,168,1.7142857142857142,1.0,260,3314,0.0
620000.0,4,2.5,3040,9606,2.0,3,7,3040,0.0,2003,1690,3849,7006 days 16:47:18.692804,364,1.6,0.0,1350,5757,3040.0
429950.0,3,1.75,1430,9750,1.0,5,7,1430,0.0,1962,1630,9282,21981 days 16:47:18.692804,293,1.7142857142857142,0.0,-200,468,1430.0
296475.0,3,2.5,1520,4170,2.0,3,7,1520,0.0,2004,1560,4237,6641 days 16:47:18.692804,188,1.2,0.0,-40,-67,1520.0
330000.0,4,2.0,1820,9450,1.0,3,7,1100,720.0,1962,1540,9450,21981 days 16:47:18.692804,117,2.0,1.5277777777777777,280,0,380.0
445000.0,3,2.25,1800,11200,1.0,3,8,1270,530.0,1979,1940,11250,15772 days 16:47:18.692804,211,1.3333333333333333,2.3962264150943398,-140,-50,740.0
846000.0,4,3.25,2720,4000,2.0,3,1,2070,650.0,2014,1450,4000,2988 days 16:47:18.692804,213,1.2307692307692308,3.1846153846153844,1270,0,1420.0
725000.0,4,1.75,1980,5850,1.0,4,8,1380,600.0,1960,1810,5850,22712 days 16:47:18.692804,134,2.2857142857142856,2.3,170,0,780.0
369000.0,4,2.5,2550,7349,2.0,3,9,2550,0.0,1989,2400,8508,12119 days 16:47:18.692804,124,1.6,0.0,150,-1159,2550.0
625000.0,3,1.75,2210,16200,1.0,3,8,1390,820.0,1958,2050,16200,23442 days 16:47:18.692804,160,1.7142857142857142,1.6951219512195121,160,0,570.0
535000.0,3,2.0,2120,4080,2.0,3,7,2120,0.0,2003,2280,4080,7006 days 16:47:18.692804,169,1.5,0.0,-160,0,2120.0
229950.0,4,1.5,1570,6717,1.0,5,6,1570,0.0,1911,1140,6716,40609 days 16:47:18.692804,352,2.6666666666666665,0.0,430,1,1570.0
229999.0,3,1.75,1310,6960,1.0,4,7,1310,0.0,1974,1580,7200,17598 days 16:47:18.692804,113,1.7142857142857142,0.0,-270,-240,1310.0
850000.0,5,3.5,3150,4120,2.0,3,8,2460,690.0,1911,2080,4160,40609 days 16:47:18.692804,237,1.4285714285714286,3.5652173913043477,1070,-40,1770.0
589900.0,4,4.5,3870,35889,2.0,3,1,2530,1340.0,2001,3020,35366,7736 days 16:47:18.692804,161,0.8888888888888888,1.8880597014925373,850,523,1190.0
513000.0,2,1.0,1840,4322,1.0,4,7,1160,680.0,1914,1750,4322,39513 days 16:47:18.692804,303,2.0,1.7058823529411764,90,0,480.0
401000.0,3,1.0,1120,8321,1.0,4,6,1120,0.0,1941,1980,8671,29651 days 16:47:18.692804,269,3.0,0.0,-860,-350,1120.0
260000.0,3,2.5,1440,2500,2.0,3,7,1440,0.0,2006,1440,5000,5910 days 16:47:18.692804,248,1.2,0.0,0,-2500,1440.0
525000.0,4,2.75,2300,26650,1.0,4,8,2300,0.0,1950,2000,9879,26364 days 16:47:18.692804,128,1.4545454545454546,0.0,300,16771,2300.0
470000.0,3,3.5,2070,11658,1.0,4,8,1370,700.0,1977,1930,8744,16502 days 16:47:18.692804,079,0.8571428571428571,1.957142857142857,140,2914,670.0
205000.0,4,1.5,1420,8063,1.0,3,7,940,480.0,1962,1330,7515,21981 days 16:47:18.692804,021,2.6666666666666665,1.9583333333333333,90,548,460.0
620000.0,3,2.25,2010,7495,1.0,4,8,1570,440.0,1979,2050,8402,15772 days 16:47:18.692804,041,1.3333333333333333,3.5681818181818183,-40,-907,1130.0
229000.0,3,1.5,1200,5000,1.0,3,6,1200,0.0,1979,1440,2500,15772 days 16:47:18.692804,223,2.0,0.0,-240,2500,1200.0
445000.0,2,2.0,1150,6634,1.0,3,7,860,290.0,1940,1680,6892,30017 days 16:47:18.692804,129,1.0,2.9655172413793105,-530,-258,570.0
215000.0,2,1.0,1240,7200,1.0,3,7,1240,0.0,1967,1130,9200,20155 days 16:47:18.692804,134,2.0,0.0,110,-2000,1240.0
504975.0,2,2.5,1900,4871,2.0,3,8,1900,0.0,2005,1640,4780,6275 days 16:47:18.692804,210,0.8,0.0,260,91,1900.0
495000.0,4,2.25,2350,10072,2.0,3,8,2350,0.0,1980,2210,9687,15407 days 16:47:18.692804,213,1.7777777777777777,0.0,140,385,2350.0
205000.0,3,1.0,1120,8342,1.0,4,7,1120,0.0,1976,1190,6660,16868 days 16:47:18.692804,070,3.0,0.0,-70,1682,1120.0
152275.0,1,1.0,1020,6871,1.0,3,6,1020,0.0,1937,1260,6933,31112 days 16:47:18.692804,211,1.0,0.0,-240,-62,1020.0
586000.0,4,2.25,1930,8338,1.0,3,8,1930,0.0,1968,2280,7616,19790 days 16:47:18.692804,084,1.7777777777777777,0.0,-350,722,1930.0
779950.0,2,2.5,2680,7625,1.0,3,9,2680,0.0,2002,2310,7395,7371 days 16:47:18.692804,290,0.8,0.0,370,230,2680.0
557000.0,4,1.75,2660,11315,2.0,4,8,2660,0.0,1983,1980,11315,14311 days 16:47:18.692804,352,2.2857142857142856,0.0,680,0,2660.0
610000.0,4,2.25,2200,7200,1.0,4,8,1220,980.0,1958,1940,6000,23442 days 16:47:18.692804,302,1.7777777777777777,1.2448979591836735,260,1200,240.0
405000.0,3,1.5,1010,7683,1.5,5,7,1010,0.0,1953,1550,7271,25268 days 16:47:18.692804,189,2.0,0.0,-540,412,1010.0
320000.0,4,2.25,2310,7490,2.0,3,8,2310,0.0,1980,2310,8480,15407 days 16:47:18.692804,129,1.7777777777777777,0.0,0,-990,2310.0
356000.0,3,1.0,920,3863,1.0,3,6,920,0.0,1970,1080,5150,19059 days 16:47:18.692804,262,3.0,0.0,-160,-1287,920.0
794500.0,5,3.0,3030,4120,1.5,4,7,1930,1100.0,1913,1280,3090,39878 days 16:47:18.692804,057,1.6666666666666667,1.7545454545454546,1750,1030,830.0
349000.0,3,1.75,1590,9620,1.0,3,7,1590,0.0,1988,2980,9398,12485 days 16:47:18.692804,128,1.7142857142857142,0.0,-1390,222,1590.0
549000.0,4,2.25,2740,88426,2.0,3,7,2740,0.0,1991,2740,62726,11389 days 16:47:18.692804,155,1.7777777777777777,0.0,0,25700,2740.0
193000.0,3,1.0,960,10761,1.0,4,6,960,0.0,1962,960,10761,21981 days 16:47:18.692804,199,3.0,0.0,0,0,960.0
700000.0,3,1.5,2240,7227,2.0,3,9,1440,800.0,1977,3150,16150,16502 days 16:47:18.692804,289,2.0,1.8,-910,-8923,640.0
523000.0,3,2.5,2400,6182,2.0,3,8,2400,0.0,1998,2420,5829,8832 days 16:47:18.692804,083,1.2,0.0,-20,353,2400.0
565000.0,5,3.25,2860,20790,1.0,4,7,1800,1060.0,1965,1920,9612,20885 days 16:47:18.692804,322,1.5384615384615385,1.6981132075471699,940,11178,740.0
500000.0,4,2.5,2960,5027,2.0,3,7,2960,0.0,2000,2760,5500,8102 days 16:47:18.692804,125,1.6,0.0,200,-473,2960.0
1450000.0,4,3.25,3770,4103,2.0,5,9,2710,1060.0,1925,2560,4160,35495 days 16:47:18.692804,188,1.2307692307692308,2.556603773584906,1210,-57,1650.0
710000.0,6,3.5,3830,68825,2.0,3,9,3830,0.0,1995,2410,68825,9928 days 16:47:18.692804,050,1.7142857142857142,0.0,1420,0,3830.0
333000.0,4,2.0,2750,9001,1.0,3,8,2750,0.0,2008,1340,11050,5180 days 16:47:18.692804,288,2.0,0.0,1410,-2049,2750.0
580000.0,3,1.75,2100,6874,1.0,3,7,1300,800.0,1943,2220,5912,28921 days 16:47:18.692804,198,1.7142857142857142,1.625,-120,962,500.0
289950.0,4,1.75,1500,8400,1.0,3,7,1200,300.0,1956,1780,9913,24173 days 16:47:18.692804,213,2.2857142857142856,4.0,-280,-1513,900.0
375000.0,2,1.0,710,4618,1.0,3,5,710,0.0,1925,1810,4988,35495 days 16:47:18.692804,050,2.0,0.0,-1100,-370,710.0
505000.0,2,3.0,2770,10800,1.5,5,8,1910,860.0,1984,2140,10800,13946 days 16:47:18.692804,269,0.6666666666666666,2.2209302325581395,630,0,1050.0
324950.0,3,1.75,2050,6720,1.0,3,7,1050,1000.0,1939,2380,7260,30382 days 16:47:18.692804,202,1.7142857142857142,1.05,-330,-540,50.0
490000.0,4,2.25,1960,10275,2.0,3,7,1960,0.0,1965,1560,10275,20885 days 16:47:18.692804,195,1.7777777777777777,0.0,400,0,1960.0
630000.0,4,2.0,1770,6000,2.0,5,7,1770,0.0,1911,1340,6000,40609 days 16:47:18.692804,132,2.0,0.0,430,0,1770.0
595000.0,3,2.75,3290,22649,2.0,4,8,3290,0.0,1993,2750,6119,10658 days 16:47:18.692804,171,1.0909090909090908,0.0,540,16530,3290.0
872500.0,4,2.0,1990,6000,1.0,3,9,1260,730.0,1956,1770,6000,24173 days 16:47:18.692804,121,2.0,1.726027397260274,220,0,530.0
1900000.0,4,3.25,5080,27755,2.0,3,1,5080,0.0,2001,4730,22326,7736 days 16:47:18.692804,350,1.2307692307692308,0.0,350,5429,5080.0
310000.0,2,1.0,1020,8102,1.0,3,7,1020,0.0,1956,1770,7291,24173 days 16:47:18.692804,125,2.0,0.0,-750,811,1020.0
450000.0,3,1.0,1350,92721,1.0,2,6,1200,150.0,1946,1860,8096,27825 days 16:47:18.692804,124,3.0,8.0,-510,84625,1050.0
539000.0,3,1.5,1740,12000,2.0,3,9,1740,0.0,1974,2580,12224,17598 days 16:47:18.692804,296,2.0,0.0,-840,-224,1740.0
888550.0,3,2.5,3540,38322,2.0,3,1,3540,0.0,1989,3540,35926,12119 days 16:47:18.692804,188,1.2,0.0,0,2396,3540.0
269950.0,3,2.5,1520,8720,1.0,3,7,1080,440.0,1981,1720,7551,15041 days 16:47:18.692804,195,1.2,2.4545454545454546,-200,1169,640.0
300000.0,3,1.75,1310,9761,1.0,3,7,1310,0.0,1967,1490,9600,20155 days 16:47:18.692804,231,1.7142857142857142,0.0,-180,161,1310.0
780000.0,2,3.25,3000,24004,1.0,3,1,2410,590.0,1952,4270,24506,25634 days 16:47:18.692804,265,0.6153846153846154,4.084745762711864,-1270,-502,1820.0
545000.0,3,2.5,2660,20369,2.0,3,8,2660,0.0,1992,2720,12927,11024 days 16:47:18.692804,196,1.2,0.0,-60,7442,2660.0
278000.0,3,2.25,2120,9804,2.0,3,7,2120,0.0,1994,2120,7200,10293 days 16:47:18.692804,105,1.3333333333333333,0.0,0,2604,2120.0
342000.0,3,2.25,1200,2845,2.0,3,7,1200,0.0,1986,1220,2140,13215 days 16:47:18.692804,335,1.3333333333333333,0.0,-20,705,1200.0
190000.0,4,1.75,1900,9861,1.0,4,7,1900,0.0,1967,1720,7967,20155 days 16:47:18.692804,126,2.2857142857142856,0.0,180,1894,1900.0
387000.0,2,1.5,1010,948,3.0,3,8,1010,0.0,1999,1330,1318,8467 days 16:47:18.692804,325,1.3333333333333333,0.0,-320,-370,1010.0
279950.0,3,2.25,1850,7480,2.0,3,7,1850,0.0,1978,1870,7480,16137 days 16:47:18.692804,063,1.3333333333333333,0.0,-20,0,1850.0
550000.0,6,4.5,4520,40164,2.0,3,9,3580,940.0,1953,2870,13068,25268 days 16:47:18.692804,077,1.3333333333333333,3.8085106382978724,1650,27096,2640.0
439000.0,3,2.0,2010,251341,2.0,3,8,1510,500.0,2003,1780,108900,7006 days 16:47:18.692804,140,1.5,3.02,230,142441,1010.0
774888.0,3,2.25,2420,23507,1.0,4,8,2420,0.0,1969,2540,22257,19424 days 16:47:18.692804,283,1.3333333333333333,0.0,-120,1250,2420.0
480000.0,5,2.5,2732,9500,1.0,4,8,1870,862.0,1975,2720,10000,17233 days 16:47:18.692804,161,2.0,2.1693735498839906,12,-500,1008.0
1500000.0,5,3.5,3520,5400,2.0,3,9,2400,1120.0,2008,1360,3600,5180 days 16:47:18.692804,062,1.4285714285714286,2.142857142857143,2160,1800,1280.0
771000.0,4,2.0,2220,3760,1.5,4,7,1370,850.0,1929,1620,3760,34034 days 16:47:18.692804,085,2.0,1.611764705882353,600,0,520.0
1230000.0,4,2.25,2020,5800,1.0,4,9,1760,260.0,1941,3100,5800,29651 days 16:47:18.692804,219,1.7777777777777777,6.769230769230769,-1080,0,1500.0
600000.0,4,2.5,2090,7290,1.0,5,8,1420,670.0,1966,2110,8436,20520 days 16:47:18.692804,290,1.6,2.1194029850746268,-20,-1146,750.0
305000.0,3,1.0,1580,7424,1.0,3,7,1010,570.0,1962,1710,7772,21981 days 16:47:18.692804,183,3.0,1.7719298245614035,-130,-348,440.0
1390000.0,5,1.75,2650,11340,1.0,3,8,2650,0.0,1955,2780,13204,24538 days 16:47:18.692804,086,2.857142857142857,0.0,-130,-1864,2650.0
216500.0,3,1.0,1020,11652,1.0,4,6,1020,0.0,1971,1690,11652,18694 days 16:47:18.692804,253,3.0,0.0,-670,0,1020.0
370000.0,3,2.5,1070,1219,2.0,3,7,720,350.0,2004,1070,1254,6641 days 16:47:18.692804,022,1.2,2.057142857142857,0,-35,370.0
492650.0,4,1.75,2120,9786,1.0,3,8,1640,480.0,1967,2310,8787,20155 days 16:47:18.692804,181,2.2857142857142856,3.4166666666666665,-190,999,1160.0
431200.0,5,1.75,1360,10609,1.0,3,7,1060,300.0,1966,1490,9935,20520 days 16:47:18.692804,206,2.857142857142857,3.533333333333333,-130,674,760.0
277500.0,4,2.0,1700,12048,2.0,3,7,1700,0.0,1990,1960,7650,11754 days 16:47:18.692804,099,2.0,0.0,-260,4398,1700.0
278000.0,5,1.5,1820,8712,1.0,5,7,1090,730.0,1960,1820,8712,22712 days 16:47:18.692804,076,3.3333333333333335,1.4931506849315068,0,0,360.0
351000.0,4,1.0,1430,8400,1.0,3,6,730,700.0,1969,1310,8240,19424 days 16:47:18.692804,245,4.0,1.042857142857143,120,160,30.0
850000.0,4,3.5,4140,7089,2.0,3,1,3160,980.0,2003,2640,8896,7006 days 16:47:18.692804,167,1.1428571428571428,3.2244897959183674,1500,-1807,2180.0
885000.0,2,2.0,1313,3600,1.0,3,8,1313,0.0,1904,1080,3600,43166 days 16:47:18.692804,223,1.0,0.0,233,0,1313.0
399950.0,3,2.0,1590,87120,1.0,3,8,1590,0.0,1998,2780,183161,8832 days 16:47:18.692804,196,1.5,0.0,-1190,-96041,1590.0
185000.0,3,1.75,1080,9262,1.0,3,7,1080,0.0,1968,1090,9262,19790 days 16:47:18.692804,217,1.7142857142857142,0.0,-10,0,1080.0
440000.0,5,3.0,2730,6000,1.0,3,8,1470,1260.0,1979,2590,6000,15772 days 16:47:18.692804,268,1.6666666666666667,1.1666666666666667,140,0,210.0
2400000.0,4,3.25,3800,19798,2.0,3,1,3800,0.0,1969,3940,18975,19424 days 16:47:18.692804,225,1.2307692307692308,0.0,-140,823,3800.0
299000.0,3,2.25,2540,9961,1.0,4,8,1320,1220.0,1969,1870,10251,19424 days 16:47:18.692804,233,1.3333333333333333,1.0819672131147542,670,-290,100.0
299500.0,3,1.75,1810,34500,1.0,3,8,1230,580.0,1980,2090,9735,15407 days 16:47:18.692804,240,1.7142857142857142,2.1206896551724137,-280,24765,650.0
420000.0,3,1.5,1540,7506,1.0,5,7,1540,0.0,1961,2180,7653,22346 days 16:47:18.692804,076,2.0,0.0,-640,-147,1540.0
234000.0,4,1.0,1390,18000,1.0,3,7,1390,0.0,1955,1390,18000,24538 days 16:47:18.692804,178,4.0,0.0,0,0,1390.0
540000.0,2,1.75,1460,4800,1.0,5,7,850,610.0,1950,2050,5592,26364 days 16:47:18.692804,195,1.1428571428571428,1.3934426229508197,-590,-792,240.0
649950.0,4,2.5,2350,63162,2.0,4,8,2350,0.0,1994,2370,63162,10293 days 16:47:18.692804,160,1.6,0.0,-20,0,2350.0
330000.0,3,1.0,1160,7912,1.0,4,7,1160,0.0,1956,1190,7482,24173 days 16:47:18.692804,008,3.0,0.0,-30,430,1160.0
840000.0,4,3.25,3500,5960,2.0,3,9,3500,0.0,2010,3390,6856,4449 days 16:47:18.692804,117,1.2307692307692308,0.0,110,-896,3500.0
370000.0,3,2.5,1980,6922,2.0,5,8,1980,0.0,1991,2090,7697,11389 days 16:47:18.692804,311,1.2,0.0,-110,-775,1980.0
410000.0,3,1.5,1250,7700,1.0,5,7,1250,0.0,1968,1430,7700,19790 days 16:47:18.692804,176,2.0,0.0,-180,0,1250.0
257000.0,2,1.0,770,7200,1.0,3,7,770,0.0,1951,1320,7139,25999 days 16:47:18.692804,343,2.0,0.0,-550,61,770.0
350000.0,3,1.0,1920,6710,1.0,3,7,1320,600.0,1959,1810,5600,23077 days 16:47:18.692804,364,3.0,2.2,110,1110,720.0
380000.0,2,1.0,1120,7560,1.0,3,6,1120,0.0,1947,1120,7200,27460 days 16:47:18.692804,237,2.0,0.0,0,360,1120.0
344000.0,3,1.0,1150,12402,1.0,4,6,1150,0.0,1969,1400,13600,19424 days 16:47:18.692804,069,3.0,0.0,-250,-1198,1150.0
488000.0,3,2.5,1590,2550,3.0,3,7,1590,0.0,1985,1260,5100,13580 days 16:47:18.692804,147,1.2,0.0,330,-2550,1590.0
465000.0,3,1.0,910,3880,1.0,3,7,780,130.0,1942,1220,3880,29286 days 16:47:18.692804,281,3.0,6.0,-310,0,650.0
229500.0,2,1.75,1870,6625,1.0,3,7,960,910.0,1948,1680,6000,27095 days 16:47:18.692804,124,1.1428571428571428,1.054945054945055,190,625,50.0
445000.0,5,3.0,2420,11250,2.0,3,8,2420,0.0,2013,1510,9950,3353 days 16:47:18.692804,316,1.6666666666666667,0.0,910,1300,2420.0
246000.0,4,1.5,2120,7110,1.5,3,6,2120,0.0,1919,1540,7110,37687 days 16:47:18.692804,076,2.6666666666666665,0.0,580,0,2120.0
545000.0,5,2.5,2730,17240,1.0,5,7,1660,1070.0,1958,2250,13200,23442 days 16:47:18.692804,155,2.0,1.5514018691588785,480,4040,590.0
518000.0,4,2.5,2560,5672,2.0,3,8,2560,0.0,2005,2190,6788,6275 days 16:47:18.692804,225,1.6,0.0,370,-1116,2560.0
565000.0,4,2.5,2620,10016,2.0,3,8,2620,0.0,1996,2620,10016,9563 days 16:47:18.692804,304,1.6,0.0,0,0,2620.0
445000.0,4,2.5,2760,8558,2.0,3,7,2760,0.0,2001,2760,7703,7736 days 16:47:18.692804,100,1.6,0.0,0,855,2760.0
968000.0,5,2.5,2900,9799,1.0,3,8,1450,1450.0,1959,2810,9687,23077 days 16:47:18.692804,198,2.0,1.0,90,112,0.0
725000.0,3,2.0,1820,6324,1.0,5,7,910,910.0,1945,1850,6440,28190 days 16:47:18.692804,090,1.5,1.0,-30,-116,0.0
315500.0,3,1.75,1870,8400,1.0,3,7,990,880.0,1977,1750,8400,16502 days 16:47:18.692804,238,1.7142857142857142,1.125,120,0,110.0
487585.0,4,1.75,2010,9211,1.0,3,7,1470,540.0,1977,1840,8500,16502 days 16:47:18.692804,125,2.2857142857142856,2.7222222222222223,170,711,930.0
246500.0,2,1.0,940,6000,1.0,2,7,940,0.0,1954,1890,8547,24903 days 16:47:18.692804,082,2.0,0.0,-950,-2547,940.0
819000.0,3,1.75,1850,6000,1.5,3,8,1650,200.0,1913,1540,6000,39878 days 16:47:18.692804,226,1.7142857142857142,8.25,310,0,1450.0
349900.0,5,2.5,2530,4229,2.0,3,7,2530,0.0,2004,2070,4879,6641 days 16:47:18.692804,352,2.0,0.0,460,-650,2530.0
267000.0,3,1.0,940,4700,1.0,4,6,940,0.0,1942,1020,5700,29286 days 16:47:18.692804,234,3.0,0.0,-80,-1000,940.0
480000.0,3,2.25,1820,15000,1.0,3,7,1480,340.0,1978,1930,13600,16137 days 16:47:18.692804,133,1.3333333333333333,4.352941176470588,-110,1400,1140.0
525000.0,2,1.0,1510,3360,1.0,3,7,880,630.0,1924,1330,3360,35861 days 16:47:18.692804,253,2.0,1.3968253968253967,180,0,250.0
578000.0,4,2.5,2070,5415,2.0,3,8,2070,0.0,1996,2120,5331,9563 days 16:47:18.692804,176,1.6,0.0,-50,84,2070.0
345000.0,3,2.5,1380,1547,3.0,3,8,1380,0.0,2000,1380,1465,8102 days 16:47:18.692804,126,1.2,0.0,0,82,1380.0
499000.0,3,1.0,1270,6250,1.0,3,7,910,360.0,1955,2000,6250,24538 days 16:47:18.692804,085,3.0,2.5277777777777777,-730,0,550.0
425000.0,3,1.5,1390,9680,1.0,4,7,1390,0.0,1956,1460,10050,24173 days 16:47:18.692804,238,2.0,0.0,-70,-370,1390.0
268000.0,4,3.0,1840,7510,2.0,5,8,1840,0.0,1988,1650,7957,12485 days 16:47:18.692804,300,1.3333333333333333,0.0,190,-447,1840.0
240000.0,3,1.0,1600,12566,1.0,4,7,1600,0.0,1971,1600,10650,18694 days 16:47:18.692804,338,3.0,0.0,0,1916,1600.0
147000.0,3,1.5,1480,9606,1.0,4,7,1100,380.0,1964,1600,9619,21251 days 16:47:18.692804,062,2.0,2.8947368421052633,-120,-13,720.0
500000.0,4,2.0,2120,7806,1.0,4,6,1770,350.0,1949,1560,9920,26729 days 16:47:18.692804,065,2.0,5.057142857142857,560,-2114,1420.0
1010000.0,4,2.75,2940,5400,1.5,5,8,1940,1000.0,1910,1970,2008,40974 days 16:47:18.692804,301,1.4545454545454546,1.94,970,3392,940.0
991500.0,4,3.0,3820,26895,2.0,3,1,3820,0.0,1995,3820,24751,9928 days 16:47:18.692804,068,1.3333333333333333,0.0,0,2144,3820.0
510000.0,5,2.0,2740,3838,1.0,4,7,1370,1370.0,1959,1660,4040,23077 days 16:47:18.692804,322,2.5,1.0,1080,-202,0.0
1980000.0,4,4.0,4360,12081,2.0,3,1,4360,0.0,2007,2180,10800,5545 days 16:47:18.692804,213,1.0,0.0,2180,1281,4360.0
484998.0,4,2.5,1540,1870,2.0,3,8,1540,0.0,2014,1540,1619,2988 days 16:47:18.692804,183,1.6,0.0,0,251,1540.0
1280000.0,4,3.5,4660,17398,2.0,3,1,4660,0.0,2003,5080,24913,7006 days 16:47:18.692804,176,1.1428571428571428,0.0,-420,-7515,4660.0
210000.0,3,1.75,1590,7617,2.0,3,7,1590,0.0,1986,1490,7450,13215 days 16:47:18.692804,149,1.7142857142857142,0.0,100,167,1590.0
450000.0,2,1.0,1180,10720,1.0,4,7,1180,0.0,1955,1420,10750,24538 days 16:47:18.692804,216,2.0,0.0,-240,-30,1180.0
875000.0,4,1.75,2360,8286,1.0,3,7,1320,1040.0,1952,1680,7630,25634 days 16:47:18.692804,092,2.2857142857142856,1.2692307692307692,680,656,280.0
529950.0,4,2.75,1860,7500,1.0,5,8,1220,640.0,1967,2020,8137,20155 days 16:47:18.692804,118,1.4545454545454546,1.90625,-160,-637,580.0
415000.0,3,1.75,1470,4000,1.0,3,7,1070,400.0,1979,1280,3500,15772 days 16:47:18.692804,204,1.7142857142857142,2.675,190,500,670.0
590000.0,4,2.0,2990,12970,1.5,4,7,1960,1030.0,1948,2500,10680,27095 days 16:47:18.692804,051,2.0,1.9029126213592233,490,2290,930.0
379950.0,3,1.5,1690,9144,1.0,4,7,1140,550.0,1956,1840,10600,24173 days 16:47:18.692804,146,2.0,2.0727272727272728,-150,-1456,590.0
385000.0,1,1.0,660,3570,1.0,3,6,660,0.0,1906,1520,4080,42435 days 16:47:18.692804,100,1.0,0.0,-860,-510,660.0
588000.0,3,1.75,2310,7620,2.0,3,8,2310,0.0,1942,2200,7672,29286 days 16:47:18.692804,302,1.7142857142857142,0.0,110,-52,2310.0
252500.0,2,1.0,770,2191,1.0,3,6,770,0.0,1937,940,5000,31112 days 16:47:18.692804,223,2.0,0.0,-170,-2809,770.0
530000.0,3,3.5,2320,3174,2.0,3,9,2060,260.0,1997,2320,3187,9197 days 16:47:18.692804,139,0.8571428571428571,7.923076923076923,0,-13,1800.0
385000.0,2,1.5,1370,159865,1.0,3,7,1370,0.0,1960,1370,16217,22712 days 16:47:18.692804,005,1.3333333333333333,0.0,0,143648,1370.0
419000.0,3,2.25,1700,7650,1.0,4,7,1340,360.0,1975,1980,7200,17233 days 16:47:18.692804,241,1.3333333333333333,3.7222222222222223,-280,450,980.0
175000.0,2,1.0,960,5508,1.0,3,6,770,190.0,1951,1280,5304,25999 days 16:47:18.692804,290,2.0,4.052631578947368,-320,204,580.0
515000.0,2,1.0,1150,5664,1.0,3,7,870,280.0,1948,1380,5664,27095 days 16:47:18.692804,090,2.0,3.107142857142857,-230,0,590.0
945000.0,4,2.5,2910,4680,1.5,5,9,1850,1060.0,1937,1960,4120,31112 days 16:47:18.692804,049,1.6,1.7452830188679245,950,560,790.0
359900.0,5,2.25,2290,7420,1.0,3,7,1290,1000.0,1973,1660,7526,17963 days 16:47:18.692804,171,2.2222222222222223,1.29,630,-106,290.0
419950.0,4,2.5,2260,5164,2.0,3,8,2260,0.0,1996,2260,5866,9563 days 16:47:18.692804,219,1.6,0.0,0,-702,2260.0
460000.0,3,1.75,1300,4000,1.0,3,7,900,400.0,1953,1750,4000,25268 days 16:47:18.692804,269,1.7142857142857142,2.25,-450,0,500.0
255000.0,3,2.25,1850,7151,2.0,3,7,1850,0.0,1989,1710,6827,12119 days 16:47:18.692804,064,1.3333333333333333,0.0,140,324,1850.0
481000.0,4,1.75,1920,9500,1.0,4,7,1470,450.0,1966,1820,10091,20520 days 16:47:18.692804,308,2.2857142857142856,3.2666666666666666,100,-591,1020.0
719521.0,4,1.75,1920,9500,1.0,4,7,1470,450.0,1966,1820,10091,20520 days 16:47:18.692804,072,2.2857142857142856,3.2666666666666666,100,-591,1020.0
1080000.0,3,3.0,4910,43560,2.0,4,1,4000,910.0,1989,3540,12288,12119 days 16:47:18.692804,171,1.0,4.395604395604396,1370,31272,3090.0
334000.0,4,2.5,2210,6080,1.0,4,8,1410,800.0,1965,2210,6175,20885 days 16:47:18.692804,143,1.6,1.7625,0,-95,610.0
675000.0,4,2.75,2280,3200,1.5,5,8,1520,760.0,1931,1970,4687,33304 days 16:47:18.692804,255,1.4545454545454546,2.0,310,-1487,760.0
556000.0,3,1.75,1640,7437,1.0,3,7,1090,550.0,1948,1640,7436,27095 days 16:47:18.692804,164,1.7142857142857142,1.981818181818182,0,1,540.0
900000.0,4,2.0,1980,7200,2.0,3,8,1700,280.0,1910,2490,4200,40974 days 16:47:18.692804,227,2.0,6.071428571428571,-510,3000,1420.0
400000.0,3,1.0,900,4084,1.5,3,7,900,0.0,1910,1280,4080,40974 days 16:47:18.692804,275,3.0,0.0,-380,4,900.0
724950.0,4,1.75,1960,4340,1.0,5,8,980,980.0,1912,1630,4360,40244 days 16:47:18.692804,083,2.2857142857142856,1.0,330,-20,0.0
321000.0,4,2.25,1800,4500,2.0,4,8,1800,0.0,2004,2010,5050,6641 days 16:47:18.692804,246,1.7777777777777777,0.0,-210,-550,1800.0
1360000.0,4,3.5,4270,5800,2.0,5,1,3170,1100.0,1937,3100,5800,31112 days 16:47:18.692804,182,1.1428571428571428,2.881818181818182,1170,0,2070.0
171000.0,4,2.0,1520,19672,1.0,3,6,1020,500.0,1920,1810,7840,37322 days 16:47:18.692804,164,2.0,2.04,-290,11832,520.0
1360000.0,4,3.0,5430,108900,2.0,4,1,5430,0.0,1987,3170,107076,12850 days 16:47:18.692804,188,1.3333333333333333,0.0,2260,1824,5430.0
323000.0,3,1.75,1950,15037,1.0,3,7,1950,0.0,1989,1760,15181,12119 days 16:47:18.692804,055,1.7142857142857142,0.0,190,-144,1950.0
491500.0,4,1.75,2190,125452,1.0,3,9,2190,0.0,1968,3000,125017,19790 days 16:47:18.692804,122,2.2857142857142856,0.0,-810,435,2190.0
226000.0,4,1.5,1200,10890,1.0,5,7,1200,0.0,1972,1250,10139,18329 days 16:47:18.692804,202,2.6666666666666665,0.0,-50,751,1200.0
580000.0,6,1.75,2180,4000,1.5,4,7,1380,800.0,1926,1720,4000,35130 days 16:47:18.692804,282,3.4285714285714284,1.725,460,0,580.0
640000.0,4,2.5,2320,11259,2.0,3,9,2320,0.0,1982,2820,11770,14676 days 16:47:18.692804,234,1.6,0.0,-500,-511,2320.0
619790.0,3,1.75,1040,5097,1.0,4,7,800,240.0,1944,1630,5097,28556 days 16:47:18.692804,232,1.7142857142857142,3.3333333333333335,-590,0,560.0
383962.0,4,2.5,2700,6998,2.0,3,8,2700,0.0,2001,2350,10550,7736 days 16:47:18.692804,181,1.6,0.0,350,-3552,2700.0
373000.0,3,2.0,1400,2445,1.0,3,7,840,560.0,2002,1400,3200,7371 days 16:47:18.692804,227,1.5,1.5,0,-755,280.0
541338.0,3,2.5,2060,8123,2.0,3,8,1010,1050.0,1977,1760,6170,16502 days 16:47:18.692804,344,1.2,0.9619047619047619,300,1953,-40.0
254922.0,2,1.0,780,8160,1.0,4,6,780,0.0,1953,1310,8160,25268 days 16:47:18.692804,276,2.0,0.0,-530,0,780.0
575000.0,3,2.25,2400,5000,1.5,4,7,1440,960.0,1926,1630,5000,35130 days 16:47:18.692804,175,1.3333333333333333,1.5,770,0,480.0
650000.0,4,3.0,2900,15535,1.0,4,7,1870,1030.0,1961,2330,10217,22346 days 16:47:18.692804,245,1.3333333333333333,1.8155339805825244,570,5318,840.0
269950.0,3,1.5,1740,9547,1.0,4,7,1740,0.0,1962,1780,9936,21981 days 16:47:18.692804,225,2.0,0.0,-40,-389,1740.0
495000.0,3,2.75,2430,14861,1.0,3,9,1530,900.0,1988,2230,10300,12485 days 16:47:18.693809,363,1.0909090909090908,1.7,200,4561,630.0
794154.0,4,2.0,2210,8556,1.0,4,8,1210,1000.0,1954,2190,7975,24903 days 16:47:18.693809,127,2.0,1.21,20,581,210.0
340768.0,3,1.5,1510,11200,1.0,4,8,1510,0.0,1960,2110,12070,22712 days 16:47:18.693809,353,2.0,0.0,-600,-870,1510.0
375000.0,2,1.0,900,5413,1.0,3,7,900,0.0,1947,1280,6380,27460 days 16:47:18.693809,213,2.0,0.0,-380,-967,900.0
820000.0,4,2.5,3670,7000,2.0,3,1,3670,0.0,2005,3680,7437,6275 days 16:47:18.693809,144,1.6,0.0,-10,-437,3670.0
555000.0,2,2.25,1160,954,2.0,3,8,960,200.0,2014,1160,1327,2988 days 16:47:18.693809,273,0.8888888888888888,4.8,0,-373,760.0
312500.0,2,1.5,1070,1200,2.0,3,7,1070,0.0,1999,1070,1200,8467 days 16:47:18.693809,163,1.3333333333333333,0.0,0,0,1070.0
739000.0,3,2.75,2950,6667,2.0,3,9,2950,0.0,2003,3340,6667,7006 days 16:47:18.693809,005,1.0909090909090908,0.0,-390,0,2950.0
320000.0,3,2.0,1420,1716,2.0,3,7,1050,370.0,2003,1420,8150,7006 days 16:47:18.693809,103,1.5,2.8378378378378377,0,-6434,680.0
235000.0,3,1.0,1590,13000,1.5,3,6,1590,0.0,1944,1460,8400,28556 days 16:47:18.693809,160,3.0,0.0,130,4600,1590.0
275500.0,4,1.0,1290,5000,1.5,3,7,1290,0.0,1957,1440,2500,23807 days 16:47:18.693809,082,4.0,0.0,-150,2500,1290.0
564000.0,2,2.0,1690,4500,1.0,3,8,1690,0.0,2004,1640,4500,6641 days 16:47:18.693809,169,1.0,0.0,50,0,1690.0
263000.0,4,1.75,1340,8700,1.5,3,6,1340,0.0,1958,1240,8700,23442 days 16:47:18.693809,121,2.2857142857142856,0.0,100,0,1340.0
257000.0,3,1.75,1397,18000,1.0,3,7,1397,0.0,1965,1950,31294,20885 days 16:47:18.693809,308,1.7142857142857142,0.0,-553,-13294,1397.0
725000.0,4,2.5,3750,218506,2.0,3,1,3750,0.0,1991,2540,39413,11389 days 16:47:18.693809,078,1.6,0.0,1210,179093,3750.0
300000.0,3,2.25,2000,7560,1.0,3,7,1400,600.0,1979,2040,6949,15772 days 16:47:18.693809,345,1.3333333333333333,2.3333333333333335,-40,611,800.0
328000.0,3,2.0,2250,7904,1.5,3,8,2250,0.0,1998,2460,8622,8832 days 16:47:18.693809,188,1.5,0.0,-210,-718,2250.0
187500.0,3,1.0,840,8400,1.0,3,6,840,0.0,1959,1030,8640,23077 days 16:47:18.693809,209,3.0,0.0,-190,-240,840.0
400000.0,3,1.0,1100,5100,2.0,4,7,1100,0.0,1900,1540,5100,44626 days 16:47:18.693809,054,3.0,0.0,-440,0,1100.0
515000.0,3,1.5,1660,5100,1.0,4,7,1210,450.0,1954,1440,5100,24903 days 16:47:18.693809,061,2.0,2.688888888888889,220,0,760.0
235000.0,3,1.0,1460,8400,1.0,3,7,1460,0.0,1958,1460,9600,23442 days 16:47:18.693809,107,3.0,0.0,0,-1200,1460.0
669000.0,4,2.5,2470,4945,2.0,3,8,2470,0.0,2012,2510,4988,3719 days 16:47:18.693809,198,1.6,0.0,-40,-43,2470.0
282000.0,3,1.0,1250,13503,1.5,4,6,1250,0.0,1931,1450,13503,33304 days 16:47:18.693809,114,3.0,0.0,-200,0,1250.0
663000.0,3,2.0,1480,3876,1.0,5,7,860,620.0,1928,1660,3774,34400 days 16:47:18.693809,177,1.5,1.3870967741935485,-180,102,240.0
279900.0,3,3.25,2240,5000,2.0,3,9,1540,700.0,1989,1800,7500,12119 days 16:47:18.693809,114,0.9230769230769231,2.2,440,-2500,840.0
335000.0,3,2.0,1570,7200,1.0,4,7,1570,0.0,1952,1410,7434,25634 days 16:47:18.693809,127,1.5,0.0,160,-234,1570.0
689000.0,4,2.75,3250,10000,2.0,3,9,3250,0.0,2014,1620,10089,2988 days 16:47:18.693809,365,1.4545454545454546,0.0,1630,-89,3250.0
413100.0,3,2.25,1790,231303,1.0,3,7,1250,540.0,1980,2090,93654,15407 days 16:47:18.693809,111,1.3333333333333333,2.314814814814815,-300,137649,710.0
506950.0,3,2.5,2080,4931,2.0,3,8,2080,0.0,2000,1890,4229,8102 days 16:47:18.693809,086,1.2,0.0,190,702,2080.0
500000.0,3,2.5,1480,1171,3.0,3,8,1480,0.0,2006,1480,1231,5910 days 16:47:18.693809,126,1.2,0.0,0,-60,1480.0
540000.0,5,3.0,3610,9775,2.0,3,8,3610,0.0,2003,2800,8582,7006 days 16:47:18.693809,164,1.6666666666666667,0.0,810,1193,3610.0
812000.0,3,2.5,2040,4559,2.0,3,9,2040,0.0,1998,1500,4500,8832 days 16:47:18.693809,234,1.2,0.0,540,59,2040.0
1200000.0,4,3.25,3850,19842,2.0,3,1,3180,670.0,1989,4320,19500,12119 days 16:47:18.693809,240,1.2307692307692308,4.746268656716418,-470,342,2510.0
370000.0,3,2.25,3230,35306,2.0,3,9,3230,0.0,1987,2760,35285,12850 days 16:47:18.693809,349,1.3333333333333333,0.0,470,21,3230.0
338000.0,3,2.0,2440,23512,1.0,3,6,1640,800.0,1933,1630,19613,32573 days 16:47:18.693809,237,1.5,2.05,810,3899,840.0
185000.0,4,1.0,1490,6600,1.0,3,7,1490,0.0,1969,1280,6600,19424 days 16:47:18.693809,127,4.0,0.0,210,0,1490.0
451000.0,2,1.0,900,6000,1.0,3,7,900,0.0,1944,1460,4800,28556 days 16:47:18.693809,193,2.0,0.0,-560,1200,900.0
785000.0,4,2.5,3210,24527,1.5,3,1,3210,0.0,1984,3280,24527,13946 days 16:47:18.693809,111,1.6,0.0,-70,0,3210.0
850000.0,5,3.0,3900,5250,1.5,5,8,2620,1280.0,1931,1950,5700,33304 days 16:47:18.693809,209,1.6666666666666667,2.046875,1950,-450,1340.0
235000.0,3,1.0,1240,18000,1.0,2,7,1240,0.0,1943,1240,18000,28921 days 16:47:18.693809,357,3.0,0.0,0,0,1240.0
1150000.0,3,1.75,1760,6788,2.0,3,7,1760,0.0,1940,1630,7588,30017 days 16:47:18.693809,014,1.7142857142857142,0.0,130,-800,1760.0
377500.0,3,2.25,1410,1377,2.0,3,7,1290,120.0,2005,1445,1370,6275 days 16:47:18.693809,136,1.3333333333333333,10.75,-35,7,1170.0
825500.0,3,2.5,2780,11964,2.0,3,9,2780,0.0,2009,1760,9640,4814 days 16:47:18.693809,150,1.2,0.0,1020,2324,2780.0
1060000.0,5,3.25,3230,3825,2.0,3,9,2480,750.0,2014,1480,5100,2988 days 16:47:18.693809,161,1.5384615384615385,3.3066666666666666,1750,-1275,1730.0
880000.0,5,3.5,4600,8764,2.0,3,1,3180,1420.0,2007,3210,9431,5545 days 16:47:18.693809,324,1.4285714285714286,2.23943661971831,1390,-667,1760.0
413800.0,3,2.0,1440,4421,1.0,3,8,1440,0.0,2007,1440,4157,5545 days 16:47:18.693809,141,1.5,0.0,0,264,1440.0
504200.0,2,1.5,1200,1687,3.0,3,8,1200,0.0,2008,1240,1296,5180 days 16:47:18.693809,178,1.3333333333333333,0.0,-40,391,1200.0
421500.0,4,3.0,2793,5703,2.0,3,9,2793,0.0,2009,2793,5704,4814 days 16:47:18.693809,112,1.3333333333333333,0.0,0,-1,2793.0
855169.0,4,2.5,2970,5050,2.0,3,8,2970,0.0,2014,2810,4998,2988 days 16:47:18.693809,064,1.6,0.0,160,52,2970.0
380000.0,3,2.0,1440,3218,1.0,3,7,850,590.0,2008,1170,5000,5180 days 16:47:18.693809,038,1.5,1.4406779661016949,270,-1782,260.0
580000.0,3,2.25,1480,1026,3.0,3,8,1480,0.0,2014,1570,1283,2988 days 16:47:18.693809,216,1.3333333333333333,0.0,-90,-257,1480.0
329900.0,4,2.75,2475,4000,2.0,3,7,2475,0.0,2014,2475,4000,2988 days 16:47:18.693809,273,1.4545454545454546,0.0,0,0,2475.0
921800.0,4,2.5,2950,7024,2.0,3,1,2950,0.0,2012,2950,6339,3719 days 16:47:18.693809,240,1.6,0.0,0,685,2950.0
529500.0,3,2.25,1410,905,3.0,3,9,1410,0.0,2014,1510,1352,2988 days 16:47:18.693809,063,1.3333333333333333,0.0,-100,-447,1410.0
363990.0,4,2.5,2240,3712,2.0,3,8,2240,0.0,2014,2530,4315,2988 days 16:47:18.693809,154,1.6,0.0,-290,-603,2240.0
834950.0,5,2.75,3230,6500,2.0,3,9,3230,0.0,2014,3180,7624,2988 days 16:47:18.693809,015,1.8181818181818181,0.0,50,-1124,3230.0
399000.0,3,2.0,2100,31550,1.0,3,8,2100,0.0,2010,1860,18452,4449 days 16:47:18.693809,231,1.5,0.0,240,13098,2100.0
338900.0,3,2.25,1936,9495,1.0,3,8,1936,0.0,2013,1410,12770,3353 days 16:47:18.693809,318,1.3333333333333333,0.0,526,-3275,1936.0
419950.0,3,2.5,3120,6000,2.0,3,9,3120,0.0,2007,2670,6000,5545 days 16:47:18.693809,070,1.2,0.0,450,0,3120.0
493000.0,4,2.5,2070,4270,2.0,3,8,2070,0.0,2010,2070,4610,4449 days 16:47:18.693809,103,1.6,0.0,0,-340,2070.0
650000.0,4,2.5,3700,4500,2.0,3,9,3700,0.0,2007,3050,5047,5545 days 16:47:18.693809,345,1.6,0.0,650,-547,3700.0
456000.0,3,2.5,2130,5205,2.0,3,8,2130,0.0,2013,2250,5462,3353 days 16:47:18.693809,252,1.2,0.0,-120,-257,2130.0
425000.0,3,2.25,1620,997,2.5,3,8,1540,80.0,2010,1620,1068,4449 days 16:47:18.693809,261,1.3333333333333333,19.25,0,-71,1460.0
348000.0,3,2.5,1490,2478,3.0,3,8,1490,0.0,2009,1270,1156,4814 days 16:47:18.693809,040,1.2,0.0,220,1322,1490.0
1040000.0,5,4.0,4180,7232,2.0,3,9,4180,0.0,2014,3570,6054,2988 days 16:47:18.693809,302,1.25,0.0,610,1178,4180.0
299000.0,2,2.5,1400,1262,2.0,3,8,1160,240.0,2008,1060,1524,5180 days 16:47:18.693809,322,0.8,4.833333333333333,340,-262,920.0
1260000.0,4,3.75,3490,9170,2.0,3,9,3490,0.0,2012,1810,8470,3719 days 16:47:18.693809,132,1.0666666666666667,0.0,1680,700,3490.0
319500.0,4,2.5,2730,4962,2.0,3,8,2730,0.0,2006,2150,3802,5910 days 16:47:18.693809,056,1.6,0.0,580,1160,2730.0
274000.0,3,2.5,1830,2517,2.0,3,8,1830,0.0,2005,1610,2762,6275 days 16:47:18.693809,356,1.2,0.0,220,-245,1830.0
429000.0,5,2.5,2340,4500,2.0,3,7,2340,0.0,2009,2190,4500,4814 days 16:47:18.693809,167,2.0,0.0,150,0,2340.0
267800.0,3,1.75,1410,1899,2.0,3,8,1410,0.0,2014,1410,1811,2988 days 16:47:18.693809,336,1.7142857142857142,0.0,0,88,1410.0
369950.0,3,2.5,1930,8254,2.0,3,7,1930,0.0,2014,1540,8849,2988 days 16:47:18.693809,098,1.2,0.0,390,-595,1930.0
440000.0,4,3.5,3180,4869,2.0,3,8,2390,790.0,2007,2850,4500,5545 days 16:47:18.693809,258,1.1428571428571428,3.0253164556962027,330,369,1600.0
839704.0,4,3.25,2950,4161,2.0,3,1,2210,740.0,2014,2790,3693,2988 days 16:47:18.693809,083,1.2307692307692308,2.9864864864864864,160,468,1470.0
535000.0,3,3.25,1430,1276,3.0,3,8,1430,0.0,2007,1430,1243,5545 days 16:47:18.693809,029,0.9230769230769231,0.0,0,33,1430.0
290000.0,2,1.5,1020,1275,3.0,3,8,1020,0.0,2008,980,1415,5180 days 16:47:18.693809,237,1.3333333333333333,0.0,40,-140,1020.0
370000.0,3,2.5,1650,1793,3.0,3,8,1650,0.0,2007,1650,1863,5545 days 16:47:18.693809,202,1.2,0.0,0,-70,1650.0
405000.0,3,2.0,1060,651,3.0,3,7,1060,0.0,2007,1440,1501,5545 days 16:47:18.693809,062,1.5,0.0,-380,-850,1060.0
499431.0,4,2.75,2620,6019,2.0,3,8,2620,0.0,2013,2790,6716,3353 days 16:47:18.693809,150,1.4545454545454546,0.0,-170,-697,2620.0
275000.0,4,2.5,1830,3868,2.0,3,7,1830,0.0,2007,2330,3868,5545 days 16:47:18.693809,191,1.6,0.0,-500,0,1830.0
320000.0,3,2.25,998,844,2.0,3,7,798,200.0,2007,998,1110,5545 days 16:47:18.693809,142,1.3333333333333333,3.99,0,-266,598.0
425000.0,4,2.5,2070,4427,2.0,3,7,2070,0.0,2007,2070,4556,5545 days 16:47:18.693809,217,1.6,0.0,0,-129,2070.0
1450000.0,4,3.5,2860,2199,3.0,3,1,2860,0.0,2013,1990,1378,3353 days 16:47:18.693809,058,1.1428571428571428,0.0,870,821,2860.0
340000.0,3,2.0,1920,5688,1.0,3,9,1920,0.0,2007,2384,4802,5545 days 16:47:18.693809,041,1.5,0.0,-464,886,1920.0
299900.0,3,2.5,1210,2046,2.0,3,9,920,290.0,2008,1070,651,5180 days 16:47:18.693809,274,1.2,3.1724137931034484,140,1395,630.0
865950.0,5,3.5,4890,12039,2.0,3,9,3590,1300.0,2014,4590,10079,2988 days 16:47:18.693809,360,1.4285714285714286,2.7615384615384615,300,1960,2290.0
720000.0,4,2.5,3420,17038,2.0,3,9,3420,0.0,2007,2520,14190,5545 days 16:47:18.693809,227,1.6,0.0,900,2848,3420.0
460000.0,4,3.5,2870,3225,2.0,3,9,2070,800.0,2006,1770,6450,5910 days 16:47:18.693809,275,1.1428571428571428,2.5875,1100,-3225,1270.0
386180.0,2,1.5,960,1829,2.0,3,7,960,0.0,2005,1470,1829,6275 days 16:47:18.693809,131,1.3333333333333333,0.0,-510,0,960.0
280000.0,3,2.75,1740,5639,1.0,3,7,1740,0.0,2010,2380,5331,4449 days 16:47:18.693809,014,1.0909090909090908,0.0,-640,308,1740.0
359000.0,4,2.5,2575,4725,2.0,3,8,2575,0.0,2011,2575,5323,4084 days 16:47:18.693809,220,1.6,0.0,0,-598,2575.0
785000.0,5,3.25,3660,11995,2.0,3,1,3660,0.0,2006,3320,11241,5910 days 16:47:18.693809,122,1.5384615384615385,0.0,340,754,3660.0
425000.0,3,2.25,1420,1230,2.0,3,8,940,480.0,2009,1400,1230,4814 days 16:47:18.693809,037,1.3333333333333333,1.9583333333333333,20,0,460.0
575000.0,5,2.5,3070,7200,2.0,3,8,3070,0.0,2005,2590,7200,6275 days 16:47:18.693809,124,2.0,0.0,480,0,3070.0
465000.0,3,2.5,1920,144619,1.0,3,8,1920,0.0,2014,2010,48787,2988 days 16:47:18.693809,062,1.2,0.0,-90,95832,1920.0
1850000.0,4,3.25,4160,10335,2.0,3,1,4160,0.0,2014,1840,10333,2988 days 16:47:18.693809,126,1.2307692307692308,0.0,2320,2,4160.0
720000.0,4,3.25,3276,10801,2.0,3,9,3276,0.0,2008,2010,11656,5180 days 16:47:18.693809,049,1.2307692307692308,0.0,1266,-855,3276.0
390000.0,5,3.75,2890,5000,1.0,3,7,1310,1580.0,2006,1930,5117,5910 days 16:47:18.693809,126,1.3333333333333333,0.8291139240506329,960,-117,-270.0
2210000.0,3,2.5,3430,10177,2.0,3,1,3430,0.0,2014,3110,12339,2988 days 16:47:18.693809,119,1.2,0.0,320,-2162,3430.0
1050000.0,4,3.5,3390,3979,2.0,3,9,2610,780.0,2014,3350,4165,2988 days 16:47:18.693809,183,1.1428571428571428,3.3461538461538463,40,-186,1830.0
915000.0,6,3.75,2930,14980,2.0,3,9,2930,0.0,2013,3210,10787,3353 days 16:47:18.693809,161,1.6,0.0,-280,4193,2930.0
562000.0,2,2.25,1300,1314,3.0,3,8,1300,0.0,2008,1300,1312,5180 days 16:47:18.693809,112,0.8888888888888888,0.0,0,2,1300.0
349000.0,2,1.75,1250,1208,2.0,3,7,1040,210.0,2007,1250,1656,5545 days 16:47:18.693809,324,1.1428571428571428,4.9523809523809526,0,-448,830.0
375000.0,4,2.5,2310,7800,2.0,3,8,2310,0.0,2011,2310,7140,4084 days 16:47:18.693809,226,1.6,0.0,0,660,2310.0
479950.0,2,2.25,1360,1336,3.0,3,8,1360,0.0,2008,1280,1295,5180 days 16:47:18.693809,346,0.8888888888888888,0.0,80,41,1360.0
319000.0,4,2.5,2020,5100,2.0,3,7,2020,0.0,2010,2300,5685,4449 days 16:47:18.693809,009,1.6,0.0,-280,-585,2020.0
325000.0,3,1.5,1270,1067,3.0,3,8,1270,0.0,2009,1090,1118,4814 days 16:47:18.693809,276,2.0,0.0,180,-51,1270.0
505657.0,4,2.75,2790,8092,2.0,3,8,2790,0.0,2013,2790,6154,3353 days 16:47:18.693809,233,1.4545454545454546,0.0,0,1938,2790.0
340000.0,4,2.5,2320,4142,2.0,3,7,2320,0.0,2010,2150,4140,4449 days 16:47:18.693809,064,1.6,0.0,170,2,2320.0
250000.0,3,2.5,1750,6351,2.0,3,7,1750,0.0,2012,1398,6092,3719 days 16:47:18.693809,023,1.2,0.0,352,259,1750.0
349500.0,4,2.5,2030,4596,2.0,3,8,2030,0.0,2014,2040,4705,2988 days 16:47:18.693809,269,1.6,0.0,-10,-109,2030.0
290750.0,3,2.5,1270,865,2.0,3,7,1080,190.0,2008,1630,7752,5180 days 16:47:18.693809,114,1.2,5.684210526315789,-360,-6887,890.0
715000.0,5,3.25,2710,2356,2.0,3,8,2230,480.0,2013,2160,2108,3353 days 16:47:18.693809,125,1.5384615384615385,4.645833333333333,550,248,1750.0
689950.0,4,2.75,2520,8433,2.0,3,8,2520,0.0,2014,1890,7772,2988 days 16:47:18.693809,223,1.4545454545454546,0.0,630,661,2520.0
425000.0,2,2.5,1340,1263,3.0,3,8,1340,0.0,2008,1510,1260,5180 days 16:47:18.693809,267,0.8,0.0,-170,3,1340.0
657000.0,2,3.0,1570,1281,3.0,3,8,1570,0.0,2014,1570,2500,2988 days 16:47:18.693809,019,0.6666666666666666,0.0,0,-1219,1570.0
359950.0,4,3.5,2690,5564,2.0,3,7,2690,0.0,2007,2210,4046,5545 days 16:47:18.693809,324,1.1428571428571428,0.0,480,1518,2690.0
319900.0,4,2.75,2475,4276,2.0,3,7,2475,0.0,2014,2475,4000,2988 days 16:47:18.693809,212,1.4545454545454546,0.0,0,276,2475.0
532000.0,3,3.75,2260,2050,2.0,3,9,1170,1090.0,2010,2130,3082,4449 days 16:47:18.693809,106,0.8,1.073394495412844,130,-1032,80.0
291000.0,2,1.0,840,863,3.0,3,8,840,0.0,2008,1110,1190,5180 days 16:47:18.693809,089,2.0,0.0,-270,-327,840.0
675000.0,3,3.25,1720,1330,2.0,3,8,1030,690.0,2004,1720,1520,6641 days 16:47:18.693809,202,0.9230769230769231,1.4927536231884058,0,-190,340.0
885000.0,3,2.25,2940,6500,3.0,3,9,2940,0.0,2014,1680,6500,2988 days 16:47:18.693809,021,1.3333333333333333,0.0,1260,0,2940.0
1450000.0,5,3.5,4170,9090,2.0,3,1,4170,0.0,2008,1930,13635,5180 days 16:47:18.693809,294,1.4285714285714286,0.0,2240,-4545,4170.0
780000.0,6,4.25,4310,10000,2.0,3,8,2950,1360.0,2008,2100,10000,5180 days 16:47:18.693809,289,1.411764705882353,2.1691176470588234,2210,0,1590.0
839950.0,4,2.75,3010,7200,2.0,3,9,3010,0.0,2014,3010,7203,2988 days 16:47:18.693809,193,1.4545454545454546,0.0,0,-3,3010.0
645000.0,3,2.5,2170,1984,2.5,3,8,2170,0.0,2008,2150,1984,5180 days 16:47:18.693809,114,1.2,0.0,20,0,2170.0
263000.0,3,2.5,1584,3200,2.0,3,7,1584,0.0,2011,1584,2800,4084 days 16:47:18.693809,357,1.2,0.0,0,400,1584.0
345000.0,2,2.25,1110,1290,3.0,3,8,1110,0.0,2006,1360,1251,5910 days 16:47:18.693809,303,0.8888888888888888,0.0,-250,39,1110.0
505000.0,4,2.5,2420,5006,2.0,3,8,2420,0.0,2013,2750,5471,3353 days 16:47:18.693809,329,1.6,0.0,-330,-465,2420.0
522500.0,2,2.25,1430,1210,2.0,3,8,1340,90.0,2005,1430,1016,6275 days 16:47:18.693809,246,0.8888888888888888,14.88888888888889,0,194,1250.0
400000.0,3,2.5,2393,4788,2.0,3,8,2393,0.0,2012,2439,5477,3719 days 16:47:18.693809,223,1.2,0.0,-46,-689,2393.0
543000.0,3,2.25,1240,949,3.0,3,8,1240,0.0,2008,1310,1140,5180 days 16:47:18.693809,170,1.3333333333333333,0.0,-70,-191,1240.0
495000.0,4,2.5,2980,12075,1.0,3,8,1910,1070.0,2007,2240,12075,5545 days 16:47:18.693809,286,1.6,1.7850467289719627,740,0,840.0
549995.0,4,3.5,2970,6587,2.0,3,8,2260,710.0,2014,2970,5690,2988 days 16:47:18.693809,254,1.1428571428571428,3.183098591549296,0,897,1550.0
327555.0,3,2.5,2329,5720,2.0,3,8,2329,0.0,2010,2197,5720,4449 days 16:47:18.693809,042,1.2,0.0,132,0,2329.0
690000.0,5,3.25,3340,9075,2.0,3,8,2600,740.0,2005,2770,6646,6275 days 16:47:18.693809,099,1.5384615384615385,3.5135135135135136,570,2429,1860.0
673000.0,4,2.25,2580,2875,2.0,3,9,2580,0.0,2015,1290,5750,2623 days 16:47:18.693809,077,1.7777777777777777,0.0,1290,-2875,2580.0
384435.0,3,2.5,2029,3906,2.0,3,9,2029,0.0,2014,2029,3920,2988 days 16:47:18.693809,202,1.2,0.0,0,-14,2029.0
780000.0,4,2.75,3430,6500,2.0,3,9,3050,380.0,2006,3070,6802,5910 days 16:47:18.693809,227,1.4545454545454546,8.026315789473685,360,-302,2670.0
1380000.0,5,3.75,3330,5042,2.0,3,9,2470,860.0,2014,1780,3990,2988 days 16:47:18.693809,302,1.3333333333333333,2.872093023255814,1550,1052,1610.0
950968.0,5,3.5,3220,5081,2.0,3,8,3220,0.0,2013,2970,5753,3353 days 16:47:18.693809,083,1.4285714285714286,0.0,250,-672,3220.0
334950.0,2,2.25,1240,750,2.0,3,7,1150,90.0,2008,1240,750,5180 days 16:47:18.693809,088,0.8888888888888888,12.777777777777779,0,0,1060.0
489000.0,3,3.5,1500,1249,2.0,3,8,1240,260.0,2004,1440,1850,6641 days 16:47:18.693809,160,0.8571428571428571,4.769230769230769,60,-601,980.0
600000.0,3,3.0,3530,8345,2.0,3,1,3530,0.0,2006,1940,9600,5910 days 16:47:18.693809,110,1.0,0.0,1590,-1255,3530.0
282000.0,3,2.25,1260,915,2.0,3,8,1020,240.0,2007,1260,1056,5545 days 16:47:18.693809,234,1.3333333333333333,4.25,0,-141,780.0
442000.0,4,4.0,4168,8485,2.0,3,1,3222,946.0,2007,4362,8100,5545 days 16:47:18.693809,213,1.0,3.4059196617336154,-194,385,2276.0
220000.0,2,1.5,1030,2850,2.0,3,7,1030,0.0,1995,1030,3000,9928 days 16:47:18.693809,132,1.3333333333333333,0.0,0,-150,1030.0
489000.0,3,2.5,3080,5598,2.0,3,8,3080,0.0,2006,3080,5303,5910 days 16:47:18.693809,049,1.2,0.0,0,295,3080.0
250000.0,3,1.5,1072,4339,2.0,3,7,1072,0.0,2009,1443,4341,4814 days 16:47:18.693809,357,2.0,0.0,-371,-2,1072.0
484259.0,4,2.75,2790,5000,2.0,3,8,2790,0.0,2014,2620,5527,2988 days 16:47:18.693809,205,1.4545454545454546,0.0,170,-527,2790.0
1680000.0,3,2.5,4090,16972,2.0,3,1,3590,500.0,2007,3740,16972,5545 days 16:47:18.693809,061,1.2,7.18,350,0,3090.0
450000.0,3,2.5,1800,4357,2.0,3,8,1800,0.0,2013,1800,3663,3353 days 16:47:18.693809,114,1.2,0.0,0,694,1800.0
299000.0,2,1.5,830,1276,2.0,3,7,830,0.0,2005,1540,1484,6275 days 16:47:18.693809,318,1.3333333333333333,0.0,-710,-208,830.0
450000.0,3,2.5,2280,4557,2.0,3,8,2280,0.0,2010,2070,4610,4449 days 16:47:18.693809,302,1.2,0.0,210,-53,2280.0
585000.0,4,3.0,2110,1286,2.0,3,9,1710,400.0,2007,2000,1286,5545 days 16:47:18.693809,023,1.3333333333333333,4.275,110,0,1310.0
660000.0,3,2.25,1570,1680,3.0,3,8,1570,0.0,2014,1290,1870,2988 days 16:47:18.693809,307,1.3333333333333333,0.0,280,-190,1570.0
301500.0,2,1.5,830,1333,2.0,3,7,830,0.0,2005,1120,4822,6275 days 16:47:18.693809,132,1.3333333333333333,0.0,-290,-3489,830.0
949950.0,4,3.75,4120,8258,2.0,3,1,4120,0.0,2012,3730,8332,3719 days 16:47:18.693809,258,1.0666666666666667,0.0,390,-74,4120.0
759990.0,4,2.5,2540,5760,2.0,3,9,2540,0.0,2009,2580,3600,4814 days 16:47:18.693809,303,1.6,0.0,-40,2160,2540.0
355000.0,4,2.75,2050,4000,2.0,3,8,2050,0.0,2014,2050,4000,2988 days 16:47:18.693809,075,1.4545454545454546,0.0,0,0,2050.0
889950.0,4,2.75,3080,7242,2.0,3,9,3080,0.0,2014,3010,7205,2988 days 16:47:18.693809,204,1.4545454545454546,0.0,70,37,3080.0
629800.0,3,2.5,2390,1984,2.0,3,8,2220,170.0,2008,2150,1984,5180 days 16:47:18.693809,182,1.2,13.058823529411764,240,0,2050.0
745000.0,4,2.5,3170,5100,2.0,3,9,3170,0.0,2012,1580,5100,3719 days 16:47:18.693809,114,1.6,0.0,1590,0,3170.0
379900.0,2,1.5,1240,1331,2.0,3,7,1050,190.0,2007,1250,1431,5545 days 16:47:18.693809,307,1.3333333333333333,5.526315789473684,-10,-100,860.0
335000.0,3,2.5,1090,1139,2.0,3,8,960,130.0,2009,1400,1348,4814 days 16:47:18.693809,318,1.2,7.384615384615385,-310,-209,830.0
809000.0,5,4.5,4630,6324,2.0,3,9,3210,1420.0,2006,4420,6790,5910 days 16:47:18.693809,132,1.1111111111111112,2.26056338028169,210,-466,1790.0
569950.0,4,2.5,3230,5899,2.0,3,8,3230,0.0,2012,2720,5899,3719 days 16:47:18.693809,238,1.6,0.0,510,0,3230.0
723000.0,4,3.5,3510,9263,2.0,3,1,3510,0.0,2001,3690,10417,7736 days 16:47:18.693809,220,1.1428571428571428,0.0,-180,-1154,3510.0
282000.0,4,2.5,1785,2552,2.0,3,8,1785,0.0,2009,1691,2700,4814 days 16:47:18.693809,314,1.6,0.0,94,-148,1785.0
569900.0,5,3.25,2360,3873,2.0,3,8,1990,370.0,2006,1720,3071,5910 days 16:47:18.693809,303,1.5384615384615385,5.378378378378378,640,802,1620.0
385000.0,4,2.0,2340,9716,1.0,3,7,2340,0.0,2009,1180,13500,4814 days 16:47:18.693809,021,2.0,0.0,1160,-3784,2340.0
420000.0,3,2.25,1620,1075,3.0,3,8,1540,80.0,2009,1620,1237,4814 days 16:47:18.693809,188,1.3333333333333333,19.25,0,-162,1460.0
2250000.0,3,3.25,3890,3452,2.0,3,1,2890,1000.0,2006,2860,2199,5910 days 16:47:18.693809,218,0.9230769230769231,2.89,1030,1253,1890.0
1210000.0,4,3.5,3590,5335,2.0,3,9,3140,450.0,2006,2100,6250,5910 days 16:47:18.693809,258,1.1428571428571428,6.977777777777778,1490,-915,2690.0
292000.0,4,3.0,1984,4460,2.0,3,7,1984,0.0,2012,2095,3402,3719 days 16:47:18.693809,342,1.3333333333333333,0.0,-111,1058,1984.0
645000.0,3,2.25,1640,1023,3.0,3,8,1640,0.0,2014,1720,1960,2988 days 16:47:18.693809,075,1.3333333333333333,0.0,-80,-937,1640.0
304500.0,4,2.0,1350,942,3.0,3,7,1350,0.0,2008,1390,942,5180 days 16:47:18.693809,078,2.0,0.0,-40,0,1350.0
489500.0,4,3.5,2730,5707,2.0,3,8,2000,730.0,2011,2430,5899,4084 days 16:47:18.693809,127,1.1428571428571428,2.73972602739726,300,-192,1270.0
1580000.0,4,4.0,5610,11063,3.0,3,1,4750,860.0,2006,4560,11063,5910 days 16:47:18.693809,114,1.0,5.523255813953488,1050,0,3890.0
390000.0,2,1.0,962,1992,2.0,3,7,962,0.0,2012,1130,1992,3719 days 16:47:18.693809,006,2.0,0.0,-168,0,962.0
815000.0,4,3.5,3040,4006,2.0,3,8,2350,690.0,2013,2050,4000,3353 days 16:47:18.693809,275,1.1428571428571428,3.4057971014492754,990,6,1660.0
719000.0,3,3.5,2540,10578,2.0,3,9,2010,530.0,2014,3240,9831,2988 days 16:47:18.693809,093,0.8571428571428571,3.792452830188679,-700,747,1480.0
331210.0,4,2.5,2240,4800,2.0,3,8,2240,0.0,2014,2240,5040,2988 days 16:47:18.693809,093,1.6,0.0,0,-240,2240.0
245000.0,3,1.5,1260,1270,2.0,3,7,1040,220.0,2005,1260,1472,6275 days 16:47:18.693809,127,2.0,4.7272727272727275,0,-202,820.0
465000.0,5,4.0,3210,7200,2.0,3,8,2410,800.0,2011,2750,7200,4084 days 16:47:18.693809,252,1.25,3.0125,460,0,1610.0
580000.0,3,2.5,1620,1171,3.0,3,8,1470,150.0,2008,1620,1505,5180 days 16:47:18.693809,273,1.2,9.8,0,-334,1320.0
540000.0,3,2.0,1580,1972,2.5,3,8,1180,400.0,2007,1500,1908,5545 days 16:47:18.693809,104,1.5,2.95,80,64,780.0
399000.0,3,2.5,1430,1250,3.0,3,7,1430,0.0,2007,1360,1269,5545 days 16:47:18.693809,322,1.2,0.0,70,-19,1430.0
328000.0,4,2.5,1850,5388,2.0,3,8,1850,0.0,2009,2140,5086,4814 days 16:47:18.693809,216,1.6,0.0,-290,302,1850.0
701000.0,4,2.5,3340,5314,2.0,3,1,3340,0.0,2010,3220,5500,4449 days 16:47:18.693809,131,1.6,0.0,120,-186,3340.0
408000.0,3,2.75,2670,4800,2.0,3,8,2670,0.0,2014,2340,5000,2988 days 16:47:18.693809,295,1.0909090909090908,0.0,330,-200,2670.0
2640000.0,5,4.25,4660,16200,2.0,3,1,4660,0.0,2005,3340,16200,6275 days 16:47:18.693809,043,1.1764705882352942,0.0,1320,0,4660.0
445000.0,3,2.5,1550,930,2.0,3,8,1060,490.0,2006,1550,1301,5910 days 16:47:18.693809,226,1.2,2.163265306122449,0,-371,570.0
672500.0,4,2.5,3470,6651,2.0,3,9,3470,0.0,2005,2730,6179,6275 days 16:47:18.693809,294,1.6,0.0,740,472,3470.0
538000.0,3,2.5,3010,7014,2.0,3,8,3010,0.0,2009,3030,6180,4814 days 16:47:18.693809,190,1.2,0.0,-20,834,3010.0
450000.0,5,3.5,3931,9497,2.0,3,1,2650,1281.0,2014,3510,9497,2988 days 16:47:18.693809,247,1.4285714285714286,2.068696330991413,421,0,1369.0
362500.0,3,2.5,1800,2700,2.0,3,8,1800,0.0,2011,1380,1200,4084 days 16:47:18.693809,170,1.2,0.0,420,1500,1800.0
414950.0,3,2.5,1570,1551,3.0,3,8,1570,0.0,2008,1570,1705,5180 days 16:47:18.693809,288,1.2,0.0,0,-154,1570.0
679950.0,3,2.5,2230,3939,2.0,3,8,2230,0.0,2014,2230,4200,2988 days 16:47:18.693809,027,1.2,0.0,0,-261,2230.0
290000.0,4,2.5,2423,7292,2.0,3,8,2423,0.0,2005,2495,7489,6275 days 16:47:18.693809,316,1.6,0.0,-72,-197,2423.0
230000.0,3,2.0,1160,1174,2.0,3,7,790,370.0,2007,1160,994,5545 days 16:47:18.693809,296,1.5,2.135135135135135,0,180,420.0
439950.0,2,2.0,1440,4666,1.0,3,8,1440,0.0,2010,1510,4595,4449 days 16:47:18.693809,051,1.0,0.0,-70,71,1440.0
349900.0,4,2.5,2052,3723,2.0,3,8,2052,0.0,2014,2052,5250,2988 days 16:47:18.693809,142,1.6,0.0,0,-1527,2052.0
550000.0,5,2.5,2780,9272,2.0,3,8,2780,0.0,2014,1150,8460,2988 days 16:47:18.693809,356,2.0,0.0,1630,812,2780.0
1050000.0,4,4.25,3720,5750,2.0,3,9,2960,760.0,2006,2550,5750,5910 days 16:47:18.693809,120,0.9411764705882353,3.8947368421052633,1170,0,2200.0
655000.0,2,2.25,1460,1851,2.0,3,9,1180,280.0,2014,1800,4269,2988 days 16:47:18.693809,078,0.8888888888888888,4.214285714285714,-340,-2418,900.0
385000.0,3,3.5,1370,1540,2.0,3,8,1100,270.0,2006,1370,915,5910 days 16:47:18.693809,314,0.8571428571428571,4.074074074074074,0,625,830.0
523950.0,3,2.25,1420,1282,3.0,3,8,1420,0.0,2006,1530,1280,5910 days 16:47:18.693809,167,1.3333333333333333,0.0,-110,2,1420.0
369000.0,2,2.5,980,895,2.0,3,8,670,310.0,2009,980,899,4814 days 16:47:18.693809,132,0.8,2.161290322580645,0,-4,360.0
509900.0,3,2.5,1790,2700,2.0,3,8,1790,0.0,2010,1890,3078,4449 days 16:47:18.693809,125,1.2,0.0,-100,-378,1790.0
282000.0,3,2.5,2010,5399,2.0,3,7,2010,0.0,2006,2280,5141,5910 days 16:47:18.693809,196,1.2,0.0,-270,258,2010.0
387865.0,3,2.5,2370,4200,2.0,3,8,2370,0.0,2014,2370,4200,2988 days 16:47:18.693809,239,1.2,0.0,0,0,2370.0
385000.0,4,2.5,2560,6238,2.0,3,8,2560,0.0,2007,2560,6240,5545 days 16:47:18.693809,324,1.6,0.0,0,-2,2560.0
536000.0,3,2.5,1900,6224,2.0,3,7,1900,0.0,2005,2260,5450,6275 days 16:47:18.693809,160,1.2,0.0,-360,774,1900.0
395000.0,2,2.25,1350,1493,2.0,3,8,1050,300.0,2007,1250,1202,5545 days 16:47:18.693809,176,0.8888888888888888,3.5,100,291,750.0
545000.0,4,2.75,2650,6717,2.0,3,1,2650,0.0,2014,2740,7923,2988 days 16:47:18.693809,321,1.4545454545454546,0.0,-90,-1206,2650.0
715000.0,4,2.5,3020,7035,2.0,3,9,3020,0.0,2001,3020,6771,7736 days 16:47:18.693809,103,1.6,0.0,0,264,3020.0
348000.0,3,2.5,1500,2255,2.0,3,7,1500,0.0,2005,1440,2040,6275 days 16:47:18.693809,191,1.2,0.0,60,215,1500.0
455000.0,3,1.75,1320,1014,3.0,3,9,1320,0.0,2015,1380,1495,2623 days 16:47:18.693809,213,1.7142857142857142,0.0,-60,-481,1320.0
575000.0,4,2.75,3120,7644,2.0,3,1,3120,0.0,2010,2980,6050,4449 days 16:47:18.693809,154,1.4545454545454546,0.0,140,1594,3120.0
449950.0,3,2.25,1540,1270,3.0,3,7,1540,0.0,2014,1230,1454,2988 days 16:47:18.693809,280,1.3333333333333333,0.0,310,-184,1540.0
364000.0,3,2.5,1800,2790,2.0,3,8,1800,0.0,2011,1580,2036,4084 days 16:47:18.693809,176,1.2,0.0,220,754,1800.0
932990.0,4,2.5,3640,6389,2.0,3,9,3640,0.0,2014,3570,6303,2988 days 16:47:18.693809,335,1.6,0.0,70,86,3640.0
710000.0,3,2.5,2440,4153,2.0,3,9,2440,0.0,2003,2030,4143,7006 days 16:47:18.693809,178,1.2,0.0,410,10,2440.0
949990.0,4,4.0,3970,7314,2.0,3,9,3970,0.0,2014,3560,5258,2988 days 16:47:18.693809,044,1.0,0.0,410,2056,3970.0
326989.0,3,2.5,2060,4200,2.0,3,8,2060,0.0,2014,2370,4200,2988 days 16:47:18.693809,212,1.2,0.0,-310,0,2060.0
335606.0,3,2.5,2538,4600,2.0,3,8,2538,0.0,2013,2570,4800,3353 days 16:47:18.693809,189,1.2,0.0,-32,-200,2538.0
1530000.0,5,4.5,4270,8076,2.0,3,1,3400,870.0,2007,4100,10631,5545 days 16:47:18.693809,127,1.1111111111111112,3.9080459770114944,170,-2555,2530.0
299950.0,3,2.5,1320,3150,2.0,3,7,1320,0.0,2005,1390,1725,6275 days 16:47:18.693809,330,1.2,0.0,-70,1425,1320.0
962000.0,4,2.75,3340,5700,2.0,3,1,3340,0.0,2013,3340,6940,3353 days 16:47:18.693809,287,1.4545454545454546,0.0,0,-1240,3340.0
395825.0,2,2.5,1590,1679,2.0,3,8,1590,0.0,2012,1590,1680,3719 days 16:47:18.693809,225,0.8,0.0,0,-1,1590.0
419354.0,5,2.75,2710,4500,2.0,3,8,2710,0.0,2014,2710,4626,2988 days 16:47:18.693809,287,1.8181818181818181,0.0,0,-126,2710.0
920000.0,4,2.75,3140,7258,2.0,3,1,3140,0.0,2006,2990,13600,5910 days 16:47:18.693809,238,1.4545454545454546,0.0,150,-6342,3140.0
366000.0,3,2.25,1445,1028,2.0,3,7,1300,145.0,2005,1445,1377,6275 days 16:47:18.693809,241,1.3333333333333333,8.96551724137931,0,-349,1155.0
388000.0,3,3.25,1370,915,2.0,3,8,1100,270.0,2006,1370,1146,5910 days 16:47:18.693809,324,0.9230769230769231,4.074074074074074,0,-231,830.0
2320000.0,4,3.5,5050,9520,2.0,3,1,3610,1440.0,2007,2430,9248,5545 days 16:47:18.693809,111,1.1428571428571428,2.5069444444444446,2620,272,2170.0
730000.0,3,2.5,1860,1290,2.0,3,9,1240,620.0,2010,1710,1525,4449 days 16:47:18.693809,021,1.2,2.0,150,-235,620.0
950000.0,5,3.75,5330,6000,2.0,3,1,3570,1760.0,2006,4420,5797,5910 days 16:47:18.693809,141,1.3333333333333333,2.028409090909091,910,203,1810.0
358990.0,3,3.25,1710,2171,2.0,3,7,1400,310.0,2014,1380,1300,2988 days 16:47:18.693809,209,0.9230769230769231,4.516129032258065,330,871,1090.0
398651.0,4,2.5,2650,4120,2.0,3,8,2650,0.0,2014,2030,3768,2988 days 16:47:18.693809,289,1.6,0.0,620,352,2650.0
530000.0,4,2.5,2590,7891,2.0,3,9,2590,0.0,2006,1400,7891,5910 days 16:47:18.693809,318,1.6,0.0,1190,0,2590.0
610360.0,4,2.5,2610,5562,2.0,3,9,2610,0.0,2013,2720,7400,3353 days 16:47:18.693809,204,1.6,0.0,-110,-1838,2610.0
436110.0,3,2.5,1770,1235,3.0,3,8,1600,170.0,2007,1680,1203,5545 days 16:47:18.693809,122,1.2,9.411764705882353,90,32,1430.0
925000.0,4,2.75,3730,8014,2.0,3,1,3730,0.0,2012,3670,8279,3719 days 16:47:18.693809,171,1.4545454545454546,0.0,60,-265,3730.0
449950.0,4,2.5,2420,5244,2.0,3,9,2420,0.0,2007,1400,5250,5545 days 16:47:18.693809,072,1.6,0.0,1020,-6,2420.0
760000.0,4,2.5,3330,7399,2.0,3,9,3330,0.0,2009,2640,8601,4814 days 16:47:18.693809,147,1.6,0.0,690,-1202,3330.0
293000.0,3,2.25,1910,3481,2.0,3,8,1910,0.0,2009,1714,3177,4814 days 16:47:18.693809,189,1.3333333333333333,0.0,196,304,1910.0
695000.0,2,2.5,2170,7665,1.0,3,8,2170,0.0,2013,2300,7100,3353 days 16:47:18.693809,043,0.8,0.0,-130,565,2170.0
285000.0,3,2.5,2437,5136,2.0,3,7,2437,0.0,2011,2437,4614,4084 days 16:47:18.693809,155,1.2,0.0,0,522,2437.0
1260000.0,5,4.0,4180,12042,2.0,3,1,4180,0.0,2014,1800,6052,2988 days 16:47:18.693809,364,1.25,0.0,2380,5990,4180.0
379900.0,3,2.5,1800,2791,2.0,3,8,1800,0.0,2011,1580,2617,4084 days 16:47:18.693809,195,1.2,0.0,220,174,1800.0
472000.0,5,2.5,2570,7412,2.0,3,8,2570,0.0,2006,2890,8056,5910 days 16:47:18.693809,117,2.0,0.0,-320,-644,2570.0
300000.0,4,2.5,2090,5195,2.0,3,7,2090,0.0,2007,2090,5236,5545 days 16:47:18.693809,188,1.6,0.0,0,-41,2090.0
272000.0,4,2.5,2789,3960,2.0,3,7,2789,0.0,2007,2547,3960,5545 days 16:47:18.693809,324,1.6,0.0,242,0,2789.0
418395.0,4,2.5,2906,5893,2.0,3,9,2906,0.0,2014,2680,4950,2988 days 16:47:18.693809,324,1.6,0.0,226,943,2906.0
465000.0,5,2.5,2550,6405,2.0,3,7,2550,0.0,2008,2190,5900,5180 days 16:47:18.693809,356,2.0,0.0,360,505,2550.0
659950.0,4,2.75,3550,9400,2.0,3,9,3550,0.0,2014,3550,9421,2988 days 16:47:18.693809,197,1.4545454545454546,0.0,0,-21,3550.0
484950.0,3,2.25,1590,926,3.0,3,8,1590,0.0,2014,1640,1321,2988 days 16:47:18.693809,007,1.3333333333333333,0.0,-50,-395,1590.0
359000.0,3,2.25,1950,1968,2.0,4,7,1160,790.0,1979,1950,1968,15772 days 16:47:18.693809,116,1.3333333333333333,1.4683544303797469,0,0,370.0
519000.0,4,2.5,3250,4500,2.0,3,8,3250,0.0,2009,3030,4518,4814 days 16:47:18.693809,168,1.6,0.0,220,-18,3250.0
1710000.0,5,4.5,4590,14685,2.0,3,1,4590,0.0,2009,3030,9486,4814 days 16:47:18.693809,147,1.1111111111111112,0.0,1560,5199,4590.0
535000.0,4,2.75,3070,7201,2.0,3,9,3070,0.0,2006,2880,8364,5910 days 16:47:18.693809,168,1.4545454545454546,0.0,190,-1163,3070.0
622950.0,4,3.25,3030,7644,2.0,3,8,2830,200.0,2006,3400,6908,5910 days 16:47:18.693809,099,1.2307692307692308,14.15,-370,736,2630.0
515000.0,3,2.5,2610,5845,2.0,3,8,2610,0.0,2005,2810,5000,6275 days 16:47:18.693809,223,1.2,0.0,-200,845,2610.0
330000.0,4,3.5,3150,6202,2.0,3,7,3150,0.0,2005,2950,5940,6275 days 16:47:18.693809,142,1.1428571428571428,0.0,200,262,3150.0
318000.0,3,1.5,1240,983,3.0,3,8,1240,0.0,2009,1240,1026,4814 days 16:47:18.693809,044,2.0,0.0,0,-43,1240.0
439000.0,3,2.5,1680,2801,2.0,3,7,1680,0.0,2011,1920,2723,4084 days 16:47:18.693809,280,1.2,0.0,-240,78,1680.0
540000.0,3,2.5,2220,5279,2.0,3,8,2220,0.0,2006,1610,5297,5910 days 16:47:18.693809,083,1.2,0.0,610,-18,2220.0
1080000.0,4,3.25,4800,12727,2.0,3,1,4800,0.0,2011,4750,13602,4084 days 16:47:18.693809,198,1.2307692307692308,0.0,50,-875,4800.0
435000.0,4,2.5,3100,4699,2.0,3,9,3100,0.0,2010,2450,5130,4449 days 16:47:18.693809,085,1.6,0.0,650,-431,3100.0
2700000.0,4,4.0,7850,89651,2.0,3,1,7850,0.0,2006,6210,95832,5910 days 16:47:18.693809,022,1.0,0.0,1640,-6181,7850.0
1100000.0,4,2.75,3590,5625,2.0,3,1,3590,0.0,2012,3590,5625,3719 days 16:47:18.693809,290,1.4545454545454546,0.0,0,0,3590.0
293467.0,4,2.0,1590,942,3.0,3,7,1590,0.0,2008,1390,942,5180 days 16:47:18.693809,037,2.0,0.0,200,0,1590.0
328000.0,3,2.5,2242,4800,2.0,3,8,2242,0.0,2013,2009,4800,3353 days 16:47:18.693809,132,1.2,0.0,233,0,2242.0
550000.0,3,3.5,2490,3582,2.0,3,8,1720,770.0,2005,1445,1590,6275 days 16:47:18.693809,189,0.8571428571428571,2.2337662337662336,1045,1992,950.0
649000.0,3,2.0,1530,1442,3.0,3,9,1530,0.0,2015,1620,1456,2623 days 16:47:18.693809,092,1.5,0.0,-90,-14,1530.0
435000.0,4,2.5,2150,3143,2.0,3,7,2150,0.0,2010,2640,3200,4449 days 16:47:18.693809,189,1.6,0.0,-490,-57,2150.0
625000.0,3,2.5,2440,4800,2.0,3,1,2440,0.0,2014,1180,5480,2988 days 16:47:18.693809,171,1.2,0.0,1260,-680,2440.0
415000.0,3,1.5,1270,1483,3.0,3,8,1270,0.0,2007,1270,1413,5545 days 16:47:18.693809,119,2.0,0.0,0,70,1270.0
400000.0,3,2.25,1450,4706,2.0,3,7,1450,0.0,2009,1490,4667,4814 days 16:47:18.693809,154,1.3333333333333333,0.0,-40,39,1450.0
979000.0,3,2.5,2690,4047,3.0,3,1,2690,0.0,2014,2040,5000,2988 days 16:47:18.693809,126,1.2,0.0,650,-953,2690.0
625250.0,4,2.5,2755,4831,2.0,3,7,2755,0.0,2003,2510,4831,7006 days 16:47:18.693809,051,1.6,0.0,245,0,2755.0
665000.0,4,3.5,2650,3474,2.0,3,8,2230,420.0,2011,2330,3474,4084 days 16:47:18.693809,252,1.1428571428571428,5.309523809523809,320,0,1810.0
589500.0,3,3.25,2310,3075,2.0,3,8,1730,580.0,2005,2310,3075,6275 days 16:47:18.693809,178,0.9230769230769231,2.9827586206896552,0,0,1150.0
437000.0,2,3.0,1460,1452,2.0,3,8,1140,320.0,2007,1460,1452,5545 days 16:47:18.693809,068,0.6666666666666666,3.5625,0,0,820.0
320000.0,3,1.0,1400,9000,1.0,5,7,1400,0.0,1959,1440,8400,23077 days 16:47:18.693809,274,3.0,0.0,-40,600,1400.0
333500.0,3,2.5,2196,7475,2.0,3,8,2196,0.0,2006,1860,6755,5910 days 16:47:18.693809,014,1.2,0.0,336,720,2196.0
430000.0,3,2.25,2020,2750,2.0,3,8,1680,340.0,2008,1720,1546,5180 days 16:47:18.693809,328,1.3333333333333333,4.9411764705882355,300,1204,1340.0
995500.0,5,4.5,4280,8465,2.0,3,1,4280,0.0,2014,2990,11067,2988 days 16:47:18.693809,217,1.1111111111111112,0.0,1290,-2602,4280.0
427874.0,3,3.0,2340,5002,2.0,3,8,2340,0.0,2013,2790,5375,3353 days 16:47:18.693809,154,1.0,0.0,-450,-373,2340.0
334990.0,4,2.5,2220,4228,2.0,3,8,2220,0.0,2014,2220,4157,2988 days 16:47:18.693809,141,1.6,0.0,0,71,2220.0
909500.0,4,4.0,4420,5940,2.0,3,1,3410,1010.0,2006,4510,5797,5910 days 16:47:18.693809,042,1.0,3.376237623762376,-90,143,2400.0
210000.0,3,2.0,1580,4961,2.0,3,7,1580,0.0,2006,2280,5000,5910 days 16:47:18.693809,078,1.5,0.0,-700,-39,1580.0
952990.0,4,2.75,3550,6558,2.0,3,9,3550,0.0,2013,3140,5617,3353 days 16:47:18.693809,023,1.4545454545454546,0.0,410,941,3550.0
622500.0,2,1.75,1510,851,3.0,3,8,1420,90.0,2013,1300,1338,3353 days 16:47:18.693809,049,1.1428571428571428,15.777777777777779,210,-487,1330.0
515000.0,3,3.5,1360,1419,2.0,3,8,1040,320.0,2007,1560,1977,5545 days 16:47:18.693809,169,0.8571428571428571,3.25,-200,-558,720.0
350000.0,3,2.5,2040,13590,2.0,3,8,2040,0.0,2009,1850,12485,4814 days 16:47:18.693809,026,1.2,0.0,190,1105,2040.0
310000.0,1,1.5,1120,912,3.0,3,7,1120,0.0,2011,1380,3200,4084 days 16:47:18.693809,289,0.6666666666666666,0.0,-260,-2288,1120.0
700000.0,4,3.5,4490,5099,2.0,3,9,3390,1100.0,2006,4290,5537,5910 days 16:47:18.693809,148,1.1428571428571428,3.081818181818182,200,-438,2290.0
907687.0,4,2.5,3560,6786,2.0,3,9,2930,630.0,2014,3560,5886,2988 days 16:47:18.693809,196,1.6,4.650793650793651,0,900,2300.0
741500.0,2,2.5,2150,5760,1.0,3,8,2150,0.0,2010,1640,4680,4449 days 16:47:18.693809,190,0.8,0.0,510,1080,2150.0
395000.0,3,2.5,2130,5088,2.0,3,8,1840,290.0,2011,2130,5762,4084 days 16:47:18.693809,205,1.2,6.344827586206897,0,-674,1550.0
559950.0,5,2.75,2990,6370,2.0,3,8,2990,0.0,2014,2730,5740,2988 days 16:47:18.693809,054,1.8181818181818181,0.0,260,630,2990.0
215000.0,4,2.5,1847,8000,2.0,3,7,1847,0.0,2008,1847,8000,5180 days 16:47:18.693809,206,1.6,0.0,0,0,1847.0
390000.0,4,2.5,2610,7227,2.0,3,9,2610,0.0,2011,2630,7421,4084 days 16:47:18.693809,053,1.6,0.0,-20,-194,2610.0
425000.0,3,2.25,1670,107157,1.0,3,7,1670,0.0,2007,3310,108900,5545 days 16:47:18.693809,062,1.3333333333333333,0.0,-1640,-1743,1670.0
472000.0,3,2.5,1860,415126,2.0,3,7,1860,0.0,2006,2070,54014,5910 days 16:47:18.693809,127,1.2,0.0,-210,361112,1860.0
1330000.0,4,3.5,3440,9776,2.0,3,1,3440,0.0,2006,2400,11000,5910 days 16:47:18.693809,097,1.1428571428571428,0.0,1040,-1224,3440.0
695000.0,4,3.5,3510,9364,2.0,3,1,3510,0.0,2001,3510,9161,7736 days 16:47:18.693809,161,1.1428571428571428,0.0,0,203,3510.0
545000.0,3,2.5,1740,1279,3.0,3,8,1740,0.0,2008,1740,1280,5180 days 16:47:18.693809,020,1.2,0.0,0,-1,1740.0
389950.0,4,2.5,2240,5500,2.0,3,8,2240,0.0,2013,700,5500,3353 days 16:47:18.693809,192,1.6,0.0,1540,0,2240.0
380000.0,3,2.25,1550,1485,3.0,3,8,1550,0.0,2011,1550,1480,4084 days 16:47:18.693809,089,1.3333333333333333,0.0,0,5,1550.0
288790.0,4,2.0,1390,745,3.0,3,7,1390,0.0,2008,1390,942,5180 days 16:47:18.693809,321,2.0,0.0,0,-197,1390.0
432500.0,3,3.0,2500,6000,2.0,3,8,2500,0.0,2012,2130,6000,3719 days 16:47:18.693809,091,1.0,0.0,370,0,2500.0
615000.0,3,3.5,2710,3326,2.0,3,8,1650,1060.0,2005,2280,2738,6275 days 16:47:18.693809,340,0.8571428571428571,1.5566037735849056,430,588,590.0
500000.0,3,2.5,1720,3012,2.0,3,9,1720,0.0,2011,1720,7658,4084 days 16:47:18.693809,188,1.2,0.0,0,-4646,1720.0
615000.0,3,2.25,1760,1146,3.0,3,9,1760,0.0,2014,1346,3472,2988 days 16:47:18.693809,151,1.3333333333333333,0.0,414,-2326,1760.0
500000.0,4,2.25,2270,8196,1.0,5,7,1150,1120.0,1963,1920,10122,21616 days 16:47:18.693809,269,1.7777777777777777,1.0267857142857142,350,-1926,30.0
622000.0,3,3.5,1690,1765,2.0,3,8,1370,320.0,2006,1690,1694,5910 days 16:47:18.693809,288,0.8571428571428571,4.28125,0,71,1050.0
802945.0,5,3.5,4000,9234,2.0,3,9,4000,0.0,2015,3690,6600,2623 days 16:47:18.693809,099,1.4285714285714286,0.0,310,2634,4000.0
1260000.0,4,2.5,2880,9003,2.0,3,1,2880,0.0,2008,2640,8126,5180 days 16:47:18.693809,212,1.6,0.0,240,877,2880.0
598950.0,3,2.5,1480,1531,3.0,3,8,1480,0.0,2014,1530,1321,2988 days 16:47:18.693809,055,1.2,0.0,-50,210,1480.0
430000.0,3,2.5,1950,4949,2.0,3,7,1950,0.0,2009,2200,5740,4814 days 16:47:18.693809,002,1.2,0.0,-250,-791,1950.0
515000.0,4,2.75,2700,5150,2.0,3,9,2700,0.0,2009,2700,5747,4814 days 16:47:18.693809,328,1.4545454545454546,0.0,0,-597,2700.0
1260000.0,2,3.0,2210,3917,2.0,3,1,1500,710.0,2008,1720,3933,5180 days 16:47:18.693809,198,0.6666666666666666,2.112676056338028,490,-16,790.0
400000.0,4,3.5,2370,3692,2.5,3,8,2370,0.0,2013,2520,5425,3353 days 16:47:18.693809,160,1.1428571428571428,0.0,-150,-1733,2370.0
390000.0,3,2.5,1310,1254,2.0,3,7,850,460.0,2007,1310,1372,5545 days 16:47:18.693809,112,1.2,1.8478260869565217,0,-118,390.0
450000.0,3,2.5,2410,4293,2.0,3,7,2410,0.0,2007,2190,5900,5545 days 16:47:18.693809,274,1.2,0.0,220,-1607,2410.0
804995.0,5,1.5,3360,5402,2.0,3,9,3360,0.0,2014,3360,5415,2988 days 16:47:18.693809,136,3.3333333333333335,0.0,0,-13,3360.0
825000.0,4,3.25,3040,4155,2.0,3,8,2350,690.0,2013,2680,4000,3353 days 16:47:18.693809,085,1.2307692307692308,3.4057971014492754,360,155,1660.0
435000.0,4,2.25,2140,6355,2.0,3,7,2140,0.0,2002,2480,5746,7371 days 16:47:18.693809,133,1.7777777777777777,0.0,-340,609,2140.0
398000.0,3,2.5,1720,1715,2.0,3,7,1240,480.0,2004,1610,1626,6641 days 16:47:18.693809,160,1.2,2.5833333333333335,110,89,760.0
411605.0,4,2.5,2658,3960,2.0,3,9,2658,0.0,2014,2578,4200,2988 days 16:47:18.693809,156,1.6,0.0,80,-240,2658.0
315000.0,3,3.25,1480,983,2.0,3,8,1180,300.0,2013,1330,1062,3353 days 16:47:18.693809,342,0.9230769230769231,3.933333333333333,150,-79,880.0
455000.0,2,2.0,1350,1209,3.0,3,8,1350,0.0,2013,1310,982,3353 days 16:47:18.693809,324,1.0,0.0,40,227,1350.0
452950.0,3,2.5,1150,1194,2.0,3,8,1020,130.0,2006,1450,1714,5910 days 16:47:18.693809,121,1.2,7.846153846153846,-300,-520,890.0
380000.0,3,1.75,1690,1468,2.0,3,8,1380,310.0,2008,1690,1936,5180 days 16:47:18.693809,140,1.7142857142857142,4.451612903225806,0,-468,1070.0
340000.0,2,1.75,1270,1916,2.0,3,8,1270,0.0,2012,1140,1916,3719 days 16:47:18.693809,328,1.1428571428571428,0.0,130,0,1270.0
409950.0,3,2.5,2655,5080,2.0,3,8,2655,0.0,2013,2879,5232,3353 days 16:47:18.693809,307,1.2,0.0,-224,-152,2655.0
360000.0,2,1.0,880,1165,2.0,3,8,880,0.0,2005,1640,3825,6275 days 16:47:18.693809,124,2.0,0.0,-760,-2660,880.0
1600000.0,4,4.25,4645,7757,2.0,3,1,3855,790.0,2006,2150,6970,5910 days 16:47:18.693809,093,0.9411764705882353,4.879746835443038,2495,787,3065.0
440000.0,3,1.5,1270,1443,3.0,3,8,1270,0.0,2007,1270,1413,5545 days 16:47:18.693809,140,2.0,0.0,0,30,1270.0
730000.0,2,1.75,1728,95950,1.0,3,9,1728,0.0,2012,1720,35735,3719 days 16:47:18.693809,253,1.1428571428571428,0.0,8,60215,1728.0
408000.0,3,2.25,1950,7221,1.0,4,8,1950,0.0,2006,2310,8125,5910 days 16:47:18.693809,142,1.3333333333333333,0.0,-360,-904,1950.0
820000.0,4,2.5,3170,3862,3.0,3,8,3170,0.0,2008,2840,4181,5180 days 16:47:18.693809,237,1.6,0.0,330,-319,3170.0
360000.0,2,2.5,1233,1244,2.0,3,7,963,270.0,2007,1230,1300,5545 days 16:47:18.693809,212,0.8,3.566666666666667,3,-56,693.0
515000.0,3,2.0,1560,1020,3.0,3,8,1560,0.0,2014,1560,1728,2988 days 16:47:18.693809,281,1.5,0.0,0,-708,1560.0
541000.0,3,1.75,1630,1166,2.0,3,8,1020,610.0,2013,1420,1670,3353 days 16:47:18.693809,021,1.7142857142857142,1.6721311475409837,210,-504,410.0
375000.0,4,2.5,2510,7245,2.0,3,9,2510,0.0,2007,1830,8900,5545 days 16:47:18.693809,096,1.6,0.0,680,-1655,2510.0
320000.0,4,2.5,2223,5780,2.0,3,8,2223,0.0,2010,1690,7766,4449 days 16:47:18.693809,293,1.6,0.0,533,-1986,2223.0
325000.0,2,2.25,1230,1058,2.0,3,7,1160,70.0,2008,1240,817,5180 days 16:47:18.693809,058,0.8888888888888888,16.571428571428573,-10,241,1090.0
740000.0,5,2.75,3050,7520,2.0,3,8,3050,0.0,2014,2180,10800,2988 days 16:47:18.693809,077,1.8181818181818181,0.0,870,-3280,3050.0
450000.0,5,2.75,2710,6220,2.0,3,8,2710,0.0,2014,2530,4759,2988 days 16:47:18.693809,303,1.8181818181818181,0.0,180,1461,2710.0
455000.0,4,2.5,2090,4400,2.0,3,8,2090,0.0,2011,2090,3430,4084 days 16:47:18.693809,204,1.6,0.0,0,970,2090.0
292500.0,3,2.5,1440,1068,2.0,3,8,1160,280.0,2006,1580,1483,5910 days 16:47:18.693809,034,1.2,4.142857142857143,-140,-415,880.0
530000.0,4,2.75,2740,7872,2.0,3,1,2740,0.0,2015,1220,6300,2623 days 16:47:18.693809,065,1.4545454545454546,0.0,1520,1572,2740.0
829995.0,5,3.25,3360,6120,2.0,3,9,3360,0.0,2014,3230,5398,2988 days 16:47:18.693809,216,1.5384615384615385,0.0,130,722,3360.0
395000.0,4,2.75,2280,5013,2.0,3,8,2280,0.0,2009,2130,5121,4814 days 16:47:18.693809,357,1.4545454545454546,0.0,150,-108,2280.0
859990.0,4,2.75,3520,5500,2.0,3,9,3520,0.0,2014,3340,5500,2988 days 16:47:18.693809,192,1.4545454545454546,0.0,180,0,3520.0
342500.0,2,1.5,1320,826,2.0,3,8,1100,220.0,2008,1340,1213,5180 days 16:47:18.693809,191,1.3333333333333333,5.0,-20,-387,880.0
743000.0,4,2.75,3410,5838,2.0,3,9,3410,0.0,2012,3420,7048,3719 days 16:47:18.693809,339,1.4545454545454546,0.0,-10,-1210,3410.0
345000.0,3,2.25,2730,9388,1.0,3,7,1390,1340.0,1975,2255,5701,17233 days 16:47:18.693809,349,1.3333333333333333,1.037313432835821,475,3687,50.0
443000.0,3,2.5,1780,2778,2.0,3,8,1530,250.0,2007,1380,1998,5545 days 16:47:18.693809,365,1.2,6.12,400,780,1280.0
260000.0,3,2.5,1427,4337,2.0,3,7,1427,0.0,2009,1443,4347,4814 days 16:47:18.693809,272,1.2,0.0,-16,-10,1427.0
810000.0,4,2.5,2910,6555,2.0,3,9,2910,0.0,2005,2910,10419,6275 days 16:47:18.693809,203,1.6,0.0,0,-3864,2910.0
570000.0,4,2.75,3250,5600,2.0,3,8,3250,0.0,2011,2730,5667,4084 days 16:47:18.693809,356,1.4545454545454546,0.0,520,-67,3250.0
1560000.0,5,3.5,3630,8100,2.0,3,1,3630,0.0,2008,1730,8246,5180 days 16:47:18.693809,062,1.4285714285714286,0.0,1900,-146,3630.0
950000.0,3,2.5,2280,2296,3.0,3,9,1890,390.0,2013,1390,4000,3353 days 16:47:18.693809,104,1.2,4.846153846153846,890,-1704,1500.0
572800.0,3,2.5,3310,4682,2.0,3,9,2380,930.0,2015,2660,5166,2623 days 16:47:18.693809,027,1.2,2.5591397849462365,650,-484,1450.0
305000.0,3,3.0,1290,1112,3.0,3,7,1290,0.0,2008,1230,9000,5180 days 16:47:18.693809,274,1.0,0.0,60,-7888,1290.0
1700000.0,5,4.75,3940,7067,2.0,3,1,3230,710.0,2008,1910,7735,5180 days 16:47:18.693809,211,1.0526315789473684,4.549295774647887,2030,-668,2520.0
445000.0,4,2.5,2170,6000,2.0,3,7,1630,540.0,2008,1720,5668,5180 days 16:47:18.693809,239,1.6,3.0185185185185186,450,332,1090.0
801000.0,4,3.5,3290,8059,2.0,3,9,3290,0.0,2012,3290,10758,3719 days 16:47:18.693809,245,1.1428571428571428,0.0,0,-2699,3290.0
711000.0,3,2.5,2550,5376,2.0,3,9,2550,0.0,2004,2250,4050,6641 days 16:47:18.693809,195,1.2,0.0,300,1326,2550.0
268500.0,3,2.25,1140,977,2.0,3,7,850,290.0,2008,1140,976,5180 days 16:47:18.693809,239,1.3333333333333333,2.9310344827586206,0,1,560.0
320000.0,4,2.5,2300,3825,2.0,3,7,2300,0.0,2012,2110,3825,3719 days 16:47:18.693809,279,1.6,0.0,190,0,2300.0
500000.0,4,3.25,2670,5001,1.0,3,9,1640,1030.0,2013,1610,5001,3353 days 16:47:18.693809,264,1.2307692307692308,1.5922330097087378,1060,0,610.0
631625.0,4,2.5,2440,6651,2.0,3,9,2440,0.0,2014,1350,7653,2988 days 16:47:18.693809,125,1.6,0.0,1090,-1002,2440.0
850000.0,2,2.5,1611,2210,2.0,3,1,1611,0.0,2005,2070,2182,6275 days 16:47:18.693809,027,0.8,0.0,-459,28,1611.0
600000.0,3,3.5,2710,3290,2.0,3,8,1650,1060.0,2006,2440,3290,5910 days 16:47:18.693809,300,0.8571428571428571,1.5566037735849056,270,0,590.0
430236.0,4,3.25,3444,5166,2.0,3,8,2714,730.0,2014,2848,5182,2988 days 16:47:18.693809,086,1.2307692307692308,3.717808219178082,596,-16,1984.0
1270000.0,3,2.5,3060,9576,2.0,3,1,3060,0.0,2005,3060,9579,6275 days 16:47:18.693809,258,1.2,0.0,0,-3,3060.0
689500.0,4,2.5,2050,2772,2.0,3,8,2050,0.0,2013,1800,2886,3353 days 16:47:18.693809,118,1.6,0.0,250,-114,2050.0
175003.0,3,1.5,1390,1882,2.0,3,7,1390,0.0,2014,1490,2175,2988 days 16:47:18.693809,335,2.0,0.0,-100,-293,1390.0
459000.0,2,2.5,1240,1249,3.0,3,8,1240,0.0,2006,1240,2500,5910 days 16:47:18.693809,258,0.8,0.0,0,-1251,1240.0
1180000.0,4,3.25,3750,74052,2.0,3,1,3750,0.0,2013,4920,74052,3353 days 16:47:18.693809,114,1.2307692307692308,0.0,-1170,0,3750.0
358000.0,3,3.25,1410,1442,3.0,3,8,1360,50.0,2006,1500,1200,5910 days 16:47:18.693809,245,0.9230769230769231,27.2,-90,242,1310.0
447055.0,4,2.5,2448,4949,2.0,3,9,2448,0.0,2014,2815,5446,2988 days 16:47:18.693809,195,1.6,0.0,-367,-497,2448.0
415000.0,3,2.75,2600,64626,1.5,3,8,2600,0.0,2009,1740,64626,4814 days 16:47:18.693809,178,1.0909090909090908,0.0,860,0,2600.0
1210000.0,4,3.25,3330,9000,2.0,3,9,2870,460.0,2004,2550,6349,6641 days 16:47:18.693809,286,1.2307692307692308,6.239130434782608,780,2651,2410.0
495000.0,2,2.25,1160,1010,2.0,3,8,1000,160.0,2006,1200,1170,5910 days 16:47:18.693809,294,0.8888888888888888,6.25,-40,-160,840.0
479000.0,2,2.25,1330,1380,2.0,3,8,1060,270.0,2005,1580,4802,6275 days 16:47:18.693809,324,0.8888888888888888,3.925925925925926,-250,-3422,790.0
1900000.0,3,2.5,2830,4334,3.0,3,1,2830,0.0,2006,2830,38211,5910 days 16:47:18.693809,076,1.2,0.0,0,-33877,2830.0
249900.0,3,2.5,1610,3517,2.0,3,8,1610,0.0,2005,1830,2889,6275 days 16:47:18.693809,289,1.2,0.0,-220,628,1610.0
1470000.0,4,2.5,2800,4000,2.0,3,9,2800,0.0,2011,1770,4200,4084 days 16:47:18.693809,303,1.6,0.0,1030,-200,2800.0
1040000.0,5,3.75,4570,10194,2.0,3,1,4570,0.0,2006,2040,7560,5910 days 16:47:18.693809,100,1.3333333333333333,0.0,2530,2634,4570.0
897000.0,4,2.5,2820,6120,2.0,3,9,2820,0.0,2014,1510,6120,2988 days 16:47:18.693809,293,1.6,0.0,1310,0,2820.0
1100000.0,4,2.5,2570,9470,2.0,3,9,2570,0.0,2006,2570,10663,5910 days 16:47:18.693809,086,1.6,0.0,0,-1193,2570.0
685000.0,3,2.25,1710,1193,2.0,3,9,1140,570.0,2014,1510,1193,2988 days 16:47:18.693809,317,1.3333333333333333,2.0,200,0,570.0
295000.0,3,1.5,1220,3286,2.0,3,7,1220,0.0,1982,1220,2640,14676 days 16:47:18.693809,273,2.0,0.0,0,646,1220.0
619000.0,3,2.25,1650,946,3.0,3,8,1650,0.0,2014,1570,1283,2988 days 16:47:18.693809,216,1.3333333333333333,0.0,80,-337,1650.0
439108.0,2,1.5,1130,1340,2.0,3,8,910,220.0,2008,1310,1340,5180 days 16:47:18.693809,329,1.3333333333333333,4.136363636363637,-180,0,690.0
260000.0,3,2.25,1489,2800,2.0,3,7,1489,0.0,2011,1584,3200,4084 days 16:47:18.693809,051,1.3333333333333333,0.0,-95,-400,1489.0
279000.0,5,2.5,2690,5557,2.0,3,7,2690,0.0,2012,2090,10500,3719 days 16:47:18.693809,157,2.0,0.0,600,-4943,2690.0
380000.0,3,2.25,1530,1305,2.0,3,7,1116,414.0,2007,1320,1427,5545 days 16:47:18.693809,089,1.3333333333333333,2.6956521739130435,210,-122,702.0
287000.0,3,2.5,1600,6315,2.0,3,8,1600,0.0,2013,1608,4300,3353 days 16:47:18.693809,311,1.2,0.0,-8,2015,1600.0
377000.0,2,1.5,1000,1251,2.0,3,7,930,70.0,2006,1420,1187,5910 days 16:47:18.693809,345,1.3333333333333333,13.285714285714286,-420,64,860.0
649950.0,4,3.5,2440,3012,3.0,3,8,2440,0.0,2005,1860,4650,6275 days 16:47:18.693809,054,1.1428571428571428,0.0,580,-1638,2440.0
445000.0,3,2.5,1260,1102,3.0,3,8,1260,0.0,2007,1320,2500,5545 days 16:47:18.693809,297,1.2,0.0,-60,-1398,1260.0
605000.0,3,2.5,1660,1692,3.0,3,7,1610,50.0,2005,1210,1230,6275 days 16:47:18.693809,124,1.2,32.2,450,462,1560.0
475000.0,3,2.25,1190,1137,2.0,3,7,960,230.0,1999,1190,1080,8467 days 16:47:18.693809,266,1.3333333333333333,4.173913043478261,0,57,730.0
399000.0,3,3.0,1520,1884,3.0,3,8,1520,0.0,2009,1360,1939,4814 days 16:47:18.693809,240,1.0,0.0,160,-55,1520.0
718000.0,5,2.75,3250,8100,2.0,3,8,3250,0.0,2014,1270,8100,2988 days 16:47:18.693809,110,1.8181818181818181,0.0,1980,0,3250.0
1400000.0,4,3.25,4700,9160,1.0,3,1,2520,2180.0,2005,2240,8700,6275 days 16:47:18.693809,148,1.2307692307692308,1.1559633027522935,2460,460,340.0
341000.0,3,2.5,1480,1663,2.0,3,9,1180,300.0,2012,1380,1537,3719 days 16:47:18.693809,136,1.2,3.933333333333333,100,126,880.0
818000.0,2,2.5,2380,9374,1.0,3,8,2380,0.0,2011,1610,5000,4084 days 16:47:18.693809,139,0.8,0.0,770,4374,2380.0
759000.0,3,2.25,1640,1873,3.0,3,8,1640,0.0,2014,1640,3920,2988 days 16:47:18.694801,336,1.3333333333333333,0.0,0,-2047,1640.0
547500.0,3,3.5,1650,2262,3.0,3,8,1650,0.0,2010,1620,3166,4449 days 16:47:18.694801,162,0.8571428571428571,0.0,30,-904,1650.0
2700000.0,5,4.75,5305,8401,2.0,3,1,3745,1560.0,2005,2960,7200,6275 days 16:47:18.694801,141,1.0526315789473684,2.4006410256410255,2345,1201,2185.0
358000.0,2,2.5,1278,987,2.0,3,7,1002,276.0,2007,1220,1287,5545 days 16:47:18.694801,203,0.8,3.630434782608696,58,-300,726.0
412000.0,3,2.5,1200,813,3.0,3,9,1200,0.0,2010,1750,4365,4449 days 16:47:18.694801,274,1.2,0.0,-550,-3552,1200.0
245000.0,2,1.5,690,1058,2.0,3,7,690,0.0,2005,690,1058,6275 days 16:47:18.694801,030,1.3333333333333333,0.0,0,0,690.0
460940.0,4,2.5,3202,4964,2.0,3,9,3202,0.0,2014,2425,4886,2988 days 16:47:18.694801,280,1.6,0.0,777,78,3202.0
321000.0,3,2.25,1347,1292,3.0,3,7,1347,0.0,2010,1480,1865,4449 days 16:47:18.694801,142,1.3333333333333333,0.0,-133,-573,1347.0
633634.0,4,3.5,2960,6000,2.0,3,9,2960,0.0,2014,2960,6000,2988 days 16:47:18.694801,174,1.1428571428571428,0.0,0,0,2960.0
290000.0,1,0.75,740,1284,1.0,4,6,740,0.0,1928,1430,3988,34400 days 16:47:18.694801,266,1.3333333333333333,0.0,-690,-2704,740.0
445000.0,2,2.25,1200,1137,3.0,3,7,1200,0.0,2007,1280,1295,5545 days 16:47:18.694801,091,0.8888888888888888,0.0,-80,-158,1200.0
887250.0,5,3.5,4320,7502,2.0,3,9,3500,820.0,2012,3250,7538,3719 days 16:47:18.694801,097,1.4285714285714286,4.2682926829268295,1070,-36,2680.0
739000.0,3,2.5,2310,7348,1.0,3,8,2310,0.0,2010,2310,7153,4449 days 16:47:18.694801,254,1.2,0.0,0,195,2310.0
429900.0,3,2.0,1490,1286,3.0,3,8,1490,0.0,2014,1420,1230,2988 days 16:47:18.694801,350,1.5,0.0,70,56,1490.0
459000.0,3,2.0,1480,800,2.0,3,8,1000,480.0,2014,1480,886,2988 days 16:47:18.694801,006,1.5,2.0833333333333335,0,-86,520.0
240000.0,3,2.25,1481,2820,2.0,3,7,1481,0.0,2012,1481,3028,3719 days 16:47:18.694801,176,1.3333333333333333,0.0,0,-208,1481.0
566950.0,3,3.0,1730,1902,3.0,3,8,1730,0.0,2014,1830,1804,2988 days 16:47:18.694801,253,1.0,0.0,-100,98,1730.0
1040000.0,4,3.5,3900,8391,2.0,3,1,3900,0.0,2006,3820,12268,5910 days 16:47:18.694801,127,1.1428571428571428,0.0,80,-3877,3900.0
343000.0,3,3.5,1130,1449,3.0,3,7,1130,0.0,2005,1130,1200,6275 days 16:47:18.694801,069,0.8571428571428571,0.0,0,249,1130.0
572115.0,4,3.25,3230,4838,2.0,3,9,3230,0.0,2014,2980,5094,2988 days 16:47:18.694801,315,1.2307692307692308,0.0,250,-256,3230.0
918000.0,5,3.5,3920,5150,2.0,3,9,2820,1100.0,2004,3170,5530,6641 days 16:47:18.694801,008,1.4285714285714286,2.5636363636363635,750,-380,1720.0
555000.0,2,1.5,1190,1361,2.0,3,8,1190,0.0,2007,1280,3360,5545 days 16:47:18.694801,125,1.3333333333333333,0.0,-90,-1999,1190.0
399440.0,4,2.5,2311,4396,2.0,3,9,2311,0.0,2014,2458,4616,2988 days 16:47:18.694801,197,1.6,0.0,-147,-220,2311.0
450000.0,3,2.5,1810,914,3.0,3,8,1380,430.0,2008,1810,914,5180 days 16:47:18.694801,192,1.2,3.2093023255813953,0,0,950.0
580000.0,4,2.5,3250,5000,2.0,3,8,3250,0.0,2008,3230,5507,5180 days 16:47:18.694801,169,1.6,0.0,20,-507,3250.0
415000.0,4,2.5,2544,4071,2.0,3,9,2544,0.0,2013,2358,4179,3353 days 16:47:18.694801,090,1.6,0.0,186,-108,2544.0
527500.0,3,2.5,1380,1389,3.0,3,8,1380,0.0,2008,1380,1249,5180 days 16:47:18.694801,294,1.2,0.0,0,140,1380.0
384000.0,3,2.25,1430,800,2.0,3,8,1140,290.0,2011,1430,1387,4084 days 16:47:18.694801,211,1.3333333333333333,3.9310344827586206,0,-587,850.0
692000.0,3,2.5,3490,28213,1.5,3,9,2242,1248.0,2009,2120,56628,4814 days 16:47:18.694801,232,1.2,1.796474358974359,1370,-28415,994.0
455000.0,2,1.5,910,966,2.0,3,8,820,90.0,2006,2740,6400,5910 days 16:47:18.694801,234,1.3333333333333333,9.11111111111111,-1830,-5434,730.0
1280000.0,4,3.25,3080,4120,2.0,3,9,2380,700.0,2014,1410,4120,2988 days 16:47:18.694801,093,1.2307692307692308,3.4,1670,0,1680.0
415000.0,3,2.5,2280,6031,2.0,3,8,2280,0.0,2011,2430,7200,4084 days 16:47:18.694801,175,1.2,0.0,-150,-1169,2280.0
975000.0,3,2.5,1660,1344,3.0,3,8,1660,0.0,2008,1750,2040,5180 days 16:47:18.694801,356,1.2,0.0,-90,-696,1660.0
799950.0,4,2.5,3320,7429,2.0,3,9,3320,0.0,2014,1840,7429,2988 days 16:47:18.694801,279,1.6,0.0,1480,0,3320.0
545000.0,5,4.0,1680,7268,1.0,3,8,1370,310.0,2008,2040,8259,5180 days 16:47:18.694801,095,1.25,4.419354838709677,-360,-991,1060.0
429900.0,4,3.5,2584,5005,2.0,3,8,2584,0.0,2014,2767,5201,2988 days 16:47:18.694801,276,1.1428571428571428,0.0,-183,-196,2584.0
275000.0,3,2.5,2217,8019,2.0,3,7,2217,0.0,2009,1470,8037,4814 days 16:47:18.694801,210,1.2,0.0,747,-18,2217.0
498000.0,3,2.5,2480,4136,2.0,3,8,2480,0.0,2009,2510,4314,4814 days 16:47:18.694801,199,1.2,0.0,-30,-178,2480.0
754950.0,3,2.5,2610,7256,2.0,3,9,2610,0.0,2014,2610,7206,2988 days 16:47:18.694801,147,1.2,0.0,0,50,2610.0
895000.0,4,3.0,3240,5562,2.0,3,1,3240,0.0,2013,3380,5562,3353 days 16:47:18.694801,157,1.3333333333333333,0.0,-140,0,3240.0
580000.0,4,3.25,3569,8327,2.0,3,1,3569,0.0,2013,2550,5251,3353 days 16:47:18.694801,126,1.2307692307692308,0.0,1019,3076,3569.0
379900.0,4,2.5,3181,5831,2.0,3,8,3181,0.0,2014,2056,24393,2988 days 16:47:18.694801,053,1.6,0.0,1125,-18562,3181.0
245000.0,4,2.5,1921,4888,2.0,3,7,1921,0.0,2009,1921,9140,4814 days 16:47:18.694801,069,1.6,0.0,0,-4252,1921.0
417000.0,3,2.5,1570,4926,2.0,3,8,1570,0.0,2014,1800,3202,2988 days 16:47:18.694801,238,1.2,0.0,-230,1724,1570.0
555000.0,3,2.5,1940,3211,2.0,3,8,1940,0.0,2009,1880,3078,4814 days 16:47:18.694801,125,1.2,0.0,60,133,1940.0
555000.0,3,2.5,1940,3211,2.0,3,8,1940,0.0,2009,1880,3078,4814 days 16:47:18.694801,238,1.2,0.0,60,133,1940.0
353000.0,4,2.5,2210,13721,2.0,3,8,2210,0.0,2009,1850,12951,4814 days 16:47:18.694801,253,1.6,0.0,360,770,2210.0
539000.0,3,2.25,1280,1187,2.0,3,8,1080,200.0,2008,1280,1681,5180 days 16:47:18.694801,115,1.3333333333333333,5.4,0,-494,880.0
434900.0,3,2.0,1520,5040,2.0,3,7,1520,0.0,1977,1860,8710,16502 days 16:47:18.694801,247,1.5,0.0,-340,-3670,1520.0
325000.0,2,2.25,1230,1078,2.0,3,7,1160,70.0,2008,1240,817,5180 days 16:47:18.694801,336,0.8888888888888888,16.571428571428573,-10,261,1090.0
650000.0,3,2.5,1480,2159,3.0,3,8,1480,0.0,2007,1480,1554,5545 days 16:47:18.694801,099,1.2,0.0,0,605,1480.0
379950.0,4,2.5,2612,5850,2.0,3,8,2612,0.0,2014,2419,8984,2988 days 16:47:18.694801,056,1.6,0.0,193,-3134,2612.0
700000.0,3,2.5,2350,4975,2.0,3,8,2350,0.0,2012,2350,3951,3719 days 16:47:18.694801,323,1.2,0.0,0,1024,2350.0
675000.0,3,2.5,1300,1590,2.0,3,8,1100,200.0,2014,1070,1223,2988 days 16:47:18.694801,349,1.2,5.5,230,367,900.0
379000.0,4,1.5,2020,7560,1.0,4,7,2020,0.0,1960,1410,8080,22712 days 16:47:18.694801,160,2.6666666666666665,0.0,610,-520,2020.0
571000.0,3,2.5,2140,2867,2.0,3,8,1960,180.0,2005,2280,2836,6275 days 16:47:18.694801,089,1.2,10.88888888888889,-140,31,1780.0
475000.0,3,2.25,1380,1621,2.0,3,8,1140,240.0,2007,1460,1403,5545 days 16:47:18.694801,297,1.3333333333333333,4.75,-80,218,900.0
769900.0,4,3.5,2730,3047,2.0,3,8,2400,330.0,2006,1980,4600,5910 days 16:47:18.694801,129,1.1428571428571428,7.2727272727272725,750,-1553,2070.0
633000.0,4,3.5,4220,5817,2.0,3,9,2910,1310.0,2006,4290,6637,5910 days 16:47:18.694801,356,1.1428571428571428,2.2213740458015265,-70,-820,1600.0
635000.0,3,2.5,1570,1433,3.0,3,8,1570,0.0,2010,1570,2652,4449 days 16:47:18.694801,132,1.2,0.0,0,-1219,1570.0
1240000.0,4,3.5,4670,6000,2.0,3,1,3820,850.0,2007,4310,6000,5545 days 16:47:18.694801,206,1.1428571428571428,4.4941176470588236,360,0,2970.0
524000.0,3,2.25,1370,1007,3.0,3,8,1330,40.0,2009,1570,1635,4814 days 16:47:18.694801,008,1.3333333333333333,33.25,-200,-628,1290.0
485000.0,4,3.5,3273,5115,2.0,3,8,2671,602.0,2014,2996,5100,2988 days 16:47:18.694801,330,1.1428571428571428,4.43687707641196,277,15,2069.0
1030000.0,3,4.0,3880,13095,2.0,3,1,3700,180.0,2009,3880,10830,4814 days 16:47:18.694801,141,0.75,20.555555555555557,0,2265,3520.0
650000.0,3,3.5,1494,1262,3.0,3,8,1494,0.0,2011,1494,1264,4084 days 16:47:18.694801,297,0.8571428571428571,0.0,0,-2,1494.0
754842.0,3,2.5,2930,5641,2.0,3,8,2930,0.0,2013,3300,5641,3353 days 16:47:18.694801,274,1.2,0.0,-370,0,2930.0
428900.0,4,2.5,2598,5553,2.0,3,9,2598,0.0,2014,2502,4900,2988 days 16:47:18.694801,267,1.6,0.0,96,653,2598.0
329900.0,3,2.5,2242,4995,2.0,3,8,2242,0.0,2011,1798,4942,4084 days 16:47:18.694801,174,1.2,0.0,444,53,2242.0
1040000.0,4,2.5,2830,5932,2.0,3,9,2830,0.0,2014,2840,5593,2988 days 16:47:18.694801,352,1.6,0.0,-10,339,2830.0
544999.0,4,2.5,2710,6937,2.0,3,7,2710,0.0,2009,2380,5866,4814 days 16:47:18.694801,252,1.6,0.0,330,1071,2710.0
449950.0,4,2.75,2320,4344,2.0,3,8,2320,0.0,2012,2310,3770,3719 days 16:47:18.694801,149,1.4545454545454546,0.0,10,574,2320.0
635000.0,4,2.5,2720,7991,2.0,3,9,2720,0.0,2006,1590,8611,5910 days 16:47:18.694801,013,1.6,0.0,1130,-620,2720.0
599000.0,3,1.75,1650,1180,3.0,3,8,1650,0.0,2014,1650,1960,2988 days 16:47:18.694801,307,1.7142857142857142,0.0,0,-780,1650.0
478000.0,3,3.25,1430,1348,2.0,3,8,1160,270.0,2008,1160,1265,5180 days 16:47:18.694801,307,0.9230769230769231,4.296296296296297,270,83,890.0
388000.0,4,2.5,2090,5040,2.0,3,9,2090,0.0,2014,1430,12000,2988 days 16:47:18.694801,272,1.6,0.0,660,-6960,2090.0
809950.0,4,3.5,3660,4903,2.0,3,9,2760,900.0,2014,3630,4992,2988 days 16:47:18.694801,216,1.1428571428571428,3.066666666666667,30,-89,1860.0
1060000.0,4,3.5,4220,8417,3.0,3,1,4220,0.0,2012,3730,8435,3719 days 16:47:18.694801,105,1.1428571428571428,0.0,490,-18,4220.0
659000.0,2,2.5,1450,1213,2.0,3,9,1110,340.0,2015,1620,1456,2623 days 16:47:18.694801,112,0.8,3.264705882352941,-170,-243,770.0
971971.0,4,3.75,3460,6738,2.0,3,1,3460,0.0,2013,3340,6120,3353 days 16:47:18.694801,177,1.0666666666666667,0.0,120,618,3460.0
389000.0,3,2.5,1350,874,3.0,3,8,1270,80.0,2006,1350,886,5910 days 16:47:18.694801,015,1.2,15.875,0,-12,1190.0
355000.0,4,2.75,3000,5470,2.0,3,8,3000,0.0,2005,2420,4891,6275 days 16:47:18.694801,189,1.4545454545454546,0.0,580,579,3000.0
551500.0,4,2.5,2950,10003,2.0,3,9,2950,0.0,2006,2790,9323,5910 days 16:47:18.694801,342,1.6,0.0,160,680,2950.0
417838.0,4,2.5,2530,5048,2.0,3,8,2530,0.0,2014,2530,4359,2988 days 16:47:18.694801,182,1.6,0.0,0,689,2530.0
1750000.0,4,4.5,4650,7660,2.0,3,1,3640,1010.0,2008,1710,8400,5180 days 16:47:18.694801,195,0.8888888888888888,3.603960396039604,2940,-740,2630.0
399950.0,2,1.0,710,1131,2.0,4,7,710,0.0,1943,1370,1173,28921 days 16:47:18.694801,162,2.0,0.0,-660,-42,710.0
740000.0,4,2.5,3050,8000,2.0,3,9,3050,0.0,2007,1910,8000,5545 days 16:47:18.694801,196,1.6,0.0,1140,0,3050.0
335000.0,3,2.5,1150,683,2.0,3,7,1150,0.0,2013,1150,755,3353 days 16:47:18.694801,054,1.2,0.0,0,-72,1150.0
2250000.0,5,5.25,3410,8118,2.0,3,1,3410,0.0,2006,3410,16236,5910 days 16:47:18.694801,111,0.9523809523809523,0.0,0,-8118,3410.0
667000.0,3,1.75,1370,1921,3.0,3,8,1370,0.0,2007,1370,4000,5545 days 16:47:18.694801,110,1.7142857142857142,0.0,0,-2079,1370.0
920000.0,4,2.5,3540,7009,2.0,3,9,3540,0.0,2007,2150,10290,5545 days 16:47:18.694801,071,1.6,0.0,1390,-3281,3540.0
368000.0,3,2.5,1370,1350,2.0,3,7,1010,360.0,2007,1450,6000,5545 days 16:47:18.694801,131,1.2,2.8055555555555554,-80,-4650,650.0
307000.0,4,2.5,1714,3080,2.0,3,8,1714,0.0,2009,1714,3250,4814 days 16:47:18.694801,191,1.6,0.0,0,-170,1714.0
550000.0,4,2.75,3650,4534,2.0,3,7,2940,710.0,2014,2400,7682,2988 days 16:47:18.694801,016,1.4545454545454546,4.140845070422535,1250,-3148,2230.0
594491.0,4,2.5,2990,6037,2.0,3,9,2990,0.0,2013,2990,5992,3353 days 16:47:18.694801,013,1.6,0.0,0,45,2990.0
460458.0,4,2.5,3284,6516,2.0,3,8,3284,0.0,2014,2555,5008,2988 days 16:47:18.694801,272,1.6,0.0,729,1508,3284.0
859000.0,4,2.25,3550,13900,1.0,3,8,1830,1720.0,2010,2770,12200,4449 days 16:47:18.694801,175,1.7777777777777777,1.063953488372093,780,1700,110.0
399950.0,3,3.0,1860,2875,2.0,3,8,1710,150.0,2009,1350,4830,4814 days 16:47:18.694801,345,1.0,11.4,510,-1955,1560.0
547500.0,3,3.25,1720,1977,2.0,3,8,1360,360.0,2007,1720,3420,5545 days 16:47:18.694801,091,0.9230769230769231,3.7777777777777777,0,-1443,1000.0
310000.0,3,2.5,2540,4775,2.0,3,7,2540,0.0,2006,2270,5000,5910 days 16:47:18.694801,174,1.2,0.0,270,-225,2540.0
939000.0,4,2.75,3270,12880,2.0,3,9,3270,0.0,2014,2420,7505,2988 days 16:47:18.694801,153,1.4545454545454546,0.0,850,5375,3270.0
329900.0,2,2.5,980,1021,3.0,3,8,980,0.0,2008,980,1023,5180 days 16:47:18.694801,287,0.8,0.0,0,-2,980.0
436000.0,3,2.5,1150,1193,2.0,3,8,1020,130.0,2006,1450,1640,5910 days 16:47:18.694801,356,1.2,7.846153846153846,-300,-447,890.0
320000.0,3,2.5,1820,1855,2.0,3,8,1570,250.0,2008,1470,6900,5180 days 16:47:18.694801,197,1.2,6.28,350,-5045,1320.0
375000.0,3,2.5,1580,3825,2.0,3,8,1580,0.0,2011,1380,1500,4084 days 16:47:18.694801,269,1.2,0.0,200,2325,1580.0
392137.0,3,2.0,1460,3696,2.0,3,7,1460,0.0,2010,1720,3631,4449 days 16:47:18.694801,083,1.5,0.0,-260,65,1460.0
520000.0,4,2.5,2900,4950,2.0,3,8,2900,0.0,2004,2590,4950,6641 days 16:47:18.694801,238,1.6,0.0,310,0,2900.0
535000.0,5,2.75,2620,6389,2.0,3,9,2620,0.0,2007,2620,4504,5545 days 16:47:18.694801,289,1.8181818181818181,0.0,0,1885,2620.0
407000.0,2,2.5,1340,999,2.0,3,8,940,400.0,2008,1470,1436,5180 days 16:47:18.694801,083,0.8,2.35,-130,-437,540.0
424950.0,4,3.25,3266,5398,2.0,3,8,3266,0.0,2014,3087,5152,2988 days 16:47:18.694801,329,1.2307692307692308,0.0,179,246,3266.0
290000.0,2,1.5,1076,1060,3.0,3,7,1076,0.0,2006,1076,1060,5910 days 16:47:18.694801,223,1.3333333333333333,0.0,0,0,1076.0
399000.0,3,3.25,1680,1478,2.0,3,8,1360,320.0,2009,1530,2753,4814 days 16:47:18.694801,302,0.9230769230769231,4.25,150,-1275,1040.0
439990.0,3,2.5,1930,1348,2.0,3,8,1300,630.0,2005,1630,6000,6275 days 16:47:18.694801,184,1.2,2.0634920634920637,300,-4652,670.0
635000.0,4,2.5,2880,3091,2.0,3,9,1940,940.0,2014,1560,4080,2988 days 16:47:18.694801,053,1.6,2.0638297872340425,1320,-989,1000.0
635000.0,4,2.25,2240,5000,2.0,3,8,2240,0.0,2013,1760,7500,3353 days 16:47:18.694801,198,1.7777777777777777,0.0,480,-2500,2240.0
351000.0,3,2.5,2594,4455,2.0,3,8,2594,0.0,2012,2981,4950,3719 days 16:47:18.694801,119,1.2,0.0,-387,-495,2594.0
437500.0,2,1.5,1210,1232,3.0,3,8,1210,0.0,2007,1330,1174,5545 days 16:47:18.694801,234,1.3333333333333333,0.0,-120,58,1210.0
919204.0,4,3.5,3760,5000,2.0,3,9,2860,900.0,2014,1340,5000,2988 days 16:47:18.694801,150,1.1428571428571428,3.1777777777777776,2420,0,1960.0
923990.0,4,2.5,3600,6055,2.0,3,9,3600,0.0,2014,3590,6050,2988 days 16:47:18.694801,251,1.6,0.0,10,5,3600.0
639888.0,4,2.5,2050,2772,2.0,3,8,2050,0.0,2012,2050,2934,3719 days 16:47:18.694801,175,1.6,0.0,0,-162,2050.0
675000.0,3,3.25,1510,2064,2.0,3,8,1220,290.0,2008,1670,2594,5180 days 16:47:18.694801,014,0.9230769230769231,4.206896551724138,-160,-530,930.0
899900.0,4,2.5,2580,3909,2.0,3,8,2580,0.0,2013,1820,5772,3353 days 16:47:18.694801,161,1.6,0.0,760,-1863,2580.0
252000.0,3,2.5,1670,4020,2.0,3,7,1670,0.0,2009,1670,4020,4814 days 16:47:18.694801,030,1.2,0.0,0,0,1670.0
925000.0,4,2.5,3190,10034,2.0,3,9,3190,0.0,2007,2110,9300,5545 days 16:47:18.694801,076,1.6,0.0,1080,734,3190.0
552000.0,3,2.5,1280,1920,3.0,3,8,1280,0.0,2009,1450,1900,4814 days 16:47:18.694801,302,1.2,0.0,-170,20,1280.0
388500.0,4,2.5,2718,6197,2.0,3,8,2718,0.0,2006,2667,5000,5910 days 16:47:18.694801,097,1.6,0.0,51,1197,2718.0
548000.0,2,2.0,1370,1878,3.0,3,8,1370,0.0,2004,1280,1878,6641 days 16:47:18.694801,241,1.0,0.0,90,0,1370.0
254950.0,3,2.5,1794,4769,2.0,3,7,1794,0.0,2005,3557,4807,6275 days 16:47:18.694801,265,1.2,0.0,-1763,-38,1794.0
1240000.0,4,4.5,5120,41327,2.0,3,1,3290,1830.0,2008,3360,82764,5180 days 16:47:18.694801,342,0.8888888888888888,1.7978142076502732,1760,-41437,1460.0
629000.0,3,2.5,2160,1912,2.0,3,9,1970,190.0,2014,1810,2653,2988 days 16:47:18.694801,273,1.2,10.368421052631579,350,-741,1780.0
734000.0,4,2.5,2180,7204,2.0,3,8,2180,0.0,2014,1500,7650,2988 days 16:47:18.694801,062,1.6,0.0,680,-446,2180.0
309000.0,3,2.25,1490,1294,2.0,3,7,1220,270.0,2010,1490,1283,4449 days 16:47:18.694801,169,1.3333333333333333,4.518518518518518,0,11,950.0
554950.0,3,2.5,2950,10254,2.0,3,9,2950,0.0,2006,2800,9323,5910 days 16:47:18.694801,184,1.2,0.0,150,931,2950.0
785000.0,3,2.75,2990,207781,2.0,3,9,2990,0.0,2000,2590,218671,8102 days 16:47:18.694801,126,1.0909090909090908,0.0,400,-10890,2990.0
550000.0,4,2.5,2700,5150,2.0,3,9,2700,0.0,2007,3160,7620,5545 days 16:47:18.694801,156,1.6,0.0,-460,-2470,2700.0
1010000.0,4,3.5,3130,5000,3.0,3,1,3130,0.0,2014,1950,5152,2988 days 16:47:18.694801,223,1.1428571428571428,0.0,1180,-152,3130.0
1580000.0,3,2.0,3620,14250,2.0,3,8,3220,400.0,2007,2370,14250,5545 days 16:47:18.694801,301,1.5,8.05,1250,0,2820.0
309000.0,5,2.75,2481,4045,2.0,3,8,2481,0.0,2014,2363,4175,2988 days 16:47:18.694801,154,1.8181818181818181,0.0,118,-130,2481.0
328423.0,3,2.5,1730,3600,2.0,3,8,1730,0.0,2014,2030,3600,2988 days 16:47:18.694801,176,1.2,0.0,-300,0,1730.0
345000.0,3,1.5,1420,1192,2.0,3,8,1140,280.0,2008,1340,1213,5180 days 16:47:18.694801,174,2.0,4.071428571428571,80,-21,860.0
660000.0,5,3.5,3160,5175,2.0,3,9,3160,0.0,2014,2100,9351,2988 days 16:47:18.694801,325,1.4285714285714286,0.0,1060,-4176,3160.0
385000.0,3,3.25,1320,1327,2.0,3,8,1040,280.0,2008,1440,1263,5180 days 16:47:18.694801,122,0.9230769230769231,3.7142857142857144,-120,64,760.0
459000.0,2,2.25,1010,1107,2.0,3,8,710,300.0,2006,1140,1531,5910 days 16:47:18.694801,077,0.8888888888888888,2.3666666666666667,-130,-424,410.0
248000.0,3,2.5,1870,4046,2.0,3,7,1870,0.0,2007,2130,4800,5545 days 16:47:18.694801,014,1.2,0.0,-260,-754,1870.0
1480000.0,4,3.5,5220,15411,2.0,3,1,3550,1670.0,2006,3110,14124,5910 days 16:47:18.694801,232,1.1428571428571428,2.125748502994012,2110,1287,1880.0
379000.0,4,2.5,2260,5824,2.0,3,8,2260,0.0,2011,2240,5561,4084 days 16:47:18.694801,213,1.6,0.0,20,263,2260.0
2950000.0,5,4.5,4340,5722,3.0,3,1,4340,0.0,2010,1770,5250,4449 days 16:47:18.694801,063,1.1111111111111112,0.0,2570,472,4340.0
395000.0,2,2.25,1620,1841,2.0,3,8,1540,80.0,2004,1530,1831,6641 days 16:47:18.694801,269,0.8888888888888888,19.25,90,10,1460.0
535000.0,3,2.5,2280,2289,2.0,3,8,1880,400.0,2006,2280,2425,5910 days 16:47:18.694801,127,1.2,4.7,0,-136,1480.0
970000.0,5,3.5,3400,9804,2.0,3,9,2550,850.0,2008,2380,7440,5180 days 16:47:18.694801,295,1.4285714285714286,3.0,1020,2364,1700.0
205000.0,2,1.5,830,1020,2.0,3,7,830,0.0,2006,830,1379,5910 days 16:47:18.694801,032,1.3333333333333333,0.0,0,-359,830.0
310000.0,4,2.5,2310,7384,2.0,3,8,2310,0.0,2010,2310,7800,4449 days 16:47:18.694801,288,1.6,0.0,0,-416,2310.0
334500.0,2,1.5,830,1858,2.0,3,7,830,0.0,2005,1480,3030,6275 days 16:47:18.694801,183,1.3333333333333333,0.0,-650,-1172,830.0
995000.0,5,3.25,4130,7197,2.0,3,1,4130,0.0,2012,3730,7202,3719 days 16:47:18.694801,240,1.5384615384615385,0.0,400,-5,4130.0
370228.0,4,3.0,2050,4000,2.0,3,8,2050,0.0,2014,2050,4000,2988 days 16:47:18.694801,091,1.3333333333333333,0.0,0,0,2050.0
383000.0,4,2.5,2050,4953,2.0,3,9,2050,0.0,2014,2340,6175,2988 days 16:47:18.694801,063,1.6,0.0,-290,-1222,2050.0
384500.0,3,2.5,1600,2610,2.0,3,8,1600,0.0,2005,1445,1288,6275 days 16:47:18.694801,216,1.2,0.0,155,1322,1600.0
865000.0,5,2.5,3190,8160,2.0,3,9,3190,0.0,2014,1650,8160,2988 days 16:47:18.694801,199,2.0,0.0,1540,0,3190.0
502000.0,4,2.5,2040,5616,2.0,3,8,2040,0.0,2012,2380,4737,3719 days 16:47:18.694801,133,1.6,0.0,-340,879,2040.0
1750000.0,4,3.5,3845,8400,2.0,3,1,3845,0.0,2013,1710,8400,3353 days 16:47:18.694801,267,1.1428571428571428,0.0,2135,0,3845.0
569995.0,4,2.5,2650,6875,2.0,3,8,2650,0.0,2014,2650,5831,2988 days 16:47:18.694801,255,1.6,0.0,0,1044,2650.0
749950.0,4,2.5,3430,64441,2.0,3,8,3430,0.0,2013,3580,64441,3353 days 16:47:18.694801,139,1.6,0.0,-150,0,3430.0
550000.0,3,2.5,2430,5400,2.0,3,8,2430,0.0,2007,2640,11990,5545 days 16:47:18.694801,364,1.2,0.0,-210,-6590,2430.0
525000.0,3,3.5,2876,5086,2.0,3,8,2360,516.0,2007,2390,4419,5545 days 16:47:18.694801,133,0.8571428571428571,4.573643410852713,486,667,1844.0
516000.0,4,3.5,2550,8698,2.0,3,7,2550,0.0,2007,2430,5519,5545 days 16:47:18.694801,162,1.1428571428571428,0.0,120,3179,2550.0
1350000.0,4,3.75,4100,61419,2.0,3,9,4100,0.0,2014,2010,32362,2988 days 16:47:18.694801,217,1.0666666666666667,0.0,2090,29057,4100.0
440000.0,4,2.5,2730,4526,2.0,3,7,2730,0.0,2009,2190,4572,4814 days 16:47:18.694801,118,1.6,0.0,540,-46,2730.0
660000.0,3,2.5,1780,1729,2.0,3,8,1080,700.0,2008,1780,1741,5180 days 16:47:18.694801,104,1.2,1.542857142857143,0,-12,380.0
261950.0,3,2.5,1880,5000,2.0,3,7,1880,0.0,2010,2260,5000,4449 days 16:47:18.694801,343,1.2,0.0,-380,0,1880.0
551000.0,5,3.75,3090,4943,2.0,3,1,3090,0.0,2010,3191,5561,4449 days 16:47:18.694801,239,1.3333333333333333,0.0,-101,-618,3090.0
665000.0,3,3.5,2460,14155,2.0,3,8,1900,560.0,2014,2440,14080,2988 days 16:47:18.694801,056,0.8571428571428571,3.392857142857143,20,75,1340.0
610000.0,4,3.5,2910,5260,2.0,3,9,2910,0.0,2012,2910,5260,3719 days 16:47:18.694801,155,1.1428571428571428,0.0,0,0,2910.0
645000.0,4,3.5,2910,5260,2.0,3,9,2910,0.0,2012,2910,5260,3719 days 16:47:18.694801,050,1.1428571428571428,0.0,0,0,2910.0
536751.0,3,1.75,1930,6360,1.0,3,9,1930,0.0,2013,2770,6373,3353 days 16:47:18.694801,169,1.7142857142857142,0.0,-840,-13,1930.0
260000.0,3,2.25,1413,3403,2.0,3,8,1413,0.0,2009,1763,3719,4814 days 16:47:18.694801,116,1.3333333333333333,0.0,-350,-316,1413.0
1310000.0,3,3.25,4030,6300,2.0,3,1,3630,400.0,2006,1660,6300,5910 days 16:47:18.694801,021,0.9230769230769231,9.075,2370,0,3230.0
429900.0,4,3.25,2880,5929,2.5,3,8,2880,0.0,2014,2880,5846,2988 days 16:47:18.694801,051,1.2307692307692308,0.0,0,83,2880.0
535000.0,4,2.75,2360,15100,1.0,3,8,2360,0.0,2014,1440,13346,2988 days 16:47:18.694801,232,1.4545454545454546,0.0,920,1754,2360.0
462550.0,2,1.75,1070,1276,3.0,3,8,1070,0.0,2006,1290,2057,5910 days 16:47:18.694801,104,1.1428571428571428,0.0,-220,-781,1070.0
602000.0,3,3.25,1460,1367,3.0,3,8,1460,0.0,2008,1310,1191,5180 days 16:47:18.694801,069,0.9230769230769231,0.0,150,176,1460.0
730000.0,4,2.75,3800,9606,2.0,3,9,3800,0.0,2008,3400,9677,5180 days 16:47:18.694801,342,1.4545454545454546,0.0,400,-71,3800.0
300500.0,2,1.5,1190,801,3.0,3,8,1190,0.0,2010,1190,810,4449 days 16:47:18.694801,113,1.3333333333333333,0.0,0,-9,1190.0
675000.0,5,2.5,3200,6455,2.0,3,9,3200,0.0,2009,3290,7924,4814 days 16:47:18.694801,136,2.0,0.0,-90,-1469,3200.0
415000.0,3,2.25,1970,2377,2.0,3,8,1680,290.0,2008,1690,1936,5180 days 16:47:18.694801,140,1.3333333333333333,5.793103448275862,280,441,1390.0
614000.0,3,2.5,2830,5831,2.0,3,9,2830,0.0,2010,2830,6064,4449 days 16:47:18.694801,321,1.2,0.0,0,-233,2830.0
385000.0,4,2.5,2630,5701,2.0,3,7,2630,0.0,2010,2770,5939,4449 days 16:47:18.694801,338,1.6,0.0,-140,-238,2630.0
594000.0,4,2.75,2720,4613,2.0,3,9,2720,0.0,2005,2830,4836,6275 days 16:47:18.694801,176,1.4545454545454546,0.0,-110,-223,2720.0
860000.0,4,2.75,3160,8097,2.0,3,9,3160,0.0,2014,2200,8097,2988 days 16:47:18.694801,140,1.4545454545454546,0.0,960,0,3160.0
1100000.0,4,4.0,3770,8899,2.0,3,1,2940,830.0,2006,3300,8308,5910 days 16:47:18.694801,252,1.0,3.5421686746987953,470,591,2110.0
775000.0,4,2.75,3500,6226,2.0,3,9,3500,0.0,2004,3480,7222,6641 days 16:47:18.694801,297,1.4545454545454546,0.0,20,-996,3500.0
430760.0,5,2.75,2710,4685,2.0,3,8,2710,0.0,2014,2710,4449,2988 days 16:47:18.694801,218,1.8181818181818181,0.0,0,236,2710.0
755000.0,2,2.5,2170,6361,1.0,3,8,2170,0.0,2009,2310,7419,4814 days 16:47:18.694801,117,0.8,0.0,-140,-1058,2170.0
640000.0,2,2.25,1540,958,3.0,3,9,1540,0.0,2007,1410,958,5545 days 16:47:18.694801,139,0.8888888888888888,0.0,130,0,1540.0
613500.0,3,3.25,1876,1531,3.0,3,9,1876,0.0,2009,1876,1533,4814 days 16:47:18.694801,121,0.9230769230769231,0.0,0,-2,1876.0
780000.0,4,3.5,3720,213073,1.0,3,1,3720,0.0,2007,2190,59241,5545 days 16:47:18.694801,290,1.1428571428571428,0.0,1530,153832,3720.0
550000.0,4,2.5,3148,9612,2.0,3,9,3148,0.0,2014,3000,11475,2988 days 16:47:18.694801,063,1.6,0.0,148,-1863,3148.0
789500.0,4,3.25,3240,4852,2.0,3,9,3240,0.0,2010,3320,5318,4449 days 16:47:18.694801,281,1.2307692307692308,0.0,-80,-466,3240.0
592000.0,5,3.5,3340,5000,2.0,3,8,2580,760.0,2012,3420,5000,3719 days 16:47:18.694801,191,1.4285714285714286,3.3947368421052633,-80,0,1820.0
454950.0,4,2.5,2413,5701,2.0,3,8,2413,0.0,2014,2380,5725,2988 days 16:47:18.694801,100,1.6,0.0,33,-24,2413.0
475000.0,4,2.5,2500,4500,2.0,3,7,2500,0.0,2010,2230,4500,4449 days 16:47:18.694801,103,1.6,0.0,270,0,2500.0
659000.0,2,1.75,1180,904,2.0,3,1,780,400.0,2014,1380,3610,2988 days 16:47:18.694801,363,1.1428571428571428,1.95,-200,-2706,380.0
570000.0,4,2.5,2890,5801,2.0,3,9,2890,0.0,2005,2890,6286,6275 days 16:47:18.694801,328,1.6,0.0,0,-485,2890.0
347500.0,5,3.0,2230,6551,1.0,3,7,1330,900.0,2014,2230,9476,2988 days 16:47:18.694801,057,1.6666666666666667,1.4777777777777779,0,-2925,430.0
205000.0,4,2.5,1767,4500,2.0,3,8,1767,0.0,2006,1949,4636,5910 days 16:47:18.694801,092,1.6,0.0,-182,-136,1767.0
380000.0,3,3.25,1450,1468,2.0,3,8,1100,350.0,2009,1450,1478,4814 days 16:47:18.694801,246,0.9230769230769231,3.142857142857143,0,-10,750.0
718000.0,5,2.75,2930,7663,2.0,3,9,2930,0.0,2013,2750,10335,3353 days 16:47:18.694801,276,1.8181818181818181,0.0,180,-2672,2930.0
1030000.0,4,3.25,3600,18645,2.0,3,1,3000,600.0,2013,3970,10957,3353 days 16:47:18.694801,195,1.2307692307692308,5.0,-370,7688,2400.0
437718.0,3,2.5,1800,3265,2.0,3,8,1800,0.0,2014,1800,3663,2988 days 16:47:18.694801,317,1.2,0.0,0,-398,1800.0
450000.0,4,2.5,2290,5515,2.0,3,8,2290,0.0,2006,1380,5515,5910 days 16:47:18.694801,226,1.6,0.0,910,0,2290.0
515000.0,3,2.5,1510,1178,2.0,3,8,1060,450.0,2007,1510,1210,5545 days 16:47:18.694801,301,1.2,2.3555555555555556,0,-32,610.0
204000.0,2,2.5,1090,13444,2.0,3,7,1090,0.0,2007,1380,6000,5545 days 16:47:18.694801,061,0.8,0.0,-290,7444,1090.0
360000.0,3,2.0,1270,1323,3.0,3,8,1270,0.0,2006,1330,1323,5910 days 16:47:18.694801,143,1.5,0.0,-60,0,1270.0
550000.0,3,2.25,1540,1005,3.0,3,8,1540,0.0,2008,1510,1501,5180 days 16:47:18.694801,337,1.3333333333333333,0.0,30,-496,1540.0
650880.0,3,2.5,2930,6050,2.0,3,9,2930,0.0,2008,2760,5765,5180 days 16:47:18.694801,149,1.2,0.0,170,285,2930.0
1790000.0,5,3.75,4360,8504,2.0,3,1,3530,830.0,2014,2680,9000,2988 days 16:47:18.694801,056,1.3333333333333333,4.253012048192771,1680,-496,2700.0
895900.0,4,3.5,3640,4983,2.0,3,9,2790,850.0,2014,3270,14700,2988 days 16:47:18.694801,056,1.1428571428571428,3.2823529411764705,370,-9717,1940.0
585000.0,4,2.5,2430,4747,2.0,3,8,2430,0.0,2008,1930,7200,5180 days 16:47:18.694801,157,1.6,0.0,500,-2453,2430.0
380000.0,3,2.25,1520,1464,2.0,3,8,1240,280.0,2010,1710,1464,4449 days 16:47:18.694801,128,1.3333333333333333,4.428571428571429,-190,0,960.0
565997.0,5,2.75,2730,5820,2.0,3,8,2730,0.0,2014,2730,5700,2988 days 16:47:18.694801,322,1.8181818181818181,0.0,0,120,2730.0
459000.0,3,3.0,2440,2076,2.0,3,8,1930,510.0,2006,2440,2310,5910 days 16:47:18.694801,124,1.0,3.784313725490196,0,-234,1420.0
550000.0,3,3.75,1580,1303,2.0,3,8,1340,240.0,2010,1560,1294,4449 days 16:47:18.694801,111,0.8,5.583333333333333,20,9,1100.0
500000.0,3,2.25,1420,983,3.0,3,8,1420,0.0,2006,1530,1280,5910 days 16:47:18.694801,206,1.3333333333333333,0.0,-110,-297,1420.0
461500.0,5,3.25,2820,3275,2.0,3,8,2230,590.0,2006,2610,3275,5910 days 16:47:18.694801,086,1.5384615384615385,3.7796610169491527,210,0,1640.0
2150000.0,4,5.5,5060,10320,2.0,3,1,5060,0.0,2008,3010,10080,5180 days 16:47:18.694801,142,0.7272727272727273,0.0,2050,240,5060.0
790000.0,4,2.5,2650,5000,2.0,3,8,2650,0.0,2007,1110,6250,5545 days 16:47:18.694801,111,1.6,0.0,1540,-1250,2650.0
735000.0,3,2.25,1490,1212,2.0,3,9,1040,450.0,2011,1490,1337,4084 days 16:47:18.694801,178,1.3333333333333333,2.311111111111111,0,-125,590.0
588000.0,4,2.5,3060,7710,2.0,3,9,3060,0.0,2009,3040,7840,4814 days 16:47:18.694801,089,1.6,0.0,20,-130,3060.0
724500.0,3,3.25,3240,4185,2.0,3,8,2770,470.0,2011,2660,4692,4084 days 16:47:18.694801,133,0.9230769230769231,5.8936170212765955,580,-507,2300.0
749000.0,3,2.75,2820,5348,2.0,3,9,2820,0.0,2008,3140,5640,5180 days 16:47:18.694801,190,1.0909090909090908,0.0,-320,-292,2820.0
720000.0,5,3.5,4140,7642,2.0,3,8,4140,0.0,2003,3330,6953,7006 days 16:47:18.694801,261,1.4285714285714286,0.0,810,689,4140.0
250000.0,2,1.5,982,846,2.0,3,8,806,176.0,2006,1010,3844,5910 days 16:47:18.694801,162,1.3333333333333333,4.579545454545454,-28,-2998,630.0
790000.0,3,2.75,2460,3600,2.0,3,9,2460,0.0,2007,2570,3600,5545 days 16:47:18.694801,086,1.0909090909090908,0.0,-110,0,2460.0
392440.0,4,2.5,2547,4800,2.0,3,9,2547,0.0,2014,2598,4800,2988 days 16:47:18.694801,021,1.6,0.0,-51,0,2547.0
280000.0,4,2.25,1834,7460,2.0,3,8,1834,0.0,2012,1979,9008,3719 days 16:47:18.694801,206,1.7777777777777777,0.0,-145,-1548,1834.0
1330000.0,4,4.5,3130,5126,3.0,3,1,2450,680.0,2014,2540,7784,2988 days 16:47:18.694801,317,0.8888888888888888,3.6029411764705883,590,-2658,1770.0
649000.0,4,2.5,2730,4847,2.0,3,9,2730,0.0,2008,1250,4840,5180 days 16:47:18.694801,351,1.6,0.0,1480,7,2730.0
457000.0,2,2.5,1380,1329,2.0,3,8,1050,330.0,2008,1360,3750,5180 days 16:47:18.694801,304,0.8,3.1818181818181817,20,-2421,720.0
2230000.0,4,4.25,4700,10800,2.0,3,1,3910,790.0,2002,2370,7680,7371 days 16:47:18.694801,082,0.9411764705882353,4.949367088607595,2330,3120,3120.0
453000.0,3,3.0,2330,4284,2.0,3,9,1920,410.0,2004,2330,3709,6641 days 16:47:18.694801,235,1.0,4.682926829268292,0,575,1510.0
329780.0,3,2.5,1730,3600,2.0,3,8,1730,0.0,2014,2030,3600,2988 days 16:47:18.694801,265,1.2,0.0,-300,0,1730.0
1050000.0,2,2.5,2350,2390,3.0,3,1,2000,350.0,2007,1950,2390,5545 days 16:47:18.694801,316,0.8,5.714285714285714,400,0,1650.0
771005.0,5,4.5,4000,6713,2.0,3,9,4000,0.0,2015,3690,6600,2623 days 16:47:18.694801,125,1.1111111111111112,0.0,310,113,4000.0
1300000.0,3,2.5,3350,7752,1.0,3,9,2180,1170.0,2009,2570,7988,4814 days 16:47:18.694801,206,1.2,1.8632478632478633,780,-236,1010.0
607500.0,3,3.25,1530,1612,3.0,3,8,1530,0.0,2006,1530,1611,5910 days 16:47:18.694801,170,0.9230769230769231,0.0,0,1,1530.0
278000.0,2,2.25,1610,1968,2.0,4,7,1610,0.0,1979,1950,1968,15772 days 16:47:18.694801,016,0.8888888888888888,0.0,-340,0,1610.0
475000.0,4,2.75,2620,6178,2.0,3,8,2620,0.0,2013,2790,6538,3353 days 16:47:18.694801,183,1.4545454545454546,0.0,-170,-360,2620.0
270000.0,3,2.0,1300,1920,2.0,3,8,850,450.0,2006,1300,1344,5910 days 16:47:18.694801,226,1.5,1.8888888888888888,0,576,400.0
1300000.0,4,3.5,3590,5334,2.0,3,9,3140,450.0,2006,2100,6250,5910 days 16:47:18.694801,113,1.1428571428571428,6.977777777777778,1490,-916,2690.0
778983.0,4,2.5,2490,5647,2.0,3,8,2490,0.0,2014,2970,5450,2988 days 16:47:18.694801,223,1.6,0.0,-480,197,2490.0
221000.0,3,2.5,1320,1780,2.0,3,7,880,440.0,2005,3040,6000,6275 days 16:47:18.694801,295,1.2,2.0,-1720,-4220,440.0
338800.0,4,2.25,1800,2752,2.0,3,8,1800,0.0,2014,1800,2752,2988 days 16:47:18.694801,233,1.7777777777777777,0.0,0,0,1800.0
834995.0,5,1.5,3360,5225,2.0,3,9,3360,0.0,2014,3230,5368,2988 days 16:47:18.694801,216,3.3333333333333335,0.0,130,-143,3360.0
550000.0,4,2.5,3220,9328,2.0,3,8,3220,0.0,2006,3020,9300,5910 days 16:47:18.694801,121,1.6,0.0,200,28,3220.0
575000.0,3,3.5,2514,1559,2.0,3,8,2024,490.0,2007,2090,10454,5545 days 16:47:18.694801,304,0.8571428571428571,4.130612244897959,424,-8895,1534.0
649000.0,4,2.75,3130,9711,2.0,3,9,3130,0.0,2014,1570,10500,2988 days 16:47:18.694801,266,1.4545454545454546,0.0,1560,-789,3130.0
545000.0,4,2.5,2720,4738,2.0,3,8,2720,0.0,2012,2590,5740,3719 days 16:47:18.694801,150,1.6,0.0,130,-1002,2720.0
625000.0,2,2.25,1390,916,2.0,3,8,1165,225.0,2007,1415,1488,5545 days 16:47:18.694801,324,0.8888888888888888,5.177777777777778,-25,-572,940.0
1040000.0,4,4.5,4920,270236,2.0,3,1,3820,1100.0,2006,4920,260924,5910 days 16:47:18.694801,357,0.8888888888888888,3.4727272727272727,0,9312,2720.0
611000.0,3,2.5,2134,1984,2.5,3,8,2134,0.0,2008,2170,1984,5180 days 16:47:18.694801,136,1.2,0.0,-36,0,2134.0
300000.0,3,2.5,1741,5701,2.0,3,8,1741,0.0,2012,2002,5700,3719 days 16:47:18.694801,076,1.2,0.0,-261,1,1741.0
577000.0,3,2.5,2560,5238,2.0,3,8,2560,0.0,2001,2560,5185,7736 days 16:47:18.694801,363,1.2,0.0,0,53,2560.0
349990.0,4,2.5,2220,3561,2.0,3,8,2220,0.0,2014,2530,4449,2988 days 16:47:18.694801,293,1.6,0.0,-310,-888,2220.0
650000.0,3,2.5,1910,4363,2.0,3,9,1910,0.0,2006,1890,3732,5910 days 16:47:18.694801,195,1.2,0.0,20,631,1910.0
378000.0,2,1.5,980,853,2.0,3,7,820,160.0,2009,1130,1270,4814 days 16:47:18.694801,087,1.3333333333333333,5.125,-150,-417,660.0
313200.0,3,2.5,1950,4197,2.0,3,7,1950,0.0,2013,2300,4178,3353 days 16:47:18.694801,036,1.2,0.0,-350,19,1950.0
1210000.0,5,4.25,4150,12015,2.0,3,1,4150,0.0,2014,3230,27520,2988 days 16:47:18.694801,255,1.1764705882352942,0.0,920,-15505,4150.0
252500.0,2,1.5,1110,986,2.0,3,7,950,160.0,2009,1110,3515,4814 days 16:47:18.694801,126,1.3333333333333333,5.9375,0,-2529,790.0
308000.0,3,2.5,1250,1150,2.0,3,8,1080,170.0,2009,1250,1150,4814 days 16:47:18.694801,064,1.2,6.352941176470588,0,0,910.0
803100.0,4,2.5,3310,5404,2.0,3,9,3310,0.0,2004,2600,4730,6641 days 16:47:18.694801,135,1.6,0.0,710,674,3310.0
415000.0,4,2.5,2020,5501,2.0,3,7,2020,0.0,2010,2020,5494,4449 days 16:47:18.694801,169,1.6,0.0,0,7,2020.0
785000.0,4,3.5,3310,4850,2.0,3,9,3310,0.0,2010,3320,5955,4449 days 16:47:18.694801,226,1.1428571428571428,0.0,-10,-1105,3310.0
499950.0,4,2.5,2798,4473,2.0,3,9,2798,0.0,2012,2358,4593,3719 days 16:47:18.694801,148,1.6,0.0,440,-120,2798.0
216000.0,4,2.5,1847,8000,2.0,3,7,1847,0.0,2008,1767,8000,5180 days 16:47:18.694801,076,1.6,0.0,80,0,1847.0
380000.0,4,2.5,2420,4981,2.0,3,9,2420,0.0,2009,2420,5000,4814 days 16:47:18.694801,057,1.6,0.0,0,-19,2420.0
345000.0,4,2.5,2020,3600,2.0,3,7,2020,0.0,2012,2210,3800,3719 days 16:47:18.694801,310,1.6,0.0,-190,-200,2020.0
456500.0,4,2.5,2400,6811,2.0,3,8,2400,0.0,2007,2710,5314,5545 days 16:47:18.694801,308,1.6,0.0,-310,1497,2400.0
382495.0,3,2.5,1760,5390,1.0,3,8,1760,0.0,2014,2310,5117,2988 days 16:47:18.694801,308,1.2,0.0,-550,273,1760.0
324950.0,4,2.5,2110,4178,2.0,3,7,2110,0.0,2013,2300,4142,3353 days 16:47:18.694801,065,1.6,0.0,-190,36,2110.0
436472.0,4,2.5,2692,8392,2.0,3,9,2692,0.0,2014,2574,14446,2988 days 16:47:18.694801,223,1.6,0.0,118,-6054,2692.0
365250.0,3,2.25,1490,4522,2.0,3,7,1490,0.0,2009,1580,4667,4814 days 16:47:18.694801,150,1.3333333333333333,0.0,-90,-145,1490.0
919990.0,5,3.25,3960,6352,2.0,3,1,3960,0.0,2014,2930,9875,2988 days 16:47:18.694801,083,1.5384615384615385,0.0,1030,-3523,3960.0
425000.0,4,2.5,1940,4517,1.0,3,8,1190,750.0,2010,1910,10410,4449 days 16:47:18.694801,083,1.6,1.5866666666666667,30,-5893,440.0
302860.0,2,1.0,970,3279,2.0,3,7,790,180.0,2007,1150,1351,5545 days 16:47:18.694801,070,2.0,4.388888888888889,-180,1928,610.0
298000.0,3,2.5,1852,4000,2.0,3,7,1852,0.0,2014,2166,4000,2988 days 16:47:18.694801,203,1.2,0.0,-314,0,1852.0
3200000.0,4,4.0,4810,18851,2.0,3,1,4810,0.0,2007,3970,19929,5545 days 16:47:18.694801,238,1.0,0.0,840,-1078,4810.0
950000.0,4,4.0,5635,9695,2.0,3,1,4360,1275.0,2011,3726,9765,4084 days 16:47:18.694801,335,1.0,3.4196078431372547,1909,-70,3085.0
333000.0,3,2.5,1520,3041,2.0,3,7,1520,0.0,2009,1820,3229,4814 days 16:47:18.694801,325,1.2,0.0,-300,-188,1520.0
289950.0,3,2.5,2099,4275,2.0,3,7,2099,0.0,2010,2099,4275,4449 days 16:47:18.694801,064,1.2,0.0,0,0,2099.0
419950.0,3,2.25,1250,811,3.0,3,8,1250,0.0,2014,1250,1232,2988 days 16:47:18.694801,126,1.3333333333333333,0.0,0,-421,1250.0
306000.0,2,1.5,1090,1183,3.0,3,8,1090,0.0,2008,1110,1384,5180 days 16:47:18.694801,196,1.3333333333333333,0.0,-20,-201,1090.0
498445.0,4,2.5,3216,5902,2.0,3,9,3216,0.0,2014,2815,4916,2988 days 16:47:18.694801,333,1.6,0.0,401,986,3216.0
775950.0,4,2.5,2970,4400,2.0,3,8,2970,0.0,2014,3010,4892,2988 days 16:47:18.694801,171,1.6,0.0,-40,-492,2970.0
605000.0,3,2.5,2610,6405,2.0,3,8,2610,0.0,2001,2580,6285,7736 days 16:47:18.694801,184,1.2,0.0,30,120,2610.0
520000.0,2,1.75,1340,1368,2.0,3,7,1060,280.0,2006,2480,1707,5910 days 16:47:18.694801,252,1.1428571428571428,3.7857142857142856,-1140,-339,780.0
849990.0,4,2.75,3300,4987,2.0,3,9,3300,0.0,2014,3520,5453,2988 days 16:47:18.694801,301,1.4545454545454546,0.0,-220,-466,3300.0
767450.0,3,2.0,1630,7599,1.0,3,1,1630,0.0,2006,2030,7599,5910 days 16:47:18.694801,155,1.5,0.0,-400,0,1630.0
665000.0,3,2.25,1590,929,2.0,3,9,1060,530.0,2014,1510,1193,2988 days 16:47:18.694801,220,1.3333333333333333,2.0,80,-264,530.0
525000.0,2,2.75,1310,1268,3.5,3,8,1310,0.0,2007,1350,1288,5545 days 16:47:18.694801,261,0.7272727272727273,0.0,-40,-20,1310.0
870515.0,4,3.5,3600,5697,2.0,3,9,2940,660.0,2014,3490,5911,2988 days 16:47:18.694801,203,1.1428571428571428,4.454545454545454,110,-214,2280.0
390000.0,4,2.5,2154,4153,2.0,3,9,2154,0.0,2012,2154,4091,3719 days 16:47:18.694801,202,1.6,0.0,0,62,2154.0
500000.0,3,1.75,1530,825,3.0,3,8,1530,0.0,2015,1580,1915,2623 days 16:47:18.694801,101,1.7142857142857142,0.0,-50,-1090,1530.0
399950.0,3,2.25,1360,1041,2.0,3,8,1094,266.0,2006,1522,1382,5910 days 16:47:18.694801,217,1.3333333333333333,4.112781954887218,-162,-341,828.0
305000.0,3,2.5,1320,2480,2.0,3,7,1320,0.0,2005,1320,3240,6275 days 16:47:18.694801,040,1.2,0.0,0,-760,1320.0
255000.0,4,2.5,1660,6724,2.0,3,7,1660,0.0,2009,1544,6054,4814 days 16:47:18.694801,023,1.6,0.0,116,670,1660.0
415000.0,4,2.5,2891,6499,2.0,3,9,2891,0.0,2014,2550,8383,2988 days 16:47:18.694801,273,1.6,0.0,341,-1884,2891.0
716500.0,3,2.5,2340,2155,2.0,3,1,2120,220.0,2012,2640,2680,3719 days 16:47:18.694801,086,1.2,9.636363636363637,-300,-525,1900.0
425000.0,3,2.5,2320,2267,3.0,3,8,2320,0.0,2009,1240,1883,4814 days 16:47:18.694801,176,1.2,0.0,1080,384,2320.0
540000.0,4,2.5,2190,3855,2.0,3,8,2190,0.0,2010,2190,3600,4449 days 16:47:18.694801,048,1.6,0.0,0,255,2190.0
324747.0,3,2.5,2060,4742,2.0,3,8,2060,0.0,2014,2370,4725,2988 days 16:47:18.694801,216,1.2,0.0,-310,17,2060.0
385000.0,3,2.5,1740,4145,2.0,3,7,1740,0.0,2010,1740,4045,4449 days 16:47:18.694801,028,1.2,0.0,0,100,1740.0
270000.0,3,2.25,1400,3825,2.0,3,7,1400,0.0,2012,2110,3825,3719 days 16:47:18.694801,224,1.3333333333333333,0.0,-710,0,1400.0
1240000.0,5,4.0,4410,14380,2.0,3,1,4410,0.0,2006,2720,11454,5910 days 16:47:18.694801,163,1.25,0.0,1690,2926,4410.0
672000.0,3,2.5,1780,1647,2.0,3,8,1080,700.0,2008,2000,1741,5180 days 16:47:18.694801,106,1.2,1.542857142857143,-220,-94,380.0
310000.0,3,2.5,1760,10137,2.0,3,8,1760,0.0,2010,2000,6935,4449 days 16:47:18.694801,029,1.2,0.0,-240,3202,1760.0
3000000.0,3,3.5,4410,10756,2.0,3,1,3430,980.0,2014,3550,5634,2988 days 16:47:18.694801,223,0.8571428571428571,3.5,860,5122,2450.0
2350000.0,6,4.25,5550,11547,2.0,3,1,4270,1280.0,2014,3480,11547,2988 days 16:47:18.694801,056,1.411764705882353,3.3359375,2070,0,2990.0
427000.0,3,2.5,2432,9391,2.0,3,9,2432,0.0,2005,2912,8932,6275 days 16:47:18.694801,178,1.2,0.0,-480,459,2432.0
389950.0,3,2.5,2283,3996,2.0,3,8,2283,0.0,2008,1760,3992,5180 days 16:47:18.694801,113,1.2,0.0,523,4,2283.0
309620.0,3,2.5,1860,3730,2.0,3,8,1860,0.0,2012,2110,4509,3719 days 16:47:18.694801,176,1.2,0.0,-250,-779,1860.0
399895.0,4,2.5,2701,4500,2.0,3,9,2701,0.0,2014,2570,4800,2988 days 16:47:18.694801,182,1.6,0.0,131,-300,2701.0
442515.0,4,2.5,2930,4875,2.0,3,9,2930,0.0,2014,2815,4900,2988 days 16:47:18.694801,033,1.6,0.0,115,-25,2930.0
375000.0,3,2.25,1540,1561,3.0,3,8,1540,0.0,2010,1540,1547,4449 days 16:47:18.694801,336,1.3333333333333333,0.0,0,14,1540.0
309780.0,3,2.5,2242,4500,2.0,3,8,2242,0.0,2014,2009,4500,2988 days 16:47:18.694801,183,1.2,0.0,233,0,2242.0
425000.0,3,2.5,1950,4345,2.0,3,7,1950,0.0,2007,2260,4345,5545 days 16:47:18.694801,071,1.2,0.0,-310,0,1950.0
405000.0,2,3.0,1160,1073,2.0,3,7,880,280.0,2007,1250,4812,5545 days 16:47:18.694801,121,0.6666666666666666,3.142857142857143,-90,-3739,600.0
356250.0,3,2.5,2060,5115,2.0,3,9,2060,0.0,2014,2648,4500,2988 days 16:47:18.694801,200,1.2,0.0,-588,615,2060.0
550000.0,3,2.25,1230,875,3.0,3,8,1230,0.0,2013,1760,5664,3353 days 16:47:18.694801,050,1.3333333333333333,0.0,-530,-4789,1230.0
340000.0,2,1.5,1160,1438,2.0,3,7,1160,0.0,2001,1220,1740,7736 days 16:47:18.694801,125,1.3333333333333333,0.0,-60,-302,1160.0
362865.0,4,2.5,2245,4301,2.0,3,8,2245,0.0,2014,2530,4478,2988 days 16:47:18.694801,235,1.6,0.0,-285,-177,2245.0
1360000.0,4,3.5,4120,12626,2.0,3,1,3970,150.0,2014,4120,11913,2988 days 16:47:18.694801,082,1.1428571428571428,26.466666666666665,0,713,3820.0
830000.0,4,2.5,3400,9692,2.0,3,9,3400,0.0,2007,3070,7375,5545 days 16:47:18.694801,125,1.6,0.0,330,2317,3400.0
1600000.0,5,3.75,4270,7500,2.0,3,1,3210,1060.0,2014,2410,8350,2988 days 16:47:18.694801,213,1.3333333333333333,3.0283018867924527,1860,-850,2150.0
855000.0,4,3.5,2890,5911,2.0,3,9,2370,520.0,2014,3490,6093,2988 days 16:47:18.694801,063,1.1428571428571428,4.5576923076923075,-600,-182,1850.0
1210000.0,5,3.5,3220,8000,2.0,3,9,2900,320.0,2008,2100,9680,5180 days 16:47:18.694801,231,1.4285714285714286,9.0625,1120,-1680,2580.0
1390000.0,4,3.5,4010,15365,2.0,3,1,4010,0.0,2006,3550,13429,5910 days 16:47:18.694801,223,1.1428571428571428,0.0,460,1936,4010.0
400200.0,4,3.5,2260,30250,2.0,3,7,2260,0.0,2013,1270,16350,3353 days 16:47:18.694801,085,1.1428571428571428,0.0,990,13900,2260.0
235000.0,2,1.0,1140,1730,1.5,3,8,1010,130.0,2007,1360,1730,5545 days 16:47:18.694801,143,2.0,7.769230769230769,-220,0,880.0
349950.0,3,2.0,1640,4714,1.0,3,8,1640,0.0,2009,1770,4802,4814 days 16:47:18.694801,127,1.5,0.0,-130,-88,1640.0
785000.0,3,2.75,3010,1842,2.0,3,9,3010,0.0,2011,2950,4200,4084 days 16:47:18.694801,128,1.0909090909090908,0.0,60,-2358,3010.0
475000.0,2,2.25,1060,925,2.0,3,8,980,80.0,2006,1020,4000,5910 days 16:47:18.694801,106,0.8888888888888888,12.25,40,-3075,900.0
263900.0,3,2.5,1658,2700,2.0,3,8,1658,0.0,2014,1658,2700,2988 days 16:47:18.694801,147,1.2,0.0,0,0,1658.0
342000.0,3,2.5,1960,3540,2.0,3,8,1960,0.0,2012,1840,3825,3719 days 16:47:18.694801,121,1.2,0.0,120,-285,1960.0
367899.0,3,2.5,2420,4725,2.0,3,8,2420,0.0,2014,2370,4200,2988 days 16:47:18.694801,261,1.2,0.0,50,525,2420.0
657044.0,3,3.5,3420,23786,1.5,3,9,3420,0.0,2014,1590,23774,2988 days 16:47:18.694801,035,0.8571428571428571,0.0,1830,12,3420.0
359950.0,2,1.5,893,965,2.0,3,8,893,0.0,2007,1340,1436,5545 days 16:47:18.694801,317,1.3333333333333333,0.0,-447,-471,893.0
879950.0,4,2.75,3020,7203,2.0,3,9,3020,0.0,2014,3010,7215,2988 days 16:47:18.694801,204,1.4545454545454546,0.0,10,-12,3020.0
550000.0,4,2.5,2470,5954,2.0,3,8,2470,0.0,2013,2470,4800,3353 days 16:47:18.694801,238,1.6,0.0,0,1154,2470.0
279000.0,4,2.5,2009,4800,2.0,3,8,2009,0.0,2012,1798,4800,3719 days 16:47:18.694801,343,1.6,0.0,211,0,2009.0
255000.0,3,2.5,1530,1116,2.5,3,7,1530,0.0,2005,1530,7780,6275 days 16:47:18.694801,199,1.2,0.0,0,-6664,1530.0
609500.0,3,1.75,1590,1113,3.0,3,8,1590,0.0,2014,1520,1357,2988 days 16:47:18.694801,055,1.7142857142857142,0.0,70,-244,1590.0
420000.0,5,3.0,2630,3149,2.0,3,8,1670,960.0,2013,2240,4825,3353 days 16:47:18.694801,171,1.6666666666666667,1.7395833333333333,390,-1676,710.0
570000.0,4,2.5,3230,7187,2.0,3,9,3230,0.0,2008,2950,6537,5180 days 16:47:18.694801,281,1.6,0.0,280,650,3230.0
439000.0,3,2.25,1430,2343,2.0,3,8,1430,0.0,2012,1270,1916,3719 days 16:47:18.694801,132,1.3333333333333333,0.0,160,427,1430.0
310000.0,3,2.5,2242,5744,2.0,3,8,2242,0.0,2012,2009,5712,3719 days 16:47:18.694801,312,1.2,0.0,233,32,2242.0
635000.0,4,2.5,2500,4000,2.0,3,8,2500,0.0,2014,1480,4300,2988 days 16:47:18.694801,040,1.6,0.0,1020,-300,2500.0
399950.0,3,2.5,1230,922,2.0,3,8,1080,150.0,2009,1230,1237,4814 days 16:47:18.694801,332,1.2,7.2,0,-315,930.0
805000.0,4,2.5,3020,3600,2.5,3,9,3020,0.0,2009,2570,3600,4814 days 16:47:18.694801,217,1.6,0.0,450,0,3020.0
1800000.0,4,3.5,3480,4000,2.0,3,9,2460,1020.0,2015,2620,4000,2623 days 16:47:18.694801,097,1.1428571428571428,2.411764705882353,860,0,1440.0
1210000.0,4,3.0,3330,7650,1.0,3,9,1830,1500.0,2008,1200,3876,5180 days 16:47:18.694801,093,1.3333333333333333,1.22,2130,3774,330.0
745000.0,4,2.5,3400,4840,2.0,3,1,3190,210.0,2006,3400,5710,5910 days 16:47:18.694801,288,1.6,15.19047619047619,0,-870,2980.0
329445.0,2,1.5,830,1119,2.0,3,7,830,0.0,2005,1480,3622,6275 days 16:47:18.694801,175,1.3333333333333333,0.0,-650,-2503,830.0
588000.0,5,3.0,3110,4464,2.0,3,8,3110,0.0,2007,2450,4221,5545 days 16:47:18.694801,288,1.6666666666666667,0.0,660,243,3110.0
494815.0,3,2.5,1910,2091,2.0,3,8,1910,0.0,2014,1630,1546,2988 days 16:47:18.694801,188,1.2,0.0,280,545,1910.0
591975.0,3,2.75,3230,5250,2.0,3,9,2680,550.0,2014,2710,5250,2988 days 16:47:18.694801,287,1.0909090909090908,4.872727272727273,520,0,2130.0
600000.0,5,2.75,3380,8179,2.0,3,9,3380,0.0,2011,2840,8179,4084 days 16:47:18.694801,008,1.8181818181818181,0.0,540,0,3380.0
673000.0,3,2.75,2830,3496,2.0,3,8,2830,0.0,2012,2160,3501,3719 days 16:47:18.694801,189,1.0909090909090908,0.0,670,-5,2830.0
889950.0,5,3.5,3700,7055,2.0,3,9,3700,0.0,2014,3170,6527,2988 days 16:47:18.694801,042,1.4285714285714286,0.0,530,528,3700.0
500000.0,4,3.0,2520,4104,2.0,3,7,2520,0.0,2002,2510,5015,7371 days 16:47:18.694801,084,1.3333333333333333,0.0,10,-911,2520.0
500000.0,3,2.25,1530,1396,2.0,3,8,1240,290.0,2007,1690,2500,5545 days 16:47:18.694801,274,1.3333333333333333,4.275862068965517,-160,-1104,950.0
890000.0,4,4.25,4420,5750,2.0,3,1,3410,1010.0,2006,4420,5750,5910 days 16:47:18.694801,125,0.9411764705882353,3.376237623762376,0,0,2400.0
437000.0,3,3.0,1460,1180,3.0,3,8,1460,0.0,2006,1460,1224,5910 days 16:47:18.694801,119,1.0,0.0,0,-44,1460.0
419700.0,3,2.25,1450,1486,2.0,3,8,1160,290.0,2006,1370,1437,5910 days 16:47:18.694801,248,1.3333333333333333,4.0,80,49,870.0
394000.0,3,2.0,1160,3441,1.0,4,6,580,580.0,1930,1160,4000,33669 days 16:47:18.694801,204,1.5,1.0,0,-559,0.0
342000.0,3,2.0,1640,4802,1.0,3,8,1640,0.0,2010,1940,4802,4449 days 16:47:18.694801,218,1.5,0.0,-300,0,1640.0
420000.0,3,1.75,1444,249126,1.5,3,7,1444,0.0,2008,1760,224770,5180 days 16:47:18.694801,177,1.7142857142857142,0.0,-316,24356,1444.0
580000.0,3,2.5,1620,1173,3.0,3,8,1470,150.0,2008,1620,1505,5180 days 16:47:18.694801,143,1.2,9.8,0,-332,1320.0
343000.0,2,1.5,1100,1228,2.0,3,7,900,200.0,2007,1340,1380,5545 days 16:47:18.694801,086,1.3333333333333333,4.5,-240,-152,700.0
390000.0,2,1.5,1340,1402,2.0,3,8,1120,220.0,2008,1340,1213,5180 days 16:47:18.694801,092,1.3333333333333333,5.090909090909091,0,189,900.0
274000.0,3,1.5,1450,4694,2.0,3,7,1450,0.0,2011,1870,4198,4084 days 16:47:18.694801,223,2.0,0.0,-420,496,1450.0
700000.0,4,2.5,3040,7200,2.0,3,9,3040,0.0,2008,2360,8245,5180 days 16:47:18.694801,014,1.6,0.0,680,-1045,3040.0
838000.0,4,2.5,2560,7210,2.0,3,9,2560,0.0,2006,2160,10439,5910 days 16:47:18.694801,106,1.6,0.0,400,-3229,2560.0
300000.0,6,3.0,2744,9926,2.0,3,7,2744,0.0,2006,2470,9926,5910 days 16:47:18.694801,260,2.0,0.0,274,0,2744.0
467000.0,3,2.25,1420,990,3.0,3,8,1420,0.0,2008,1350,1415,5180 days 16:47:18.694801,246,1.3333333333333333,0.0,70,-425,1420.0
395000.0,2,1.0,700,7457,1.0,3,6,700,0.0,1943,1500,7130,28921 days 16:47:18.694801,061,2.0,0.0,-800,327,700.0
734000.0,5,4.25,4110,42755,2.0,3,1,2970,1140.0,2000,2730,12750,8102 days 16:47:18.694801,267,1.1764705882352942,2.6052631578947367,1380,30005,1830.0
480000.0,5,2.75,2670,4780,2.0,3,8,2670,0.0,2013,2560,5380,3353 days 16:47:18.694801,006,1.8181818181818181,0.0,110,-600,2670.0
539000.0,3,2.75,2130,1400,2.0,3,9,1080,1050.0,2010,1520,3132,4449 days 16:47:18.694801,048,1.0909090909090908,1.0285714285714285,610,-1732,30.0
459950.0,5,2.75,3078,6371,2.0,3,9,3078,0.0,2014,1979,19030,2988 days 16:47:18.694801,125,1.8181818181818181,0.0,1099,-12659,3078.0
306500.0,2,1.0,840,892,2.0,3,7,840,0.0,2006,1030,1007,5910 days 16:47:18.694801,303,2.0,0.0,-190,-115,840.0
408474.0,3,2.5,1800,2731,2.0,3,8,1800,0.0,2014,1800,3265,2988 days 16:47:18.694801,085,1.2,0.0,0,-534,1800.0
437000.0,3,2.75,2580,5200,2.0,3,8,2580,0.0,2008,2700,5602,5180 days 16:47:18.694801,134,1.0909090909090908,0.0,-120,-402,2580.0
160797.0,3,1.5,1270,2356,2.0,3,7,1270,0.0,2012,1490,2175,3719 days 16:47:18.694801,174,2.0,0.0,-220,181,1270.0
729000.0,4,3.5,3065,5440,3.0,3,9,3065,0.0,2014,2210,8400,2988 days 16:47:18.694801,007,1.1428571428571428,0.0,855,-2960,3065.0
499000.0,3,2.5,1861,1587,2.0,3,8,1578,283.0,2007,2090,10454,5545 days 16:47:18.694801,304,1.2,5.575971731448763,-229,-8867,1295.0
359950.0,4,2.75,2260,5705,2.0,3,8,2260,0.0,2014,2260,5727,2988 days 16:47:18.694801,289,1.4545454545454546,0.0,0,-22,2260.0
929000.0,5,3.25,4150,7100,2.0,3,1,4150,0.0,2013,3560,7214,3353 days 16:47:18.694801,344,1.5384615384615385,0.0,590,-114,4150.0
529950.0,2,2.5,1500,1174,2.0,3,8,1140,360.0,2014,1550,1519,2988 days 16:47:18.694801,279,0.8,3.1666666666666665,-50,-345,780.0
461000.0,3,2.25,1620,998,2.5,3,8,1540,80.0,2012,1620,1068,3719 days 16:47:18.694801,093,1.3333333333333333,19.25,0,-70,1460.0
271115.0,2,1.5,830,1325,2.0,3,7,830,0.0,2005,1310,1485,6275 days 16:47:18.694801,287,1.3333333333333333,0.0,-480,-160,830.0
653000.0,4,2.5,3120,5137,2.0,3,7,3120,0.0,2003,2755,5137,7006 days 16:47:18.694801,006,1.6,0.0,365,0,3120.0
565000.0,3,2.5,1870,1058,3.0,3,8,1380,490.0,2007,1440,1136,5545 days 16:47:18.694801,297,1.2,2.816326530612245,430,-78,890.0
529950.0,3,2.25,1240,1250,3.0,3,8,1240,0.0,2014,1470,1250,2988 days 16:47:18.694801,338,1.3333333333333333,0.0,-230,0,1240.0
585000.0,4,2.5,2820,5612,2.0,3,9,2820,0.0,2007,1620,14881,5545 days 16:47:18.694801,085,1.6,0.0,1200,-9269,2820.0
609000.0,3,1.75,1630,1526,3.0,3,8,1630,0.0,2014,1570,1274,2988 days 16:47:18.694801,184,1.7142857142857142,0.0,60,252,1630.0
267000.0,3,2.25,1584,2800,2.0,3,7,1584,0.0,2012,1584,2800,3719 days 16:47:18.694801,169,1.3333333333333333,0.0,0,0,1584.0
557000.0,4,2.5,2840,4500,2.0,3,8,2840,0.0,2012,2840,4939,3719 days 16:47:18.694801,129,1.6,0.0,0,-439,2840.0
709950.0,4,3.25,3910,6293,2.0,3,9,3130,780.0,2006,4410,6015,5910 days 16:47:18.694801,321,1.2307692307692308,4.012820512820513,-500,278,2350.0
625000.0,3,2.5,1730,1301,3.0,3,9,1730,0.0,2011,1330,1240,4084 days 16:47:18.694801,199,1.2,0.0,400,61,1730.0
599000.0,3,2.75,1840,2060,2.0,3,1,1700,140.0,2013,2590,2680,3353 days 16:47:18.694801,357,1.0909090909090908,12.142857142857142,-750,-620,1560.0
920000.0,4,3.75,4030,503989,2.0,3,1,4030,0.0,2008,2110,71874,5180 days 16:47:18.694801,126,1.0666666666666667,0.0,1920,432115,4030.0
1290000.0,4,3.5,3440,3800,3.0,3,9,3440,0.0,2014,1760,3800,2988 days 16:47:18.694801,289,1.1428571428571428,0.0,1680,0,3440.0
324500.0,4,2.5,2110,3825,2.0,3,7,2110,0.0,2012,2110,3825,3719 days 16:47:18.694801,089,1.6,0.0,0,0,2110.0
471500.0,3,2.5,2430,5866,2.0,3,7,2430,0.0,2009,2380,5866,4814 days 16:47:18.694801,016,1.2,0.0,50,0,2430.0
1020000.0,4,3.75,4690,207141,2.0,3,1,4030,660.0,2007,2890,200527,5545 days 16:47:18.694801,220,1.0666666666666667,6.106060606060606,1800,6614,3370.0
998000.0,4,3.5,3500,43560,2.0,3,9,2850,650.0,2014,3640,40545,2988 days 16:47:18.694801,315,1.1428571428571428,4.384615384615385,-140,3015,2200.0
262000.0,4,2.5,2070,8685,2.0,3,7,2070,0.0,2006,2170,9715,5910 days 16:47:18.694801,029,1.6,0.0,-100,-1030,2070.0
844000.0,4,3.5,3350,6350,2.0,3,8,2610,740.0,2009,1820,6350,4814 days 16:47:18.694801,091,1.1428571428571428,3.527027027027027,1530,0,1870.0
745641.0,4,2.5,2440,4850,2.0,3,8,2440,0.0,2013,2970,5450,3353 days 16:47:18.694801,175,1.6,0.0,-530,-600,2440.0
659950.0,5,3.0,3010,7357,2.0,3,9,3010,0.0,2008,2370,8050,5180 days 16:47:18.694801,346,1.6666666666666667,0.0,640,-693,3010.0
339989.0,3,2.5,2060,4200,2.0,3,8,2060,0.0,2014,2370,4200,2988 days 16:47:18.694801,216,1.2,0.0,-310,0,2060.0
352500.0,2,2.5,1570,2399,2.0,3,7,1180,390.0,2009,1590,2306,4814 days 16:47:18.694801,124,0.8,3.0256410256410255,-20,93,790.0
525000.0,3,2.5,1580,1161,2.0,3,8,1010,570.0,2008,1680,1177,5180 days 16:47:18.694801,133,1.2,1.7719298245614035,-100,-16,440.0
1140000.0,5,3.5,4280,6530,2.0,3,1,4280,0.0,2014,3960,6863,2988 days 16:47:18.694801,272,1.4285714285714286,0.0,320,-333,4280.0
491000.0,5,3.5,2815,4900,2.0,3,9,2815,0.0,2011,2798,4900,4084 days 16:47:18.694801,224,1.4285714285714286,0.0,17,0,2815.0
675000.0,4,2.5,2620,6114,2.0,3,9,2620,0.0,2011,2620,5808,4084 days 16:47:18.694801,199,1.6,0.0,0,306,2620.0
344000.0,3,2.25,1250,1033,3.0,3,8,1250,0.0,2007,1250,1150,5545 days 16:47:18.694801,006,1.3333333333333333,0.0,0,-117,1250.0
530000.0,4,2.5,3250,4500,2.0,3,8,3250,0.0,2008,3030,4598,5180 days 16:47:18.694801,308,1.6,0.0,220,-98,3250.0
290500.0,4,3.25,2510,7686,2.0,3,9,2510,0.0,2003,2510,6732,7006 days 16:47:18.694801,344,1.2307692307692308,0.0,0,954,2510.0
335000.0,2,1.75,1270,1685,2.0,3,8,1270,0.0,2012,1270,1843,3719 days 16:47:18.694801,013,1.1428571428571428,0.0,0,-158,1270.0
3000000.0,5,4.0,6670,16481,2.0,3,1,4960,1710.0,2007,4800,16607,5545 days 16:47:18.694801,127,1.25,2.9005847953216373,1870,-126,3250.0
379000.0,3,2.5,1580,3075,2.0,3,8,1580,0.0,2013,1710,2934,3353 days 16:47:18.694801,262,1.2,0.0,-130,141,1580.0
385000.0,3,1.5,1360,2030,3.0,3,8,1360,0.0,2008,1360,1167,5180 days 16:47:18.694801,198,2.0,0.0,0,863,1360.0
500012.0,4,2.5,2400,9612,1.0,3,8,1230,1170.0,1962,2430,5539,21981 days 16:47:18.694801,056,1.6,1.0512820512820513,-30,4073,60.0
366750.0,3,3.0,1571,2017,3.0,3,8,1571,0.0,2008,1520,1497,5180 days 16:47:18.695827,125,1.0,0.0,51,520,1571.0
405000.0,2,2.0,1405,1073,2.0,3,8,1140,265.0,2007,1405,3000,5545 days 16:47:18.695827,157,1.0,4.30188679245283,0,-1927,875.0
356999.0,3,1.5,1010,1546,2.0,3,8,1010,0.0,1971,1010,1517,18694 days 16:47:18.695827,043,2.0,0.0,0,29,1010.0
590000.0,2,2.5,1450,1281,2.0,3,8,1220,230.0,2006,1440,1281,5910 days 16:47:18.695827,107,0.8,5.304347826086956,10,0,990.0
294000.0,3,1.75,1420,1361,2.0,3,7,960,460.0,2014,1340,1343,2988 days 16:47:18.695827,308,1.7142857142857142,2.0869565217391304,80,18,500.0
731500.0,4,2.5,2650,4644,2.0,3,8,2650,0.0,2013,2640,5099,3353 days 16:47:18.695827,116,1.6,0.0,10,-455,2650.0
837219.0,5,2.75,3030,7679,2.0,3,9,3030,0.0,2014,3080,6341,2988 days 16:47:18.695827,157,1.8181818181818181,0.0,-50,1338,3030.0
1600000.0,4,5.5,6530,871200,2.0,3,1,6530,0.0,2008,1280,858132,5180 days 16:47:18.695827,105,0.7272727272727273,0.0,5250,13068,6530.0
798800.0,3,2.75,2670,3738,1.0,3,1,1720,950.0,2013,2610,3734,3353 days 16:47:18.695827,167,1.0909090909090908,1.8105263157894738,60,4,770.0
482500.0,2,2.5,1170,809,2.0,3,9,1170,0.0,2007,1170,1121,5545 days 16:47:18.695827,281,0.8,0.0,0,-312,1170.0
820000.0,4,2.5,3260,26772,2.0,3,9,3260,0.0,2007,3260,14491,5545 days 16:47:18.695827,065,1.6,0.0,0,12281,3260.0
319000.0,3,1.5,1480,1722,3.0,3,7,1480,0.0,2007,1480,5764,5545 days 16:47:18.695827,192,2.0,0.0,0,-4042,1480.0
950000.0,3,2.5,2700,6947,2.0,3,9,2700,0.0,2013,2500,6947,3353 days 16:47:18.695827,225,1.2,0.0,200,0,2700.0
1270000.0,4,3.5,4640,13404,2.0,3,1,4640,0.0,2007,4690,13590,5545 days 16:47:18.695827,127,1.1428571428571428,0.0,-50,-186,4640.0
378000.0,3,2.5,1601,2491,3.0,3,7,1536,65.0,2007,1420,1156,5545 days 16:47:18.695827,188,1.2,23.630769230769232,181,1335,1471.0
3350000.0,5,3.75,5350,15360,1.0,3,1,3040,2310.0,2008,3740,15940,5180 days 16:47:18.695827,092,1.3333333333333333,1.316017316017316,1610,-580,730.0
489950.0,3,2.5,2540,5237,2.0,3,8,2540,0.0,2011,1800,4097,4084 days 16:47:18.695827,300,1.2,0.0,740,1140,2540.0
345000.0,2,1.75,1030,1106,2.0,3,7,765,265.0,2006,1030,1066,5910 days 16:47:18.695827,117,1.1428571428571428,2.8867924528301887,0,40,500.0
510000.0,3,2.5,2730,7136,2.0,3,8,2730,0.0,2012,2130,8932,3719 days 16:47:18.695827,057,1.2,0.0,600,-1796,2730.0
432500.0,4,2.5,3172,5033,2.0,3,8,3172,0.0,2014,2704,5232,2988 days 16:47:18.695827,210,1.6,0.0,468,-199,3172.0
650000.0,4,2.5,3160,8530,2.0,3,9,3160,0.0,2006,3160,6460,5910 days 16:47:18.695827,110,1.6,0.0,0,2070,3160.0
750000.0,4,2.5,2850,12429,2.0,3,9,2850,0.0,2008,2540,12000,5180 days 16:47:18.695827,276,1.6,0.0,310,429,2850.0
870000.0,4,3.5,2780,3100,2.0,3,8,2120,660.0,2014,1740,3600,2988 days 16:47:18.695827,117,1.1428571428571428,3.212121212121212,1040,-500,1460.0
900000.0,4,3.5,3860,6543,2.0,3,1,3860,0.0,2014,3760,6888,2988 days 16:47:18.695827,349,1.1428571428571428,0.0,100,-345,3860.0
664950.0,2,1.75,1180,900,2.0,3,1,780,400.0,2014,1380,3610,2988 days 16:47:18.695827,350,1.1428571428571428,1.95,-200,-2710,380.0
391000.0,3,2.25,1410,1290,2.0,3,7,1290,120.0,2004,1490,1380,6641 days 16:47:18.695827,153,1.3333333333333333,10.75,-80,-90,1170.0
1800000.0,4,3.5,6370,205603,2.0,3,1,6370,0.0,2008,1490,33580,5180 days 16:47:18.695827,023,1.1428571428571428,0.0,4880,172023,6370.0
479349.0,5,3.0,3223,6371,2.0,3,9,3223,0.0,2014,1979,9008,2988 days 16:47:18.695827,134,1.6666666666666667,0.0,1244,-2637,3223.0
661000.0,4,3.25,2600,2074,2.0,3,8,2150,450.0,2011,2510,2074,4084 days 16:47:18.695827,357,1.2307692307692308,4.777777777777778,90,0,1700.0
379000.0,3,3.25,1380,1234,3.0,3,8,1380,0.0,2006,1370,1282,5910 days 16:47:18.695827,275,0.9230769230769231,0.0,10,-48,1380.0
415000.0,3,2.25,1620,998,2.5,3,8,1540,80.0,2010,1620,1299,4449 days 16:47:18.695827,125,1.3333333333333333,19.25,0,-301,1460.0
375000.0,3,3.25,1370,1227,3.0,3,8,1370,0.0,2007,1370,1236,5545 days 16:47:18.695827,335,0.9230769230769231,0.0,0,-9,1370.0
355000.0,3,2.0,1220,1186,3.0,3,8,1220,0.0,2007,1280,1251,5545 days 16:47:18.695827,143,1.5,0.0,-60,-65,1220.0
540000.0,3,2.5,1280,1889,3.0,3,8,1280,0.0,2009,1450,1889,4814 days 16:47:18.695827,248,1.2,0.0,-170,0,1280.0
290000.0,2,1.5,770,850,2.0,3,7,770,0.0,2006,1350,915,5910 days 16:47:18.695827,205,1.3333333333333333,0.0,-580,-65,770.0
500000.0,3,2.5,1210,1200,3.0,3,8,1210,0.0,2008,1210,1200,5180 days 16:47:18.695827,140,1.2,0.0,0,0,1210.0
416000.0,4,2.5,2890,6322,2.0,3,8,2890,0.0,2011,2380,5738,4084 days 16:47:18.695827,245,1.6,0.0,510,584,2890.0
349900.0,3,2.5,1580,2765,2.0,3,8,1580,0.0,2011,1580,1820,4084 days 16:47:18.695827,223,1.2,0.0,0,945,1580.0
465000.0,3,2.25,1530,1245,2.0,3,9,1050,480.0,2014,1530,2307,2988 days 16:47:18.695827,156,1.3333333333333333,2.1875,0,-1062,570.0
950000.0,4,2.5,3670,7680,2.5,3,1,3670,0.0,2007,3130,6112,5545 days 16:47:18.695827,181,1.6,0.0,540,1568,3670.0
496800.0,4,2.25,1850,2340,2.5,3,8,1850,0.0,2014,1850,2340,2988 days 16:47:18.695827,085,1.7777777777777777,0.0,0,0,1850.0
680000.0,4,2.5,2440,6581,2.0,3,8,2440,0.0,2014,1480,7432,2988 days 16:47:18.695827,079,1.6,0.0,960,-851,2440.0
920000.0,4,3.25,2190,4265,2.0,3,9,1540,650.0,2015,1730,4265,2623 days 16:47:18.695827,114,1.2307692307692308,2.3692307692307693,460,0,890.0
1290000.0,5,4.0,4360,8030,2.0,3,1,4360,0.0,2015,3570,6185,2623 days 16:47:18.695827,033,1.25,0.0,790,1845,4360.0
825000.0,4,2.75,3990,6637,2.0,3,9,3990,0.0,2003,3500,7074,7006 days 16:47:18.695827,182,1.4545454545454546,0.0,490,-437,3990.0
292000.0,3,2.5,1270,1283,3.0,3,7,1270,0.0,2007,1270,1512,5545 days 16:47:18.695827,275,1.2,0.0,0,-229,1270.0
576000.0,4,2.5,3340,6924,2.0,3,8,3340,0.0,2009,3030,6119,4814 days 16:47:18.695827,099,1.6,0.0,310,805,3340.0
670000.0,2,2.0,1500,761,3.0,3,8,1500,0.0,2008,1360,1527,5180 days 16:47:18.695827,072,1.0,0.0,140,-766,1500.0
953007.0,4,3.5,3120,5086,2.0,3,9,2480,640.0,2008,1880,5092,5180 days 16:47:18.695827,140,1.1428571428571428,3.875,1240,-6,1840.0
399000.0,4,2.5,2480,4334,2.0,3,8,2480,0.0,2012,2480,5632,3719 days 16:47:18.695827,054,1.6,0.0,0,-1298,2480.0
399000.0,2,2.0,1110,1155,3.0,3,7,980,130.0,2008,1110,1089,5180 days 16:47:18.695827,117,1.0,7.538461538461538,0,66,850.0
847093.0,4,2.75,2760,5670,2.0,3,1,2760,0.0,2014,2760,6600,2988 days 16:47:18.695827,321,1.4545454545454546,0.0,0,-930,2760.0
599950.0,3,2.5,1510,1493,3.0,3,8,1510,0.0,2014,1530,1357,2988 days 16:47:18.695827,037,1.2,0.0,-20,136,1510.0
499000.0,3,2.5,1460,1614,2.0,3,8,1180,280.0,2007,1380,1402,5545 days 16:47:18.695827,225,1.2,4.214285714285714,80,212,900.0
760000.0,4,2.75,3980,285318,2.0,3,9,3980,0.0,2006,2100,105415,5910 days 16:47:18.695827,288,1.4545454545454546,0.0,1880,179903,3980.0
1700000.0,4,3.75,3320,8234,2.0,3,1,3320,0.0,2014,1560,8240,2988 days 16:47:18.695827,302,1.0666666666666667,0.0,1760,-6,3320.0
1030000.0,4,3.25,3270,5187,2.0,3,9,3110,160.0,2014,3600,5825,2988 days 16:47:18.695827,132,1.2307692307692308,19.4375,-330,-638,2950.0
515000.0,4,2.5,2670,8765,2.0,3,9,2670,0.0,2006,2880,8765,5910 days 16:47:18.695827,140,1.6,0.0,-210,0,2670.0
355000.0,3,2.25,1410,1332,2.0,3,7,1290,120.0,2004,1445,1290,6641 days 16:47:18.695827,343,1.3333333333333333,10.75,-35,42,1170.0
319900.0,4,2.75,2475,4000,2.0,3,7,2475,0.0,2014,2166,4000,2988 days 16:47:18.695827,217,1.4545454545454546,0.0,309,0,2475.0
460000.0,3,3.5,1600,1431,2.0,3,8,1240,360.0,2006,1500,4120,5910 days 16:47:18.695827,147,0.8571428571428571,3.4444444444444446,100,-2689,880.0
305000.0,2,1.0,1290,3383,2.0,3,7,1290,0.0,2008,1290,2828,5180 days 16:47:18.695827,008,2.0,0.0,0,555,1290.0
280000.0,3,2.5,1608,4818,2.0,3,8,1608,0.0,2012,2009,5200,3719 days 16:47:18.695827,076,1.2,0.0,-401,-382,1608.0
394950.0,2,2.25,1300,2104,2.0,3,8,1010,290.0,2011,1430,1850,4084 days 16:47:18.695827,058,0.8888888888888888,3.4827586206896552,-130,254,720.0
382000.0,4,3.5,2530,3000,2.0,3,8,1850,680.0,2014,1470,6000,2988 days 16:47:18.695827,233,1.1428571428571428,2.7205882352941178,1060,-3000,1170.0
560000.0,3,2.5,1390,1411,3.0,3,8,1390,0.0,2008,1350,1266,5180 days 16:47:18.695827,112,1.2,0.0,40,145,1390.0
772000.0,3,2.25,1640,1204,3.0,3,8,1640,0.0,2014,1630,3136,2988 days 16:47:18.695827,140,1.3333333333333333,0.0,10,-1932,1640.0
324950.0,4,2.5,2229,5723,2.0,3,7,2229,0.0,2012,2738,5742,3719 days 16:47:18.695827,203,1.6,0.0,-509,-19,2229.0
530000.0,3,2.5,1790,3078,2.0,3,8,1790,0.0,2010,1890,3078,4449 days 16:47:18.695827,190,1.2,0.0,-100,0,1790.0
384000.0,3,2.25,990,736,2.5,3,8,880,110.0,2009,1030,1201,4814 days 16:47:18.695827,297,1.3333333333333333,8.0,-40,-465,770.0
719950.0,5,2.75,3240,6863,2.0,3,1,3240,0.0,2013,2360,6002,3353 days 16:47:18.695827,162,1.8181818181818181,0.0,880,861,3240.0
319950.0,2,2.5,1280,819,2.0,3,8,1060,220.0,2006,1290,2900,5910 days 16:47:18.695827,223,0.8,4.818181818181818,-10,-2081,840.0
292000.0,3,2.5,1610,3848,2.0,3,8,1610,0.0,2006,1610,3049,5910 days 16:47:18.695827,028,1.2,0.0,0,799,1610.0
1500000.0,6,3.5,3670,3959,2.0,3,1,2410,1260.0,2008,2060,3625,5180 days 16:47:18.695827,118,1.7142857142857142,1.9126984126984128,1610,334,1150.0
425000.0,2,2.5,1150,1027,3.0,3,8,1150,0.0,2008,1360,1210,5180 days 16:47:18.695827,127,0.8,0.0,-210,-183,1150.0
799950.0,5,3.75,3760,4702,2.0,3,9,2780,980.0,2014,2950,5981,2988 days 16:47:18.695827,283,1.3333333333333333,2.836734693877551,810,-1279,1800.0
499000.0,2,2.5,1320,1157,2.0,3,8,990,330.0,2014,1550,1519,2988 days 16:47:18.695827,237,0.8,3.0,-230,-362,660.0
572000.0,4,2.75,2700,7992,2.0,3,9,2700,0.0,2012,2840,7992,3719 days 16:47:18.695827,086,1.4545454545454546,0.0,-140,0,2700.0
459000.0,2,2.0,1480,804,3.0,3,8,1480,0.0,2008,1380,1751,5180 days 16:47:18.695827,203,1.0,0.0,100,-947,1480.0
529500.0,3,2.25,1410,905,3.0,3,9,1410,0.0,2014,1510,1352,2988 days 16:47:18.695827,077,1.3333333333333333,0.0,-100,-447,1410.0
374500.0,4,2.5,3135,5811,2.0,3,9,3135,0.0,2005,3008,5799,6275 days 16:47:18.695827,252,1.6,0.0,127,12,3135.0
1900000.0,4,4.5,4020,9656,2.0,3,1,4020,0.0,2007,1960,9520,5545 days 16:47:18.695827,015,0.8888888888888888,0.0,2060,136,4020.0
505000.0,2,2.25,1060,1209,2.0,3,8,940,120.0,2006,1300,1169,5910 days 16:47:18.695827,188,0.8888888888888888,7.833333333333333,-240,40,820.0
565000.0,2,2.5,1950,2457,3.0,3,8,1950,0.0,2009,1650,1639,4814 days 16:47:18.695827,318,0.8,0.0,300,818,1950.0
799000.0,4,2.75,3340,5677,2.0,3,9,3340,0.0,2011,3240,5643,4084 days 16:47:18.695827,084,1.4545454545454546,0.0,100,34,3340.0
547000.0,3,2.5,1570,1452,2.5,3,9,1240,330.0,2007,1670,1596,5545 days 16:47:18.695827,119,1.2,3.757575757575758,-100,-144,910.0
550000.0,3,2.5,1930,6604,2.0,3,7,1930,0.0,2014,910,6604,2988 days 16:47:18.695827,058,1.2,0.0,1020,0,1930.0
250000.0,3,2.0,1590,8100,1.0,3,7,1060,530.0,1996,1590,8100,9563 days 16:47:18.695827,261,1.5,2.0,0,0,530.0
960000.0,4,4.5,3720,7746,2.0,3,1,3720,0.0,2014,3080,11067,2988 days 16:47:18.695827,005,0.8888888888888888,0.0,640,-3321,3720.0
2950000.0,4,4.25,4470,5884,2.0,3,1,3230,1240.0,2010,2570,6000,4449 days 16:47:18.695827,303,0.9411764705882353,2.6048387096774195,1900,-116,1990.0
441000.0,2,1.0,1290,1289,2.0,3,7,1030,260.0,2005,1290,1332,6275 days 16:47:18.695827,086,2.0,3.9615384615384617,0,-43,770.0
265000.0,3,2.25,1489,2800,2.0,3,7,1489,0.0,2012,1584,2800,3719 days 16:47:18.695827,097,1.3333333333333333,0.0,-95,0,1489.0
430000.0,3,2.5,2075,39553,1.0,3,7,2075,0.0,2012,1960,9047,3719 days 16:47:18.695827,099,1.2,0.0,115,30506,2075.0
286800.0,3,2.5,1413,3600,2.0,3,8,1413,0.0,2011,2150,3869,4084 days 16:47:18.695827,168,1.2,0.0,-737,-269,1413.0
375000.0,3,2.5,1300,1362,2.0,3,8,880,420.0,2008,1300,1251,5180 days 16:47:18.695827,106,1.2,2.0952380952380953,0,111,460.0
312500.0,3,3.25,1480,983,2.0,3,8,1180,300.0,2013,1330,1062,3353 days 16:47:18.695827,349,0.9230769230769231,3.933333333333333,150,-79,880.0
850000.0,4,2.75,3320,5559,2.0,3,9,3320,0.0,2012,3400,6854,3719 days 16:47:18.695827,007,1.4545454545454546,0.0,-80,-1295,3320.0
390500.0,3,2.25,1530,1279,2.0,3,7,1116,414.0,2007,1320,1427,5545 days 16:47:18.695827,084,1.3333333333333333,2.6956521739130435,210,-148,702.0
455000.0,3,2.5,1180,932,3.0,3,8,1180,0.0,2010,1180,2632,4449 days 16:47:18.695827,302,1.2,0.0,0,-1700,1180.0
455000.0,2,2.0,1190,1303,2.0,3,8,800,390.0,2009,1670,2425,4814 days 16:47:18.695827,096,1.0,2.051282051282051,-480,-1122,410.0
515000.0,3,2.25,1300,1180,3.0,3,8,1300,0.0,2008,1300,1174,5180 days 16:47:18.695827,337,1.3333333333333333,0.0,0,6,1300.0
362500.0,3,3.5,1710,2212,2.0,3,7,1400,310.0,2013,1580,2212,3353 days 16:47:18.695827,091,0.8571428571428571,4.516129032258065,130,0,1090.0
460000.0,3,2.5,2390,47480,2.0,3,9,2390,0.0,2007,1720,44866,5545 days 16:47:18.695827,267,1.2,0.0,670,2614,2390.0
540000.0,4,3.5,3510,6005,2.0,3,8,2750,760.0,2010,3090,5866,4449 days 16:47:18.695827,247,1.1428571428571428,3.6184210526315788,420,139,1990.0
230000.0,3,1.75,1140,1165,2.0,3,8,1140,0.0,2014,1150,1552,2988 days 16:47:18.695827,212,1.7142857142857142,0.0,-10,-387,1140.0
425000.0,2,2.5,1320,1329,2.0,3,8,1180,140.0,2007,1490,5000,5545 days 16:47:18.695827,272,0.8,8.428571428571429,-170,-3671,1040.0
298450.0,5,3.0,2100,9752,1.0,3,8,1200,900.0,2007,1270,10200,5545 days 16:47:18.695827,139,1.6666666666666667,1.3333333333333333,830,-448,300.0
344000.0,4,2.5,2400,4848,2.0,3,8,2400,0.0,2004,1980,5199,6641 days 16:47:18.695827,356,1.6,0.0,420,-351,2400.0
416286.0,3,2.5,1408,989,3.0,3,8,1408,0.0,2005,1408,1342,6275 days 16:47:18.695827,125,1.2,0.0,0,-353,1408.0
379500.0,4,2.5,2560,5102,2.0,3,8,2560,0.0,2013,2586,5059,3353 days 16:47:18.695827,054,1.6,0.0,-26,43,2560.0
350000.0,2,2.5,1260,1347,3.0,3,8,1260,0.0,2005,1260,1356,6275 days 16:47:18.695827,168,0.8,0.0,0,-9,1260.0
258800.0,2,1.75,1290,1624,2.0,3,8,1290,0.0,2014,1410,1963,2988 days 16:47:18.695827,098,1.1428571428571428,0.0,-120,-339,1290.0
620000.0,4,2.5,2730,9260,2.0,3,8,2730,0.0,2008,2730,7357,5180 days 16:47:18.695827,352,1.6,0.0,0,1903,2730.0
295000.0,2,2.5,1630,1368,2.0,3,7,1280,350.0,2009,1590,2306,4814 days 16:47:18.695827,122,0.8,3.657142857142857,40,-938,930.0
908990.0,4,2.75,3530,6844,2.0,3,1,3530,0.0,2014,3530,10038,2988 days 16:47:18.695827,058,1.4545454545454546,0.0,0,-3194,3530.0
485230.0,4,2.5,2714,12558,2.0,3,9,2714,0.0,2014,2873,8269,2988 days 16:47:18.695827,321,1.6,0.0,-159,4289,2714.0
475000.0,3,2.25,1630,2520,2.0,3,7,1630,0.0,2005,1630,3131,6275 days 16:47:18.695827,162,1.3333333333333333,0.0,0,-611,1630.0
1240000.0,5,3.25,5790,13726,2.0,3,1,4430,1360.0,2014,5790,13726,2988 days 16:47:18.695827,216,1.5384615384615385,3.2573529411764706,0,0,3070.0
635000.0,3,3.0,2230,1407,2.5,3,8,1850,380.0,2013,2290,1407,3353 days 16:47:18.695827,231,1.0,4.868421052631579,-60,0,1470.0
350000.0,3,2.5,1380,1590,2.0,3,9,1160,220.0,2012,1380,1590,3719 days 16:47:18.695827,309,1.2,5.2727272727272725,0,0,940.0
345000.0,3,3.5,1320,1161,3.0,3,8,1320,0.0,2010,1320,1161,4449 days 16:47:18.695827,363,0.8571428571428571,0.0,0,0,1320.0
700000.0,2,2.0,1490,713,3.0,3,9,1490,0.0,2014,1490,1110,2988 days 16:47:18.695827,264,1.0,0.0,0,-397,1490.0
490000.0,3,2.25,1280,1520,2.0,3,8,1080,200.0,2008,1280,1681,5180 days 16:47:18.695827,233,1.3333333333333333,5.4,0,-161,880.0
552500.0,3,1.5,1300,1435,2.0,3,8,1120,180.0,2007,1320,1652,5545 days 16:47:18.695827,086,2.0,6.222222222222222,-20,-217,940.0
467000.0,4,2.75,2170,5024,2.0,3,8,2170,0.0,2012,2460,5024,3719 days 16:47:18.695827,035,1.4545454545454546,0.0,-290,0,2170.0
305000.0,4,2.25,1763,3717,2.0,3,8,1763,0.0,2012,1763,3666,3719 days 16:47:18.695827,317,1.7777777777777777,0.0,0,51,1763.0
212000.0,2,1.5,1020,1525,2.0,3,7,1020,0.0,2004,1020,3844,6641 days 16:47:18.695827,129,1.3333333333333333,0.0,0,-2319,1020.0
429000.0,4,2.5,1840,4593,2.0,3,7,1840,0.0,2010,1740,3600,4449 days 16:47:18.695827,233,1.6,0.0,100,993,1840.0
479950.0,3,2.0,1820,1358,3.0,3,9,1820,0.0,2014,1710,1367,2988 days 16:47:18.695827,268,1.5,0.0,110,-9,1820.0
825000.0,3,3.5,2670,3000,2.0,3,9,1870,800.0,2014,1750,5000,2988 days 16:47:18.695827,352,0.8571428571428571,2.3375,920,-2000,1070.0
1180000.0,6,6.5,6260,10955,2.0,3,1,4840,1420.0,2007,2710,12550,5545 days 16:47:18.695827,087,0.9230769230769231,3.408450704225352,3550,-1595,3420.0
250000.0,3,2.25,1400,3814,2.0,3,7,1400,0.0,2012,1610,3814,3719 days 16:47:18.695827,164,1.3333333333333333,0.0,-210,0,1400.0
289000.0,2,1.5,1160,2158,2.0,3,7,1160,0.0,1982,1150,2158,14676 days 16:47:18.695827,300,1.3333333333333333,0.0,10,0,1160.0
265000.0,3,2.5,1400,3368,2.0,3,7,1400,0.0,2013,1400,4316,3353 days 16:47:18.695827,275,1.2,0.0,0,-948,1400.0
344000.0,3,2.5,1232,1130,3.0,3,7,1232,0.0,2007,1232,1202,5545 days 16:47:18.695827,135,1.2,0.0,0,-72,1232.0
749000.0,4,2.75,2700,6000,2.0,4,8,2100,600.0,1910,2050,5400,40974 days 16:47:18.695827,190,1.4545454545454546,3.5,650,600,1500.0
492000.0,4,2.5,2550,6382,2.0,3,7,2550,0.0,2007,2430,5900,5545 days 16:47:18.695827,251,1.6,0.0,120,482,2550.0
552500.0,4,2.5,3260,6902,2.0,3,8,3260,0.0,2008,3130,6588,5180 days 16:47:18.695827,019,1.6,0.0,130,314,3260.0
653500.0,2,2.5,1680,1240,2.0,3,8,1120,560.0,2014,2060,3630,2988 days 16:47:18.695827,316,0.8,2.0,-380,-2390,560.0
855000.0,4,3.25,2630,2550,2.0,3,1,2030,600.0,2006,1810,2600,5910 days 16:47:18.695827,092,1.2307692307692308,3.3833333333333333,820,-50,1430.0
333000.0,3,1.5,1260,5758,2.0,3,7,1260,0.0,1999,3090,10142,8467 days 16:47:18.695827,323,2.0,0.0,-1830,-4384,1260.0
415000.0,4,2.5,2550,4500,2.0,3,7,2550,0.0,2009,2340,4526,4814 days 16:47:18.695827,162,1.6,0.0,210,-26,2550.0
445000.0,4,3.25,3450,5000,2.0,3,8,3450,0.0,2008,1420,5000,5180 days 16:47:18.695827,311,1.2307692307692308,0.0,2030,0,3450.0
273500.0,3,2.5,1550,3402,2.0,3,7,1550,0.0,2009,2095,3402,4814 days 16:47:18.695827,191,1.2,0.0,-545,0,1550.0
969990.0,4,2.5,4150,8436,2.0,3,1,4150,0.0,2014,4070,8438,2988 days 16:47:18.695827,157,1.6,0.0,80,-2,4150.0
1200000.0,5,3.5,3900,4400,2.0,3,9,2650,1250.0,2014,1190,4400,2988 days 16:47:18.695827,281,1.4285714285714286,2.12,2710,0,1400.0
430000.0,3,3.25,1550,1444,3.0,3,8,1550,0.0,2006,1550,1444,5910 days 16:47:18.695827,218,0.9230769230769231,0.0,0,0,1550.0
392000.0,4,2.5,2130,4000,2.0,3,8,2130,0.0,2014,1830,7217,2988 days 16:47:18.695827,082,1.6,0.0,300,-3217,2130.0
795000.0,4,2.5,2890,7798,2.0,3,9,2890,0.0,2005,3300,30950,6275 days 16:47:18.695827,183,1.6,0.0,-410,-23152,2890.0
457000.0,3,2.5,1220,1330,2.0,3,8,1010,210.0,2008,1360,3750,5180 days 16:47:18.695827,181,1.2,4.809523809523809,-140,-2420,800.0
453000.0,4,2.5,2502,8306,2.0,3,9,2502,0.0,2013,2597,6983,3353 days 16:47:18.695827,079,1.6,0.0,-95,1323,2502.0
376000.0,3,2.0,1340,1384,3.0,3,8,1340,0.0,2008,1110,1384,5180 days 16:47:18.695827,129,1.5,0.0,230,0,1340.0
469995.0,4,2.5,2350,3800,2.0,3,8,2350,0.0,2014,2670,4180,2988 days 16:47:18.695827,216,1.6,0.0,-320,-380,2350.0
540000.0,3,2.5,1810,3930,2.0,3,8,1810,0.0,2008,1560,5100,5180 days 16:47:18.695827,124,1.2,0.0,250,-1170,1810.0
555000.0,4,2.5,3310,6500,2.0,3,8,3310,0.0,2012,2380,5000,3719 days 16:47:18.695827,122,1.6,0.0,930,1500,3310.0
445000.0,3,2.0,1620,5101,1.0,3,7,590,1030.0,2006,1700,7750,5910 days 16:47:18.695827,206,1.5,0.5728155339805825,-80,-2649,-440.0
256950.0,2,2.0,1070,635,2.0,3,9,720,350.0,2008,1070,928,5180 days 16:47:18.695827,349,1.0,2.057142857142857,0,-293,370.0
297000.0,4,2.5,2230,4952,2.0,3,8,2230,0.0,2011,2030,3721,4084 days 16:47:18.695827,279,1.6,0.0,200,1231,2230.0
320000.0,4,2.5,1970,4558,2.0,3,8,1970,0.0,2005,1980,5123,6275 days 16:47:18.695827,290,1.6,0.0,-10,-565,1970.0
805000.0,5,4.5,4600,7810,2.0,3,9,3200,1400.0,2006,4480,6324,5910 days 16:47:18.695827,318,1.1111111111111112,2.2857142857142856,120,1486,1800.0
799990.0,4,2.75,3110,6050,2.0,3,9,3110,0.0,2014,3590,6054,2988 days 16:47:18.695827,213,1.4545454545454546,0.0,-480,-4,3110.0
680000.0,4,2.5,3490,3677,2.0,3,9,2850,640.0,2007,3440,3600,5545 days 16:47:18.695827,099,1.6,4.453125,50,77,2210.0
395000.0,3,2.5,1600,1936,2.0,3,7,1600,0.0,2007,1600,1936,5545 days 16:47:18.695827,175,1.2,0.0,0,0,1600.0
732000.0,3,2.5,1960,3060,2.0,3,8,1960,0.0,2010,1220,3060,4449 days 16:47:18.695827,336,1.2,0.0,740,0,1960.0
163800.0,2,2.5,1000,1092,2.0,3,7,990,10.0,2004,1330,1466,6641 days 16:47:18.695827,214,0.8,99.0,-330,-374,980.0
220000.0,2,2.5,1000,1092,2.0,3,7,990,10.0,2004,1330,1466,6641 days 16:47:18.695827,335,0.8,99.0,-330,-374,980.0
308625.0,2,2.0,1500,1408,3.0,3,7,1500,0.0,1999,1500,1245,8467 days 16:47:18.695827,310,1.0,0.0,0,163,1500.0
375000.0,3,2.5,2424,5931,2.0,3,9,2424,0.0,2014,2424,6036,2988 days 16:47:18.695827,090,1.2,0.0,0,-105,2424.0
300000.0,4,2.5,2303,3826,2.0,3,8,2303,0.0,2006,2516,4500,5910 days 16:47:18.695827,182,1.6,0.0,-213,-674,2303.0
284000.0,3,2.5,1880,6008,2.0,3,7,1880,0.0,2009,2180,5185,4814 days 16:47:18.695827,167,1.2,0.0,-300,823,1880.0
610000.0,2,2.0,1210,740,2.0,3,8,780,430.0,2014,1480,1171,2988 days 16:47:18.695827,051,1.0,1.813953488372093,-270,-431,350.0
955000.0,4,3.25,3720,6765,2.0,3,9,3720,0.0,2012,3100,6790,3719 days 16:47:18.695827,083,1.2307692307692308,0.0,620,-25,3720.0
982000.0,4,2.75,3610,8580,2.0,3,9,3610,0.0,2014,2360,8580,2988 days 16:47:18.695827,178,1.4545454545454546,0.0,1250,0,3610.0
359000.0,3,1.5,1360,885,3.0,3,8,1360,0.0,2008,1360,1167,5180 days 16:47:18.695827,142,2.0,0.0,0,-282,1360.0
779380.0,5,2.5,2590,7084,2.0,3,8,2590,0.0,2014,3010,4823,2988 days 16:47:18.695827,199,2.0,0.0,-420,2261,2590.0
1510000.0,5,3.25,4390,11250,2.0,3,1,4390,0.0,2007,2160,9249,5545 days 16:47:18.695827,181,1.5384615384615385,0.0,2230,2001,4390.0
635000.0,3,3.0,2290,1407,2.5,3,8,1890,400.0,2014,2230,1407,2988 days 16:47:18.695827,054,1.0,4.725,60,0,1490.0
1060000.0,4,3.75,3880,9979,2.5,3,1,3880,0.0,2007,3130,6112,5545 days 16:47:18.695827,238,1.0666666666666667,0.0,750,3867,3880.0
389500.0,3,2.5,1350,874,3.0,3,8,1270,80.0,2006,1350,886,5910 days 16:47:18.695827,197,1.2,15.875,0,-12,1190.0
359800.0,5,2.5,2170,2752,2.0,3,8,2170,0.0,2014,1800,2752,2988 days 16:47:18.695827,219,2.0,0.0,370,0,2170.0
399950.0,3,3.0,1296,1051,3.0,3,8,1296,0.0,2009,1520,1939,4814 days 16:47:18.695827,147,1.0,0.0,-224,-888,1296.0
320000.0,3,3.25,1530,1602,2.0,3,8,1140,390.0,2013,1450,1198,3353 days 16:47:18.695827,154,0.9230769230769231,2.923076923076923,80,404,750.0
255900.0,3,2.5,1489,3266,2.0,3,7,1489,0.0,2014,1537,3273,2988 days 16:47:18.695827,206,1.2,0.0,-48,-7,1489.0
380000.0,4,2.5,2130,4467,2.0,3,8,2130,0.0,2014,1830,8160,2988 days 16:47:18.695827,040,1.6,0.0,300,-3693,2130.0
580000.0,3,2.75,1430,1521,2.0,3,9,1130,300.0,2009,1930,2700,4814 days 16:47:18.695827,261,1.0909090909090908,3.7666666666666666,-500,-1179,830.0
545000.0,5,3.75,2380,7268,1.0,3,8,1430,950.0,2008,2040,10810,5180 days 16:47:18.695827,119,1.3333333333333333,1.5052631578947369,340,-3542,480.0
451300.0,3,2.5,1420,814,2.0,3,8,1140,280.0,2008,1340,1382,5180 days 16:47:18.695827,206,1.2,4.071428571428571,80,-568,860.0
852880.0,4,3.25,3450,6184,2.0,3,9,3450,0.0,2014,3020,5369,2988 days 16:47:18.695827,167,1.2307692307692308,0.0,430,815,3450.0
305000.0,4,2.5,1914,3150,2.0,3,8,1914,0.0,2009,1714,3164,4814 days 16:47:18.695827,262,1.6,0.0,200,-14,1914.0
295000.0,2,1.5,988,1080,3.0,3,7,988,0.0,2007,1128,1080,5545 days 16:47:18.695827,120,1.3333333333333333,0.0,-140,0,988.0
261000.0,3,2.25,1584,2800,2.0,3,7,1584,0.0,2012,1584,2800,3719 days 16:47:18.695827,289,1.3333333333333333,0.0,0,0,1584.0
560000.0,4,2.5,2630,5710,2.0,3,8,2630,0.0,2001,2550,5500,7736 days 16:47:18.695827,076,1.6,0.0,80,210,2630.0
795000.0,4,3.25,3520,5250,2.0,3,9,3520,0.0,2012,3220,5781,3719 days 16:47:18.695827,262,1.2307692307692308,0.0,300,-531,3520.0
384950.0,4,2.5,2380,4913,2.0,3,8,2380,0.0,2006,2580,5311,5910 days 16:47:18.695827,272,1.6,0.0,-200,-398,2380.0
500000.0,3,1.75,1410,1197,3.0,3,8,1410,0.0,2012,1350,2512,3719 days 16:47:18.695827,128,1.7142857142857142,0.0,60,-1315,1410.0
640000.0,4,3.5,3220,5741,2.0,3,9,3220,0.0,2013,2960,6534,3353 days 16:47:18.695827,036,1.1428571428571428,0.0,260,-793,3220.0
418000.0,4,3.25,3266,5969,2.0,3,8,3266,0.0,2014,3087,5169,2988 days 16:47:18.695827,325,1.2307692307692308,0.0,179,800,3266.0
799000.0,3,2.0,2550,4794,2.0,3,9,2550,0.0,2007,1630,5100,5545 days 16:47:18.695827,283,1.5,0.0,920,-306,2550.0
552900.0,4,3.5,3828,18900,2.5,3,9,3828,0.0,2014,2120,18900,2988 days 16:47:18.695827,079,1.1428571428571428,0.0,1708,0,3828.0
539950.0,3,2.25,1670,1596,3.0,3,8,1670,0.0,2014,1640,1310,2988 days 16:47:18.695827,353,1.3333333333333333,0.0,30,286,1670.0
524225.0,4,2.5,3056,11385,2.0,3,9,3056,0.0,2014,2849,8607,2988 days 16:47:18.695827,020,1.6,0.0,207,2778,3056.0
424950.0,2,1.5,1000,1188,3.0,3,8,1000,0.0,2005,2300,3500,6275 days 16:47:18.695827,033,1.3333333333333333,0.0,-1300,-2312,1000.0
560000.0,3,3.25,1530,1786,2.0,3,8,1200,330.0,2007,1390,2900,5545 days 16:47:18.695827,329,0.9230769230769231,3.6363636363636362,140,-1114,870.0
715000.0,5,3.0,3490,6091,2.0,3,9,3490,0.0,2009,2870,5932,4814 days 16:47:18.695827,119,1.6666666666666667,0.0,620,159,3490.0
300000.0,5,2.5,2760,6000,2.0,3,8,2760,0.0,2006,1360,6000,5910 days 16:47:18.695827,142,2.0,0.0,1400,0,2760.0
405000.0,3,2.5,1440,2163,2.0,3,7,1440,0.0,2005,1440,2207,6275 days 16:47:18.695827,055,1.2,0.0,0,-44,1440.0
327000.0,3,3.0,1370,1001,3.0,3,8,1370,0.0,2009,1399,1151,4814 days 16:47:18.695827,280,1.0,0.0,-29,-150,1370.0
859950.0,6,4.0,3180,6551,2.0,3,9,3180,0.0,2014,3230,7602,2988 days 16:47:18.695827,343,1.5,0.0,-50,-1051,3180.0
560000.0,4,3.0,2720,7570,2.0,3,9,2720,0.0,2008,1770,5705,5180 days 16:47:18.695827,013,1.3333333333333333,0.0,950,1865,2720.0
379900.0,3,2.5,1800,2792,2.0,3,8,1800,0.0,2011,1580,2617,4084 days 16:47:18.695827,250,1.2,0.0,220,175,1800.0
625000.0,3,2.5,3220,6409,2.0,3,9,3220,0.0,2008,3330,6231,5180 days 16:47:18.695827,121,1.2,0.0,-110,178,3220.0
398096.0,3,2.5,2370,5321,2.0,3,8,2370,0.0,2014,2370,4357,2988 days 16:47:18.695827,113,1.2,0.0,0,964,2370.0
315000.0,3,2.5,1410,1325,2.0,3,7,1180,230.0,2007,1270,1282,5545 days 16:47:18.695827,324,1.2,5.130434782608695,140,43,950.0
939000.0,4,3.5,3640,6049,2.0,3,9,3640,0.0,2014,3590,6104,2988 days 16:47:18.695827,346,1.1428571428571428,0.0,50,-55,3640.0
674000.0,3,2.5,1920,3624,2.0,3,9,1920,0.0,2003,1930,3533,7006 days 16:47:18.695827,206,1.2,0.0,-10,91,1920.0
306000.0,4,2.5,2267,3577,2.0,3,7,2267,0.0,2014,2056,3577,2988 days 16:47:18.695827,226,1.6,0.0,211,0,2267.0
2320000.0,5,4.75,5780,17004,2.0,3,1,4260,1520.0,2006,3460,10855,5910 days 16:47:18.695827,190,1.0526315789473684,2.8026315789473686,2320,6149,2740.0
394950.0,2,1.0,1131,1304,3.0,3,7,1131,0.0,2011,1131,1992,4084 days 16:47:18.695827,033,2.0,0.0,0,-688,1131.0
914154.0,3,3.5,2940,6431,2.0,3,1,2940,0.0,2014,2760,6695,2988 days 16:47:18.695827,261,0.8571428571428571,0.0,180,-264,2940.0
496000.0,3,2.5,2180,4533,2.0,3,7,2180,0.0,2010,2180,7347,4449 days 16:47:18.695827,321,1.2,0.0,0,-2814,2180.0
430100.0,3,2.25,1400,1078,2.0,3,8,940,460.0,2009,1420,1230,4814 days 16:47:18.695827,107,1.3333333333333333,2.0434782608695654,-20,-152,480.0
449990.0,4,2.5,2680,5539,2.0,3,8,2680,0.0,2013,2680,5992,3353 days 16:47:18.695827,189,1.6,0.0,0,-453,2680.0
502000.0,4,2.5,2680,5539,2.0,3,8,2680,0.0,2013,2680,5992,3353 days 16:47:18.695827,089,1.6,0.0,0,-453,2680.0
310000.0,3,2.5,1300,3612,2.0,3,7,1300,0.0,2005,1390,2943,6275 days 16:47:18.695827,070,1.2,0.0,-90,669,1300.0
349950.0,4,3.5,2796,3520,2.5,3,8,2796,0.0,2013,2040,5195,3353 days 16:47:18.695827,082,1.1428571428571428,0.0,756,-1675,2796.0
625000.0,2,1.75,1460,1500,2.0,3,8,1000,460.0,2008,1440,4120,5180 days 16:47:18.695827,262,1.1428571428571428,2.1739130434782608,20,-2620,540.0
1050000.0,4,3.5,4210,6481,2.0,3,9,3260,950.0,2014,3920,5331,2988 days 16:47:18.695827,239,1.1428571428571428,3.431578947368421,290,1150,2310.0
680000.0,4,2.75,2330,3920,2.0,3,9,2330,0.0,2005,2410,4063,6275 days 16:47:18.695827,188,1.4545454545454546,0.0,-80,-143,2330.0
828950.0,4,3.5,3930,5680,2.0,3,9,2820,1110.0,2013,3700,5816,3353 days 16:47:18.695827,135,1.1428571428571428,2.5405405405405403,230,-136,1710.0
274950.0,3,2.5,1608,4000,2.0,3,8,1608,0.0,2014,2009,4983,2988 days 16:47:18.695827,093,1.2,0.0,-401,-983,1608.0
293000.0,2,2.25,1610,1968,2.0,4,7,1610,0.0,1979,1950,1968,15772 days 16:47:18.695827,071,0.8888888888888888,0.0,-340,0,1610.0
795000.0,4,3.5,3200,3250,2.0,3,9,2670,530.0,2007,3400,3663,5545 days 16:47:18.695827,164,1.1428571428571428,5.037735849056604,-200,-413,2140.0
282900.0,4,2.5,1710,3500,2.0,3,7,1710,0.0,2014,1710,3500,2988 days 16:47:18.695827,265,1.6,0.0,0,0,1710.0
909950.0,5,3.75,3050,8972,2.0,3,9,3050,0.0,2014,2750,8979,2988 days 16:47:18.695827,106,1.3333333333333333,0.0,300,-7,3050.0
922755.0,4,3.5,3560,4951,2.0,3,9,3560,0.0,2014,3540,5500,2988 days 16:47:18.695827,308,1.1428571428571428,0.0,20,-549,3560.0
424000.0,4,2.5,2650,8685,2.0,3,9,2650,0.0,2006,2650,7932,5910 days 16:47:18.695827,106,1.6,0.0,0,753,2650.0
630000.0,3,2.5,3490,12410,2.0,3,8,2590,900.0,2009,1740,14448,4814 days 16:47:18.695827,113,1.2,2.8777777777777778,1750,-2038,1690.0
810000.0,4,3.25,4140,46173,2.0,3,9,4140,0.0,2007,2060,43103,5545 days 16:47:18.695827,356,1.2307692307692308,0.0,2080,3070,4140.0
256703.0,3,2.0,1670,4441,1.0,3,7,1670,0.0,2014,1670,4622,2988 days 16:47:18.695827,211,1.5,0.0,0,-181,1670.0
386380.0,3,2.5,1720,3600,2.0,3,7,1720,0.0,2010,1720,3600,4449 days 16:47:18.695827,135,1.2,0.0,0,0,1720.0
485000.0,2,2.0,1510,3961,1.0,3,8,1510,0.0,2010,1510,3962,4449 days 16:47:18.695827,259,1.0,0.0,0,-1,1510.0
275000.0,3,2.25,1450,4040,2.0,3,7,1450,0.0,2010,1610,4040,4449 days 16:47:18.695827,042,1.3333333333333333,0.0,-160,0,1450.0
370000.0,4,2.5,1812,5026,2.0,3,8,1812,0.0,2011,2440,6007,4084 days 16:47:18.695827,061,1.6,0.0,-628,-981,1812.0
499950.0,2,2.25,1060,1208,2.0,3,8,940,120.0,2005,1300,1169,6275 days 16:47:18.695827,161,0.8888888888888888,7.833333333333333,-240,39,820.0
654000.0,3,3.25,1530,1565,2.0,3,8,1280,250.0,2005,1530,1381,6275 days 16:47:18.695827,171,0.9230769230769231,5.12,0,184,1030.0
575000.0,4,2.25,2070,1230,3.0,3,9,1500,570.0,2013,1569,4802,3353 days 16:47:18.695827,195,1.7777777777777777,2.6315789473684212,501,-3572,930.0
500000.0,4,2.5,3630,7482,2.0,3,1,3630,0.0,2008,1600,15716,5180 days 16:47:18.695827,105,1.6,0.0,2030,-8234,3630.0
554000.0,3,2.5,2140,4126,2.0,3,8,1960,180.0,2005,2280,2615,6275 days 16:47:18.695827,014,1.2,10.88888888888889,-140,1511,1780.0
360000.0,4,1.75,2010,12188,1.0,4,7,1150,860.0,1960,1720,8475,22712 days 16:47:18.695827,128,2.2857142857142856,1.3372093023255813,290,3713,290.0
619990.0,4,2.75,2630,4501,2.0,3,8,2630,0.0,2015,2380,4599,2623 days 16:47:18.695827,119,1.4545454545454546,0.0,250,-98,2630.0
317500.0,4,2.5,2233,6025,2.0,3,7,2233,0.0,2012,1544,6036,3719 days 16:47:18.695827,071,1.6,0.0,689,-11,2233.0
564950.0,4,2.75,2990,4521,2.0,3,7,2990,0.0,2014,2580,7539,2988 days 16:47:18.695827,240,1.4545454545454546,0.0,410,-3018,2990.0
545000.0,2,1.25,1240,2150,2.0,3,8,1240,0.0,2014,1340,5289,2988 days 16:47:18.695827,162,1.6,0.0,-100,-3139,1240.0
333700.0,3,2.5,2230,5050,2.0,3,7,2230,0.0,2006,2260,5050,5910 days 16:47:18.695827,121,1.2,0.0,-30,0,2230.0
1480000.0,3,3.25,3700,2264,2.0,3,1,2280,1420.0,1998,3930,2567,8832 days 16:47:18.695827,192,0.9230769230769231,1.6056338028169015,-230,-303,860.0
530000.0,4,3.0,2290,5105,2.0,3,8,2290,0.0,2012,2450,5105,3719 days 16:47:18.695827,098,1.3333333333333333,0.0,-160,0,2290.0
396000.0,2,1.5,950,865,3.0,3,8,950,0.0,2006,1290,1189,5910 days 16:47:18.695827,103,1.3333333333333333,0.0,-340,-324,950.0
305000.0,2,1.75,1120,758,2.0,3,7,1120,0.0,2012,1150,758,3719 days 16:47:18.695827,289,1.1428571428571428,0.0,-30,0,1120.0
380000.0,5,3.5,2420,4670,2.0,3,7,2420,0.0,2013,1430,4468,3353 days 16:47:18.695827,142,1.4285714285714286,0.0,990,202,2420.0
305000.0,4,2.5,1714,3250,2.0,3,8,1714,0.0,2010,1714,3250,4449 days 16:47:18.695827,062,1.6,0.0,0,0,1714.0
440000.0,4,2.5,2230,5650,2.0,3,7,2230,0.0,2011,1590,7241,4084 days 16:47:18.695827,271,1.6,0.0,640,-1591,2230.0
459000.0,4,3.0,2530,10000,2.0,3,7,2530,0.0,2013,1420,9898,3353 days 16:47:18.695827,178,1.3333333333333333,0.0,1110,102,2530.0
530000.0,3,3.5,1550,1233,2.0,3,8,1160,390.0,2005,1490,1539,6275 days 16:47:18.695827,065,0.8571428571428571,2.9743589743589745,60,-306,770.0
600000.0,4,2.75,3110,11225,2.0,3,8,3110,0.0,2012,2610,8535,3719 days 16:47:18.695827,106,1.4545454545454546,0.0,500,2690,3110.0
515000.0,3,3.0,2100,2409,2.0,3,8,1660,440.0,2008,1900,2400,5180 days 16:47:18.695827,199,1.0,3.772727272727273,200,9,1220.0
275000.0,4,2.5,2150,3721,2.0,3,8,2150,0.0,2007,2150,3721,5545 days 16:47:18.695827,098,1.6,0.0,0,0,2150.0
540000.0,3,1.75,1630,1404,2.0,3,8,1020,610.0,2014,1420,1670,2988 days 16:47:18.695827,012,1.7142857142857142,1.6721311475409837,210,-266,410.0
445000.0,3,2.5,2230,7934,2.0,3,7,2230,0.0,2005,2310,4818,6275 days 16:47:18.695827,217,1.2,0.0,-80,3116,2230.0
285000.0,3,2.5,1320,955,3.0,3,7,1320,0.0,2009,1300,1003,4814 days 16:47:18.695827,097,1.2,0.0,20,-48,1320.0
440000.0,5,3.25,2610,3642,2.0,3,8,2080,530.0,2005,1750,3118,6275 days 16:47:18.695827,020,1.5384615384615385,3.9245283018867925,860,524,1550.0
287450.0,3,2.5,1440,2500,2.0,3,7,1440,0.0,2008,1440,5000,5180 days 16:47:18.695827,042,1.2,0.0,0,-2500,1440.0
507950.0,4,2.5,2630,6283,2.0,3,9,2630,0.0,2006,2630,7210,5910 days 16:47:18.695827,091,1.6,0.0,0,-927,2630.0
750000.0,3,3.5,3390,10078,2.0,3,1,3040,350.0,2012,3290,12332,3719 days 16:47:18.695827,170,0.8571428571428571,8.685714285714285,100,-2254,2690.0
425000.0,3,1.5,1400,1022,3.0,3,8,1400,0.0,2007,1270,1205,5545 days 16:47:18.695827,184,2.0,0.0,130,-183,1400.0
420000.0,3,3.5,1900,2133,2.0,3,8,1520,380.0,2009,1530,3264,4814 days 16:47:18.695827,336,0.8571428571428571,4.0,370,-1131,1140.0
394950.0,3,2.5,1350,1250,3.0,3,8,1270,80.0,2006,1350,886,5910 days 16:47:18.695827,130,1.2,15.875,0,364,1190.0
635000.0,4,3.25,3420,6752,2.0,3,9,3030,390.0,2012,3010,5172,3719 days 16:47:18.695827,192,1.2307692307692308,7.769230769230769,410,1580,2640.0
513000.0,3,2.5,2150,161607,2.0,3,7,1330,820.0,1995,2400,207781,9928 days 16:47:18.695827,126,1.2,1.6219512195121952,-250,-46174,510.0
380000.0,4,2.5,2110,5306,2.0,3,8,2110,0.0,2012,2250,5306,3719 days 16:47:18.695827,125,1.6,0.0,-140,0,2110.0
1130000.0,4,3.25,3810,8519,1.0,3,1,2680,1130.0,2007,3240,10748,5545 days 16:47:18.695827,141,1.2307692307692308,2.3716814159292037,570,-2229,1550.0
540000.0,5,3.0,2870,4369,2.0,3,8,2090,780.0,2007,2640,4610,5545 days 16:47:18.695827,159,1.6666666666666667,2.6794871794871793,230,-241,1310.0
352499.0,2,2.25,1240,705,2.0,3,7,1150,90.0,2009,1240,750,4814 days 16:47:18.695827,117,0.8888888888888888,12.777777777777779,0,-45,1060.0
603000.0,4,3.5,3610,6345,2.0,3,9,2370,1240.0,2008,3010,29279,5180 days 16:47:18.695827,125,1.1428571428571428,1.9112903225806452,600,-22934,1130.0
685000.0,4,2.5,2310,5100,2.0,3,9,2310,0.0,2013,1260,5100,3353 days 16:47:18.695827,150,1.6,0.0,1050,0,2310.0
330675.0,4,3.0,1930,3031,1.0,3,7,1200,730.0,2006,1930,2611,5910 days 16:47:18.695827,177,1.3333333333333333,1.643835616438356,0,420,470.0
275000.0,3,3.0,1390,1080,2.0,3,7,1140,250.0,2006,1450,1081,5910 days 16:47:18.695827,156,1.0,4.56,-60,-1,890.0
259950.0,3,2.5,1578,7340,2.0,3,7,1578,0.0,2010,1850,7200,4449 days 16:47:18.695827,197,1.2,0.0,-272,140,1578.0
441000.0,3,2.0,1720,15000,1.0,3,9,1720,0.0,2011,1900,15337,4084 days 16:47:18.695827,210,1.5,0.0,-180,-337,1720.0
1140000.0,5,3.75,4700,11237,2.0,3,1,2930,1770.0,2006,3180,13140,5910 days 16:47:18.695827,337,1.3333333333333333,1.655367231638418,1520,-1903,1160.0
590000.0,3,3.5,1970,5079,2.0,3,8,1680,290.0,2007,1940,6000,5545 days 16:47:18.695827,339,0.8571428571428571,5.793103448275862,30,-921,1390.0
497000.0,3,2.25,1460,1353,2.0,3,8,1050,410.0,2012,1690,3776,3719 days 16:47:18.695827,261,1.3333333333333333,2.5609756097560976,-230,-2423,640.0
345500.0,3,2.5,1930,4000,2.0,3,8,1930,0.0,2014,2050,4000,2988 days 16:47:18.695827,325,1.2,0.0,-120,0,1930.0
562500.0,3,2.25,1300,907,2.0,3,8,1000,300.0,2006,1300,1169,5910 days 16:47:18.695827,174,1.3333333333333333,3.3333333333333335,0,-262,700.0
355000.0,3,2.25,1445,1087,2.0,3,7,1300,145.0,2005,1410,1336,6275 days 16:47:18.695827,247,1.3333333333333333,8.96551724137931,35,-249,1155.0
345000.0,2,2.25,860,696,2.0,3,9,860,0.0,2009,1100,3000,4814 days 16:47:18.695827,248,0.8888888888888888,0.0,-240,-2304,860.0
478000.0,3,2.5,3040,4535,2.0,3,9,3040,0.0,2007,2670,4666,5545 days 16:47:18.695827,125,1.2,0.0,370,-131,3040.0
391500.0,3,2.5,2424,6143,2.0,3,9,2424,0.0,2014,2381,6036,2988 days 16:47:18.695827,092,1.2,0.0,43,107,2424.0
265000.0,2,1.5,1084,3427,2.0,3,7,1084,0.0,1976,1084,6250,16868 days 16:47:18.695827,102,1.3333333333333333,0.0,0,-2823,1084.0
395000.0,3,2.5,2510,5320,2.0,3,8,2510,0.0,2005,1820,5736,6275 days 16:47:18.695827,303,1.2,0.0,690,-416,2510.0
286308.0,2,1.5,1220,1036,3.0,3,7,1220,0.0,2006,1210,659,5910 days 16:47:18.695827,208,1.3333333333333333,0.0,10,377,1220.0
370000.0,2,2.25,1280,835,2.0,3,7,1080,200.0,2009,1280,1246,4814 days 16:47:18.695827,147,0.8888888888888888,5.4,0,-411,880.0
1080000.0,5,3.5,3740,5610,2.0,3,9,2860,880.0,2014,1520,4590,2988 days 16:47:18.695827,266,1.4285714285714286,3.25,2220,1020,1980.0
298900.0,3,2.5,1852,4000,2.0,3,7,1852,0.0,2014,2475,4000,2988 days 16:47:18.695827,288,1.2,0.0,-623,0,1852.0
775000.0,4,2.5,2580,5787,2.0,3,9,2580,0.0,2007,2580,4410,5545 days 16:47:18.695827,111,1.6,0.0,0,1377,2580.0
790000.0,4,3.5,3190,31450,2.0,3,9,3190,0.0,2010,3000,72745,4449 days 16:47:18.695827,175,1.1428571428571428,0.0,190,-41295,3190.0
1050000.0,3,2.5,3400,5119,2.0,3,8,2300,1100.0,2014,1740,5969,2988 days 16:47:18.695827,239,1.2,2.090909090909091,1660,-850,1200.0
249000.0,2,1.5,1090,2686,2.0,3,7,1090,0.0,1982,1160,2158,14676 days 16:47:18.695827,189,1.3333333333333333,0.0,-70,528,1090.0
358000.0,5,2.5,2460,5604,2.0,3,8,2460,0.0,2011,2210,6395,4084 days 16:47:18.695827,318,2.0,0.0,250,-791,2460.0
260000.0,5,2.5,2025,7760,2.0,3,7,2025,0.0,2007,1664,9000,5545 days 16:47:18.695827,176,2.0,0.0,361,-1240,2025.0
765000.0,4,3.0,4410,5104,2.0,3,9,3400,1010.0,2006,4390,5537,5910 days 16:47:18.695827,155,1.3333333333333333,3.366336633663366,20,-433,2390.0
739000.0,3,2.5,2810,5400,2.0,3,9,2810,0.0,2005,2870,5400,6275 days 16:47:18.695827,148,1.2,0.0,-60,0,2810.0
890000.0,5,3.5,4490,6000,2.0,3,1,3200,1290.0,2006,4530,6000,5910 days 16:47:18.695827,125,1.4285714285714286,2.4806201550387597,-40,0,1910.0
462000.0,4,2.5,3070,6432,2.0,3,9,3070,0.0,2006,2910,5106,5910 days 16:47:18.695827,158,1.6,0.0,160,1326,3070.0
380000.0,4,2.5,1984,32400,1.0,3,8,1564,420.0,1962,1390,9152,21981 days 16:47:18.695827,189,1.6,3.723809523809524,594,23248,1144.0
770000.0,5,3.5,4750,8234,2.0,3,1,3350,1400.0,2013,2160,14496,3353 days 16:47:18.695827,131,1.4285714285714286,2.392857142857143,2590,-6262,1950.0
641000.0,4,3.25,2760,4104,2.0,3,8,1900,860.0,2014,2760,5186,2988 days 16:47:18.695827,230,1.2307692307692308,2.2093023255813953,0,-1082,1040.0
2300000.0,4,4.0,4360,8175,2.5,3,1,3940,420.0,2007,2670,8525,5545 days 16:47:18.695827,107,1.0,9.380952380952381,1690,-350,3520.0
369000.0,4,2.5,3060,27251,1.5,3,8,3060,0.0,2008,1760,27251,5180 days 16:47:18.695827,124,1.6,0.0,1300,0,3060.0
1110000.0,4,3.0,2770,2650,2.0,3,9,2180,590.0,2014,1820,2960,2988 days 16:47:18.695827,259,1.3333333333333333,3.694915254237288,950,-310,1590.0
357000.0,5,2.5,2990,9240,2.0,3,8,2990,0.0,2015,1970,18110,2623 days 16:47:18.695827,240,2.0,0.0,1020,-8870,2990.0
650000.0,3,2.75,1540,1251,2.0,3,8,1230,310.0,2002,1540,1287,7371 days 16:47:18.695827,330,1.0909090909090908,3.967741935483871,0,-36,920.0
563500.0,3,2.5,1400,1312,3.5,3,8,1400,0.0,2007,1350,1312,5545 days 16:47:18.695827,176,1.2,0.0,50,0,1400.0
345000.0,3,2.5,1680,2229,2.0,3,7,1680,0.0,2007,1230,9300,5545 days 16:47:18.695827,168,1.2,0.0,450,-7071,1680.0
479950.0,3,2.0,2260,7163,1.0,3,9,2260,0.0,2012,2340,6730,3719 days 16:47:18.695827,206,1.5,0.0,-80,433,2260.0
660000.0,4,3.5,3400,5196,2.0,3,9,3400,0.0,2012,3170,5260,3719 days 16:47:18.695827,133,1.1428571428571428,0.0,230,-64,3400.0
800000.0,4,2.5,2930,5000,2.0,3,9,2760,170.0,2007,3230,5778,5545 days 16:47:18.695827,210,1.6,16.235294117647058,-300,-778,2590.0
253101.0,3,2.0,1239,6036,1.0,3,7,1239,0.0,2009,2060,5746,4814 days 16:47:18.695827,205,1.5,0.0,-821,290,1239.0
555000.0,3,3.5,2100,2479,2.0,3,9,1450,650.0,2011,1800,2457,4084 days 16:47:18.695827,272,0.8571428571428571,2.230769230769231,300,22,800.0
240000.0,4,1.0,1200,2171,1.5,3,7,1200,0.0,1933,1130,1598,32573 days 16:47:18.695827,177,4.0,0.0,70,573,1200.0
380000.0,4,1.0,1200,2171,1.5,3,7,1200,0.0,1933,1130,1598,32573 days 16:47:18.695827,124,4.0,0.0,70,573,1200.0
239000.0,2,1.5,680,772,2.0,3,7,680,0.0,2005,690,1059,6275 days 16:47:18.695827,321,1.3333333333333333,0.0,-10,-287,680.0
430000.0,4,2.5,2750,7200,2.0,3,8,2750,0.0,2011,2750,7200,4084 days 16:47:18.695827,238,1.6,0.0,0,0,2750.0
660000.0,3,2.5,2450,4332,2.0,3,8,2450,0.0,2010,2450,4154,4449 days 16:47:18.695827,142,1.2,0.0,0,178,2450.0
399963.0,4,2.5,2620,4050,2.0,3,8,2620,0.0,2014,2030,3944,2988 days 16:47:18.695827,232,1.6,0.0,590,106,2620.0
411000.0,2,2.0,1130,1148,2.0,3,9,800,330.0,2007,1350,1201,5545 days 16:47:18.695827,199,1.0,2.4242424242424243,-220,-53,470.0
483453.0,4,2.75,2790,5527,2.0,3,8,2790,0.0,2014,2620,5509,2988 days 16:47:18.695827,178,1.4545454545454546,0.0,170,18,2790.0
469950.0,3,2.0,1820,1357,3.0,3,9,1820,0.0,2014,1710,1372,2988 days 16:47:18.695827,314,1.5,0.0,110,-15,1820.0
504058.0,4,2.75,2910,7467,2.0,3,8,2910,0.0,2013,2790,7868,3353 days 16:47:18.695827,196,1.4545454545454546,0.0,120,-401,2910.0
425996.0,4,2.5,2568,5000,2.0,3,9,2568,0.0,2014,2547,4500,2988 days 16:47:18.695827,118,1.6,0.0,21,500,2568.0
760005.0,4,2.75,3090,5859,2.0,3,9,3090,0.0,2010,2960,5250,4449 days 16:47:18.695827,189,1.4545454545454546,0.0,130,609,3090.0
699999.0,2,2.0,1460,1085,2.0,3,8,950,510.0,2014,1580,1202,2988 days 16:47:18.695827,110,1.0,1.8627450980392157,-120,-117,440.0
749950.0,3,2.5,2010,2263,2.0,3,8,1340,670.0,2014,1500,2670,2988 days 16:47:18.695827,197,1.2,2.0,510,-407,670.0
674600.0,4,2.5,2610,5140,2.0,3,8,2610,0.0,2006,1190,5101,5910 days 16:47:18.695827,189,1.6,0.0,1420,39,2610.0
450000.0,2,1.5,960,1000,2.0,3,8,920,40.0,2008,1200,1297,5180 days 16:47:18.695827,055,1.3333333333333333,23.0,-240,-297,880.0
272000.0,3,2.5,1528,7616,2.0,3,7,1528,0.0,2011,1850,7340,4084 days 16:47:18.695827,097,1.2,0.0,-322,276,1528.0
450000.0,2,1.5,1310,1264,2.0,3,8,1120,190.0,2006,1330,1265,5910 days 16:47:18.695827,195,1.3333333333333333,5.894736842105263,-20,-1,930.0
643950.0,3,2.25,1760,2122,3.0,3,9,1760,0.0,2015,1420,1618,2623 days 16:47:18.695827,125,1.3333333333333333,0.0,340,504,1760.0
290000.0,3,2.5,1420,3542,2.0,3,8,1310,110.0,2007,1180,1622,5545 days 16:47:18.695827,314,1.2,11.909090909090908,240,1920,1200.0
378000.0,3,2.5,1650,2082,3.0,3,8,1650,0.0,2007,1650,1965,5545 days 16:47:18.695827,281,1.2,0.0,0,117,1650.0
728050.0,3,2.5,2320,6775,1.0,3,8,2320,0.0,2008,1680,4750,5180 days 16:47:18.695827,170,1.2,0.0,640,2025,2320.0
499160.0,4,2.5,2628,11466,2.0,3,9,2628,0.0,2014,2849,10909,2988 days 16:47:18.695827,116,1.6,0.0,-221,557,2628.0
536000.0,4,2.5,2520,4831,2.0,3,8,2520,0.0,2009,2430,3937,4814 days 16:47:18.695827,335,1.6,0.0,90,894,2520.0
419900.0,5,3.5,2880,5000,2.0,3,8,2260,620.0,2012,2590,4800,3719 days 16:47:18.695827,036,1.4285714285714286,3.6451612903225805,290,200,1640.0
469000.0,3,2.25,1440,1362,3.0,3,7,1440,0.0,2014,1180,2603,2988 days 16:47:18.695827,344,1.3333333333333333,0.0,260,-1241,1440.0
374000.0,3,2.5,2185,6042,2.0,3,9,2185,0.0,2009,2297,5876,4814 days 16:47:18.695827,098,1.2,0.0,-112,166,2185.0
182568.0,4,1.5,1500,2106,2.0,3,7,1500,0.0,2014,1490,2175,2988 days 16:47:18.695827,209,2.6666666666666665,0.0,10,-69,1500.0
334888.0,3,2.5,1769,7324,2.0,3,9,1769,0.0,2012,2502,6017,3719 days 16:47:18.695827,177,1.2,0.0,-733,1307,1769.0
799900.0,4,4.0,3650,18223,2.0,3,9,3330,320.0,2013,3220,11022,3353 days 16:47:18.695827,260,1.0,10.40625,430,7201,3010.0
383000.0,4,2.5,2160,6223,2.0,3,8,2160,0.0,2010,2160,5555,4449 days 16:47:18.695827,132,1.6,0.0,0,668,2160.0
580000.0,3,2.5,1820,374616,2.0,3,7,1820,0.0,1999,1870,220654,8467 days 16:47:18.695827,352,1.2,0.0,-50,153962,1820.0
351999.0,3,2.5,2370,4200,2.0,3,8,2370,0.0,2014,2370,4200,2988 days 16:47:18.695827,188,1.2,0.0,0,0,2370.0
1330000.0,3,3.0,3180,2758,2.0,3,1,2240,940.0,2008,2420,2758,5180 days 16:47:18.695827,054,1.0,2.382978723404255,760,0,1300.0
312000.0,3,2.5,1780,4077,2.0,3,8,1780,0.0,2011,1970,4077,4084 days 16:47:18.695827,025,1.2,0.0,-190,0,1780.0
674950.0,4,3.5,2650,3127,2.0,3,8,2230,420.0,2011,2330,3137,4084 days 16:47:18.695827,255,1.1428571428571428,5.309523809523809,320,-10,1810.0
1110000.0,5,2.75,3300,7560,2.0,3,1,3300,0.0,2007,3150,8580,5545 days 16:47:18.695827,363,1.8181818181818181,0.0,150,-1020,3300.0
415000.0,2,2.5,1160,1219,3.0,3,8,1160,0.0,2007,1320,2800,5545 days 16:47:18.695827,072,0.8,0.0,-160,-1581,1160.0
1250000.0,3,3.0,3460,5353,2.0,3,1,2850,610.0,2007,2460,6325,5545 days 16:47:18.695827,191,1.0,4.672131147540983,1000,-972,2240.0
208800.0,3,2.5,1390,2450,2.0,3,7,1390,0.0,2009,1390,2450,4814 days 16:47:18.695827,262,1.2,0.0,0,0,1390.0
452000.0,2,2.5,1260,1131,3.0,3,8,1260,0.0,2006,1490,2500,5910 days 16:47:18.695827,302,0.8,0.0,-230,-1369,1260.0
837000.0,5,2.75,2940,5225,2.0,3,8,2760,180.0,2010,3090,6261,4449 days 16:47:18.695827,112,1.8181818181818181,15.333333333333334,-150,-1036,2580.0
780000.0,5,3.5,3190,4247,2.0,3,8,2430,760.0,2013,2580,3989,3353 days 16:47:18.695827,055,1.4285714285714286,3.1973684210526314,610,258,1670.0
1490000.0,4,3.5,3930,6120,2.0,3,1,3310,620.0,2007,3390,6120,5545 days 16:47:18.695827,275,1.1428571428571428,5.338709677419355,540,0,2690.0
1600000.0,5,3.75,3570,10125,2.0,3,1,3570,0.0,2014,1760,10125,2988 days 16:47:18.695827,269,1.3333333333333333,0.0,1810,0,3570.0
369946.0,3,2.5,2420,4725,2.0,3,8,2420,0.0,2014,2370,4200,2988 days 16:47:18.695827,261,1.2,0.0,50,525,2420.0
530000.0,3,2.75,3400,7200,2.0,3,9,2470,930.0,2009,1580,8676,4814 days 16:47:18.695827,159,1.0909090909090908,2.6559139784946235,1820,-1476,1540.0
386000.0,4,2.5,2478,6079,2.0,3,8,2478,0.0,2012,2279,6079,3719 days 16:47:18.695827,079,1.6,0.0,199,0,2478.0
1900000.0,4,2.5,3070,7830,2.0,3,1,1970,1100.0,2009,2440,4682,4814 days 16:47:18.695827,049,1.6,1.790909090909091,630,3148,870.0
735000.0,4,3.5,3200,7605,2.0,3,9,2500,700.0,2013,2240,4416,3353 days 16:47:18.695827,254,1.1428571428571428,3.5714285714285716,960,3189,1800.0
1750000.0,5,3.25,5790,12739,2.0,3,1,4430,1360.0,2014,5790,13928,2988 days 16:47:18.695827,275,1.5384615384615385,3.2573529411764706,0,-1189,3070.0
489950.0,3,2.25,1590,926,3.0,3,8,1590,0.0,2014,1640,1321,2988 days 16:47:18.695827,054,1.3333333333333333,0.0,-50,-395,1590.0
357500.0,3,3.0,1730,1442,2.0,3,8,1440,290.0,2008,1370,1524,5180 days 16:47:18.695827,103,1.0,4.9655172413793105,360,-82,1150.0
329995.0,4,2.5,2303,3680,2.0,3,8,2303,0.0,2013,2303,3760,3353 days 16:47:18.695827,140,1.6,0.0,0,-80,2303.0
414000.0,3,2.5,1790,3754,2.0,3,8,1790,0.0,2013,1800,3393,3353 days 16:47:18.695827,268,1.2,0.0,-10,361,1790.0
533500.0,3,3.5,2490,3517,2.0,3,8,1720,770.0,2005,1600,2378,6275 days 16:47:18.695827,344,0.8571428571428571,2.2337662337662336,890,1139,950.0
402395.0,4,2.5,2669,5385,2.0,3,9,2669,0.0,2014,2669,4645,2988 days 16:47:18.695827,064,1.6,0.0,0,740,2669.0
725000.0,4,3.25,2610,2552,2.0,3,1,2160,450.0,2008,2610,2664,5180 days 16:47:18.696823,100,1.2307692307692308,4.8,0,-112,1710.0
1280000.0,6,5.25,6160,27490,2.0,3,1,4040,2120.0,2007,4225,9100,5545 days 16:47:18.696823,240,1.1428571428571428,1.9056603773584906,1935,18390,1920.0
239800.0,2,1.75,1290,1493,2.0,3,8,1290,0.0,2014,1410,1875,2988 days 16:47:18.696823,260,1.1428571428571428,0.0,-120,-382,1290.0
616950.0,5,3.5,3560,5008,2.0,3,8,2810,750.0,2013,2910,5026,3353 days 16:47:18.696823,247,1.4285714285714286,3.7466666666666666,650,-18,2060.0
1260000.0,4,3.25,4360,6000,2.0,3,1,3400,960.0,2007,4310,6000,5545 days 16:47:18.696823,274,1.2307692307692308,3.5416666666666665,50,0,2440.0
435000.0,3,2.25,1230,1238,2.0,3,8,1080,150.0,2009,1230,953,4814 days 16:47:18.696823,168,1.3333333333333333,7.2,0,285,930.0
925000.0,4,3.25,3640,60086,2.0,3,1,3640,0.0,2005,2900,51721,6275 days 16:47:18.696823,227,1.2307692307692308,0.0,740,8365,3640.0
631500.0,2,2.5,1780,2493,3.0,3,8,1780,0.0,1981,2050,4400,15041 days 16:47:18.696823,118,0.8,0.0,-270,-1907,1780.0
399995.0,3,1.5,1140,1069,3.0,3,8,1140,0.0,2005,1230,1276,6275 days 16:47:18.696823,089,2.0,0.0,-90,-207,1140.0
369950.0,3,2.0,1270,1320,3.0,3,8,1270,0.0,2006,1370,1320,5910 days 16:47:18.696823,126,1.5,0.0,-100,0,1270.0
475000.0,5,3.5,2780,3583,2.0,3,8,2180,600.0,2005,2640,3850,6275 days 16:47:18.696823,113,1.4285714285714286,3.6333333333333333,140,-267,1580.0
353000.0,4,2.5,1912,5000,2.0,3,8,1912,0.0,2012,2020,5000,3719 days 16:47:18.696823,329,1.6,0.0,-108,0,1912.0
329950.0,4,2.5,2300,9690,2.0,3,8,2300,0.0,2006,1200,9085,5910 days 16:47:18.696823,056,1.6,0.0,1100,605,2300.0
367000.0,3,2.5,2828,4050,2.0,3,8,2828,0.0,2013,2513,4507,3353 days 16:47:18.696823,072,1.2,0.0,315,-457,2828.0
447500.0,4,2.5,2425,9017,2.0,3,9,2425,0.0,2013,2725,7019,3353 days 16:47:18.696823,248,1.6,0.0,-300,1998,2425.0
595000.0,4,3.25,3730,4560,2.0,3,9,2760,970.0,2015,1800,4560,2623 days 16:47:18.696823,190,1.2307692307692308,2.845360824742268,1930,0,1790.0
325000.0,1,1.0,730,1942,1.0,3,7,730,0.0,2009,1020,2044,4814 days 16:47:18.696823,247,1.0,0.0,-290,-102,730.0
690000.0,2,2.5,1990,1756,3.0,3,9,1780,210.0,2005,1955,1438,6275 days 16:47:18.696823,034,0.8,8.476190476190476,35,318,1570.0
329950.0,3,2.5,1300,812,2.0,3,8,880,420.0,2008,1300,824,5180 days 16:47:18.696823,315,1.2,2.0952380952380953,0,-12,460.0
399500.0,4,2.5,2560,7492,2.0,3,8,2560,0.0,2014,1260,11541,2988 days 16:47:18.696823,028,1.6,0.0,1300,-4049,2560.0
555000.0,5,2.5,2450,5047,2.0,3,8,2450,0.0,2007,2450,4478,5545 days 16:47:18.696823,021,2.0,0.0,0,569,2450.0
427000.0,2,1.5,1440,725,2.0,3,8,1100,340.0,2011,1440,4255,4084 days 16:47:18.696823,274,1.3333333333333333,3.235294117647059,0,-3530,760.0
375000.0,3,2.25,1140,1557,3.0,3,8,1140,0.0,2007,1140,1245,5545 days 16:47:18.696823,293,1.3333333333333333,0.0,0,312,1140.0
499000.0,2,1.5,1110,957,2.0,3,8,930,180.0,2005,1680,1104,6275 days 16:47:18.696823,128,1.3333333333333333,5.166666666666667,-570,-147,750.0
750000.0,3,2.5,2620,43832,2.0,3,8,2620,0.0,2013,2620,120686,3353 days 16:47:18.696823,199,1.2,0.0,0,-76854,2620.0
336900.0,3,2.5,1690,1200,2.0,3,8,1410,280.0,2014,1740,1664,2988 days 16:47:18.696823,363,1.2,5.035714285714286,-50,-464,1130.0
555000.0,2,2.75,1950,1610,3.0,3,8,1950,0.0,2009,910,1745,4814 days 16:47:18.696823,262,0.7272727272727273,0.0,1040,-135,1950.0
1280000.0,4,3.5,3530,8126,2.0,3,1,3530,0.0,2007,2660,8126,5545 days 16:47:18.696823,310,1.1428571428571428,0.0,870,0,3530.0
999950.0,4,3.5,3310,4684,2.0,3,9,2290,1020.0,2014,1850,4750,2988 days 16:47:18.696823,287,1.1428571428571428,2.2450980392156863,1460,-66,1270.0
975000.0,5,3.0,2620,5477,2.0,3,1,2620,0.0,2009,1680,5217,4814 days 16:47:18.696823,176,1.6666666666666667,0.0,940,260,2620.0
299000.0,3,2.25,1350,3582,2.0,3,8,1350,0.0,2010,1940,3860,4449 days 16:47:18.696823,050,1.3333333333333333,0.0,-590,-278,1350.0
479000.0,2,2.5,1741,1439,2.0,3,8,1446,295.0,2007,2090,10454,5545 days 16:47:18.696823,107,0.8,4.901694915254238,-349,-9015,1151.0
409000.0,3,2.5,1890,6500,2.0,3,7,1890,0.0,2012,2340,7500,3719 days 16:47:18.696823,241,1.2,0.0,-450,-1000,1890.0
798500.0,3,3.0,1950,1833,3.0,3,9,1610,340.0,2009,2040,2131,4814 days 16:47:18.696823,085,1.0,4.735294117647059,-90,-298,1270.0
689000.0,4,3.5,4490,5805,2.0,3,9,3390,1100.0,2006,4410,6299,5910 days 16:47:18.696823,346,1.1428571428571428,3.081818181818182,80,-494,2290.0
375000.0,6,2.25,3206,5793,2.0,3,7,3206,0.0,2012,2527,5804,3719 days 16:47:18.696823,128,2.6666666666666665,0.0,679,-11,3206.0
775000.0,4,3.5,4130,77832,2.0,3,1,4130,0.0,2011,4130,87476,4084 days 16:47:18.696823,198,1.1428571428571428,0.0,0,-9644,4130.0
639983.0,5,3.0,2800,5700,2.0,3,8,2800,0.0,2014,2910,5349,2988 days 16:47:18.696823,287,1.6666666666666667,0.0,-110,351,2800.0
300000.0,4,3.0,1984,4419,2.0,3,7,1984,0.0,2010,2440,4418,4449 days 16:47:18.696823,085,1.3333333333333333,0.0,-456,1,1984.0
627000.0,4,2.5,2750,11830,2.0,3,9,2750,0.0,2014,2310,11830,2988 days 16:47:18.696823,356,1.6,0.0,440,0,2750.0
275000.0,3,2.75,1740,5757,1.0,3,7,1740,0.0,2010,2380,5647,4449 days 16:47:18.696823,105,1.0909090909090908,0.0,-640,110,1740.0
352800.0,4,2.25,1800,2752,2.0,3,8,1800,0.0,2014,1650,2752,2988 days 16:47:18.696823,269,1.7777777777777777,0.0,150,0,1800.0
565000.0,3,2.25,1540,1005,3.0,3,8,1540,0.0,2008,1510,1501,5180 days 16:47:18.696823,071,1.3333333333333333,0.0,30,-496,1540.0
765000.0,4,2.25,2030,2222,2.0,3,9,1610,420.0,2015,1420,2222,2623 days 16:47:18.696823,104,1.7777777777777777,3.8333333333333335,610,0,1190.0
644000.0,4,2.5,3310,4839,2.0,3,9,3310,0.0,2007,3240,5280,5545 days 16:47:18.696823,099,1.6,0.0,70,-441,3310.0
461000.0,3,1.5,1270,1416,3.0,3,8,1270,0.0,2007,1270,1413,5545 days 16:47:18.696823,054,2.0,0.0,0,3,1270.0
270500.0,5,2.5,2406,7093,2.0,3,8,2406,0.0,2006,1767,7093,5910 days 16:47:18.696823,357,2.0,0.0,639,0,2406.0
640000.0,2,2.25,1540,965,3.0,3,9,1540,0.0,2007,1410,964,5545 days 16:47:18.696823,182,0.8888888888888888,0.0,130,1,1540.0
457000.0,4,2.5,2820,6983,2.0,3,9,2820,0.0,2013,2597,7222,3353 days 16:47:18.696823,217,1.6,0.0,223,-239,2820.0
355000.0,5,2.5,2540,5100,2.0,3,7,2540,0.0,2014,1400,9440,2988 days 16:47:18.696823,335,2.0,0.0,1140,-4340,2540.0
356000.0,2,2.25,1230,989,3.0,3,8,1230,0.0,2007,1230,1223,5545 days 16:47:18.696823,349,0.8888888888888888,0.0,0,-234,1230.0
425000.0,4,2.5,1900,2766,2.0,3,8,1900,0.0,2014,1900,2604,2988 days 16:47:18.696823,217,1.6,0.0,0,162,1900.0
562500.0,5,2.75,2920,6327,2.0,3,8,2920,0.0,2007,2520,5026,5545 days 16:47:18.696823,266,1.8181818181818181,0.0,400,1301,2920.0
460000.0,3,2.5,1450,1053,2.0,3,8,940,510.0,2008,1410,1080,5180 days 16:47:18.696823,182,1.2,1.8431372549019607,40,-27,430.0
790000.0,4,3.0,5370,69848,2.0,3,1,3500,1870.0,2005,4443,94403,6275 days 16:47:18.696823,096,1.3333333333333333,1.8716577540106951,927,-24555,1630.0
401000.0,3,2.0,1270,1333,3.0,3,8,1270,0.0,2006,1330,1333,5910 days 16:47:18.696823,077,1.5,0.0,-60,0,1270.0
1100000.0,3,2.5,2550,5100,2.0,3,9,2550,0.0,2014,1250,4080,2988 days 16:47:18.696823,240,1.2,0.0,1300,1020,2550.0
850000.0,4,3.0,3070,7150,2.0,3,9,3070,0.0,2007,3200,6984,5545 days 16:47:18.696823,093,1.3333333333333333,0.0,-130,166,3070.0
274500.0,3,2.25,1450,4050,2.0,3,7,1450,0.0,2010,1660,3800,4449 days 16:47:18.696823,183,1.3333333333333333,0.0,-210,250,1450.0
1940000.0,5,3.5,4230,16526,2.0,3,1,4230,0.0,2008,3000,12362,5180 days 16:47:18.696823,105,1.4285714285714286,0.0,1230,4164,4230.0
808000.0,4,2.5,3480,6262,2.0,3,9,3480,0.0,2003,3490,6629,7006 days 16:47:18.696823,216,1.6,0.0,-10,-367,3480.0
312000.0,3,2.25,1490,974,2.0,3,7,1220,270.0,2009,1490,1283,4814 days 16:47:18.696823,135,1.3333333333333333,4.518518518518518,0,-309,950.0
320000.0,3,2.25,1200,1400,3.0,3,8,1200,0.0,2005,1370,6552,6275 days 16:47:18.696823,167,1.3333333333333333,0.0,-170,-5152,1200.0
410000.0,3,2.5,2150,4332,2.0,3,8,2150,0.0,2013,2140,4332,3353 days 16:47:18.696823,013,1.2,0.0,10,0,2150.0
725000.0,3,3.5,3690,8837,2.0,3,1,3690,0.0,2001,3690,9585,7736 days 16:47:18.696823,171,0.8571428571428571,0.0,0,-748,3690.0
335000.0,4,2.5,1900,3301,2.0,3,7,1900,0.0,2007,1960,3379,5545 days 16:47:18.696823,288,1.6,0.0,-60,-78,1900.0
519990.0,4,3.25,1690,1321,2.0,3,8,1320,370.0,2014,3080,4558,2988 days 16:47:18.696823,020,1.2307692307692308,3.5675675675675675,-1390,-3237,950.0
533112.0,4,2.75,2790,8853,2.0,3,8,2790,0.0,2013,2790,8092,3353 days 16:47:18.696823,161,1.4545454545454546,0.0,0,761,2790.0
274900.0,3,2.0,1936,6612,2.0,3,7,1936,0.0,2014,1620,21600,2988 days 16:47:18.696823,301,1.5,0.0,316,-14988,1936.0
325000.0,2,2.25,1150,711,2.0,3,7,1150,0.0,2013,1150,748,3353 days 16:47:18.696823,356,0.8888888888888888,0.0,0,-37,1150.0
350000.0,4,2.5,2040,22653,2.0,3,7,2040,0.0,2011,2020,20502,4084 days 16:47:18.696823,149,1.6,0.0,20,2151,2040.0
550000.0,4,2.5,2470,7539,2.0,3,9,2470,0.0,2006,2580,7539,5910 days 16:47:18.696823,266,1.6,0.0,-110,0,2470.0
311850.0,4,2.5,1890,4158,2.0,3,8,1890,0.0,2014,2720,4549,2988 days 16:47:18.696823,068,1.6,0.0,-830,-391,1890.0
526000.0,3,2.5,1626,1583,2.5,3,8,1419,207.0,2007,1400,1583,5545 days 16:47:18.696823,041,1.2,6.855072463768116,226,0,1212.0
375000.0,4,2.5,2250,5306,2.0,3,8,2250,0.0,2012,2250,5306,3719 days 16:47:18.696823,274,1.6,0.0,0,0,2250.0
299999.0,3,2.25,1350,1234,2.0,3,7,1160,190.0,2007,1420,1234,5545 days 16:47:18.696823,054,1.3333333333333333,6.105263157894737,-70,0,970.0
436000.0,3,2.5,1460,1238,2.0,3,8,1200,260.0,2008,1280,1257,5180 days 16:47:18.696823,262,1.2,4.615384615384615,180,-19,940.0
303000.0,3,2.5,2056,3564,2.0,3,7,2056,0.0,2014,2056,3577,2988 days 16:47:18.696823,346,1.2,0.0,0,-13,2056.0
525000.0,2,2.5,1160,1458,2.0,3,8,1040,120.0,2012,1650,2311,3719 days 16:47:18.696823,182,0.8,8.666666666666666,-490,-853,920.0
575000.0,3,3.0,1384,1287,2.0,3,8,1144,240.0,2006,1570,1288,5910 days 16:47:18.696823,164,1.0,4.766666666666667,-186,-1,904.0
420000.0,2,1.5,1100,1107,3.0,3,8,1100,0.0,2008,1110,2750,5180 days 16:47:18.696823,297,1.3333333333333333,0.0,-10,-1643,1100.0
1830000.0,4,4.25,4500,215186,2.0,3,1,2630,1870.0,2009,3030,25447,4814 days 16:47:18.696823,294,0.9411764705882353,1.4064171122994653,1470,189739,760.0
1180000.0,4,3.25,3780,10099,1.0,3,1,2240,1540.0,2006,3120,10669,5910 days 16:47:18.696823,098,1.2307692307692308,1.4545454545454546,660,-570,700.0
499950.0,2,2.5,1320,1157,2.0,3,8,990,330.0,2014,1550,1519,2988 days 16:47:18.696823,254,0.8,3.0,-230,-362,660.0
1150000.0,4,3.0,5940,11533,2.0,3,1,4950,990.0,2004,4240,12813,6641 days 16:47:18.696823,147,1.3333333333333333,5.0,1700,-1280,3960.0
400000.0,3,2.0,1650,5027,1.5,3,7,1650,0.0,2009,2430,6000,4814 days 16:47:18.696823,049,1.5,0.0,-780,-973,1650.0
246950.0,3,3.0,1670,4440,1.0,3,7,1670,0.0,2014,1670,4622,2988 days 16:47:18.696823,178,1.0,0.0,0,-182,1670.0
630000.0,3,3.25,1610,1275,2.0,3,8,1220,390.0,2005,1750,3000,6275 days 16:47:18.696823,218,0.9230769230769231,3.128205128205128,-140,-1725,830.0
561000.0,5,2.75,3370,10315,2.0,3,9,3370,0.0,2006,3010,8296,5910 days 16:47:18.696823,255,1.8181818181818181,0.0,360,2019,3370.0
287000.0,4,2.5,2660,4082,2.0,3,7,2660,0.0,2010,2390,4876,4449 days 16:47:18.696823,342,1.6,0.0,270,-794,2660.0
600000.0,3,3.25,1690,1473,2.0,3,8,1380,310.0,2008,1670,2594,5180 days 16:47:18.696823,090,0.9230769230769231,4.451612903225806,20,-1121,1070.0
490000.0,3,2.25,1620,1062,3.0,3,8,1620,0.0,2014,1560,1728,2988 days 16:47:18.696823,240,1.3333333333333333,0.0,60,-666,1620.0
330000.0,3,1.75,1300,958,2.0,3,7,840,460.0,2011,1340,1254,4084 days 16:47:18.696823,089,1.7142857142857142,1.826086956521739,-40,-296,380.0
286950.0,4,2.5,1610,4052,2.0,3,7,1610,0.0,2013,2110,4034,3353 days 16:47:18.696823,335,1.6,0.0,-500,18,1610.0
1550000.0,3,3.25,3530,4920,2.0,3,9,2660,870.0,2015,1900,4200,2623 days 16:47:18.696823,113,0.9230769230769231,3.057471264367816,1630,720,1790.0
880000.0,4,2.5,3550,8618,2.0,3,1,3550,0.0,2007,1310,9746,5545 days 16:47:18.696823,043,1.6,0.0,2240,-1128,3550.0
577450.0,3,3.0,1730,1755,3.0,3,8,1730,0.0,2014,1830,1804,2988 days 16:47:18.696823,286,1.0,0.0,-100,-49,1730.0
405000.0,5,2.75,2400,4900,2.0,3,8,2400,0.0,2011,2110,5696,4084 days 16:47:18.696823,120,1.8181818181818181,0.0,290,-796,2400.0
510000.0,3,2.5,1420,1237,3.0,3,8,1420,0.0,2014,1510,2501,2988 days 16:47:18.696823,188,1.2,0.0,-90,-1264,1420.0
465000.0,2,1.5,1220,1120,2.5,3,8,1110,110.0,2008,2010,3175,5180 days 16:47:18.696823,224,1.3333333333333333,10.090909090909092,-790,-2055,1000.0
1300000.0,4,2.25,2360,4000,2.0,3,9,2360,0.0,2013,3040,4400,3353 days 16:47:18.696823,188,1.7777777777777777,0.0,-680,-400,2360.0
609000.0,4,3.5,3990,11270,2.0,3,9,2930,1060.0,2007,1980,11328,5545 days 16:47:18.696823,098,1.1428571428571428,2.7641509433962264,2010,-58,1870.0
336000.0,3,2.5,1260,1211,3.0,3,8,1260,0.0,2004,1270,1211,6641 days 16:47:18.696823,254,1.2,0.0,-10,0,1260.0
375000.0,3,2.5,1580,2407,2.0,3,8,1580,0.0,2013,1580,2212,3353 days 16:47:18.696823,008,1.2,0.0,0,195,1580.0
294500.0,3,2.5,1760,2688,2.0,3,7,1760,0.0,2005,1760,2329,6275 days 16:47:18.696823,338,1.2,0.0,0,359,1760.0
925000.0,5,3.5,3420,4216,2.0,3,9,2520,900.0,2008,1420,4500,5180 days 16:47:18.696823,329,1.4285714285714286,2.8,2000,-284,1620.0
280000.0,4,2.5,1934,5677,2.0,3,8,1934,0.0,2013,1919,5049,3353 days 16:47:18.696823,262,1.6,0.0,15,628,1934.0
605000.0,3,2.75,2450,5750,2.0,3,9,2450,0.0,2013,3200,8036,3353 days 16:47:18.696823,083,1.0909090909090908,0.0,-750,-2286,2450.0
379950.0,3,3.25,1860,1787,3.0,3,8,1860,0.0,2007,1830,1787,5545 days 16:47:18.696823,136,0.9230769230769231,0.0,30,0,1860.0
720000.0,2,1.75,1570,1108,3.0,3,9,1570,0.0,2007,1940,1160,5545 days 16:47:18.696823,121,1.1428571428571428,0.0,-370,-52,1570.0
549900.0,3,2.0,1280,960,2.0,3,9,1040,240.0,2014,1280,1173,2988 days 16:47:18.696823,307,1.5,4.333333333333333,0,-213,800.0
427000.0,3,2.5,3192,5653,2.0,3,8,3192,0.0,2014,3000,5134,2988 days 16:47:18.696823,021,1.2,0.0,192,519,3192.0
492000.0,3,2.5,1690,1479,3.0,3,8,1420,270.0,2005,1280,1253,6275 days 16:47:18.696823,301,1.2,5.2592592592592595,410,226,1150.0
419190.0,2,2.5,1590,1426,2.0,3,8,1590,0.0,2014,1590,1426,2988 days 16:47:18.696823,125,0.8,0.0,0,0,1590.0
650000.0,3,2.5,2870,7288,2.0,3,9,2870,0.0,2012,2870,5998,3719 days 16:47:18.696823,316,1.2,0.0,0,1290,2870.0
379950.0,4,2.5,2580,4818,2.0,3,8,2580,0.0,2005,2570,5386,6275 days 16:47:18.696823,328,1.6,0.0,10,-568,2580.0
269800.0,4,2.75,1830,3420,2.0,3,8,1830,0.0,2012,1813,3420,3719 days 16:47:18.696823,209,1.4545454545454546,0.0,17,0,1830.0
407000.0,4,2.5,2927,6000,2.0,3,7,2927,0.0,2011,2533,6000,4084 days 16:47:18.696823,225,1.6,0.0,394,0,2927.0
580000.0,3,1.5,1320,1250,3.0,3,8,1320,0.0,2008,1560,1694,5180 days 16:47:18.696823,105,2.0,0.0,-240,-444,1320.0
389700.0,3,2.5,1720,3581,2.0,3,7,1720,0.0,2011,1720,3600,4084 days 16:47:18.696823,016,1.2,0.0,0,-19,1720.0
110000.0,2,1.0,828,4524,1.0,3,6,828,0.0,1968,828,5402,19790 days 16:47:18.696823,070,2.0,0.0,0,-878,828.0
230000.0,3,1.5,1040,1264,2.0,3,9,900,140.0,2015,1350,3000,2623 days 16:47:18.696823,212,2.0,6.428571428571429,-310,-1736,760.0
533380.0,4,2.75,2790,6685,2.0,3,8,2790,0.0,2014,2790,6444,2988 days 16:47:18.696823,241,1.4545454545454546,0.0,0,241,2790.0
295500.0,3,2.5,1410,1332,2.0,3,7,960,450.0,2014,1410,1343,2988 days 16:47:18.696823,261,1.2,2.1333333333333333,0,-11,510.0
860000.0,4,4.5,4040,8400,2.0,3,9,3220,820.0,2006,3940,8400,5910 days 16:47:18.696823,280,0.8888888888888888,3.926829268292683,100,0,2400.0
812000.0,4,3.5,3370,3634,2.0,3,9,2750,620.0,2007,3200,3650,5545 days 16:47:18.696823,189,1.1428571428571428,4.435483870967742,170,-16,2130.0
324500.0,3,2.5,1660,3990,2.0,3,7,1660,0.0,2009,1670,4050,4814 days 16:47:18.696823,156,1.2,0.0,-10,-60,1660.0
193000.0,2,1.75,910,2550,1.0,3,6,910,0.0,2004,1310,2550,6641 days 16:47:18.696823,085,1.1428571428571428,0.0,-400,0,910.0
355000.0,3,2.25,1280,959,3.0,3,8,1280,0.0,2005,1130,1126,6275 days 16:47:18.696823,142,1.3333333333333333,0.0,150,-167,1280.0
525000.0,4,2.75,2360,4924,2.0,3,8,2360,0.0,2008,2360,4670,5180 days 16:47:18.696823,165,1.4545454545454546,0.0,0,254,2360.0
370950.0,3,2.5,2529,9653,2.0,3,7,2529,0.0,2012,2533,6125,3719 days 16:47:18.696823,058,1.2,0.0,-4,3528,2529.0
1240000.0,4,3.5,4700,10183,1.0,3,1,2660,2040.0,2002,3770,9000,7371 days 16:47:18.696823,311,1.1428571428571428,1.303921568627451,930,1183,620.0
950000.0,3,2.5,2780,275033,1.0,3,1,2780,0.0,2006,1680,16340,5910 days 16:47:18.696823,124,1.2,0.0,1100,258693,2780.0
888990.0,4,2.75,3540,5500,2.0,3,9,3540,0.0,2014,3540,5500,2988 days 16:47:18.696823,261,1.4545454545454546,0.0,0,0,3540.0
705000.0,3,2.5,1580,1321,2.0,3,8,1080,500.0,2014,1530,1357,2988 days 16:47:18.696823,078,1.2,2.16,50,-36,580.0
268000.0,3,2.5,1700,2250,2.0,3,7,1700,0.0,2014,1520,4500,2988 days 16:47:18.696823,238,1.2,0.0,180,-2250,1700.0
305450.0,3,2.5,1600,3573,2.0,3,7,1600,0.0,2013,1500,11089,3353 days 16:47:18.696823,127,1.2,0.0,100,-7516,1600.0
399900.0,2,1.75,1410,1005,1.5,3,9,900,510.0,2011,1440,1188,4084 days 16:47:18.696823,184,1.1428571428571428,1.7647058823529411,-30,-183,390.0
495000.0,3,1.5,1580,1228,3.0,3,8,1580,0.0,2014,1580,3605,2988 days 16:47:18.696823,363,2.0,0.0,0,-2377,1580.0
857326.0,3,3.5,3940,11632,2.0,3,1,3940,0.0,2014,2015,11632,2988 days 16:47:18.696823,308,0.8571428571428571,0.0,1925,0,3940.0
845950.0,5,2.75,4450,9600,2.0,3,9,3650,800.0,2014,4000,9750,2988 days 16:47:18.696823,254,1.8181818181818181,4.5625,450,-150,2850.0
303210.0,4,2.5,2009,5000,2.0,3,8,2009,0.0,2014,2009,5182,2988 days 16:47:18.696823,161,1.6,0.0,0,-182,2009.0
343000.0,6,5.0,2732,7655,2.0,3,7,2732,0.0,2009,3078,69993,4814 days 16:47:18.696823,288,1.2,0.0,-346,-62338,2732.0
300000.0,3,2.5,2090,4590,2.0,3,7,2090,0.0,2005,2190,4060,6275 days 16:47:18.696823,197,1.2,0.0,-100,530,2090.0
334900.0,2,2.5,980,1013,3.0,3,8,980,0.0,2008,980,1023,5180 days 16:47:18.696823,326,0.8,0.0,0,-10,980.0
477500.0,5,3.5,2815,5619,2.0,3,9,2815,0.0,2012,2583,5295,3719 days 16:47:18.696823,106,1.4285714285714286,0.0,232,324,2815.0
820000.0,4,2.5,3170,8523,2.0,3,9,3170,0.0,2008,3230,8523,5180 days 16:47:18.696823,169,1.6,0.0,-60,0,3170.0
580000.0,5,3.25,3030,7410,2.0,3,8,2150,880.0,2014,2020,7410,2988 days 16:47:18.696823,217,1.5384615384615385,2.4431818181818183,1010,0,1270.0
350000.0,2,2.5,1280,940,2.0,3,8,1060,220.0,2006,1290,2900,5910 days 16:47:18.696823,203,0.8,4.818181818181818,-10,-1960,840.0
910000.0,3,2.5,2030,1160,3.0,3,9,1970,60.0,2007,1950,1160,5545 days 16:47:18.696823,057,1.2,32.833333333333336,80,0,1910.0
414000.0,3,2.5,2490,4540,2.5,3,8,2490,0.0,2012,2640,3844,3719 days 16:47:18.696823,177,1.2,0.0,-150,696,2490.0
525000.0,3,2.5,3030,4500,2.0,3,8,3030,0.0,2009,3030,4501,4814 days 16:47:18.696823,089,1.2,0.0,0,-1,3030.0
650000.0,2,2.5,1470,690,3.0,3,8,1470,0.0,2008,1480,1284,5180 days 16:47:18.696823,099,0.8,0.0,-10,-594,1470.0
450000.0,3,2.25,1620,997,2.5,3,8,1540,80.0,2012,1620,1068,3719 days 16:47:18.696823,344,1.3333333333333333,19.25,0,-71,1460.0
1270000.0,4,3.0,5520,8313,2.0,3,9,3570,1950.0,2008,3770,8278,5180 days 16:47:18.696823,136,1.3333333333333333,1.8307692307692307,1750,35,1620.0
699000.0,3,3.5,3200,10344,2.0,3,1,3200,0.0,2007,2550,20152,5545 days 16:47:18.696823,102,0.8571428571428571,0.0,650,-9808,3200.0
899000.0,4,2.5,2580,3943,2.0,3,8,2580,0.0,2013,1700,5772,3353 days 16:47:18.696823,204,1.6,0.0,880,-1829,2580.0
353500.0,4,3.0,2050,4000,2.0,3,8,2050,0.0,2014,2050,4000,2988 days 16:47:18.696823,220,1.3333333333333333,0.0,0,0,2050.0
485000.0,3,2.5,2430,5867,2.0,3,7,2430,0.0,2011,2620,5866,4084 days 16:47:18.696823,251,1.2,0.0,-190,1,2430.0
782900.0,4,3.25,3060,3898,2.0,3,1,2300,760.0,2014,2920,3448,2988 days 16:47:18.696823,177,1.2307692307692308,3.026315789473684,140,450,1540.0
529000.0,2,2.0,1540,9714,2.0,3,8,1540,0.0,2008,1840,8179,5180 days 16:47:18.696823,118,1.0,0.0,-300,1535,1540.0
514700.0,3,3.25,1310,1072,2.0,3,8,1060,250.0,2008,1160,1266,5180 days 16:47:18.696823,106,0.9230769230769231,4.24,150,-194,810.0
409316.0,3,2.5,1800,3168,2.0,3,8,1800,0.0,2014,1800,3393,2988 days 16:47:18.696823,140,1.2,0.0,0,-225,1800.0
388598.0,3,2.5,2370,4200,2.0,3,8,2370,0.0,2014,2370,4370,2988 days 16:47:18.696823,126,1.2,0.0,0,-170,2370.0
415000.0,3,2.25,1445,1512,2.0,3,7,1300,145.0,2004,1445,1082,6641 days 16:47:18.696823,058,1.3333333333333333,8.96551724137931,0,430,1155.0
521500.0,3,2.25,1450,1619,2.0,3,8,1140,310.0,2006,1580,3472,5910 days 16:47:18.696823,097,1.3333333333333333,3.6774193548387095,-130,-1853,830.0
882566.0,4,2.5,3560,5265,3.0,3,8,3560,0.0,2014,3220,4892,2988 days 16:47:18.696823,181,1.6,0.0,340,373,3560.0
525000.0,3,2.75,2130,1400,2.0,3,9,1080,1050.0,2010,1880,3132,4449 days 16:47:18.696823,098,1.0909090909090908,1.0285714285714285,250,-1732,30.0
515000.0,5,2.75,2980,4502,2.0,3,9,2980,0.0,2007,2850,4501,5545 days 16:47:18.696823,335,1.8181818181818181,0.0,130,1,2980.0
589410.0,3,3.0,2840,7201,2.0,3,9,2840,0.0,2014,2540,5260,2988 days 16:47:18.696823,269,1.0,0.0,300,1941,2840.0
757500.0,4,2.5,3420,6845,2.0,3,9,3420,0.0,2009,2800,5715,4814 days 16:47:18.696823,083,1.6,0.0,620,1130,3420.0
284000.0,3,2.5,1660,4083,2.0,3,7,1660,0.0,2013,1800,4087,3353 days 16:47:18.696823,275,1.2,0.0,-140,-4,1660.0
338500.0,2,2.25,1150,711,2.0,3,7,1150,0.0,2013,1150,748,3353 days 16:47:18.696823,087,0.8888888888888888,0.0,0,-37,1150.0
550000.0,3,2.0,1420,1369,2.5,3,9,1340,80.0,2007,1540,2168,5545 days 16:47:18.696823,204,1.5,16.75,-120,-799,1260.0
294900.0,3,2.5,1860,5025,2.0,3,8,1860,0.0,2010,2000,5550,4449 days 16:47:18.696823,245,1.2,0.0,-140,-525,1860.0
345000.0,2,1.5,1340,1210,2.0,3,8,1120,220.0,2008,1340,1213,5180 days 16:47:18.696823,160,1.3333333333333333,5.090909090909091,0,-3,900.0
450000.0,2,1.5,1530,1012,2.0,3,8,1200,330.0,2005,1530,1425,6275 days 16:47:18.696823,040,1.3333333333333333,3.6363636363636362,0,-413,870.0
420000.0,3,2.5,1509,1114,3.0,3,8,1509,0.0,2014,1509,2431,2988 days 16:47:18.696823,105,1.2,0.0,0,-1317,1509.0
740000.0,3,2.5,2350,3798,2.0,3,8,2350,0.0,2013,2020,3532,3353 days 16:47:18.696823,092,1.2,0.0,330,266,2350.0
286000.0,2,1.5,1010,825,3.0,3,7,1010,0.0,2007,1128,1080,5545 days 16:47:18.696823,051,1.3333333333333333,0.0,-118,-255,1010.0
870000.0,5,3.5,4495,10079,2.0,3,9,3580,915.0,2013,4495,10079,3353 days 16:47:18.696823,076,1.4285714285714286,3.912568306010929,0,0,2665.0
727000.0,3,2.5,1580,991,3.0,3,9,1580,0.0,2009,1610,1297,4814 days 16:47:18.696823,318,1.2,0.0,-30,-306,1580.0
395000.0,4,3.0,2750,7965,2.0,3,9,2750,0.0,2012,2750,6000,3719 days 16:47:18.696823,035,1.3333333333333333,0.0,0,1965,2750.0
535000.0,4,2.25,1890,3615,2.0,3,7,1890,0.0,2005,1630,3280,6275 days 16:47:18.696823,217,1.7777777777777777,0.0,260,335,1890.0
255000.0,3,2.25,1320,963,2.0,3,7,1040,280.0,2007,1300,1285,5545 days 16:47:18.696823,363,1.3333333333333333,3.7142857142857144,20,-322,760.0
260000.0,4,2.5,2150,3721,2.0,3,8,2150,0.0,2006,2150,3721,5910 days 16:47:18.696823,288,1.6,0.0,0,0,2150.0
810000.0,4,2.5,3340,8384,2.0,3,9,3340,0.0,2014,1560,9429,2988 days 16:47:18.696823,253,1.6,0.0,1780,-1045,3340.0
359782.0,3,2.5,1850,3400,2.0,3,7,1850,0.0,2010,1850,3400,4449 days 16:47:18.696823,335,1.2,0.0,0,0,1850.0
500000.0,2,2.5,1950,2162,2.0,3,9,1500,450.0,2012,1800,2457,3719 days 16:47:18.696823,079,0.8,3.3333333333333335,150,-295,1050.0
810000.0,4,3.5,2700,2868,2.0,3,1,1920,780.0,2006,1430,3858,5910 days 16:47:18.696823,056,1.1428571428571428,2.4615384615384617,1270,-990,1140.0
605000.0,5,4.0,3040,6000,2.0,3,8,2280,760.0,2011,3070,5558,4084 days 16:47:18.696823,037,1.25,3.0,-30,442,1520.0
730000.0,4,2.5,2460,7930,2.0,3,8,2460,0.0,2005,1850,9000,6275 days 16:47:18.696823,076,1.6,0.0,610,-1070,2460.0
327000.0,4,2.5,2110,3825,2.0,3,7,2110,0.0,2013,1950,3825,3353 days 16:47:18.696823,076,1.6,0.0,160,0,2110.0
370000.0,2,1.0,780,1133,2.0,3,7,780,0.0,2009,1130,1270,4814 days 16:47:18.696823,314,2.0,0.0,-350,-137,780.0
459000.0,5,3.5,2640,6895,2.0,3,7,2640,0.0,2001,2640,5267,7736 days 16:47:18.696823,176,1.4285714285714286,0.0,0,1628,2640.0
2900000.0,5,4.0,5190,14600,2.0,3,1,5190,0.0,2013,3840,19250,3353 days 16:47:18.696823,317,1.25,0.0,1350,-4650,5190.0
365000.0,4,2.5,2420,8404,2.0,3,8,2420,0.0,2013,2440,4822,3353 days 16:47:18.696823,344,1.6,0.0,-20,3582,2420.0
255000.0,4,2.5,1987,6000,2.0,3,7,1987,0.0,2011,1880,9589,4084 days 16:47:18.696823,360,1.6,0.0,107,-3589,1987.0
375000.0,1,1.0,720,3166,1.0,3,6,720,0.0,1920,1140,6250,37322 days 16:47:18.696823,198,1.0,0.0,-420,-3084,720.0
375000.0,2,1.5,1130,912,2.0,3,8,1000,130.0,2006,1500,1474,5910 days 16:47:18.696823,275,1.3333333333333333,7.6923076923076925,-370,-562,870.0
518380.0,4,2.5,2810,4500,2.0,3,9,2810,0.0,2014,2980,5046,2988 days 16:47:18.696823,203,1.6,0.0,-170,-546,2810.0
346000.0,3,3.25,1500,1442,2.0,3,8,1150,350.0,2007,1500,1533,5545 days 16:47:18.696823,202,0.9230769230769231,3.2857142857142856,0,-91,800.0
302059.0,4,2.0,1390,745,3.0,3,7,1390,0.0,2008,1390,942,5180 days 16:47:18.696823,054,2.0,0.0,0,-197,1390.0
575000.0,4,2.5,2500,4945,2.0,3,9,2500,0.0,2013,2760,6000,3353 days 16:47:18.696823,139,1.6,0.0,-260,-1055,2500.0
549950.0,4,3.5,3906,9674,2.0,3,9,3906,0.0,2014,2673,6500,2988 days 16:47:18.696823,204,1.1428571428571428,0.0,1233,3174,3906.0
900000.0,5,6.0,7120,40806,2.0,3,1,5480,1640.0,2007,3440,36859,5545 days 16:47:18.696823,050,0.8333333333333334,3.341463414634146,3680,3947,3840.0
397500.0,3,2.5,1470,1256,2.0,3,8,930,540.0,2006,1510,1797,5910 days 16:47:18.696823,192,1.2,1.7222222222222223,-40,-541,390.0
1080000.0,5,3.5,3230,7560,2.0,3,1,3230,0.0,2007,3230,8580,5545 days 16:47:18.696823,325,1.4285714285714286,0.0,0,-1020,3230.0
775900.0,3,2.5,2700,5764,2.0,3,9,2700,0.0,2014,3270,14700,2988 days 16:47:18.696823,112,1.2,0.0,-570,-8936,2700.0
510000.0,4,2.5,4073,17334,2.0,3,8,4073,0.0,2008,1780,9625,5180 days 16:47:18.696823,128,1.6,0.0,2293,7709,4073.0
471275.0,4,2.5,3361,5038,2.0,3,9,3361,0.0,2014,2316,4105,2988 days 16:47:18.696823,241,1.6,0.0,1045,933,3361.0
288000.0,4,2.25,1610,3560,2.0,3,7,1610,0.0,2010,1760,3692,4449 days 16:47:18.696823,254,1.7777777777777777,0.0,-150,-132,1610.0
989990.0,4,3.5,3830,7150,2.0,3,9,3830,0.0,2014,3640,6055,2988 days 16:47:18.696823,289,1.1428571428571428,0.0,190,1095,3830.0
300000.0,3,3.25,1470,1235,2.0,3,7,1180,290.0,2008,1470,1243,5180 days 16:47:18.696823,163,0.9230769230769231,4.068965517241379,0,-8,890.0
664950.0,5,3.0,3190,7081,1.0,3,9,1890,1300.0,2013,2270,7623,3353 days 16:47:18.696823,174,1.6666666666666667,1.4538461538461538,920,-542,590.0
699188.0,4,3.25,3250,5478,2.0,3,9,3250,0.0,2014,3250,5482,2988 days 16:47:18.696823,197,1.2307692307692308,0.0,0,-4,3250.0
390000.0,3,2.25,1490,4539,2.0,3,7,1490,0.0,2009,1750,4667,4814 days 16:47:18.696823,062,1.3333333333333333,0.0,-260,-128,1490.0
670000.0,5,2.75,2900,5155,2.0,3,8,2900,0.0,2008,2900,6176,5180 days 16:47:18.696823,080,1.8181818181818181,0.0,0,-1021,2900.0
487000.0,4,2.5,2540,5001,2.0,3,9,2540,0.0,2005,2360,6834,6275 days 16:47:18.696823,190,1.6,0.0,180,-1833,2540.0
769995.0,5,2.75,3360,12080,2.0,3,9,3360,0.0,2014,3360,9724,2988 days 16:47:18.696823,204,1.8181818181818181,0.0,0,2356,3360.0
321950.0,2,1.25,860,1277,2.0,3,7,860,0.0,2007,1280,1265,5545 days 16:47:18.696823,128,1.6,0.0,-420,12,860.0
613500.0,4,2.5,3020,6068,2.0,3,9,3020,0.0,2006,3240,5757,5910 days 16:47:18.696823,117,1.6,0.0,-220,311,3020.0
300000.0,3,2.5,1330,1200,3.0,3,7,1330,0.0,2002,1330,1206,7371 days 16:47:18.696823,218,1.2,0.0,0,-6,1330.0
400950.0,4,2.5,2578,4554,2.0,3,9,2578,0.0,2014,2647,4554,2988 days 16:47:18.696823,329,1.6,0.0,-69,0,2578.0
389517.0,4,2.5,2640,4725,2.0,3,8,2640,0.0,2014,2370,4725,2988 days 16:47:18.696823,261,1.6,0.0,270,0,2640.0
255000.0,3,1.75,1260,1133,2.0,3,7,810,450.0,2011,1260,1172,4084 days 16:47:18.696823,233,1.7142857142857142,1.8,0,-39,360.0
1080000.0,3,2.5,1990,1891,3.0,3,9,1990,0.0,2012,1990,3600,3719 days 16:47:18.696823,051,1.2,0.0,0,-1709,1990.0
637850.0,5,3.25,3340,4900,2.0,3,9,2500,840.0,2014,3220,5200,2988 days 16:47:18.696823,325,1.5384615384615385,2.9761904761904763,120,-300,1660.0
636230.0,4,2.5,2840,6284,2.0,3,9,2840,0.0,2013,2790,7168,3353 days 16:47:18.696823,240,1.6,0.0,50,-884,2840.0
375000.0,3,2.5,1530,1131,3.0,3,8,1530,0.0,2009,1530,1445,4814 days 16:47:18.696823,350,1.2,0.0,0,-314,1530.0
586500.0,3,2.5,1780,1487,3.0,3,8,1600,180.0,2006,1780,1300,5910 days 16:47:18.696823,155,1.2,8.88888888888889,0,187,1420.0
544000.0,4,2.5,2340,6973,2.0,3,8,1930,410.0,2005,2950,6908,6275 days 16:47:18.696823,020,1.6,4.7073170731707314,-610,65,1520.0
425000.0,4,2.5,2390,5021,2.0,3,7,2390,0.0,2002,2520,5333,7371 days 16:47:18.696823,218,1.6,0.0,-130,-312,2390.0
374950.0,4,2.5,2090,3777,2.0,3,8,2090,0.0,2012,2160,3993,3719 days 16:47:18.696823,070,1.6,0.0,-70,-216,2090.0
294570.0,3,1.0,1140,8400,1.0,4,7,1140,0.0,1960,1400,9000,22712 days 16:47:18.696823,071,3.0,0.0,-260,-600,1140.0
300000.0,3,2.5,1960,1477,2.0,3,7,1670,290.0,2012,1980,1467,3719 days 16:47:18.696823,286,1.2,5.758620689655173,-20,10,1380.0
395950.0,5,3.5,2738,6031,2.0,3,8,2738,0.0,2014,2738,5201,2988 days 16:47:18.696823,253,1.4285714285714286,0.0,0,830,2738.0
800000.0,4,2.5,3691,11088,2.0,3,8,3691,0.0,2013,3190,11270,3353 days 16:47:18.696823,199,1.6,0.0,501,-182,3691.0
439990.0,3,2.5,2340,5171,2.0,3,8,2340,0.0,2013,2790,5684,3353 days 16:47:18.696823,211,1.2,0.0,-450,-513,2340.0
680000.0,4,3.5,2510,3763,2.0,3,8,1990,520.0,2013,2560,3820,3353 days 16:47:18.696823,310,1.1428571428571428,3.826923076923077,-50,-57,1470.0
677790.0,6,3.0,2800,4213,2.0,3,8,2800,0.0,1998,1440,3960,8832 days 16:47:18.696823,077,2.0,0.0,1360,253,2800.0
424950.0,3,2.5,1650,4777,2.0,3,8,1650,0.0,2013,1800,3331,3353 days 16:47:18.696823,121,1.2,0.0,-150,1446,1650.0
223990.0,2,2.25,1061,2884,2.0,3,7,1061,0.0,2013,1481,2887,3353 days 16:47:18.696823,090,0.8888888888888888,0.0,-420,-3,1061.0
498000.0,4,2.5,3402,14355,2.0,3,1,2846,556.0,2014,3402,8487,2988 days 16:47:18.696823,133,1.6,5.118705035971223,0,5868,2290.0
359950.0,4,2.5,2542,6120,2.0,3,8,2542,0.0,2014,2419,8984,2988 days 16:47:18.696823,304,1.6,0.0,123,-2864,2542.0
720000.0,3,2.5,3150,151588,2.0,3,9,3150,0.0,2007,2410,208652,5545 days 16:47:18.696823,135,1.2,0.0,740,-57064,3150.0
530000.0,4,2.5,3010,9000,2.0,3,8,3010,0.0,2008,3250,5531,5180 days 16:47:18.696823,316,1.6,0.0,-240,3469,3010.0
295000.0,3,2.5,1660,4898,2.0,3,7,1660,0.0,2011,1810,4462,4084 days 16:47:18.696823,280,1.2,0.0,-150,436,1660.0
255500.0,3,2.5,1770,5000,2.0,3,7,1770,0.0,2009,2230,5200,4814 days 16:47:18.696823,294,1.2,0.0,-460,-200,1770.0
556000.0,3,3.0,1960,1168,2.0,3,9,1600,360.0,2007,2080,1423,5545 days 16:47:18.696823,141,1.0,4.444444444444445,-120,-255,1240.0
277950.0,4,2.5,1889,6000,2.0,3,7,1889,0.0,2012,1990,6350,3719 days 16:47:18.696823,191,1.6,0.0,-101,-350,1889.0
431000.0,4,2.5,3040,6000,2.0,3,9,3040,0.0,2007,2640,6000,5545 days 16:47:18.696823,098,1.6,0.0,400,0,3040.0
780000.0,4,2.75,3420,6787,2.0,3,9,3420,0.0,2010,3450,6137,4449 days 16:47:18.696823,321,1.4545454545454546,0.0,-30,650,3420.0
649000.0,3,3.25,1720,936,2.0,3,8,1030,690.0,2004,1720,1527,6641 days 16:47:18.696823,287,0.9230769230769231,1.4927536231884058,0,-591,340.0
447000.0,3,2.5,1740,3043,2.0,3,7,1740,0.0,2012,1920,2869,3719 days 16:47:18.696823,195,1.2,0.0,-180,174,1740.0
712198.0,4,2.5,2450,4247,2.0,3,8,2450,0.0,2013,2970,4685,3353 days 16:47:18.696823,125,1.6,0.0,-520,-438,2450.0
277140.0,3,1.5,1190,785,2.0,3,8,920,270.0,2014,2820,5626,2988 days 16:47:18.696823,227,2.0,3.4074074074074074,-1630,-4841,650.0
363000.0,4,2.5,3753,7204,2.0,3,1,3336,417.0,2008,3494,9375,5180 days 16:47:18.696823,148,1.6,8.0,259,-2171,2919.0
585000.0,3,2.5,2160,1250,3.0,3,8,1830,330.0,2010,1870,2825,4449 days 16:47:18.696823,345,1.2,5.545454545454546,290,-1575,1500.0
1270000.0,4,2.75,3820,8850,2.0,3,1,3820,0.0,2014,2330,12000,2988 days 16:47:18.696823,212,1.4545454545454546,0.0,1490,-3150,3820.0
380950.0,2,2.0,1120,1039,2.0,3,7,840,280.0,2007,1130,5400,5545 days 16:47:18.696823,043,1.0,3.0,-10,-4361,560.0
333490.0,4,2.5,2250,3916,2.0,3,8,2250,0.0,2014,2156,3920,2988 days 16:47:18.696823,189,1.6,0.0,94,-4,2250.0
520000.0,3,3.25,1540,1487,2.0,3,8,1540,0.0,2011,1620,1104,4084 days 16:47:18.696823,155,0.9230769230769231,0.0,-80,383,1540.0
315000.0,2,2.25,1240,705,2.0,3,7,1150,90.0,2009,1240,750,4814 days 16:47:18.696823,280,0.8888888888888888,12.777777777777779,0,-45,1060.0
487000.0,2,1.5,1160,1118,2.0,3,8,1020,140.0,2007,1210,1118,5545 days 16:47:18.696823,090,1.3333333333333333,7.285714285714286,-50,0,880.0
424950.0,5,3.5,2760,3865,2.5,3,8,2760,0.0,2013,2590,4587,3353 days 16:47:18.696823,220,1.4285714285714286,0.0,170,-722,2760.0
542300.0,3,2.25,1580,1487,3.0,3,9,1580,0.0,2013,1600,1525,3353 days 16:47:18.696823,041,1.3333333333333333,0.0,-20,-38,1580.0
320000.0,3,3.25,1480,1192,2.0,3,8,1180,300.0,2013,1330,1094,3353 days 16:47:18.696823,345,0.9230769230769231,3.933333333333333,150,98,880.0
1140000.0,4,3.25,3740,11467,2.0,3,1,3740,0.0,2014,2510,27520,2988 days 16:47:18.696823,204,1.2307692307692308,0.0,1230,-16053,3740.0
425000.0,4,2.5,1950,5000,2.0,3,8,1950,0.0,2012,2710,5000,3719 days 16:47:18.696823,349,1.6,0.0,-760,0,1950.0
474950.0,3,3.0,1530,1568,3.0,3,8,1530,0.0,2012,1460,1224,3719 days 16:47:18.696823,304,1.0,0.0,70,344,1530.0
307635.0,3,2.5,1820,4200,2.0,3,8,1820,0.0,2014,2370,4200,2988 days 16:47:18.696823,216,1.2,0.0,-550,0,1820.0
834538.0,3,2.5,2760,6187,2.0,3,1,2760,0.0,2014,2760,6600,2988 days 16:47:18.696823,344,1.2,0.0,0,-413,2760.0
769995.0,5,2.75,3010,5398,2.0,3,9,3010,0.0,2014,3360,5407,2988 days 16:47:18.696823,204,1.8181818181818181,0.0,-350,-9,3010.0
820875.0,5,3.25,3860,9387,2.0,3,9,3860,0.0,2006,3860,8979,5910 days 16:47:18.696823,114,1.5384615384615385,0.0,0,408,3860.0
595500.0,4,2.5,2490,6537,2.0,3,8,2490,0.0,2013,2520,5848,3353 days 16:47:18.696823,075,1.6,0.0,-30,689,2490.0
450000.0,4,2.5,3236,9608,2.0,3,1,3236,0.0,2005,3236,9660,6275 days 16:47:18.696823,255,1.6,0.0,0,-52,3236.0
695000.0,4,2.5,2830,14538,2.0,3,8,2830,0.0,2003,2270,6939,7006 days 16:47:18.696823,111,1.6,0.0,560,7599,2830.0
300000.0,3,2.0,1451,7159,1.0,3,7,1451,0.0,2010,2303,6126,4449 days 16:47:18.696823,082,1.5,0.0,-852,1033,1451.0
545000.0,3,2.5,1280,1845,3.0,3,8,1280,0.0,2009,1450,1889,4814 days 16:47:18.696823,246,1.2,0.0,-170,-44,1280.0
365000.0,3,2.25,1110,979,2.0,3,7,960,150.0,2008,1170,1400,5180 days 16:47:18.696823,049,1.3333333333333333,6.4,-60,-421,810.0
718500.0,4,2.75,2840,8800,2.0,3,9,2840,0.0,2008,1840,7700,5180 days 16:47:18.696823,195,1.4545454545454546,0.0,1000,1100,2840.0
279800.0,3,1.75,1410,2052,2.0,3,8,1410,0.0,2014,1410,1988,2988 days 16:47:18.696823,091,1.7142857142857142,0.0,0,64,1410.0
486940.0,4,2.5,3250,13360,2.0,3,9,3250,0.0,2014,2612,14448,2988 days 16:47:18.696823,268,1.6,0.0,638,-1088,3250.0
525000.0,4,2.75,3030,6625,2.0,3,8,3030,0.0,2011,3030,9620,4084 days 16:47:18.696823,177,1.4545454545454546,0.0,0,-2995,3030.0
345000.0,4,2.5,1983,6002,2.0,3,9,1983,0.0,2012,2502,4750,3719 days 16:47:18.696823,206,1.6,0.0,-519,1252,1983.0
613000.0,3,3.25,2440,2812,2.0,3,8,1710,730.0,2005,2440,2836,6275 days 16:47:18.696823,303,0.9230769230769231,2.3424657534246576,0,-24,980.0
370000.0,3,2.5,2313,5700,2.0,3,9,2313,0.0,2011,2323,5701,4084 days 16:47:18.696823,237,1.2,0.0,-10,-1,2313.0
449500.0,3,2.25,1260,2556,2.0,3,7,1260,0.0,2005,1630,2844,6275 days 16:47:18.696823,275,1.3333333333333333,0.0,-370,-288,1260.0
515000.0,3,2.5,2000,3837,2.0,3,8,2000,0.0,2011,2210,4075,4084 days 16:47:18.696823,106,1.2,0.0,-210,-238,2000.0
346100.0,2,1.75,1150,698,2.0,3,7,1150,0.0,2013,1150,757,3353 days 16:47:18.696823,124,1.1428571428571428,0.0,0,-59,1150.0
398500.0,4,2.5,2820,6666,2.0,3,9,2820,0.0,2007,1880,7200,5545 days 16:47:18.696823,343,1.6,0.0,940,-534,2820.0
310000.0,2,1.75,1160,2500,2.0,3,7,1160,0.0,2008,970,7500,5180 days 16:47:18.696823,232,1.1428571428571428,0.0,190,-5000,1160.0
250000.0,3,2.25,1481,2820,2.0,3,7,1481,0.0,2012,1481,2889,3719 days 16:47:18.696823,057,1.3333333333333333,0.0,0,-69,1481.0
1880000.0,5,3.5,4390,6220,2.0,3,9,3170,1220.0,2013,2740,6448,3353 days 16:47:18.696823,218,1.4285714285714286,2.598360655737705,1650,-228,1950.0
695000.0,2,1.75,1570,1207,3.0,3,9,1570,0.0,2007,1570,1206,5545 days 16:47:18.696823,239,1.1428571428571428,0.0,0,1,1570.0
1090000.0,4,3.0,3410,6541,2.0,3,9,2680,730.0,2007,2300,6345,5545 days 16:47:18.696823,239,1.3333333333333333,3.671232876712329,1110,196,1950.0
864327.0,5,3.25,3480,6507,2.0,3,9,3480,0.0,2014,3360,5398,2988 days 16:47:18.696823,216,1.5384615384615385,0.0,120,1109,3480.0
749995.0,4,3.25,3430,9870,2.0,3,9,3430,0.0,2014,3360,9724,2988 days 16:47:18.696823,167,1.2307692307692308,0.0,70,146,3430.0
525000.0,5,2.75,2880,8364,2.0,3,9,2880,0.0,2006,3010,8296,5910 days 16:47:18.696823,161,1.8181818181818181,0.0,-130,68,2880.0
659950.0,3,2.5,2990,9413,2.0,3,1,2990,0.0,2006,1940,9600,5910 days 16:47:18.696823,325,1.2,0.0,1050,-187,2990.0
1800000.0,5,5.0,4490,10279,2.0,3,1,3930,560.0,2013,2490,10279,3353 days 16:47:18.696823,126,1.0,7.017857142857143,2000,0,3370.0
950000.0,5,4.0,4100,8120,2.0,3,9,4100,0.0,2011,4100,7625,4084 days 16:47:18.696823,302,1.25,0.0,0,495,4100.0
1400000.0,4,2.75,3870,10046,2.0,3,1,3870,0.0,2005,3560,10046,6275 days 16:47:18.696823,169,1.4545454545454546,0.0,310,0,3870.0
265050.0,2,1.5,800,2119,2.0,3,7,800,0.0,2008,1020,4800,5180 days 16:47:18.696823,183,1.3333333333333333,0.0,-220,-2681,800.0
450000.0,3,2.25,1620,1057,3.0,3,8,1540,80.0,2009,1390,942,4814 days 16:47:18.696823,065,1.3333333333333333,19.25,230,115,1460.0
915000.0,4,2.5,2910,4356,3.0,3,8,2910,0.0,2010,2840,4181,4449 days 16:47:18.696823,125,1.6,0.0,70,175,2910.0
963000.0,4,3.25,3530,8589,2.0,3,1,3530,0.0,2007,2470,9019,5545 days 16:47:18.696823,181,1.2307692307692308,0.0,1060,-430,3530.0
270000.0,4,2.5,2701,5821,2.0,3,7,2701,0.0,2013,2566,5843,3353 days 16:47:18.696823,281,1.6,0.0,135,-22,2701.0
294000.0,2,2.5,1380,889,2.0,3,7,1140,240.0,2012,1580,1397,3719 days 16:47:18.696823,205,0.8,4.75,-200,-508,900.0
700000.0,3,2.5,2050,4185,2.0,3,9,2050,0.0,2011,1150,5000,4084 days 16:47:18.696823,156,1.2,0.0,900,-815,2050.0
1070000.0,3,4.0,3370,8252,2.0,3,1,3370,0.0,2014,3710,8252,2988 days 16:47:18.696823,075,0.75,0.0,-340,0,3370.0
494900.0,3,2.5,2040,2500,2.0,3,7,1470,570.0,2008,1410,2500,5180 days 16:47:18.696823,119,1.2,2.5789473684210527,630,0,900.0
415000.0,3,2.5,1610,3600,2.0,3,8,1610,0.0,2010,2210,3600,4449 days 16:47:18.696823,213,1.2,0.0,-600,0,1610.0
459990.0,3,2.5,2680,5539,2.0,3,8,2680,0.0,2013,2990,6037,3353 days 16:47:18.696823,122,1.2,0.0,-310,-498,2680.0
882990.0,4,3.5,3560,6562,2.0,3,1,3560,0.0,2014,3710,6562,2988 days 16:47:18.696823,276,1.1428571428571428,0.0,-150,0,3560.0
620000.0,4,3.5,3880,8244,2.0,3,1,3060,820.0,2007,3180,10947,5545 days 16:47:18.696823,363,1.1428571428571428,3.731707317073171,700,-2703,2240.0
375900.0,3,2.0,1824,7120,1.0,3,9,1824,0.0,2010,2409,6264,4449 days 16:47:18.696823,043,1.5,0.0,-585,856,1824.0
654000.0,3,2.5,2220,2873,2.0,3,1,2010,210.0,2012,2290,3213,3719 days 16:47:18.696823,279,1.2,9.571428571428571,-70,-340,1800.0
1840000.0,4,3.25,4140,11007,2.0,3,1,4140,0.0,2013,2150,9663,3353 days 16:47:18.696823,084,1.2307692307692308,0.0,1990,1344,4140.0
215000.0,3,2.5,1322,6006,2.0,3,7,1322,0.0,2009,1440,6796,4814 days 16:47:18.696823,344,1.2,0.0,-118,-790,1322.0
630500.0,3,2.5,1909,1300,3.0,3,8,1766,143.0,2006,1780,1248,5910 days 16:47:18.696823,328,1.2,12.34965034965035,129,52,1623.0
855000.0,4,3.5,3460,7702,2.0,3,1,3460,0.0,2010,3380,7464,4449 days 16:47:18.696823,311,1.1428571428571428,0.0,80,238,3460.0
235245.0,4,2.5,1954,5075,2.0,3,8,1954,0.0,2007,1934,5000,5545 days 16:47:18.696823,027,1.6,0.0,20,75,1954.0
770000.0,5,2.5,3000,7912,1.0,3,9,1610,1390.0,2007,2700,7205,5545 days 16:47:18.696823,191,2.0,1.158273381294964,300,707,220.0
734990.0,4,2.5,2650,6884,2.0,3,8,2650,0.0,2012,2520,5866,3719 days 16:47:18.696823,170,1.6,0.0,130,1018,2650.0
880000.0,4,2.5,2580,3436,2.0,3,8,2580,0.0,2013,1780,5772,3353 days 16:47:18.696823,009,1.6,0.0,800,-2336,2580.0
525000.0,4,3.0,2650,4924,2.0,3,8,2650,0.0,2011,2380,4733,4084 days 16:47:18.696823,014,1.3333333333333333,0.0,270,191,2650.0
775000.0,4,3.5,3390,3960,2.0,3,1,3390,0.0,2008,2990,3400,5180 days 16:47:18.696823,219,1.1428571428571428,0.0,400,560,3390.0
687015.0,3,1.75,1470,873,3.0,3,1,1470,0.0,2009,1410,967,4814 days 16:47:18.696823,120,1.7142857142857142,0.0,60,-94,1470.0
663000.0,3,2.5,1910,5125,2.0,3,9,1910,0.0,2006,1910,3215,5910 days 16:47:18.696823,316,1.2,0.0,0,1910,1910.0
815000.0,4,2.5,3030,7187,2.0,3,9,3030,0.0,2005,3030,7187,6275 days 16:47:18.696823,089,1.6,0.0,0,0,3030.0
1050000.0,4,3.25,2930,25020,2.0,3,9,2930,0.0,2013,2400,32374,3353 days 16:47:18.696823,117,1.2307692307692308,0.0,530,-7354,2930.0
433190.0,3,2.5,1650,2787,2.0,3,8,1650,0.0,2014,1760,2787,2988 days 16:47:18.696823,113,1.2,0.0,-110,0,1650.0
725000.0,4,2.5,2870,5118,2.0,3,9,2870,0.0,2006,2940,4800,5910 days 16:47:18.696823,344,1.6,0.0,-70,318,2870.0
279950.0,3,2.5,1608,4800,2.0,3,8,1608,0.0,2013,2009,4800,3353 days 16:47:18.696823,098,1.2,0.0,-401,0,1608.0
272167.0,2,2.5,1620,3795,2.0,3,7,1620,0.0,2014,1620,6000,2988 days 16:47:18.696823,086,0.8,0.0,0,-2205,1620.0
468500.0,3,2.5,1350,1186,2.0,3,8,1120,230.0,2007,1500,1605,5545 days 16:47:18.696823,167,1.2,4.869565217391305,-150,-419,890.0
298000.0,3,2.5,1950,3600,2.0,3,7,1950,0.0,2010,1870,4184,4449 days 16:47:18.696823,153,1.2,0.0,80,-584,1950.0
303500.0,6,4.5,3390,7200,2.0,3,8,2440,950.0,2007,2040,7214,5545 days 16:47:18.696823,014,1.3333333333333333,2.568421052631579,1350,-14,1490.0
308000.0,3,1.75,1300,1237,2.0,3,7,1060,240.0,2008,1350,942,5180 days 16:47:18.696823,100,1.7142857142857142,4.416666666666667,-50,295,820.0
646800.0,3,3.0,2230,1407,2.5,3,8,1850,380.0,2014,2230,1407,2988 days 16:47:18.696823,105,1.0,4.868421052631579,0,0,1470.0
530200.0,4,2.5,1880,3853,2.0,3,8,1880,0.0,2010,1890,3078,4449 days 16:47:18.696823,002,1.6,0.0,-10,775,1880.0
405000.0,5,2.5,3370,5092,2.0,3,7,3370,0.0,2006,2910,5092,5910 days 16:47:18.696823,316,2.0,0.0,460,0,3370.0
529000.0,2,2.5,1320,1395,2.0,3,8,990,330.0,2014,1550,1519,2988 days 16:47:18.696823,205,0.8,3.0,-230,-124,660.0
675900.0,3,2.5,2920,9096,2.0,3,9,2920,0.0,2013,2930,7995,3353 days 16:47:18.696823,251,1.2,0.0,-10,1101,2920.0
570000.0,3,3.25,1550,1280,2.0,3,9,1220,330.0,2013,1550,1579,3353 days 16:47:18.696823,092,0.9230769230769231,3.696969696969697,0,-299,890.0
375500.0,4,2.5,2301,6452,2.0,3,9,2301,0.0,2010,2650,6054,4449 days 16:47:18.696823,360,1.6,0.0,-349,398,2301.0
445000.0,3,3.25,1710,1960,2.0,3,8,1360,350.0,2004,1420,955,6641 days 16:47:18.696823,294,0.9230769230769231,3.8857142857142857,290,1005,1010.0
1100000.0,4,3.75,2890,4164,2.0,3,9,2240,650.0,2013,2354,3207,3353 days 16:47:18.696823,005,1.0666666666666667,3.4461538461538463,536,957,1590.0
477000.0,3,2.5,2100,5060,2.0,3,7,2100,0.0,2006,1520,2468,5910 days 16:47:18.696823,237,1.2,0.0,580,2592,2100.0
450000.0,3,2.75,2240,3360,2.0,3,8,2100,140.0,2014,1790,5873,2988 days 16:47:18.696823,325,1.0909090909090908,15.0,450,-2513,1960.0
427005.0,3,3.0,1460,1200,3.0,3,8,1460,0.0,2006,1460,1245,5910 days 16:47:18.696823,085,1.0,0.0,0,-45,1460.0
720000.0,3,1.75,1370,1990,3.0,3,9,1370,0.0,2014,1730,1990,2988 days 16:47:18.696823,055,1.7142857142857142,0.0,-360,0,1370.0
2230000.0,3,3.5,3760,5634,2.0,3,1,2830,930.0,2014,3560,5762,2988 days 16:47:18.696823,281,0.8571428571428571,3.043010752688172,200,-128,1900.0
450800.0,4,3.25,2510,5311,2.0,3,9,2510,0.0,2009,1590,9583,4814 days 16:47:18.696823,147,1.2307692307692308,0.0,920,-4272,2510.0
461100.0,2,2.25,1210,1267,2.0,3,8,1120,90.0,2010,1360,1349,4449 days 16:47:18.696823,241,0.8888888888888888,12.444444444444445,-150,-82,1030.0
1060000.0,4,3.0,2990,6695,2.0,3,1,2990,0.0,2014,2760,6600,2988 days 16:47:18.696823,274,1.3333333333333333,0.0,230,95,2990.0
590000.0,3,2.5,1710,2875,2.0,3,8,1710,0.0,2006,1640,5750,5910 days 16:47:18.696823,098,1.2,0.0,70,-2875,1710.0
478830.0,4,2.5,3274,4950,2.0,3,9,3274,0.0,2014,2578,4200,2988 days 16:47:18.696823,197,1.6,0.0,696,750,3274.0
760000.0,4,2.25,3300,8365,3.0,3,9,3300,0.0,2014,1290,8369,2988 days 16:47:18.696823,190,1.7777777777777777,0.0,2010,-4,3300.0
1030000.0,4,3.5,4370,10860,2.0,3,1,4370,0.0,2008,3560,8070,5180 days 16:47:18.696823,184,1.1428571428571428,0.0,810,2790,4370.0
385000.0,4,2.5,2050,5276,2.0,3,7,2050,0.0,2006,2480,5447,5910 days 16:47:18.696823,164,1.6,0.0,-430,-171,2050.0
500000.0,2,2.5,1310,1500,2.0,3,8,1160,150.0,2006,1320,1581,5910 days 16:47:18.696823,136,0.8,7.733333333333333,-10,-81,1010.0
425000.0,3,1.5,1680,8000,1.5,3,7,1680,0.0,2012,1990,26336,3719 days 16:47:18.696823,105,2.0,0.0,-310,-18336,1680.0
552100.0,3,3.0,1330,1379,2.0,4,8,1120,210.0,2005,1810,1770,6275 days 16:47:18.696823,248,1.0,5.333333333333333,-480,-391,910.0
785000.0,3,3.0,1950,1983,3.0,3,9,1610,340.0,2009,2040,2131,4814 days 16:47:18.696823,363,1.0,4.735294117647059,-90,-148,1270.0
615000.0,5,3.25,3090,7069,2.0,3,9,3090,0.0,2012,2480,8000,3719 days 16:47:18.696823,082,1.5384615384615385,0.0,610,-931,3090.0
309000.0,3,2.5,1950,3825,2.0,3,7,1950,0.0,2013,1950,3825,3353 days 16:47:18.696823,113,1.2,0.0,0,0,1950.0
369500.0,3,2.0,1108,1128,3.0,3,7,1108,0.0,2009,1285,1253,4814 days 16:47:18.696823,051,1.5,0.0,-177,-125,1108.0
391000.0,4,2.25,2190,3850,2.0,3,7,2190,0.0,2006,2190,3980,5910 days 16:47:18.696823,042,1.7777777777777777,0.0,0,-130,2190.0
465000.0,3,1.75,1590,1322,2.0,3,8,1060,530.0,2014,1530,5400,2988 days 16:47:18.696823,302,1.7142857142857142,2.0,60,-4078,530.0
879950.0,4,2.75,3010,7215,2.0,3,9,3010,0.0,2014,3010,7215,2988 days 16:47:18.696823,157,1.4545454545454546,0.0,0,0,3010.0
372000.0,3,2.0,1330,1042,2.0,3,8,1060,270.0,2014,1440,2428,2988 days 16:47:18.696823,296,1.5,3.925925925925926,-110,-1386,790.0
259000.0,3,2.5,1550,3569,2.0,3,7,1550,0.0,2011,2095,3402,4084 days 16:47:18.696823,142,1.2,0.0,-545,167,1550.0
374000.0,2,1.5,1260,1575,2.0,3,7,1260,0.0,2001,1220,1740,7736 days 16:47:18.696823,188,1.3333333333333333,0.0,40,-165,1260.0
561000.0,4,2.5,2550,5395,2.0,3,8,2550,0.0,2001,2850,6109,7736 days 16:47:18.696823,064,1.6,0.0,-300,-714,2550.0
610000.0,3,2.5,1300,1331,3.0,3,8,1300,0.0,2007,1450,5270,5545 days 16:47:18.696823,093,1.2,0.0,-150,-3939,1300.0
635000.0,3,3.0,2230,1407,2.5,3,8,1850,380.0,2014,2290,1407,2988 days 16:47:18.696823,008,1.0,4.868421052631579,-60,0,1470.0
623300.0,4,3.5,4170,4524,2.0,3,9,3500,670.0,2007,3510,5001,5545 days 16:47:18.696823,197,1.1428571428571428,5.223880597014926,660,-477,2830.0
412500.0,3,2.0,1680,5246,1.0,3,7,1680,0.0,2007,2430,6883,5545 days 16:47:18.696823,296,1.5,0.0,-750,-1637,1680.0
380000.0,4,3.25,2864,8035,3.0,3,8,2864,0.0,2014,2419,8984,2988 days 16:47:18.696823,325,1.2307692307692308,0.0,445,-949,2864.0
497000.0,3,2.25,1630,3817,2.0,3,7,1630,0.0,2005,1630,3348,6275 days 16:47:18.696823,174,1.3333333333333333,0.0,0,469,1630.0
452000.0,4,2.5,2716,7850,2.0,3,9,2716,0.0,2014,2580,14448,2988 days 16:47:18.696823,315,1.6,0.0,136,-6598,2716.0
312000.0,3,2.5,1750,4076,2.0,3,7,1750,0.0,2013,1810,4090,3353 days 16:47:18.696823,298,1.2,0.0,-60,-14,1750.0
469950.0,5,3.0,3223,6371,2.0,3,9,3223,0.0,2014,1979,19030,2988 days 16:47:18.696823,262,1.6666666666666667,0.0,1244,-12659,3223.0
775000.0,5,2.5,2600,4284,2.0,3,9,2600,0.0,2014,1620,5000,2988 days 16:47:18.696823,217,2.0,0.0,980,-716,2600.0
679990.0,4,2.75,3320,8653,2.0,3,8,3320,0.0,2014,2140,8727,2988 days 16:47:18.696823,117,1.4545454545454546,0.0,1180,-74,3320.0
288790.0,4,2.0,1350,942,3.0,3,7,1350,0.0,2008,1390,942,5180 days 16:47:18.696823,178,2.0,0.0,-40,0,1350.0
800000.0,5,2.5,3410,4726,2.0,3,9,3410,0.0,2007,2810,5129,5545 days 16:47:18.696823,098,2.0,0.0,600,-403,3410.0
299000.0,3,2.5,1572,4000,2.0,3,8,1572,0.0,2013,1608,5175,3353 days 16:47:18.696823,117,1.2,0.0,-36,-1175,1572.0
332000.0,4,2.5,2300,4482,2.0,3,7,2300,0.0,2013,2300,3825,3353 days 16:47:18.696823,029,1.6,0.0,0,657,2300.0
525000.0,1,1.5,1030,5923,1.0,3,8,1030,0.0,1940,2650,5000,30017 days 16:47:18.697822,110,0.6666666666666666,0.0,-1620,923,1030.0
620000.0,3,1.75,1458,858,2.0,3,8,950,508.0,2014,1458,3000,2988 days 16:47:18.697822,246,1.7142857142857142,1.8700787401574803,0,-2142,442.0
452000.0,4,2.5,2190,6896,2.0,3,7,2190,0.0,2007,2190,5900,5545 days 16:47:18.697822,307,1.6,0.0,0,996,2190.0
630000.0,4,3.0,3640,5096,2.0,3,8,2740,900.0,2010,1910,9189,4449 days 16:47:18.697822,301,1.3333333333333333,3.0444444444444443,1730,-4093,1840.0
485000.0,4,2.75,2790,7803,2.0,3,8,2790,0.0,2013,2620,6178,3353 days 16:47:18.697822,205,1.4545454545454546,0.0,170,1625,2790.0
349950.0,4,2.5,2632,4117,2.0,3,8,2632,0.0,2013,2040,5195,3353 days 16:47:18.697822,286,1.6,0.0,592,-1078,2632.0
499990.0,4,2.75,2910,6334,2.0,3,8,2910,0.0,2013,2790,6352,3353 days 16:47:18.697822,182,1.4545454545454546,0.0,120,-18,2910.0
510000.0,2,2.25,1470,1101,2.0,3,8,1340,130.0,2005,1470,1582,6275 days 16:47:18.697822,339,0.8888888888888888,10.307692307692308,0,-481,1210.0
1080000.0,3,2.5,2240,21477,2.0,3,8,2240,0.0,1995,2930,21569,9928 days 16:47:18.697822,062,1.2,0.0,-690,-92,2240.0
494000.0,3,2.5,2310,4729,2.0,3,8,2310,0.0,2011,2440,4711,4084 days 16:47:18.697822,128,1.2,0.0,-130,18,2310.0
429900.0,3,2.5,2370,5353,2.0,3,8,2370,0.0,2009,2130,6850,4814 days 16:47:18.697822,177,1.2,0.0,240,-1497,2370.0
505000.0,4,2.75,2980,9825,1.0,3,8,1910,1070.0,2007,2580,12231,5545 days 16:47:18.697822,288,1.4545454545454546,1.7850467289719627,400,-2406,840.0
671500.0,3,2.5,1770,1714,3.0,3,8,1770,0.0,2012,1720,3360,3719 days 16:47:18.697822,041,1.2,0.0,50,-1646,1770.0
729950.0,4,3.5,3510,10010,2.0,3,1,3510,0.0,2001,4200,9935,7736 days 16:47:18.697822,070,1.1428571428571428,0.0,-690,75,3510.0
471835.0,4,2.5,3281,5354,2.0,3,9,3281,0.0,2014,2598,4815,2988 days 16:47:18.697822,202,1.6,0.0,683,539,3281.0
249950.0,3,2.0,1670,4438,1.0,3,7,1670,0.0,2014,1670,4558,2988 days 16:47:18.697822,307,1.5,0.0,0,-120,1670.0
424950.0,5,3.5,2760,3846,2.5,3,8,2760,0.0,2013,2760,4587,3353 days 16:47:18.697822,220,1.4285714285714286,0.0,0,-741,2760.0
1240000.0,5,3.5,5430,10327,2.0,3,1,4010,1420.0,2007,4340,10324,5545 days 16:47:18.697822,190,1.4285714285714286,2.823943661971831,1090,3,2590.0
440000.0,4,2.5,2990,7928,2.0,3,9,2990,0.0,2011,2810,7401,4084 days 16:47:18.697822,254,1.6,0.0,180,527,2990.0
495000.0,4,3.5,3170,3858,2.0,3,8,2530,640.0,2008,2640,3844,5180 days 16:47:18.697822,098,1.1428571428571428,3.953125,530,14,1890.0
870000.0,4,2.5,3520,6773,2.5,3,9,2650,870.0,2006,2930,6458,5910 days 16:47:18.697822,133,1.6,3.045977011494253,590,315,1780.0
559000.0,2,3.0,1650,960,3.0,3,8,1350,300.0,2015,1650,3000,2623 days 16:47:18.697822,329,0.6666666666666666,4.5,0,-2040,1050.0
495000.0,4,2.75,2656,21195,2.0,3,9,2656,0.0,2014,1860,16510,2988 days 16:47:18.697822,127,1.4545454545454546,0.0,796,4685,2656.0
567500.0,3,2.5,2280,2502,2.0,3,8,1880,400.0,2006,2280,2812,5910 days 16:47:18.697822,183,1.2,4.7,0,-310,1480.0
440000.0,4,2.5,2798,5085,2.0,3,9,2798,0.0,2011,2502,5707,4084 days 16:47:18.697822,351,1.6,0.0,296,-622,2798.0
400000.0,4,2.5,2398,5988,2.0,3,8,2398,0.0,2008,2370,5988,5180 days 16:47:18.697822,241,1.6,0.0,28,0,2398.0
459995.0,4,2.5,2350,3760,2.0,3,8,2350,0.0,2014,2590,4136,2988 days 16:47:18.697822,279,1.6,0.0,-240,-376,2350.0
365000.0,5,2.75,2410,5003,1.0,3,7,1410,1000.0,2008,1590,5003,5180 days 16:47:18.697822,127,1.8181818181818181,1.41,820,0,410.0
389950.0,3,2.25,1580,920,3.0,3,8,1580,0.0,2015,1250,1150,2623 days 16:47:18.697822,107,1.3333333333333333,0.0,330,-230,1580.0
320000.0,3,3.25,1450,1387,2.0,3,8,1180,270.0,2013,1450,1198,3353 days 16:47:18.697822,189,0.9230769230769231,4.37037037037037,0,189,910.0
415500.0,4,2.5,1750,4779,2.0,3,7,1750,0.0,2009,1580,4687,4814 days 16:47:18.697822,164,1.6,0.0,170,92,1750.0
775000.0,3,2.5,3020,4120,2.0,3,9,2360,660.0,2008,2280,4120,5180 days 16:47:18.697822,068,1.2,3.5757575757575757,740,0,1700.0
590000.0,3,3.0,1740,1100,3.0,3,8,1740,0.0,2007,1370,1180,5545 days 16:47:18.697822,070,1.0,0.0,370,-80,1740.0
950000.0,2,2.25,2200,2043,2.0,3,9,1760,440.0,2007,2020,1957,5545 days 16:47:18.697822,023,0.8888888888888888,4.0,180,86,1320.0
378950.0,4,2.5,1867,15314,2.0,3,9,1867,0.0,2013,2616,8048,3353 days 16:47:18.697822,218,1.6,0.0,-749,7266,1867.0
441750.0,2,1.5,1020,1060,3.0,3,8,1020,0.0,2008,1340,1415,5180 days 16:47:18.697822,128,1.3333333333333333,0.0,-320,-355,1020.0
335900.0,4,2.75,2475,4000,2.0,3,7,2475,0.0,2014,2475,4000,2988 days 16:47:18.697822,304,1.4545454545454546,0.0,0,0,2475.0
229800.0,2,1.75,1110,1773,2.0,3,8,1110,0.0,2014,1420,2855,2988 days 16:47:18.697822,178,1.1428571428571428,0.0,-310,-1082,1110.0
645000.0,3,2.5,1900,1258,2.5,3,7,1700,200.0,2007,1780,1877,5545 days 16:47:18.697822,069,1.2,8.5,120,-619,1500.0
448000.0,3,3.25,1560,1345,2.0,3,8,1260,300.0,2009,1560,4800,4814 days 16:47:18.697822,113,0.9230769230769231,4.2,0,-3455,960.0
706000.0,4,2.5,2510,5436,2.0,3,8,2510,0.0,2011,2520,5436,4084 days 16:47:18.697822,350,1.6,0.0,-10,0,2510.0
988990.0,4,4.75,4150,6303,3.0,3,9,4150,0.0,2014,3570,6285,2988 days 16:47:18.697822,058,0.8421052631578947,0.0,580,18,4150.0
716000.0,3,3.0,1660,1849,3.0,3,9,1660,0.0,2013,1660,3300,3353 days 16:47:18.697822,197,1.0,0.0,0,-1451,1660.0
319000.0,2,1.5,1090,847,3.0,3,8,1090,0.0,2009,1090,1118,4814 days 16:47:18.697822,111,1.3333333333333333,0.0,0,-271,1090.0
300000.0,4,2.5,1914,3272,2.0,3,8,1914,0.0,2009,1714,3250,4814 days 16:47:18.697822,287,1.6,0.0,200,22,1914.0
625000.0,4,3.25,2730,54014,1.0,3,9,1560,1170.0,2007,2730,111274,5545 days 16:47:18.697822,122,1.2307692307692308,1.3333333333333333,0,-57260,390.0
773000.0,3,2.75,2470,3600,2.0,3,9,2470,0.0,2007,2570,3600,5545 days 16:47:18.697822,134,1.0909090909090908,0.0,-100,0,2470.0
392000.0,5,2.5,2340,5670,2.0,3,7,2340,0.0,2009,2190,4869,4814 days 16:47:18.697822,268,2.0,0.0,150,801,2340.0
549995.0,4,3.5,2660,5690,2.0,3,8,1920,740.0,2014,2970,5690,2988 days 16:47:18.697822,254,1.1428571428571428,2.5945945945945947,-310,0,1180.0
480000.0,3,2.5,2410,4656,2.0,3,7,2410,0.0,2009,2410,4840,4814 days 16:47:18.697822,263,1.2,0.0,0,-184,2410.0
355000.0,3,2.25,1430,4777,2.0,3,7,1430,0.0,2010,1639,3854,4449 days 16:47:18.697822,293,1.3333333333333333,0.0,-209,923,1430.0
208400.0,2,2.5,1570,1268,3.0,3,7,1570,0.0,2007,1570,1300,5545 days 16:47:18.697822,364,0.8,0.0,0,-32,1570.0
831548.0,5,2.75,3010,4919,2.0,3,9,3010,0.0,2014,3230,5415,2988 days 16:47:18.697822,234,1.8181818181818181,0.0,-220,-496,3010.0
279500.0,4,2.5,1613,4338,2.0,3,7,1613,0.0,2009,1427,4341,4814 days 16:47:18.697822,321,1.6,0.0,186,-3,1613.0
445000.0,3,2.5,2380,5269,2.0,3,8,2380,0.0,2008,2150,7600,5180 days 16:47:18.697822,058,1.2,0.0,230,-2331,2380.0
492500.0,5,2.5,2570,9962,2.0,3,8,2570,0.0,2006,2890,9075,5910 days 16:47:18.697822,167,2.0,0.0,-320,887,2570.0
435000.0,4,2.5,2550,5200,2.0,3,7,2550,0.0,2009,2550,4660,4814 days 16:47:18.697822,190,1.6,0.0,0,540,2550.0
325000.0,3,2.25,1330,969,3.0,3,7,1330,0.0,2007,1310,1941,5545 days 16:47:18.697822,132,1.3333333333333333,0.0,20,-972,1330.0
453000.0,2,1.5,1160,1269,2.0,3,7,970,190.0,2005,1700,3150,6275 days 16:47:18.697822,321,1.3333333333333333,5.105263157894737,-540,-1881,780.0
612995.0,5,3.5,3240,6919,2.0,3,8,2760,480.0,2014,2970,5690,2988 days 16:47:18.697822,234,1.4285714285714286,5.75,270,1229,2280.0
540000.0,4,2.5,2710,9248,2.0,3,7,2710,0.0,2011,2710,5000,4084 days 16:47:18.697822,247,1.6,0.0,0,4248,2710.0
465000.0,3,1.0,1150,18200,1.0,5,7,1150,0.0,1959,1714,18200,23077 days 16:47:18.697822,119,3.0,0.0,-564,0,1150.0
799950.0,3,2.25,1860,1386,3.0,3,9,1860,0.0,2014,1680,3080,2988 days 16:47:18.697822,224,1.3333333333333333,0.0,180,-1694,1860.0
495000.0,3,2.25,1280,1517,2.0,3,8,1080,200.0,2008,1280,1681,5180 days 16:47:18.697822,328,1.3333333333333333,5.4,0,-164,880.0
579950.0,3,2.5,1810,1585,3.0,3,7,1810,0.0,2014,1560,1586,2988 days 16:47:18.697822,059,1.2,0.0,250,-1,1810.0
331000.0,2,2.25,1240,720,2.0,3,7,1150,90.0,2008,1260,810,5180 days 16:47:18.697822,051,0.8888888888888888,12.777777777777779,-20,-90,1060.0
580000.0,4,3.5,1460,951,3.0,3,8,1460,0.0,2008,1430,1282,5180 days 16:47:18.697822,237,1.1428571428571428,0.0,30,-331,1460.0
669000.0,2,2.5,1640,1953,2.0,3,1,1640,0.0,2014,1820,2653,2988 days 16:47:18.697822,104,0.8,0.0,-180,-700,1640.0
2350000.0,4,4.25,5010,19412,2.0,3,1,4000,1010.0,2014,3820,17064,2988 days 16:47:18.697822,184,0.9411764705882353,3.9603960396039604,1190,2348,2990.0
539900.0,3,3.25,1300,1325,2.0,3,8,1080,220.0,2005,1290,1323,6275 days 16:47:18.697822,016,0.9230769230769231,4.909090909090909,10,2,860.0
490000.0,4,2.5,2510,4349,2.0,3,8,2510,0.0,2010,2510,4314,4449 days 16:47:18.697822,204,1.6,0.0,0,35,2510.0
627000.0,3,3.5,2710,3475,2.0,3,8,1650,1060.0,2005,2440,2867,6275 days 16:47:18.697822,147,0.8571428571428571,1.5566037735849056,270,608,590.0
458000.0,4,3.5,3217,4000,2.0,3,8,2587,630.0,2008,2996,5418,5180 days 16:47:18.697822,209,1.1428571428571428,4.106349206349206,221,-1418,1957.0
440000.0,3,2.5,1650,4929,2.0,3,7,1520,130.0,2007,1520,2287,5545 days 16:47:18.697822,314,1.2,11.692307692307692,130,2642,1390.0
1700000.0,4,3.5,3950,6240,2.0,3,1,3950,0.0,2015,2040,6240,2623 days 16:47:18.697822,069,1.1428571428571428,0.0,1910,0,3950.0
935000.0,2,2.5,1680,977,3.0,3,9,1680,0.0,2009,1680,977,4814 days 16:47:18.697822,131,0.8,0.0,0,0,1680.0
641000.0,5,3.5,3420,6403,2.0,3,8,2700,720.0,2013,2710,6038,3353 days 16:47:18.697822,107,1.4285714285714286,3.75,710,365,1980.0
452000.0,3,2.75,2300,5090,2.0,3,8,1700,600.0,2007,1530,9100,5545 days 16:47:18.697822,254,1.0909090909090908,2.8333333333333335,770,-4010,1100.0
625000.0,4,2.75,3010,6854,2.0,3,9,2570,440.0,2012,1830,2952,3719 days 16:47:18.697822,357,1.4545454545454546,5.840909090909091,1180,3902,2130.0
1350000.0,4,3.5,4680,12495,2.0,3,1,3040,1640.0,2008,3240,10749,5180 days 16:47:18.697822,062,1.1428571428571428,1.853658536585366,1440,1746,1400.0
834950.0,5,3.5,3630,4911,2.0,3,9,2790,840.0,2014,3600,4992,2988 days 16:47:18.697822,251,1.4285714285714286,3.3214285714285716,30,-81,1950.0
1500000.0,3,3.5,3530,3610,2.0,3,1,2370,1160.0,2008,1780,3610,5180 days 16:47:18.697822,301,0.8571428571428571,2.043103448275862,1750,0,1210.0
305000.0,4,2.5,2280,3800,2.0,3,7,2280,0.0,2006,2630,4045,5910 days 16:47:18.697822,237,1.6,0.0,-350,-245,2280.0
659000.0,3,2.5,3090,384634,2.0,3,8,3090,0.0,2007,2200,292645,5545 days 16:47:18.697822,316,1.2,0.0,890,91989,3090.0
353000.0,1,1.0,550,1279,2.0,3,7,550,0.0,2008,1460,1385,5180 days 16:47:18.697822,142,1.0,0.0,-910,-106,550.0
535000.0,4,3.25,2840,4000,2.0,3,9,2330,510.0,2014,2160,4867,2988 days 16:47:18.697822,063,1.2307692307692308,4.568627450980392,680,-867,1820.0
999000.0,4,2.5,3130,10849,2.0,3,1,3130,0.0,2013,2470,9131,3353 days 16:47:18.697822,189,1.6,0.0,660,1718,3130.0
375000.0,3,2.5,1440,1102,3.0,3,8,1440,0.0,2009,1440,1434,4814 days 16:47:18.697822,029,1.2,0.0,0,-332,1440.0
685000.0,4,3.5,2840,4637,3.0,3,8,2840,0.0,2008,1730,5279,5180 days 16:47:18.697822,167,1.1428571428571428,0.0,1110,-642,2840.0
333000.0,4,2.5,2623,7184,2.0,3,8,2623,0.0,2012,2010,4939,3719 days 16:47:18.697822,220,1.6,0.0,613,2245,2623.0
245000.0,1,1.0,390,2000,1.0,4,6,390,0.0,1920,1340,5100,37322 days 16:47:18.697822,131,1.0,0.0,-950,-3100,390.0
2000000.0,4,3.25,5640,35006,2.0,3,1,4900,740.0,2015,4920,35033,2623 days 16:47:18.697822,128,1.2307692307692308,6.621621621621622,720,-27,4160.0
329950.0,2,2.25,1260,1032,2.0,3,7,1170,90.0,2008,1240,809,5180 days 16:47:18.697822,288,0.8888888888888888,13.0,20,223,1080.0
403000.0,2,1.0,894,1552,2.0,3,7,894,0.0,2011,1131,1992,4084 days 16:47:18.697822,110,2.0,0.0,-237,-440,894.0
559630.0,4,2.5,3370,4934,2.0,3,9,3370,0.0,2014,2980,5046,2988 days 16:47:18.697822,315,1.6,0.0,390,-112,3370.0
344000.0,3,2.25,1250,871,3.0,3,8,1250,0.0,2007,1250,1158,5545 days 16:47:18.697822,230,1.3333333333333333,0.0,0,-287,1250.0
435000.0,3,1.5,1180,1231,3.0,3,7,1180,0.0,2008,1280,3360,5180 days 16:47:18.697822,092,2.0,0.0,-100,-2129,1180.0
430000.0,2,2.5,1520,1588,2.0,3,8,1240,280.0,2007,1660,6000,5545 days 16:47:18.697822,142,0.8,4.428571428571429,-140,-4412,960.0
417000.0,3,2.5,2000,4500,2.0,3,7,2000,0.0,2010,2230,4501,4449 days 16:47:18.697822,321,1.2,0.0,-230,-1,2000.0
895950.0,5,2.75,3180,9255,2.0,3,9,3180,0.0,2014,3180,7782,2988 days 16:47:18.697822,099,1.8181818181818181,0.0,0,1473,3180.0
563950.0,4,2.75,3050,4750,2.0,3,8,3050,0.0,2014,2730,5480,2988 days 16:47:18.697822,078,1.4545454545454546,0.0,320,-730,3050.0
332220.0,3,1.5,2580,47480,1.0,3,7,1360,1220.0,1953,1760,48181,25268 days 16:47:18.697822,268,2.0,1.1147540983606556,820,-701,140.0
1490000.0,5,6.0,6880,279968,2.0,3,1,4070,2810.0,2007,4690,256803,5545 days 16:47:18.697822,234,0.8333333333333334,1.4483985765124556,2190,23165,1260.0
680000.0,3,2.5,2570,3600,2.5,3,9,2570,0.0,2007,2570,3600,5545 days 16:47:18.697822,163,1.2,0.0,0,0,2570.0
825750.0,4,3.5,2950,3737,2.0,3,1,2270,680.0,2012,2580,3581,3719 days 16:47:18.697822,040,1.1428571428571428,3.338235294117647,370,156,1590.0
338000.0,3,2.5,1690,1760,2.0,3,8,1410,280.0,2014,1740,1760,2988 days 16:47:18.697822,343,1.2,5.035714285714286,-50,0,1130.0
535365.0,4,2.75,2790,6969,2.0,3,8,2790,0.0,2012,2620,6307,3719 days 16:47:18.697822,199,1.4545454545454546,0.0,170,662,2790.0
608000.0,3,2.25,1720,5234,2.0,3,9,1240,480.0,2011,1720,5825,4084 days 16:47:18.697822,345,1.3333333333333333,2.5833333333333335,0,-591,760.0
930000.0,3,2.25,2890,5000,3.0,3,9,2890,0.0,2014,2020,5000,2988 days 16:47:18.697822,289,1.3333333333333333,0.0,870,0,2890.0
565000.0,2,1.75,1130,276170,1.0,3,8,1130,0.0,2006,2092,217800,5910 days 16:47:18.697822,294,1.1428571428571428,0.0,-962,58370,1130.0
495000.0,2,2.25,1460,1623,2.0,3,8,1260,200.0,2005,1460,1137,6275 days 16:47:18.697822,353,0.8888888888888888,6.3,0,486,1060.0
667000.0,3,2.5,2510,3819,2.0,3,8,2510,0.0,2007,2520,3990,5545 days 16:47:18.697822,203,1.2,0.0,-10,-171,2510.0
495000.0,4,2.5,3390,7870,2.0,3,8,3390,0.0,2014,1960,10069,2988 days 16:47:18.697822,316,1.6,0.0,1430,-2199,3390.0
928990.0,4,2.5,3570,6054,2.0,3,9,3570,0.0,2014,3600,6050,2988 days 16:47:18.697822,272,1.6,0.0,-30,4,3570.0
345000.0,4,2.5,2280,5000,2.0,3,7,2280,0.0,2006,2910,5000,5910 days 16:47:18.697822,181,1.6,0.0,-630,0,2280.0
1070000.0,5,3.5,2920,3000,2.0,3,9,2260,660.0,2014,1580,4000,2988 days 16:47:18.697822,350,1.4285714285714286,3.4242424242424243,1340,-1000,1600.0
519995.0,4,3.0,2590,6160,2.0,3,8,2590,0.0,2014,2670,5600,2988 days 16:47:18.697822,184,1.3333333333333333,0.0,-80,560,2590.0
924000.0,5,2.75,3210,8001,2.0,3,9,3210,0.0,2014,3190,6624,2988 days 16:47:18.697822,309,1.8181818181818181,0.0,20,1377,3210.0
295000.0,3,2.0,1230,3405,1.0,3,7,1230,0.0,2010,1440,4066,4449 days 16:47:18.697822,114,1.5,0.0,-210,-661,1230.0
472000.0,3,2.5,3800,104979,2.0,3,8,3210,590.0,2005,2040,109771,6275 days 16:47:18.697822,202,1.2,5.440677966101695,1760,-4792,2620.0
405000.0,3,2.5,1500,2314,2.0,3,7,1500,0.0,2005,1440,2170,6275 days 16:47:18.697822,213,1.2,0.0,60,144,1500.0
410000.0,4,2.25,2510,4090,2.0,3,8,1840,670.0,2012,2070,4090,3719 days 16:47:18.697822,199,1.7777777777777777,2.746268656716418,440,0,1170.0
419500.0,3,1.5,1400,1091,3.0,3,8,1400,0.0,2007,1270,1413,5545 days 16:47:18.697822,329,2.0,0.0,130,-322,1400.0
382000.0,3,2.25,1450,4667,2.0,3,7,1450,0.0,2009,1490,4667,4814 days 16:47:18.697822,246,1.3333333333333333,0.0,-40,0,1450.0
370000.0,2,2.5,1390,1821,2.0,3,7,1180,210.0,2007,1350,1821,5545 days 16:47:18.697822,055,0.8,5.619047619047619,40,0,970.0
553000.0,3,2.75,3160,9072,2.0,3,9,3160,0.0,2005,3160,9072,6275 days 16:47:18.697822,279,1.0909090909090908,0.0,0,0,3160.0
2070000.0,4,3.75,4350,7965,2.0,3,1,4350,0.0,2013,2190,8557,3353 days 16:47:18.697822,181,1.0666666666666667,0.0,2160,-592,4350.0
455950.0,4,2.5,2720,5771,2.0,3,8,2720,0.0,2015,1940,4184,2623 days 16:47:18.697822,091,1.6,0.0,780,1587,2720.0
331000.0,3,3.25,1290,1153,3.0,3,7,1290,0.0,2008,1290,1200,5180 days 16:47:18.697822,300,0.9230769230769231,0.0,0,-47,1290.0
417250.0,3,2.25,1606,1452,3.0,3,8,1606,0.0,2009,1516,1939,4814 days 16:47:18.697822,127,1.3333333333333333,0.0,90,-487,1606.0
705000.0,5,3.5,3250,4800,2.0,3,9,2410,840.0,2010,1330,4920,4449 days 16:47:18.697822,054,1.4285714285714286,2.869047619047619,1920,-120,1570.0
1170000.0,6,3.5,4310,7760,2.0,3,1,3260,1050.0,2013,4620,10217,3353 days 16:47:18.697822,198,1.7142857142857142,3.104761904761905,-310,-2457,2210.0
365000.0,3,2.25,1310,915,2.0,3,7,1060,250.0,2007,1500,1215,5545 days 16:47:18.697822,053,1.3333333333333333,4.24,-190,-300,810.0
403000.0,2,1.5,1240,1101,2.0,3,8,1080,160.0,2009,1530,1209,4814 days 16:47:18.697822,321,1.3333333333333333,6.75,-290,-108,920.0
409000.0,3,2.5,1950,7263,2.0,3,7,1950,0.0,2007,2190,5900,5545 days 16:47:18.697822,225,1.2,0.0,-240,1363,1950.0
391000.0,3,2.5,1800,1120,2.0,3,8,1800,0.0,2011,1800,2380,4084 days 16:47:18.697822,097,1.2,0.0,0,-1260,1800.0
542525.0,4,2.5,2650,5600,2.0,3,8,2650,0.0,2014,2650,5600,2988 days 16:47:18.697822,167,1.6,0.0,0,0,2650.0
499990.0,4,2.75,2620,7001,2.0,3,8,2620,0.0,2012,2620,6543,3719 days 16:47:18.697822,231,1.4545454545454546,0.0,0,458,2620.0
1770000.0,4,3.25,3980,10249,2.0,3,1,3980,0.0,2011,2450,10912,4084 days 16:47:18.697822,266,1.2307692307692308,0.0,1530,-663,3980.0
608000.0,3,3.5,1660,2298,2.0,3,8,1260,400.0,2009,1500,2198,4814 days 16:47:18.697822,082,0.8571428571428571,3.15,160,100,860.0
392000.0,4,2.5,2130,4028,2.0,3,8,2130,0.0,2014,1830,7817,2988 days 16:47:18.697822,071,1.6,0.0,300,-3789,2130.0
320000.0,3,1.75,1790,66250,1.5,3,7,1790,0.0,2003,1440,59346,7006 days 16:47:18.697822,107,1.7142857142857142,0.0,350,6904,1790.0
274800.0,3,1.75,1410,1988,2.0,3,8,1410,0.0,2014,1410,1899,2988 days 16:47:18.697822,107,1.7142857142857142,0.0,0,89,1410.0
325000.0,3,2.25,1330,1198,2.0,3,8,1080,250.0,2007,1260,1062,5545 days 16:47:18.697822,117,1.3333333333333333,4.32,70,136,830.0
418500.0,4,2.5,2190,4866,2.0,3,7,2190,0.0,2009,2190,5670,4814 days 16:47:18.697822,119,1.6,0.0,0,-804,2190.0
300000.0,3,2.5,2540,5050,2.0,3,7,2540,0.0,2006,2280,5050,5910 days 16:47:18.697822,122,1.2,0.0,260,0,2540.0
269950.0,3,2.5,2244,4079,2.0,3,7,2244,0.0,2012,2077,4078,3719 days 16:47:18.697822,005,1.2,0.0,167,1,2244.0
358000.0,3,2.5,2026,7611,2.0,3,8,2026,0.0,2010,2270,7611,4449 days 16:47:18.697822,126,1.2,0.0,-244,0,2026.0
350000.0,3,2.5,1730,4086,2.0,3,8,1730,0.0,2013,2030,4086,3353 days 16:47:18.697822,124,1.2,0.0,-300,0,1730.0
782000.0,4,3.5,3910,8095,2.0,3,9,3130,780.0,2007,3770,7021,5545 days 16:47:18.697822,148,1.1428571428571428,4.012820512820513,140,1074,2350.0
779000.0,3,2.5,1580,1487,3.0,3,9,1580,0.0,2009,1610,1297,4814 days 16:47:18.697822,258,1.2,0.0,-30,190,1580.0
685000.0,4,2.5,2510,3479,2.0,3,8,2510,0.0,2007,2540,4171,5545 days 16:47:18.697822,351,1.6,0.0,-30,-692,2510.0
305000.0,2,2.25,1000,905,3.0,3,8,1000,0.0,2006,980,1023,5910 days 16:47:18.697822,149,0.8888888888888888,0.0,20,-118,1000.0
350000.0,4,2.5,1660,2500,2.0,3,7,1660,0.0,2007,1030,5000,5545 days 16:47:18.697822,107,1.6,0.0,630,-2500,1660.0
775000.0,4,3.5,3060,4573,2.0,3,9,2410,650.0,2012,3170,3634,3719 days 16:47:18.697822,266,1.1428571428571428,3.707692307692308,-110,939,1760.0
317750.0,3,2.5,1980,4500,2.0,3,7,1980,0.0,2012,1980,4500,3719 days 16:47:18.697822,240,1.2,0.0,0,0,1980.0
438000.0,2,1.0,980,1179,2.0,3,8,980,0.0,2010,1190,1600,4449 days 16:47:18.697822,128,2.0,0.0,-210,-421,980.0
325000.0,2,2.5,1050,1609,2.0,3,7,1050,0.0,2005,1120,1693,6275 days 16:47:18.697822,148,0.8,0.0,-70,-84,1050.0
830000.0,4,3.25,3080,4287,2.0,3,1,2230,850.0,2012,2250,2520,3719 days 16:47:18.697822,118,1.2307692307692308,2.623529411764706,830,1767,1380.0
353000.0,3,2.25,1900,3800,2.0,3,7,1900,0.0,2006,1950,3800,5910 days 16:47:18.697822,265,1.3333333333333333,0.0,-50,0,1900.0
460000.0,4,2.5,2200,6400,2.0,3,8,2200,0.0,2010,2600,5870,4449 days 16:47:18.697822,206,1.6,0.0,-400,530,2200.0
370000.0,3,1.5,1360,1167,3.0,3,8,1360,0.0,2008,1360,1167,5180 days 16:47:18.697822,075,2.0,0.0,0,0,1360.0
330000.0,3,2.5,2238,7209,2.0,3,8,2238,0.0,2011,2456,7212,4084 days 16:47:18.697822,170,1.2,0.0,-218,-3,2238.0
569888.0,4,2.5,2590,6474,2.0,3,8,2590,0.0,2014,1960,8679,2988 days 16:47:18.697822,028,1.6,0.0,630,-2205,2590.0
353900.0,3,2.5,2517,3900,2.0,3,8,2517,0.0,2014,2390,7108,2988 days 16:47:18.697822,261,1.2,0.0,127,-3208,2517.0
695000.0,4,3.5,3510,9084,2.0,3,1,3510,0.0,2001,3690,9568,7736 days 16:47:18.697822,063,1.1428571428571428,0.0,-180,-484,3510.0
288790.0,3,1.75,1290,1237,2.0,3,7,1060,230.0,2008,1370,942,5180 days 16:47:18.697822,199,1.7142857142857142,4.608695652173913,-80,295,830.0
334950.0,5,3.0,2230,8642,1.0,3,7,1330,900.0,2014,2100,11056,2988 days 16:47:18.697822,044,1.6666666666666667,1.4777777777777779,130,-2414,430.0
869950.0,4,2.75,3140,7928,2.0,3,9,3140,0.0,2013,3500,7055,3353 days 16:47:18.697822,349,1.4545454545454546,0.0,-360,873,3140.0
557500.0,3,3.5,3350,5025,2.0,3,8,2670,680.0,2014,2030,5117,2988 days 16:47:18.697822,281,0.8571428571428571,3.926470588235294,1320,-92,1990.0
389990.0,4,2.5,2245,4330,2.0,3,8,2245,0.0,2014,2530,4478,2988 days 16:47:18.697822,262,1.6,0.0,-285,-148,2245.0
455000.0,3,1.75,1420,1189,3.0,3,8,1420,0.0,2006,1380,1196,5910 days 16:47:18.697822,155,1.7142857142857142,0.0,40,-7,1420.0
598500.0,3,3.0,1560,2091,3.0,3,8,1560,0.0,2006,1530,2091,5910 days 16:47:18.697822,303,1.0,0.0,30,0,1560.0
750000.0,4,2.75,2810,5497,2.0,3,9,2810,0.0,2011,2990,5842,4084 days 16:47:18.697822,061,1.4545454545454546,0.0,-180,-345,2810.0
729999.0,2,2.25,1630,1686,2.0,3,1,1330,300.0,2014,1570,2580,2988 days 16:47:18.697822,317,0.8888888888888888,4.433333333333334,60,-894,1030.0
299950.0,3,2.5,1740,4497,2.0,3,7,1740,0.0,2012,1950,4486,3719 days 16:47:18.697822,062,1.2,0.0,-210,11,1740.0
374950.0,3,2.25,1390,1484,3.0,3,8,1390,0.0,2007,1250,1087,5545 days 16:47:18.697822,190,1.3333333333333333,0.0,140,397,1390.0
386950.0,3,2.5,1070,1089,2.0,3,7,900,170.0,2009,1450,1437,4814 days 16:47:18.697822,050,1.2,5.294117647058823,-380,-348,730.0
535000.0,5,3.25,2850,4551,2.0,3,8,2370,480.0,2006,2850,4849,5910 days 16:47:18.697822,191,1.5384615384615385,4.9375,0,-298,1890.0
890000.0,5,3.25,4100,7578,2.0,3,1,4100,0.0,2011,3710,8156,4084 days 16:47:18.697822,243,1.5384615384615385,0.0,390,-578,4100.0
1050000.0,4,2.5,3260,5974,2.0,3,9,2820,440.0,2007,2260,6780,5545 days 16:47:18.697822,034,1.6,6.409090909090909,1000,-806,2380.0
1110000.0,4,3.5,3660,4760,2.0,3,9,2840,820.0,2014,3210,4640,2988 days 16:47:18.697822,288,1.1428571428571428,3.4634146341463414,450,120,2020.0
436952.0,4,2.5,2708,4772,2.0,3,9,2708,0.0,2014,2502,4900,2988 days 16:47:18.697822,276,1.6,0.0,206,-128,2708.0
365000.0,3,2.5,1800,2700,2.0,3,8,1800,0.0,2011,1580,2036,4084 days 16:47:18.697822,160,1.2,0.0,220,664,1800.0
288000.0,3,2.5,1150,887,3.0,3,7,1150,0.0,2007,1180,915,5545 days 16:47:18.697822,176,1.2,0.0,-30,-28,1150.0
700000.0,3,2.5,2230,4006,2.0,3,8,2230,0.0,2014,2230,4180,2988 days 16:47:18.697822,051,1.2,0.0,0,-174,2230.0
800000.0,4,3.25,3540,159430,2.0,3,9,3540,0.0,2007,1940,392040,5545 days 16:47:18.697822,129,1.2307692307692308,0.0,1600,-232610,3540.0
899000.0,4,3.5,2490,5500,2.0,3,9,1780,710.0,2015,1710,5500,2623 days 16:47:18.697822,131,1.1428571428571428,2.507042253521127,780,0,1070.0
465750.0,3,2.5,2670,4534,2.0,3,9,2670,0.0,2007,3040,5079,5545 days 16:47:18.697822,352,1.2,0.0,-370,-545,2670.0
485000.0,2,2.5,1430,923,3.0,3,8,1410,20.0,2008,1620,1505,5180 days 16:47:18.697822,169,0.8,70.5,-190,-582,1390.0
494995.0,5,2.75,2670,3800,2.0,3,8,2670,0.0,2014,2670,3800,2988 days 16:47:18.697822,154,1.8181818181818181,0.0,0,0,2670.0
255000.0,3,2.5,2555,5720,2.0,3,8,2555,0.0,2006,2844,5769,5910 days 16:47:18.697822,033,1.2,0.0,-289,-49,2555.0
530000.0,3,2.5,1970,6295,2.0,3,7,1970,0.0,2011,2710,6009,4084 days 16:47:18.697822,210,1.2,0.0,-740,286,1970.0
435000.0,3,2.0,1980,2674,3.0,3,8,1980,0.0,2007,1440,2674,5545 days 16:47:18.697822,167,1.5,0.0,540,0,1980.0
639000.0,3,2.5,2010,3300,2.0,3,9,1610,400.0,2014,1660,4950,2988 days 16:47:18.697822,223,1.2,4.025,350,-1650,1210.0
440000.0,3,1.5,1270,1413,3.0,3,8,1270,0.0,2007,1270,1413,5545 days 16:47:18.697822,190,2.0,0.0,0,0,1270.0
914500.0,4,2.5,3950,10856,3.0,3,1,3950,0.0,2013,3200,10856,3353 days 16:47:18.697822,135,1.6,0.0,750,0,3950.0
580000.0,3,2.0,1870,5300,1.0,3,8,1870,0.0,2009,1870,5050,4814 days 16:47:18.697822,309,1.5,0.0,0,250,1870.0
250000.0,1,1.5,1180,1688,2.0,3,8,1070,110.0,2007,1380,2059,5545 days 16:47:18.697822,097,0.6666666666666666,9.727272727272727,-200,-371,960.0
410000.0,3,2.5,1420,1269,3.0,3,7,1420,0.0,2007,1420,1300,5545 days 16:47:18.697822,075,1.2,0.0,0,-31,1420.0
531155.0,4,2.75,2810,5046,2.0,3,9,2810,0.0,2014,3060,4934,2988 days 16:47:18.697822,271,1.4545454545454546,0.0,-250,112,2810.0
358000.0,3,2.5,1400,1529,2.0,3,7,1400,0.0,2005,1440,1536,6275 days 16:47:18.697822,262,1.2,0.0,-40,-7,1400.0
425000.0,3,2.5,1950,5689,2.0,3,7,1950,0.0,2009,2190,5653,4814 days 16:47:18.697822,182,1.2,0.0,-240,36,1950.0
326000.0,3,2.25,1930,3462,2.0,3,7,1930,0.0,2004,1930,2952,6641 days 16:47:18.697822,192,1.3333333333333333,0.0,0,510,1930.0
650000.0,4,2.5,2210,4861,2.0,3,9,2210,0.0,2013,1590,5080,3353 days 16:47:18.697822,133,1.6,0.0,620,-219,2210.0
749950.0,4,3.5,2630,3757,2.0,3,1,2200,430.0,2008,2620,2699,5180 days 16:47:18.697822,134,1.1428571428571428,5.116279069767442,10,1058,1770.0
239950.0,3,1.75,1600,4888,1.0,3,6,1600,0.0,2014,2520,5700,2988 days 16:47:18.697822,071,1.7142857142857142,0.0,-920,-812,1600.0
315000.0,3,2.5,1480,1590,2.0,3,8,1150,330.0,2010,1480,5761,4449 days 16:47:18.697822,160,1.2,3.484848484848485,0,-4171,820.0
375000.0,2,2.5,750,1430,2.0,3,8,750,0.0,2006,1320,2790,5910 days 16:47:18.697822,143,0.8,0.0,-570,-1360,750.0
375000.0,3,1.5,1290,1213,3.0,3,8,1290,0.0,2007,1360,1227,5545 days 16:47:18.697822,117,2.0,0.0,-70,-14,1290.0
349000.0,3,3.25,1340,1151,3.0,3,7,1340,0.0,2008,1290,1200,5180 days 16:47:18.697822,265,0.9230769230769231,0.0,50,-49,1340.0
450000.0,2,1.5,1020,1049,3.0,3,8,1020,0.0,2008,1350,1395,5180 days 16:47:18.697822,056,1.3333333333333333,0.0,-330,-346,1020.0
669950.0,3,3.0,2330,1944,2.5,3,8,1950,380.0,2014,2290,1407,2988 days 16:47:18.697822,287,1.0,5.131578947368421,40,537,1570.0
400000.0,3,2.5,1495,936,3.0,3,8,1405,90.0,2006,1495,1186,5910 days 16:47:18.697822,153,1.2,15.61111111111111,0,-250,1315.0
1020000.0,4,3.5,3770,8501,2.0,3,1,3770,0.0,2008,1520,9660,5180 days 16:47:18.697822,182,1.1428571428571428,0.0,2250,-1159,3770.0
518000.0,5,2.5,2890,13104,2.0,3,8,2890,0.0,2006,3020,9300,5910 days 16:47:18.697822,098,2.0,0.0,-130,3804,2890.0
535000.0,3,2.75,1320,1125,3.0,3,8,1320,0.0,2008,1320,1266,5180 days 16:47:18.697822,225,1.0909090909090908,0.0,0,-141,1320.0
380000.0,4,2.5,3120,5001,2.0,3,9,3120,0.0,2005,3120,5244,6275 days 16:47:18.697822,069,1.6,0.0,0,-243,3120.0
875000.0,5,3.0,2960,15152,2.0,3,9,2960,0.0,2004,1850,9453,6641 days 16:47:18.697822,191,1.6666666666666667,0.0,1110,5699,2960.0
385000.0,3,2.25,1630,1598,3.0,3,8,1630,0.0,2008,1320,1605,5180 days 16:47:18.697822,245,1.3333333333333333,0.0,310,-7,1630.0
1990000.0,5,3.5,5230,8960,2.0,3,1,4450,780.0,2014,2310,9603,2988 days 16:47:18.697822,335,1.4285714285714286,5.705128205128205,2920,-643,3670.0
649500.0,4,3.0,3150,6599,2.0,3,9,3150,0.0,2008,2680,9430,5180 days 16:47:18.697822,128,1.3333333333333333,0.0,470,-2831,3150.0
1050000.0,4,3.75,3280,11000,2.0,3,1,2320,960.0,2008,2400,8351,5180 days 16:47:18.697822,132,1.0666666666666667,2.4166666666666665,880,2649,1360.0
249000.0,3,1.0,1030,24750,1.0,3,5,1030,0.0,1943,2810,28800,28921 days 16:47:18.697822,009,3.0,0.0,-1780,-4050,1030.0
525000.0,4,2.5,3130,5795,2.0,3,9,3130,0.0,2008,2950,5259,5180 days 16:47:18.697822,276,1.6,0.0,180,536,3130.0
402000.0,3,3.5,1240,1666,2.0,3,7,1000,240.0,2008,1110,1027,5180 days 16:47:18.697822,163,0.8571428571428571,4.166666666666667,130,639,760.0
1750000.0,4,2.75,3560,8975,2.0,3,1,3560,0.0,2014,3440,12825,2988 days 16:47:18.697822,305,1.4545454545454546,0.0,120,-3850,3560.0
359800.0,5,2.5,2170,2752,2.0,3,8,2170,0.0,2014,1800,2752,2988 days 16:47:18.697822,293,2.0,0.0,370,0,2170.0
330000.0,3,2.5,1520,3003,2.0,3,7,1520,0.0,2009,1820,3030,4814 days 16:47:18.697822,268,1.2,0.0,-300,-27,1520.0
433000.0,3,2.5,1270,1062,2.0,3,8,1060,210.0,2008,1260,1112,5180 days 16:47:18.697822,084,1.2,5.0476190476190474,10,-50,850.0
1010000.0,4,3.25,3610,4000,2.0,3,9,2640,970.0,2007,1980,4000,5545 days 16:47:18.697822,316,1.2307692307692308,2.7216494845360826,1630,0,1670.0
599832.0,3,2.75,3230,5200,2.0,3,9,2680,550.0,2014,3100,4900,2988 days 16:47:18.697822,096,1.0909090909090908,4.872727272727273,130,300,2130.0
312891.0,5,3.0,2300,8214,2.0,3,8,2300,0.0,2013,2594,4950,3353 days 16:47:18.697822,174,1.6666666666666667,0.0,-294,3264,2300.0
449000.0,2,2.5,1460,1296,2.0,3,8,1160,300.0,2008,1460,1296,5180 days 16:47:18.697822,255,0.8,3.8666666666666667,0,0,860.0
495000.0,3,2.5,1750,1548,3.0,3,9,1750,0.0,2013,1750,3960,3353 days 16:47:18.697822,147,1.2,0.0,0,-2412,1750.0
819995.0,5,2.75,3030,10335,2.0,3,9,3030,0.0,2013,2720,11213,3353 days 16:47:18.697822,135,1.8181818181818181,0.0,310,-878,3030.0
407500.0,3,3.5,1522,1465,2.0,3,8,1248,274.0,2006,1522,1341,5910 days 16:47:18.697822,317,0.8571428571428571,4.554744525547445,0,124,974.0
850000.0,4,3.75,3890,22000,2.0,3,1,3890,0.0,2007,1610,23142,5545 days 16:47:18.697822,005,1.0666666666666667,0.0,2280,-1142,3890.0
1720000.0,5,4.0,4590,35046,2.0,3,1,4590,0.0,2008,3350,35857,5180 days 16:47:18.697822,206,1.25,0.0,1240,-811,4590.0
1460000.0,4,4.0,4620,130208,2.0,3,1,4620,0.0,2014,4620,131007,2988 days 16:47:18.697822,118,1.0,0.0,0,-799,4620.0
579000.0,4,2.75,3220,9825,2.0,3,8,3220,0.0,2012,2820,8566,3719 days 16:47:18.697822,260,1.4545454545454546,0.0,400,1259,3220.0
890776.0,5,2.75,3170,8093,2.0,3,9,3170,0.0,2014,3210,7062,2988 days 16:47:18.697822,223,1.8181818181818181,0.0,-40,1031,3170.0
529000.0,3,1.75,2340,7724,1.0,3,1,2340,0.0,2010,3040,5787,4449 days 16:47:18.697822,121,1.7142857142857142,0.0,-700,1937,2340.0
484000.0,3,2.25,1620,1425,3.0,3,8,1540,80.0,2009,1620,1237,4814 days 16:47:18.697822,086,1.3333333333333333,19.25,0,188,1460.0
400000.0,3,2.5,1910,4408,3.0,3,8,1910,0.0,2007,1910,8154,5545 days 16:47:18.697822,107,1.2,0.0,0,-3746,1910.0
649950.0,3,2.5,2420,6847,2.0,3,9,2420,0.0,2009,1180,8100,4814 days 16:47:18.697822,107,1.2,0.0,1240,-1253,2420.0
915000.0,3,4.5,3850,62726,2.0,3,1,3120,730.0,2013,2630,46609,3353 days 16:47:18.697822,183,0.6666666666666666,4.273972602739726,1220,16117,2390.0
534950.0,5,2.5,3220,10572,2.0,3,8,3220,0.0,2006,2890,9090,5910 days 16:47:18.697822,124,2.0,0.0,330,1482,3220.0
776000.0,4,2.5,3040,6425,2.0,3,8,3040,0.0,2008,3040,7800,5180 days 16:47:18.697822,126,1.6,0.0,0,-1375,3040.0
370000.0,3,1.75,1496,1423,2.0,3,8,1248,248.0,2006,1460,1423,5910 days 16:47:18.697822,121,1.7142857142857142,5.032258064516129,36,0,1000.0
610000.0,3,1.75,1630,1500,3.0,3,8,1630,0.0,2014,1570,1335,2988 days 16:47:18.697822,195,1.7142857142857142,0.0,60,165,1630.0
850000.0,5,3.5,4200,5400,2.0,3,9,3140,1060.0,2012,3300,5564,3719 days 16:47:18.697822,287,1.4285714285714286,2.9622641509433962,900,-164,2080.0
443000.0,3,2.5,2430,7049,2.0,3,8,2430,0.0,2007,1770,7049,5545 days 16:47:18.697822,309,1.2,0.0,660,0,2430.0
1150000.0,5,4.25,4010,8252,2.0,3,1,4010,0.0,2015,3370,8252,2623 days 16:47:18.697822,034,1.1764705882352942,0.0,640,0,4010.0
453000.0,3,2.5,1510,1618,2.5,3,8,1330,180.0,2011,1350,1397,4084 days 16:47:18.697822,213,1.2,7.388888888888889,160,221,1150.0
735000.0,4,3.5,2340,2810,2.0,3,8,1730,610.0,2011,2600,2843,4084 days 16:47:18.697822,100,1.1428571428571428,2.8360655737704916,-260,-33,1120.0
810000.0,2,2.75,2700,8572,1.0,3,9,2700,0.0,2007,2680,8569,5545 days 16:47:18.697822,189,0.7272727272727273,0.0,20,3,2700.0
1560000.0,3,3.5,4360,6240,2.0,3,1,2960,1400.0,2008,1920,3910,5180 days 16:47:18.697822,168,0.8571428571428571,2.1142857142857143,2440,2330,1560.0
2240000.0,5,6.5,7270,130017,2.0,3,1,6420,850.0,2010,1800,44890,4449 days 16:47:18.697822,129,0.7692307692307693,7.552941176470588,5470,85127,5570.0
377500.0,3,2.5,1350,886,3.0,3,8,1270,80.0,2006,1350,886,5910 days 16:47:18.697822,220,1.2,15.875,0,0,1190.0
482000.0,3,3.25,1380,1120,3.0,3,8,1380,0.0,2008,1310,1405,5180 days 16:47:18.697822,169,0.9230769230769231,0.0,70,-285,1380.0
600000.0,2,2.5,1830,1988,2.0,3,9,1530,300.0,2011,1800,2467,4084 days 16:47:18.697822,230,0.8,5.1,30,-479,1230.0
420000.0,3,2.5,1470,1571,2.0,3,8,1180,290.0,2007,1580,4329,5545 days 16:47:18.697822,219,1.2,4.068965517241379,-110,-2758,890.0
480000.0,4,2.5,2940,9172,2.0,3,9,2940,0.0,2006,2660,7955,5910 days 16:47:18.697822,111,1.6,0.0,280,1217,2940.0
406000.0,2,2.0,1110,1095,3.0,3,7,980,130.0,2008,1110,1083,5180 days 16:47:18.697822,090,1.0,7.538461538461538,0,12,850.0
505000.0,4,2.5,2790,5602,2.0,3,8,2790,0.0,2009,2790,5309,4814 days 16:47:18.697822,133,1.6,0.0,0,293,2790.0
1870000.0,4,3.75,3790,8797,2.0,3,1,3290,500.0,2006,2660,12150,5910 days 16:47:18.697822,058,1.0666666666666667,6.58,1130,-3353,2790.0
942990.0,4,2.5,3570,6218,2.0,3,9,3570,0.0,2014,3230,5972,2988 days 16:47:18.697822,349,1.6,0.0,340,246,3570.0
440000.0,3,2.25,1230,1097,3.0,3,8,1230,0.0,2009,1420,1437,4814 days 16:47:18.697822,274,1.3333333333333333,0.0,-190,-340,1230.0
390000.0,3,3.25,1370,913,2.0,3,8,1100,270.0,2006,1370,915,5910 days 16:47:18.697822,177,0.9230769230769231,4.074074074074074,0,-2,830.0
475000.0,3,3.25,1380,1121,3.0,3,8,1380,0.0,2008,1310,1405,5180 days 16:47:18.697822,192,0.9230769230769231,0.0,70,-284,1380.0
420000.0,1,2.0,1070,675,2.0,3,8,880,190.0,2007,1220,788,5545 days 16:47:18.697822,097,0.5,4.631578947368421,-150,-113,690.0
1410000.0,4,4.0,4920,50621,2.0,3,1,4280,640.0,2012,4920,74052,3719 days 16:47:18.697822,237,1.0,6.6875,0,-23431,3640.0
1380000.0,5,3.5,5150,12230,2.0,3,1,3700,1450.0,2007,2940,13462,5545 days 16:47:18.697822,343,1.4285714285714286,2.5517241379310347,2210,-1232,2250.0
462500.0,6,3.0,2390,4000,2.0,3,7,2390,0.0,2014,1680,5000,2988 days 16:47:18.697822,061,2.0,0.0,710,-1000,2390.0
579950.0,4,2.75,2460,8643,2.0,3,9,2460,0.0,2011,3110,8626,4084 days 16:47:18.697822,127,1.4545454545454546,0.0,-650,17,2460.0
861111.0,4,2.5,3650,7090,2.0,3,1,3650,0.0,2008,3860,7272,5180 days 16:47:18.697822,125,1.6,0.0,-210,-182,3650.0
1450000.0,4,3.5,4300,108865,2.0,3,1,4300,0.0,2014,4650,107498,2988 days 16:47:18.697822,328,1.1428571428571428,0.0,-350,1367,4300.0
290000.0,3,2.25,1610,3764,2.0,3,7,1610,0.0,2012,1610,3825,3719 days 16:47:18.697822,118,1.3333333333333333,0.0,0,-61,1610.0
535000.0,4,2.5,2610,4595,2.0,3,8,2610,0.0,2008,2440,4588,5180 days 16:47:18.697822,169,1.6,0.0,170,7,2610.0
585000.0,3,2.5,1750,1381,3.0,3,8,1750,0.0,2008,1940,4800,5180 days 16:47:18.697822,048,1.2,0.0,-190,-3419,1750.0
670000.0,3,2.5,3310,5300,2.0,3,8,2440,870.0,2008,2140,7500,5180 days 16:47:18.697822,174,1.2,2.8045977011494254,1170,-2200,1570.0
3000000.0,4,3.75,5090,14823,1.0,3,1,4180,910.0,2013,3030,12752,3353 days 16:47:18.697822,097,1.0666666666666667,4.593406593406593,2060,2071,3270.0
346000.0,3,2.0,1060,1184,2.0,3,7,730,330.0,2006,1270,1601,5910 days 16:47:18.697822,337,1.5,2.212121212121212,-210,-417,400.0
1330000.0,4,4.0,4420,16526,2.0,3,1,4420,0.0,2013,3510,50447,3353 days 16:47:18.697822,168,1.0,0.0,910,-33921,4420.0
999999.0,3,2.5,2100,4097,2.0,3,9,2100,0.0,2008,1780,4764,5180 days 16:47:18.697822,057,1.2,0.0,320,-667,2100.0
599000.0,3,1.75,1650,1180,3.0,3,8,1650,0.0,2014,1720,1960,2988 days 16:47:18.697822,223,1.7142857142857142,0.0,-70,-780,1650.0
336750.0,2,2.25,1170,1011,2.0,3,7,1170,0.0,2009,1240,750,4814 days 16:47:18.697822,163,0.8888888888888888,0.0,-70,261,1170.0
370000.0,4,2.5,2531,6843,2.0,3,8,2531,0.0,2013,2604,6238,3353 days 16:47:18.697822,345,1.6,0.0,-73,605,2531.0
324000.0,3,2.25,998,904,2.0,3,7,798,200.0,2007,998,1110,5545 days 16:47:18.697822,129,1.3333333333333333,3.99,0,-206,598.0
338500.0,3,2.25,1333,1470,3.0,3,7,1333,0.0,2009,1360,1680,4814 days 16:47:18.697822,050,1.3333333333333333,0.0,-27,-210,1333.0
1880000.0,5,3.5,4410,13000,2.0,3,1,2920,1490.0,2014,5790,12969,2988 days 16:47:18.697822,013,1.4285714285714286,1.9597315436241611,-1380,31,1430.0
402723.0,3,2.75,1160,1073,2.0,3,7,880,280.0,2007,1250,5400,5545 days 16:47:18.697822,100,1.0909090909090908,3.142857142857143,-90,-4327,600.0
715000.0,4,3.25,2630,7770,2.0,3,9,2630,0.0,2014,1370,7770,2988 days 16:47:18.697822,058,1.2307692307692308,0.0,1260,0,2630.0
459000.0,3,1.5,1160,1031,3.0,3,8,1160,0.0,2008,1268,1688,5180 days 16:47:18.697822,280,2.0,0.0,-108,-657,1160.0
589999.0,3,2.5,2140,3628,2.0,3,8,1960,180.0,2006,2280,2812,5910 days 16:47:18.697822,113,1.2,10.88888888888889,-140,816,1780.0
405000.0,4,2.5,1980,5020,2.0,3,7,1980,0.0,2007,1980,5064,5545 days 16:47:18.697822,349,1.6,0.0,0,-44,1980.0
509900.0,3,2.5,3030,9053,2.0,3,8,3030,0.0,2009,3010,6026,4814 days 16:47:18.697822,188,1.2,0.0,20,3027,3030.0
327000.0,2,2.0,1490,1627,2.0,3,8,1190,300.0,2009,1400,1498,4814 days 16:47:18.697822,232,1.0,3.966666666666667,90,129,890.0
1060000.0,2,1.5,2370,184231,2.0,3,1,2370,0.0,2005,3860,151081,6275 days 16:47:18.697822,231,1.3333333333333333,0.0,-1490,33150,2370.0
327500.0,3,2.5,1820,1866,2.0,3,8,1570,250.0,2008,1660,6900,5180 days 16:47:18.697822,365,1.2,6.28,160,-5034,1320.0
249000.0,3,2.0,1260,1125,2.0,3,7,810,450.0,2011,1260,1172,4084 days 16:47:18.697822,210,1.5,1.8,0,-47,360.0
1380000.0,5,4.5,4350,13405,2.0,3,1,4350,0.0,2014,3990,7208,2988 days 16:47:18.697822,358,1.1111111111111112,0.0,360,6197,4350.0
516500.0,1,1.25,1100,638,3.0,3,9,1100,0.0,2014,1110,1933,2988 days 16:47:18.697822,178,0.8,0.0,-10,-1295,1100.0
465000.0,3,2.5,2050,15035,2.0,3,9,2050,0.0,2006,1300,15836,5910 days 16:47:18.697822,099,1.2,0.0,750,-801,2050.0
388000.0,3,2.5,2198,6222,2.0,3,8,2198,0.0,2010,2198,7621,4449 days 16:47:18.697822,220,1.2,0.0,0,-1399,2198.0
549000.0,3,2.25,1230,1380,3.0,3,8,1230,0.0,2013,1760,5664,3353 days 16:47:18.697822,273,1.3333333333333333,0.0,-530,-4284,1230.0
553000.0,2,2.0,1400,1512,2.0,3,8,940,460.0,2006,1400,3500,5910 days 16:47:18.697822,276,1.0,2.0434782608695654,0,-1988,480.0
530000.0,3,2.5,1410,1250,2.0,3,8,1140,270.0,2010,1720,2825,4449 days 16:47:18.697822,112,1.2,4.222222222222222,-310,-1575,870.0
747450.0,3,2.5,2110,1339,2.0,3,8,1410,700.0,2014,1630,2670,2988 days 16:47:18.697822,232,1.2,2.0142857142857142,480,-1331,710.0
305000.0,2,2.5,1590,2656,2.0,3,7,1220,370.0,2009,1590,2306,4814 days 16:47:18.697822,140,0.8,3.2972972972972974,0,350,850.0
540000.0,5,2.5,3370,4850,2.0,3,9,3370,0.0,2007,2900,5570,5545 days 16:47:18.697822,322,2.0,0.0,470,-720,3370.0
750000.0,5,4.0,4500,8130,2.0,3,1,4500,0.0,2007,2840,8402,5545 days 16:47:18.697822,015,1.25,0.0,1660,-272,4500.0
422000.0,4,2.5,2930,5973,2.0,3,1,2930,0.0,2008,3038,7095,5180 days 16:47:18.697822,104,1.6,0.0,-108,-1122,2930.0
337000.0,4,2.5,2470,5100,2.0,3,8,2470,0.0,2005,2240,5123,6275 days 16:47:18.697822,293,1.6,0.0,230,-23,2470.0
579950.0,5,2.75,3080,5752,2.0,3,9,3080,0.0,2014,3000,4650,2988 days 16:47:18.697822,282,1.8181818181818181,0.0,80,1102,3080.0
341780.0,4,2.75,2260,4440,2.0,3,7,2260,0.0,2014,2260,4563,2988 days 16:47:18.697822,057,1.4545454545454546,0.0,0,-123,2260.0
710200.0,4,3.0,1670,2642,2.0,3,8,1350,320.0,2008,1670,2594,5180 days 16:47:18.697822,113,1.3333333333333333,4.21875,0,48,1030.0
690000.0,3,3.25,1540,1428,3.0,3,9,1540,0.0,2013,1660,3300,3353 days 16:47:18.697822,169,0.9230769230769231,0.0,-120,-1872,1540.0
1700000.0,4,3.5,3830,8963,2.0,3,1,3120,710.0,2014,2190,10777,2988 days 16:47:18.697822,030,1.1428571428571428,4.394366197183099,1640,-1814,2410.0
329000.0,2,2.5,980,1020,3.0,3,8,980,0.0,2008,980,1023,5180 days 16:47:18.697822,288,0.8,0.0,0,-3,980.0
330000.0,3,2.5,1450,5008,1.0,3,7,840,610.0,2007,2120,5019,5545 days 16:47:18.697822,133,1.2,1.3770491803278688,-670,-11,230.0
608500.0,4,3.5,2850,5577,2.0,3,8,1950,900.0,2014,2850,5708,2988 days 16:47:18.697822,122,1.1428571428571428,2.1666666666666665,0,-131,1050.0
230000.0,3,1.75,1140,1201,2.0,3,8,1140,0.0,2014,1210,1552,2988 days 16:47:18.697822,188,1.7142857142857142,0.0,-70,-351,1140.0
785000.0,4,3.5,3070,4684,2.0,3,1,2190,880.0,2009,2290,2664,4814 days 16:47:18.697822,140,1.1428571428571428,2.4886363636363638,780,2020,1310.0
610950.0,3,3.0,1680,1570,3.0,3,8,1680,0.0,2014,1640,4800,2988 days 16:47:18.697822,127,1.0,0.0,40,-3230,1680.0
399950.0,3,2.5,3087,5002,2.0,3,8,3087,0.0,2014,2927,5183,2988 days 16:47:18.697822,315,1.2,0.0,160,-181,3087.0
3570000.0,5,4.5,4850,10584,2.0,3,1,3540,1310.0,2007,3470,18270,5545 days 16:47:18.697822,007,1.1111111111111112,2.7022900763358777,1380,-7686,2230.0
579000.0,4,3.25,1900,2631,2.0,3,9,1250,650.0,2014,1710,4502,2988 days 16:47:18.697822,023,1.2307692307692308,1.9230769230769231,190,-1871,600.0
362500.0,2,1.5,940,1768,2.0,3,7,940,0.0,2009,1130,1159,4814 days 16:47:18.697822,174,1.3333333333333333,0.0,-190,609,940.0
645000.0,3,3.25,1730,1229,2.0,3,9,1320,410.0,2008,1710,1686,5180 days 16:47:18.697822,149,0.9230769230769231,3.2195121951219514,20,-457,910.0
594866.0,3,3.0,2780,6000,2.0,3,9,2780,0.0,2013,2850,6000,3353 days 16:47:18.697822,276,1.0,0.0,-70,0,2780.0
625000.0,3,3.0,2780,6000,2.0,3,9,2780,0.0,2013,2850,6000,3353 days 16:47:18.697822,124,1.0,0.0,-70,0,2780.0
490000.0,3,2.25,1500,1290,2.0,3,8,1220,280.0,2006,1460,1375,5910 days 16:47:18.697822,316,1.3333333333333333,4.357142857142857,40,-85,940.0
399950.0,2,1.0,710,1157,2.0,4,7,710,0.0,1943,1370,1173,28921 days 16:47:18.697822,161,2.0,0.0,-660,-16,710.0
380000.0,3,2.5,1260,900,2.0,3,7,940,320.0,2007,1310,1415,5545 days 16:47:18.697822,336,1.2,2.9375,-50,-515,620.0
270000.0,3,2.5,1870,5000,2.0,3,7,1870,0.0,2009,2170,5399,4814 days 16:47:18.697822,240,1.2,0.0,-300,-399,1870.0
505000.0,2,2.5,1430,1201,3.0,3,8,1430,0.0,2009,1430,1249,4814 days 16:47:18.697822,288,0.8,0.0,0,-48,1430.0
385000.0,3,2.5,1520,1488,3.0,3,8,1520,0.0,2006,1520,1497,5910 days 16:47:18.697822,064,1.2,0.0,0,-9,1520.0
414500.0,2,1.5,1210,1278,2.0,3,8,1020,190.0,2007,1210,1118,5545 days 16:47:18.697822,317,1.3333333333333333,5.368421052631579,0,160,830.0
347500.0,3,2.5,2540,4760,2.0,3,8,2540,0.0,2010,2540,4571,4449 days 16:47:18.697822,253,1.2,0.0,0,189,2540.0
1220000.0,4,3.5,4910,9444,1.5,3,1,3110,1800.0,2007,4560,11063,5545 days 16:47:18.697822,134,1.1428571428571428,1.7277777777777779,350,-1619,1310.0
572000.0,4,2.75,2770,3852,2.0,3,8,2770,0.0,2014,1810,5641,2988 days 16:47:18.697822,275,1.4545454545454546,0.0,960,-1789,2770.0
475000.0,3,2.25,1190,1200,3.0,3,8,1190,0.0,2008,1180,1224,5180 days 16:47:18.697822,106,1.3333333333333333,0.0,10,-24,1190.0
1090000.0,5,3.75,4170,8142,2.0,3,1,4170,0.0,2006,3030,7980,5910 days 16:47:18.697822,076,1.3333333333333333,0.0,1140,162,4170.0
350000.0,4,2.75,2500,5995,2.0,3,8,2500,0.0,2008,2530,5988,5180 days 16:47:18.697822,290,1.4545454545454546,0.0,-30,7,2500.0
520000.0,2,2.25,1530,981,3.0,3,8,1480,50.0,2006,1530,1282,5910 days 16:47:18.697822,304,0.8888888888888888,29.6,0,-301,1430.0
679950.0,5,2.75,3600,9437,2.0,3,9,3600,0.0,2014,3550,9421,2988 days 16:47:18.697822,225,1.8181818181818181,0.0,50,16,3600.0
541800.0,4,2.5,3118,7866,2.0,3,9,3118,0.0,2014,2673,6500,2988 days 16:47:18.697822,286,1.6,0.0,445,1366,3118.0
810000.0,4,3.0,3990,7838,2.0,3,9,3990,0.0,2003,3370,6814,7006 days 16:47:18.697822,258,1.3333333333333333,0.0,620,1024,3990.0
1540000.0,5,3.75,4470,8088,2.0,3,1,4470,0.0,2008,2780,8964,5180 days 16:47:18.697822,288,1.3333333333333333,0.0,1690,-876,4470.0
467000.0,3,2.5,1425,1179,3.0,3,8,1425,0.0,2008,1285,1253,5180 days 16:47:18.697822,097,1.2,0.0,140,-74,1425.0
224000.0,3,1.75,1500,11968,1.0,3,6,1500,0.0,2014,1320,11303,2988 days 16:47:18.697822,177,1.7142857142857142,0.0,180,665,1500.0
507250.0,3,2.5,2270,5536,2.0,3,8,2270,0.0,2003,2270,5731,7006 days 16:47:18.697822,237,1.2,0.0,0,-195,2270.0
429000.0,3,2.0,1490,1126,3.0,3,8,1490,0.0,2014,1400,1230,2988 days 16:47:18.697822,026,1.5,0.0,90,-104,1490.0
610685.0,4,2.5,2520,6023,2.0,3,9,2520,0.0,2014,2520,6023,2988 days 16:47:18.697822,287,1.6,0.0,0,0,2520.0
1010000.0,4,3.5,3510,7200,2.0,3,9,2600,910.0,2009,2050,6200,4814 days 16:47:18.697822,085,1.1428571428571428,2.857142857142857,1460,1000,1690.0
475000.0,3,2.5,1310,1294,2.0,3,8,1180,130.0,2008,1330,1265,5180 days 16:47:18.697822,050,1.2,9.076923076923077,-20,29,1050.0
360000.0,3,2.5,1530,1131,3.0,3,8,1530,0.0,2009,1530,1509,4814 days 16:47:18.697822,141,1.2,0.0,0,-378,1530.0
400000.0,4,2.5,2310,5813,2.0,3,8,2310,0.0,2014,1830,7200,2988 days 16:47:18.697822,054,1.6,0.0,480,-1387,2310.0
402101.0,2,0.75,1020,1350,2.0,3,7,1020,0.0,2009,1020,2007,4814 days 16:47:18.697822,174,2.6666666666666665,0.0,0,-657,1020.0
400000.0,3,2.5,1600,2388,2.0,3,8,1600,0.0,2004,1410,1287,6641 days 16:47:18.697822,016,1.2,0.0,190,1101,1600.0
325000.0,2,0.75,1020,1076,2.0,3,7,1020,0.0,2008,1020,1357,5180 days 16:47:18.697822,288,2.6666666666666665,0.0,0,-281,1020.0
